Scaffold	start_pos	end_pos	intergenic_length	upstream_gene	downstream_gene
Super-Scaffold_100001	0	33283	33283	none	g_32457
Super-Scaffold_100001	45828	47152	1324	g_32457	g_32458
Super-Scaffold_100001	54311	58665	4354	g_32458	g_32459
Super-Scaffold_100001	76720	79171	2451	g_32459	g_32460
Super-Scaffold_100001	91822	124925	33103	g_32460	g_32461
Super-Scaffold_100001	131831	134744	2913	g_32461	g_32462
Super-Scaffold_100001	150640	165691	15051	g_32462	g_32463
Super-Scaffold_100001	166731	193351	26620	g_32463	g_32464
Super-Scaffold_100001	212815	227161	14346	g_32464	g_32465
Super-Scaffold_100001	227433	292464	65031	g_32465	g_32468
Super-Scaffold_100001	292952	301538	8586	g_32468	g_32469
Super-Scaffold_100001	302656	303479	823	g_32469	g_32470
Super-Scaffold_100001	303814	406153	102339	g_32470	g_32475
Super-Scaffold_100001	406572	463049	56477	g_32475	g_32476
Super-Scaffold_100001	504008	507506	3498	g_32476	g_42525
Super-Scaffold_100001	508075	571949	63874	g_42525	g_32479
Super-Scaffold_100001	584226	592387	8161	g_32479	g_32480
Super-Scaffold_100001	593451	669756	76305	g_32480	g_32482
Super-Scaffold_100001	690923	705447	14524	g_32482	g_32483
Super-Scaffold_100001	716128	774708	58580	g_32483	g_42528
Super-Scaffold_100001	774959	776541	1582	g_42528	g_32486
Super-Scaffold_100001	776900	789256	12356	g_32486	g_32488
Super-Scaffold_100001	789792	912691	122899	g_32488	g_32490
Super-Scaffold_100001	913886	964455	50569	g_32490	g_32493
Super-Scaffold_100001	967619	969483	1864	g_32493	g_32494
Super-Scaffold_100001	971862	971915	53	g_32494	g_32495
Super-Scaffold_100001	972549	1035258	62709	g_32495	g_32497
Super-Scaffold_100001	1038597	1045662	7065	g_32497	g_45523
Super-Scaffold_100001	1046006	1091714	45708	g_45523	g_32499
Super-Scaffold_100001	1094310	1173469	79159	g_32499	g_32500
Super-Scaffold_100001	1188578	1273261	84683	g_32500	g_32501
Super-Scaffold_100001	1288417	1317520	29103	g_32501	g_32502
Super-Scaffold_100001	1318320	1318472	152	g_32502	g_45524
Super-Scaffold_100001	1318897	1340944	22047	g_45524	g_32503
Super-Scaffold_100001	1352264	1360343	8079	g_32503	g_32504
Super-Scaffold_100001	1361527	1381047	19520	g_32504	g_32506
Super-Scaffold_100001	1381928	1405827	23899	g_32506	g_32507
Super-Scaffold_100001	1406231	1406318	87	g_32507	g_32508
Super-Scaffold_100001	1406821	1421261	14440	g_32508	g_32509
Super-Scaffold_100001	1421476	1439408	17932	g_32509	g_32511
Super-Scaffold_100001	1441787	1467631	25844	g_32511	g_32512
Super-Scaffold_100001	1468137	1495975	27838	g_32512	g_32513
Super-Scaffold_100001	1511357	1548762	37405	g_32513	g_32516
Super-Scaffold_100001	1549022	1549091	69	g_32516	g_32517
Super-Scaffold_100001	1549732	1555972	6240	g_32517	g_32518
Super-Scaffold_100001	1560862	1603323	42461	g_32518	g_32519
Super-Scaffold_100001	1604912	1605231	319	g_32519	g_32520
Super-Scaffold_100001	1607132	1645460	38328	g_32520	g_32522
Super-Scaffold_100001	1645669	1674964	29295	g_32522	g_42536
Super-Scaffold_100001	1675248	1681073	5825	g_42536	g_32524
Super-Scaffold_100001	1682683	1703078	20395	g_32524	g_42537
Super-Scaffold_100001	1703467	1717044	13577	g_42537	g_32525
Super-Scaffold_100001	1721760	1724384	2624	g_32525	g_32526
Super-Scaffold_100001	1725591	1746419	20828	g_32526	g_32527
Super-Scaffold_100001	1762765	1763792	1027	g_32527	g_32528
Super-Scaffold_100001	1764289	1772575	8286	g_32528	g_32529
Super-Scaffold_100001	1776864	1791172	14308	g_32529	g_32530
Super-Scaffold_100001	1793857	1825041	31184	g_42538	g_32531
Super-Scaffold_100001	1829431	1831986	2555	g_32531	g_32532
Super-Scaffold_100001	1850091	1864827	14736	g_32532	g_32533
Super-Scaffold_100001	1869635	1881410	11775	g_32533	g_32534
Super-Scaffold_100001	1881646	1903174	21528	g_32534	g_32536
Super-Scaffold_100001	1910368	1917852	7484	g_32536	g_32537
Super-Scaffold_100001	1921209	2018692	97483	g_32537	g_32538
Super-Scaffold_100001	2025027	2066450	41423	g_32538	g_32539
Super-Scaffold_100001	2066734	2066767	33	g_32539	g_32540
Super-Scaffold_100001	2070319	2095287	24968	g_32540	g_32542
Super-Scaffold_100001	2095571	2201283	105712	g_32542	g_32544
Super-Scaffold_100001	2201660	2300985	99325	g_32544	g_32548
Super-Scaffold_100001	2301893	2301966	73	g_32548	g_45525
Super-Scaffold_100001	2304651	2332075	27424	g_45525	g_32549
Super-Scaffold_100001	2332479	2428367	95888	g_32549	g_32550
Super-Scaffold_100001	2431278	2523020	91742	g_32550	g_32551
Super-Scaffold_100001	2526277	2555085	28808	g_32551	g_32553
Super-Scaffold_100001	2555528	2555589	61	g_32553	g_32552
Super-Scaffold_100001	2556857	2685621	128764	g_32552	g_32554
Super-Scaffold_100001	2686010	2719844	33834	g_32554	g_32555
Super-Scaffold_100001	2721825	2755738	33913	g_32555	g_32556
Super-Scaffold_100001	2756621	2756854	233	g_32556	g_45526
Super-Scaffold_100001	2760340	2785055	24715	g_45526	g_32557
Super-Scaffold_100001	2785450	2898997	113547	g_32557	g_32561
Super-Scaffold_100001	2900090	2900369	279	g_32561	g_32562
Super-Scaffold_100001	2900932	2933487	32555	g_32562	g_32563
Super-Scaffold_100001	2933768	2985761	51993	g_32563	g_32565
Super-Scaffold_100001	2988504	3028494	39990	g_32565	g_32567
Super-Scaffold_100001	3031449	3061263	29814	g_32567	g_32569
Super-Scaffold_100001	3075930	3076390	460	g_32569	g_32570
Super-Scaffold_100001	3076656	3078692	2036	g_32570	g_32572
Super-Scaffold_100001	3080512	3088067	7555	g_32572	g_32573
Super-Scaffold_100001	3090733	3126594	35861	g_32573	g_32574
Super-Scaffold_100001	3130131	3134114	3983	g_32574	g_32575
Super-Scaffold_100001	3137897	3143266	5369	g_32575	g_32576
Super-Scaffold_100001	3144726	3146456	1730	g_32576	g_32577
Super-Scaffold_100001	3154149	3157532	3383	g_32577	g_32578
Super-Scaffold_100001	3161656	3163209	1553	g_32578	g_32579
Super-Scaffold_100001	3171375	3174961	3586	g_32579	g_32580
Super-Scaffold_100001	3185751	3190360	4609	g_32580	g_32581
Super-Scaffold_100001	3191322	3193534	2212	g_32581	g_32582
Super-Scaffold_100001	3194736	3202718	7982	g_32582	g_32583
Super-Scaffold_100001	3213081	3240591	27510	g_32583	g_32585
Super-Scaffold_100001	3248373	3266138	17765	g_32585	g_32587
Super-Scaffold_100001	3266365	3318120	51755	g_32587	g_32589
Super-Scaffold_100001	3318383	3323885	5502	g_32589	g_42551
Super-Scaffold_100001	3324295	3334030	9735	g_42551	g_32590
Super-Scaffold_100001	3334323	3360099	25776	g_32590	g_32591
Super-Scaffold_100001	3362468	3364633	2165	g_32591	g_32592
Super-Scaffold_100001	3372155	3376074	3919	g_32592	g_32593
Super-Scaffold_100001	3385671	3388376	2705	g_32593	g_32594
Super-Scaffold_100001	3394679	3443939	49260	g_32594	g_42555
Super-Scaffold_100001	3444160	3445058	898	g_42555	g_32595
Super-Scaffold_100001	3470994	3508544	37550	g_32595	g_32599
Super-Scaffold_100001	3508953	3516501	7548	g_32599	g_32600
Super-Scaffold_100001	3523045	3532001	8956	g_32600	g_45527
Super-Scaffold_100001	3532210	3554937	22727	g_45527	g_32601
Super-Scaffold_100001	3555254	3564790	9536	g_32601	g_42556
Super-Scaffold_100001	3564990	3587614	22624	g_42556	g_32602
Super-Scaffold_100001	3590623	3625440	34817	g_32602	g_32603
Super-Scaffold_100001	3625733	3652256	26523	g_32603	g_32604
Super-Scaffold_100001	3657560	3753396	95836	g_32604	g_32607
Super-Scaffold_100001	3753836	3797745	43909	g_32607	g_32608
Super-Scaffold_100001	3803407	3881757	78350	g_32608	g_32609
Super-Scaffold_100001	3885798	3891148	5350	g_32609	g_45528
Super-Scaffold_100001	3893539	3895233	1694	g_45528	g_32610
Super-Scaffold_100001	3934718	3950442	15724	g_32610	g_32611
Super-Scaffold_100001	3951547	3976786	25239	g_32611	g_45529
Super-Scaffold_100001	3997481	4008652	11171	g_45529	g_32612
Super-Scaffold_100001	4019932	4020953	1021	g_32612	g_32613
Super-Scaffold_100001	4022008	4023821	1813	g_32613	g_32615
Super-Scaffold_100001	4024408	4024733	325	g_32615	g_32616
Super-Scaffold_100001	4025356	4026881	1525	g_32616	g_32618
Super-Scaffold_100001	4027504	4027838	334	g_32618	g_32619
Super-Scaffold_100001	4028173	4028498	325	g_32619	g_32620
Super-Scaffold_100001	4048678	4070659	21981	g_32620	g_32621
Super-Scaffold_100001	4079166	4080946	1780	g_32621	g_32622
Super-Scaffold_100001	4095407	4124189	28782	g_32622	g_32624
Super-Scaffold_100001	4124431	4138056	13625	g_32624	g_32625
Super-Scaffold_100001	4139648	4161373	21725	g_32625	g_32626
Super-Scaffold_100001	4185710	4188046	2336	g_32626	g_32627
Super-Scaffold_100001	4188318	4198393	10075	g_32627	g_32629
Super-Scaffold_100001	4198929	4199942	1013	g_32629	g_32630
Super-Scaffold_100001	4200241	4203903	3662	g_32630	g_45530
Super-Scaffold_100001	4223358	4234041	10683	g_45530	g_32631
Super-Scaffold_100001	4258621	4332664	74043	g_32631	g_32634
Super-Scaffold_100001	4338585	4374098	35513	g_32634	g_42559
Super-Scaffold_100001	4374829	4410538	35709	g_42559	g_32635
Super-Scaffold_100001	4411067	4418022	6955	g_32635	g_32636
Super-Scaffold_100001	4418911	4464240	45329	g_32636	g_32638
Super-Scaffold_100001	4464553	4501541	36988	g_32638	g_32639
Super-Scaffold_100001	4508223	4524851	16628	g_32639	g_32640
Super-Scaffold_100001	4535892	4537846	1954	g_32640	g_45531
Super-Scaffold_100001	4548584	4561377	12793	g_45531	g_32641
Super-Scaffold_100001	4563001	4652918	89917	g_32641	g_32643
Super-Scaffold_100001	4653622	4663540	9918	g_32643	g_32644
Super-Scaffold_100001	4666760	4699843	33083	g_32644	g_32645
Super-Scaffold_100001	4704599	4747723	43124	g_32645	g_32646
Super-Scaffold_100001	4752909	4755686	2777	g_32646	g_45532
Super-Scaffold_100001	4758284	4771089	12805	g_45532	g_32647
Super-Scaffold_100001	4771541	4776420	4879	g_32647	g_45533
Super-Scaffold_100001	4780851	4783622	2771	g_45533	g_45534
Super-Scaffold_100001	4803692	4811161	7469	g_45534	g_32648
Super-Scaffold_100001	4814890	4817043	2153	g_32648	g_32649
Super-Scaffold_100001	4819789	4824280	4491	g_32649	g_32650
Super-Scaffold_100001	4828158	4885315	57157	g_32650	g_32651
Super-Scaffold_100001	4889192	4889411	219	g_32651	g_45535
Super-Scaffold_100001	4891183	4903182	11999	g_45535	g_32652
Super-Scaffold_100001	4908368	4918024	9656	g_32652	g_32653
Super-Scaffold_100001	4919524	4948890	29366	g_42561	g_32654
Super-Scaffold_100001	4949777	4950952	1175	g_32654	g_45536
Super-Scaffold_100001	4952016	4966510	14494	g_45536	g_32656
Super-Scaffold_100001	4969013	4977144	8131	g_32656	g_45537
Super-Scaffold_100001	4984626	4985600	974	g_45537	g_32657
Super-Scaffold_100001	4986865	4990857	3992	g_32657	g_32658
Super-Scaffold_100001	5019632	5042468	22836	g_32658	g_32660
Super-Scaffold_100001	5049429	5075116	25687	g_32660	g_32661
Super-Scaffold_100001	5092634	5109412	16778	g_32661	g_32662
Super-Scaffold_100001	5119568	5120558	990	g_32662	g_32663
Super-Scaffold_100001	5124190	5136423	12233	g_32663	g_32664
Super-Scaffold_100001	5136842	5148159	11317	g_32664	g_32665
Super-Scaffold_100001	5182120	5218041	35921	g_32665	g_32666
Super-Scaffold_100001	5226873	5230070	3197	g_32666	g_32667
Super-Scaffold_100001	5250863	5255910	5047	g_32667	g_32668
Super-Scaffold_100001	5257117	5262522	5405	g_32668	g_32669
Super-Scaffold_100001	5264826	5265434	608	g_32669	g_32670
Super-Scaffold_100001	5270981	5272466	1485	g_32670	g_32671
Super-Scaffold_100001	5280410	5492565	212155	g_32671	g_32672
Super-Scaffold_100001	5493314	5625839	132525	g_32672	g_32675
Super-Scaffold_100001	5626234	5870209	243975	g_32675	g_32680
Super-Scaffold_100001	5870607	5966903	96296	g_32680	g_32685
Super-Scaffold_100001	5967169	6006410	39241	g_32685	g_32687
Super-Scaffold_100001	6007480	6211834	204354	g_32687	g_32690
Super-Scaffold_100001	6212115	6228958	16843	g_32690	g_32691
Super-Scaffold_100001	6233791	6338784	104993	g_32691	g_32695
Super-Scaffold_100001	6339197	6365087	25890	g_32695	g_32696
Super-Scaffold_100001	6365374	6368141	2767	g_32696	g_32697
Super-Scaffold_100001	6369478	6369866	388	g_32697	g_32698
Super-Scaffold_100001	6371059	6371181	122	g_32698	g_32699
Super-Scaffold_100001	6371435	6418844	47409	g_32699	g_32700
Super-Scaffold_100001	6419104	6684146	265042	g_32700	g_32703
Super-Scaffold_100001	6685168	6686216	1048	g_32703	g_32704
Super-Scaffold_100001	6687616	6687653	37	g_32704	g_32705
Super-Scaffold_100001	6687991	6766253	78262	g_32705	g_32706
Super-Scaffold_100001	6791202	6819361	28159	g_32706	g_32708
Super-Scaffold_100001	6852407	6874575	22168	g_32708	g_45538
Super-Scaffold_100001	6876006	6884614	8608	g_45538	g_32709
Super-Scaffold_100001	6896317	6923539	27222	g_32709	g_32710
Super-Scaffold_100001	6977011	7019131	42120	g_32710	g_32711
Super-Scaffold_100001	7118140	7133090	14950	g_32711	g_32713
Super-Scaffold_100001	7133881	7154900	21019	g_32713	g_32714
Super-Scaffold_100001	7155169	7173925	18756	g_32714	g_32715
Super-Scaffold_100001	7175834	7177825	1991	g_32715	g_32716
Super-Scaffold_100001	7196484	7273096	76612	g_32716	g_32718
Super-Scaffold_100001	7273311	7474989	201678	g_32718	g_32720
Super-Scaffold_100001	7475264	7626414	151150	g_32720	g_32722
Super-Scaffold_100001	7627482	7654842	27360	g_32722	g_32724
Super-Scaffold_100001	7655530	7655676	146	g_32724	g_32725
Super-Scaffold_100001	7656740	7792858	136118	g_32725	g_32729
Super-Scaffold_100001	7818538	7913692	95154	g_32729	g_32732
Super-Scaffold_100001	7920490	8016890	96400	g_32732	g_32735
Super-Scaffold_100001	8040588	8044849	4261	g_32735	g_32736
Super-Scaffold_100001	8058281	8067189	8908	g_32736	g_32737
Super-Scaffold_100001	8091903	8094801	2898	g_32737	g_32738
Super-Scaffold_100001	8107544	8108284	740	g_32738	g_32739
Super-Scaffold_100001	8117984	8126251	8267	g_32739	g_32740
Super-Scaffold_100001	8135581	8140565	4984	g_32740	g_32741
Super-Scaffold_100001	8165362	8176697	11335	g_32741	g_32742
Super-Scaffold_100001	8177857	8183702	5845	g_32742	g_32743
Super-Scaffold_100001	8187167	8191968	4801	g_32743	g_32744
Super-Scaffold_100001	8212861	8260615	47754	g_32744	g_32745
Super-Scaffold_100001	8261115	8277271	16156	g_32745	g_32746
Super-Scaffold_100001	8350179	8361045	10866	g_32746	g_32747
Super-Scaffold_100001	8362937	8370628	7691	g_32747	g_32748
Super-Scaffold_100001	8383684	8394191	10507	g_32748	g_32749
Super-Scaffold_100001	8408956	8430488	21532	g_32749	g_32750
Super-Scaffold_100001	8441938	8443184	1246	g_32750	g_32751
Super-Scaffold_100001	8444844	8473132	28288	g_32751	g_32752
Super-Scaffold_100001	8473377	8502151	28774	g_32752	g_32753
Super-Scaffold_100001	8502963	8513173	10210	g_32753	g_32754
Super-Scaffold_100001	8513997	8518190	4193	g_32754	g_32755
Super-Scaffold_100001	8518599	8643607	125008	g_32755	g_32758
Super-Scaffold_100001	8643930	8686914	42984	g_32758	g_32759
Super-Scaffold_100001	8687927	8699997	12070	g_32759	g_32761
Super-Scaffold_100001	8702391	8702647	256	g_32761	g_32762
Super-Scaffold_100001	8703446	8774967	71521	g_32762	g_32763
Super-Scaffold_100001	8775263	8807611	32348	g_32763	g_32764
Super-Scaffold_100001	8807820	8817187	9367	g_32764	g_32765
Super-Scaffold_100001	8817408	8859814	42406	g_32765	g_32767
Super-Scaffold_100001	8860158	8885989	25831	g_32767	g_32768
Super-Scaffold_100001	8903820	8926923	23103	g_32768	g_45539
Super-Scaffold_100001	8933209	9026493	93284	g_45539	g_42586
Super-Scaffold_100001	9026801	9145345	118544	g_42586	g_32772
Super-Scaffold_100001	9146805	9292725	145920	g_32773	g_32774
Super-Scaffold_100001	9293429	9618605	325176	g_32774	g_32777
Super-Scaffold_100001	9619132	9667172	48040	g_32777	g_32778
Super-Scaffold_100001	9689812	9691973	2161	g_32778	g_32780
Super-Scaffold_100001	9692191	9750056	57865	g_32780	g_32781
Super-Scaffold_100001	9751878	9852499	100621	g_32781	g_32782
Super-Scaffold_100001	9852864	9933419	80555	g_32782	g_32784
Super-Scaffold_100001	9953086	10021273	68187	g_32784	g_32785
Super-Scaffold_100001	10024744	10135862	111118	g_32785	g_32787
Super-Scaffold_100001	10137959	10204125	66166	g_32787	g_32789
Super-Scaffold_100001	10213026	10215949	2923	g_32789	g_32790
Super-Scaffold_100001	10216206	10216803	597	g_32790	g_32791
Super-Scaffold_100001	10239981	10241417	1436	g_32791	g_32792
Super-Scaffold_100001	10241653	10247099	5446	g_32792	g_32793
Super-Scaffold_100001	10264824	10275344	10520	g_32793	g_32794
Super-Scaffold_100001	10288917	10345782	56865	g_32794	g_32796
Super-Scaffold_100001	10380391	10433839	53448	g_32796	g_32798
Super-Scaffold_100001	10434567	10452030	17463	g_32798	g_42593
Super-Scaffold_100001	10452296	10457364	5068	g_42593	g_32799
Super-Scaffold_100001	10459508	10479032	19524	g_32799	g_32800
Super-Scaffold_100001	10499389	10532171	32782	g_32800	g_32801
Super-Scaffold_100001	10538207	10549513	11306	g_32801	g_45540
Super-Scaffold_100001	10560157	10585784	25627	g_45540	g_32804
Super-Scaffold_100001	10621915	10623377	1462	g_32804	g_45541
Super-Scaffold_100001	10623628	10643487	19859	g_45541	g_42594
Super-Scaffold_100001	10643699	10660840	17141	g_42594	g_32807
Super-Scaffold_100001	10665205	10680089	14884	g_32807	g_32809
Super-Scaffold_100001	10696679	10700232	3553	g_32809	g_32810
Super-Scaffold_100001	10700759	10701946	1187	g_32810	g_32811
Super-Scaffold_100001	10702260	10717907	15647	g_32811	g_32812
Super-Scaffold_100001	10725800	10726067	267	g_32812	g_42598
Super-Scaffold_100001	10726360	10735795	9435	g_42598	g_32813
Super-Scaffold_100001	10736418	10739398	2980	g_32813	g_32815
Super-Scaffold_100001	10739604	10740448	844	g_32815	g_32816
Super-Scaffold_100001	10740705	10769431	28726	g_32816	g_32817
Super-Scaffold_100001	10770234	10772732	2498	g_32817	g_32818
Super-Scaffold_100001	10773544	10776046	2502	g_32818	g_32819
Super-Scaffold_100001	10776855	10786472	9617	g_32819	g_32820
Super-Scaffold_100001	10787278	10789779	2501	g_32820	g_32821
Super-Scaffold_100001	10790585	10793086	2501	g_32821	g_32822
Super-Scaffold_100001	10793886	10796387	2501	g_32822	g_32823
Super-Scaffold_100001	10797190	10799686	2496	g_32823	g_32824
Super-Scaffold_100001	10800495	10802984	2489	g_32824	g_32825
Super-Scaffold_100001	10803796	10806298	2502	g_32825	g_32826
Super-Scaffold_100001	10807143	10809642	2499	g_32826	g_32827
Super-Scaffold_100001	10810556	10816364	5808	g_32827	g_42599
Super-Scaffold_100001	10816888	10825082	8194	g_42599	g_32830
Super-Scaffold_100001	10825544	10825740	196	g_32830	g_32831
Super-Scaffold_100001	10826387	10827435	1048	g_32831	g_32832
Super-Scaffold_100001	10828445	10868976	40531	g_32832	g_32833
Super-Scaffold_100001	10870283	10911999	41716	g_32833	g_32834
Super-Scaffold_100001	10914910	10938152	23242	g_32834	g_32835
Super-Scaffold_100001	10938602	10938883	281	g_32835	g_32836
Super-Scaffold_100001	10939554	10947666	8112	g_32836	g_32837
Super-Scaffold_100001	10949711	10951603	1892	g_32837	g_45542
Super-Scaffold_100001	10957762	10959892	2130	g_45542	g_32838
Super-Scaffold_100001	10998499	11001130	2631	g_32838	g_32839
Super-Scaffold_100001	11004398	11011356	6958	g_32839	g_32840
Super-Scaffold_100001	11014215	11026427	12212	g_32840	g_32841
Super-Scaffold_100001	11029151	11033186	4035	g_32841	g_32842
Super-Scaffold_100001	11034739	11044150	9411	g_32842	g_32843
Super-Scaffold_100001	11048570	11059514	10944	g_32843	g_32844
Super-Scaffold_100001	11061744	11064167	2423	g_32844	g_32845
Super-Scaffold_100001	11064556	11076944	12388	g_32845	g_32846
Super-Scaffold_100001	11100120	11144777	44657	g_32846	g_32847
Super-Scaffold_100001	11156637	11159544	2907	g_32847	g_45543
Super-Scaffold_100001	11161960	11208381	46421	g_45543	g_32848
Super-Scaffold_100001	11223364	11227501	4137	g_32848	g_32849
Super-Scaffold_100001	11296539	11306703	10164	g_32849	g_32850
Super-Scaffold_100001	11313345	11316734	3389	g_32850	g_32851
Super-Scaffold_100001	11320555	11321954	1399	g_32851	g_32852
Super-Scaffold_100001	11328104	11496364	168260	g_32852	g_32856
Super-Scaffold_100001	11518768	11520382	1614	g_32856	g_32857
Super-Scaffold_100001	11525851	11528251	2400	g_32857	g_32858
Super-Scaffold_100001	11533587	11536254	2667	g_32858	g_32859
Super-Scaffold_100001	11540226	11541014	788	g_32859	g_32860
Super-Scaffold_100001	11543250	11546644	3394	g_32860	g_32861
Super-Scaffold_100001	11562236	11562524	288	g_32861	g_32862
Super-Scaffold_100001	11575758	11578296	2538	g_32862	g_32863
Super-Scaffold_100001	11588785	11592251	3466	g_32863	g_32864
Super-Scaffold_100001	11604258	11621803	17545	g_32864	g_32865
Super-Scaffold_100001	11622285	11638798	16513	g_32865	g_32867
Super-Scaffold_100001	11640267	11640444	177	g_32867	g_32868
Super-Scaffold_100001	11658125	11672547	14422	g_32868	g_32870
Super-Scaffold_100001	11679892	11686299	6407	g_32870	g_32871
Super-Scaffold_100001	11694213	11709335	15122	g_32871	g_32873
Super-Scaffold_100001	11726936	11732385	5449	g_32873	g_32874
Super-Scaffold_100001	11754153	11765988	11835	g_32874	g_32876
Super-Scaffold_100001	11771651	11775138	3487	g_32876	g_32877
Super-Scaffold_100001	11832547	11862292	29745	g_32877	g_32879
Super-Scaffold_100001	11864686	11867220	2534	g_32879	g_32880
Super-Scaffold_100001	11873992	11908309	34317	g_32880	g_32882
Super-Scaffold_100001	11909223	11911143	1920	g_32882	g_32883
Super-Scaffold_100001	11916783	11943502	26719	g_32883	g_42604
Super-Scaffold_100001	11943750	11959390	15640	g_42604	g_32884
Super-Scaffold_100001	11966058	11979718	13660	g_32884	g_32885
Super-Scaffold_100001	11983389	11997739	14350	g_32885	g_32886
Super-Scaffold_100001	12001256	12003412	2156	g_32886	g_32887
Super-Scaffold_100001	12008355	12048242	39887	g_32887	g_32888
Super-Scaffold_100001	12050261	12108272	58011	g_32888	g_32889
Super-Scaffold_100001	12110448	12121423	10975	g_32889	g_32890
Super-Scaffold_100001	12126323	12128120	1797	g_32890	g_45544
Super-Scaffold_100001	12133293	12135506	2213	g_45544	g_32891
Super-Scaffold_100001	12135919	12142166	6247	g_32891	g_32893
Super-Scaffold_100001	12150684	12151644	960	g_32893	g_45545
Super-Scaffold_100001	12160510	12161029	519	g_45545	g_32894
Super-Scaffold_100001	12163602	12168709	5107	g_32894	g_32895
Super-Scaffold_100001	12174360	12174999	639	g_32895	g_32896
Super-Scaffold_100001	12177111	12187759	10648	g_32896	g_32897
Super-Scaffold_100001	12188178	12188275	97	g_32897	g_32898
Super-Scaffold_100001	12211517	12221214	9697	g_32898	g_32899
Super-Scaffold_100001	12221603	12223790	2187	g_32899	g_32900
Super-Scaffold_100001	12238394	12284353	45959	g_32900	g_32902
Super-Scaffold_100001	12305211	12311168	5957	g_32902	g_32903
Super-Scaffold_100001	12311533	12324347	12814	g_32903	g_32904
Super-Scaffold_100001	12332701	12341849	9148	g_32904	g_32905
Super-Scaffold_100001	12378554	12397735	19181	g_32906	g_32907
Super-Scaffold_100001	12399829	12433185	33356	g_32907	g_32908
Super-Scaffold_100001	12434106	12443835	9729	g_32908	g_32909
Super-Scaffold_100001	12445672	12446502	830	g_32909	g_32910
Super-Scaffold_100001	12453683	12454738	1055	g_32910	g_32911
Super-Scaffold_100001	12474717	12514666	39949	g_32911	g_32915
Super-Scaffold_100001	12525671	12545098	19427	g_32915	g_32916
Super-Scaffold_100001	12561500	12578429	16929	g_32916	g_32917
Super-Scaffold_100001	12583683	12583803	120	g_32917	g_32918
Super-Scaffold_100001	12592796	12600349	7553	g_32918	g_32919
Super-Scaffold_100001	12613333	12628383	15050	g_32919	g_32920
Super-Scaffold_100001	12637553	12691212	53659	g_32920	g_32921
Super-Scaffold_100001	12699031	12704023	4992	g_32921	g_32922
Super-Scaffold_100001	12712719	12724055	11336	g_32922	g_32923
Super-Scaffold_100001	12734444	12740515	6071	g_32923	g_32924
Super-Scaffold_100001	12743934	12744434	500	g_32924	g_32925
Super-Scaffold_100001	12749583	12757967	8384	g_32925	g_32926
Super-Scaffold_100001	12758347	12758559	212	g_32926	g_32927
Super-Scaffold_100001	12769851	12774777	4926	g_32927	g_32928
Super-Scaffold_100001	12775001	12776244	1243	g_32928	g_32929
Super-Scaffold_100001	12778001	12782698	4697	g_32929	g_32930
Super-Scaffold_100001	12792385	12796495	4110	g_32930	g_32931
Super-Scaffold_100001	12801028	12825882	24854	g_32931	g_32932
Super-Scaffold_100001	12828120	12832755	4635	g_42607	g_32933
Super-Scaffold_100001	12834503	12863129	28626	g_32933	g_32936
Super-Scaffold_100001	12867151	12868813	1662	g_32936	g_32937
Super-Scaffold_100001	12872841	12885492	12651	g_32937	g_32938
Super-Scaffold_100001	12889149	12900052	10903	g_32938	g_32940
Super-Scaffold_100001	12900333	12904743	4410	g_32940	g_32941
Super-Scaffold_100001	12913971	12918735	4764	g_32941	g_32942
Super-Scaffold_100001	12918980	12941369	22389	g_32942	g_32943
Super-Scaffold_100001	12964573	12974617	10044	g_32943	g_32945
Super-Scaffold_100001	12988894	12995118	6224	g_32945	g_32946
Super-Scaffold_100001	13015082	13019821	4739	g_32946	g_32947
Super-Scaffold_100001	13021011	13054643	33632	g_32947	g_32948
Super-Scaffold_100001	13105979	13110696	4717	g_32948	g_32949
Super-Scaffold_100001	13115576	13128050	12474	g_32949	g_32950
Super-Scaffold_100001	13137910	13140236	2326	g_32950	g_32951
Super-Scaffold_100001	13147569	13166766	19197	g_32951	g_32952
Super-Scaffold_100001	13171111	13188692	17581	g_42610	g_32954
Super-Scaffold_100001	13194096	13198500	4404	g_32954	g_45546
Super-Scaffold_100001	13212631	13215960	3329	g_45546	g_32955
Super-Scaffold_100001	13218098	13262224	44126	g_32955	g_32956
Super-Scaffold_100001	13262451	13287639	25188	g_32956	g_32957
Super-Scaffold_100001	13287956	13301558	13602	g_32957	g_32958
Super-Scaffold_100001	13302007	13304411	2404	g_32958	g_32959
Super-Scaffold_100001	13326914	13347241	20327	g_32959	g_42612
Super-Scaffold_100001	13347444	13391707	44263	g_42612	g_42613
Super-Scaffold_100001	13391982	13403489	11507	g_42613	g_32963
Super-Scaffold_100001	13405084	13415606	10522	g_32963	g_32964
Super-Scaffold_100001	13419012	13421981	2969	g_32964	g_32965
Super-Scaffold_100001	13428363	13459286	30923	g_32965	g_42615
Super-Scaffold_100001	13459525	13497311	37786	g_42615	g_32967
Super-Scaffold_100001	13497514	13543000	45486	g_32967	g_32968
Super-Scaffold_100001	13543200	13543792	592	g_32968	g_32969
Super-Scaffold_100001	13544016	13593086	49070	g_32969	g_32971
Super-Scaffold_100001	13646378	13649424	3046	g_32971	g_32972
Super-Scaffold_100001	13652046	13671846	19800	g_32972	g_32975
Super-Scaffold_100001	13672166	13684431	12265	g_32975	g_32976
Super-Scaffold_100001	13688020	13692458	4438	g_32976	g_32977
Super-Scaffold_100001	13707225	13720302	13077	g_32977	g_42618
Super-Scaffold_100001	13720664	13752529	31865	g_42618	g_32980
Super-Scaffold_100001	13770301	14017638	247337	g_32980	g_32984
Super-Scaffold_100001	14033296	14049834	16538	g_32984	g_32985
Super-Scaffold_100001	14052480	14054376	1896	g_32985	g_45547
Super-Scaffold_100001	14067009	14092153	25144	g_45547	g_32986
Super-Scaffold_100001	14098287	14151833	53546	g_32986	g_32987
Super-Scaffold_100001	14168912	14205559	36647	g_32987	g_32988
Super-Scaffold_100001	14224656	14240797	16141	g_32988	g_32989
Super-Scaffold_100001	14241141	14277239	36098	g_32989	g_32990
Super-Scaffold_100001	14277559	14333571	56012	g_32990	g_32992
Super-Scaffold_100001	14334164	14413041	78877	g_32992	g_32995
Super-Scaffold_100001	14415243	14558647	143404	g_32995	g_32996
Super-Scaffold_100001	14562780	14626200	63420	g_32996	g_32999
Super-Scaffold_100001	14626445	14630523	4078	g_32999	g_33000
Super-Scaffold_100001	14630762	14636477	5715	g_33000	g_33001
Super-Scaffold_100001	14638066	14638392	326	g_33001	g_33002
Super-Scaffold_100001	14641519	14650639	9120	g_33002	g_33003
Super-Scaffold_100001	14652627	14742389	89762	g_33003	g_33004
Super-Scaffold_100001	14743663	14967583	223920	g_33004	g_33008
Super-Scaffold_100001	14971120	14982932	11812	g_33008	g_33009
Super-Scaffold_100001	14993075	15003700	10625	g_33009	g_45548
Super-Scaffold_100001	15012535	15015581	3046	g_45548	g_33010
Super-Scaffold_100001	15018473	15033312	14839	g_33010	g_33011
Super-Scaffold_100001	15040064	15112307	72243	g_33011	g_33012
Super-Scaffold_100001	15114202	15195941	81739	g_33012	g_33013
Super-Scaffold_100001	15196177	15198246	2069	g_33013	g_33014
Super-Scaffold_100001	15215977	15232494	16517	g_33014	g_33015
Super-Scaffold_100001	15254713	15255668	955	g_33015	g_33016
Super-Scaffold_100001	15259291	15261269	1978	g_33016	g_33017
Super-Scaffold_100001	15282665	15293690	11025	g_33017	g_33018
Super-Scaffold_100001	15294311	15296776	2465	g_33018	g_33019
Super-Scaffold_100001	15297045	15343812	46767	g_33019	g_33020
Super-Scaffold_100001	15344174	15380850	36676	g_33020	g_33021
Super-Scaffold_100001	15381278	15381368	90	g_33021	g_33022
Super-Scaffold_100001	15382666	15405771	23105	g_33022	g_33023
Super-Scaffold_100001	15407642	15558626	150984	g_33023	g_33024
Super-Scaffold_100001	15563650	15718123	154473	g_33024	g_33026
Super-Scaffold_100001	15719025	15784893	65868	g_33026	g_33027
Super-Scaffold_100001	15789678	15792251	2573	g_33027	g_42629
Super-Scaffold_100001	15792490	15817964	25474	g_42629	g_33028
Super-Scaffold_100001	15818581	15833828	15247	g_33028	g_33030
Super-Scaffold_100001	15834184	15835439	1255	g_33030	g_33031
Super-Scaffold_100001	15840560	15844646	4086	g_33031	g_33032
Super-Scaffold_100001	15881755	15897872	16117	g_33032	g_33033
Super-Scaffold_100001	15902705	15908322	5617	g_33033	g_33034
Super-Scaffold_100001	15917011	15924069	7058	g_33034	g_33035
Super-Scaffold_100001	15925276	15932896	7620	g_33035	g_33036
Super-Scaffold_100001	15933729	15944466	10737	g_33036	g_33039
Super-Scaffold_100001	15946547	15966207	19660	g_33039	g_33041
Super-Scaffold_100001	15967046	16042175	75129	g_33041	g_33042
Super-Scaffold_100001	16045355	16045413	58	g_33042	g_33043
Super-Scaffold_100001	16047075	16049575	2500	g_33043	g_33044
Super-Scaffold_100001	16053336	16067627	14291	g_33044	g_33046
Super-Scaffold_100001	16084360	16089832	5472	g_33046	g_33047
Super-Scaffold_100001	16093714	16094373	659	g_33047	g_33048
Super-Scaffold_100001	16107545	16108192	647	g_33048	g_33049
Super-Scaffold_100001	16156861	16179702	22841	g_33049	g_33050
Super-Scaffold_100001	16222418	16264717	42299	g_33050	g_33052
Super-Scaffold_100001	16265049	16309051	44002	g_33052	g_33054
Super-Scaffold_100001	16317589	16324621	7032	g_33054	g_33055
Super-Scaffold_100001	16337569	16345728	8159	g_33055	g_45549
Super-Scaffold_100001	16357861	16359969	2108	g_45549	g_33056
Super-Scaffold_100001	16366638	16371141	4503	g_33056	g_33057
Super-Scaffold_100001	16372484	16375017	2533	g_33057	g_33058
Super-Scaffold_100001	16377437	16381880	4443	g_33058	g_33059
Super-Scaffold_100001	16382167	16400701	18534	g_33059	g_33060
Super-Scaffold_100001	16409094	16424933	15839	g_33060	g_33062
Super-Scaffold_100001	16435695	16442908	7213	g_33062	g_33063
Super-Scaffold_100001	16448747	16452961	4214	g_33063	g_45550
Super-Scaffold_100001	16453323	16453871	548	g_45550	g_33064
Super-Scaffold_100001	16472188	16480821	8633	g_33064	g_33065
Super-Scaffold_100001	16487169	16494890	7721	g_33065	g_33066
Super-Scaffold_100001	16505843	16554119	48276	g_33066	g_45551
Super-Scaffold_100001	16556982	16696598	139616	g_45551	g_33069
Super-Scaffold_100001	16710862	16712608	1746	g_33069	g_33070
Super-Scaffold_100001	16717460	16826286	108826	g_33070	g_33073
Super-Scaffold_100001	16826951	16842220	15269	g_33073	g_33075
Super-Scaffold_100001	16852541	16866656	14115	g_33075	g_33076
Super-Scaffold_100001	16866985	16873735	6750	g_33076	g_45552
Super-Scaffold_100001	16890790	16942398	51608	g_45552	g_33078
Super-Scaffold_100001	16942640	17006849	64209	g_33078	g_33079
Super-Scaffold_100001	17007079	17020463	13384	g_33079	g_33080
Super-Scaffold_100001	17025009	17026532	1523	g_33080	g_45553
Super-Scaffold_100001	17044859	17048767	3908	g_45553	g_33081
Super-Scaffold_100001	17056210	17058164	1954	g_33081	g_45554
Super-Scaffold_100001	17061886	17124848	62962	g_45554	g_33083
Super-Scaffold_100001	17125978	17244619	118641	g_33083	g_33086
Super-Scaffold_100001	17261007	17264329	3322	g_33086	g_33087
Super-Scaffold_100001	17268237	17340902	72665	g_33087	g_33088
Super-Scaffold_100001	17354511	17379757	25246	g_33088	g_33089
Super-Scaffold_100001	17385955	17387156	1201	g_33089	g_45555
Super-Scaffold_100001	17397833	17456063	58230	g_45555	g_42637
Super-Scaffold_100001	17456356	17458313	1957	g_42637	g_33091
Super-Scaffold_100001	17458639	17486303	27664	g_33091	g_33093
Super-Scaffold_100001	17486512	17515570	29058	g_33093	g_42639
Super-Scaffold_100001	17515773	17564687	48914	g_42639	g_42640
Super-Scaffold_100001	17564896	17669530	104634	g_42640	g_33096
Super-Scaffold_100001	17688980	17711816	22836	g_33096	g_33097
Super-Scaffold_100001	17719084	17725301	6217	g_33097	g_33098
Super-Scaffold_100001	17726287	17731221	4934	g_33098	g_33099
Super-Scaffold_100001	17743967	17754212	10245	g_33099	g_45556
Super-Scaffold_100001	17754721	17780909	26188	g_45556	g_33100
Super-Scaffold_100001	17787065	17819746	32681	g_33100	g_33101
Super-Scaffold_100001	17829477	17839950	10473	g_33101	g_45557
Super-Scaffold_100001	17853506	17875967	22461	g_45557	g_33102
Super-Scaffold_100001	17884030	17921651	37621	g_33102	g_33104
Super-Scaffold_100001	17936224	17954799	18575	g_42645	g_33105
Super-Scaffold_100001	17958348	17959104	756	g_33105	g_33106
Super-Scaffold_100001	17962928	17976408	13480	g_33106	g_33108
Super-Scaffold_100001	17991440	17995341	3901	g_33108	g_33109
Super-Scaffold_100001	18004898	18008546	3648	g_33109	g_33110
Super-Scaffold_100001	18010641	18015709	5068	g_33110	g_33111
Super-Scaffold_100001	18017926	18027880	9954	g_33111	g_33112
Super-Scaffold_100001	18031880	18032680	800	g_33112	g_33113
Super-Scaffold_100001	18041589	18047244	5655	g_33113	g_33114
Super-Scaffold_100001	18052088	18054108	2020	g_33114	g_33115
Super-Scaffold_100001	18066064	18066735	671	g_33115	g_33116
Super-Scaffold_100001	18068832	18081027	12195	g_33116	g_33117
Super-Scaffold_100001	18084913	18108211	23298	g_33117	g_33118
Super-Scaffold_100001	18113489	18114298	809	g_33118	g_45558
Super-Scaffold_100001	18130437	18134690	4253	g_45558	g_33119
Super-Scaffold_100001	18144459	18219483	75024	g_33119	g_33121
Super-Scaffold_100001	18222815	18224810	1995	g_33121	g_45559
Super-Scaffold_100001	18236486	18241982	5496	g_45559	g_33122
Super-Scaffold_100001	18242227	18246479	4252	g_33122	g_33123
Super-Scaffold_100001	18257822	18258904	1082	g_33123	g_33124
Super-Scaffold_100001	18263926	18277853	13927	g_33124	g_33125
Super-Scaffold_100001	18278941	18305260	26319	g_33125	g_33126
Super-Scaffold_100001	18315891	18366605	50714	g_33126	g_33129
Super-Scaffold_100001	18366850	18561149	194299	g_33129	g_33133
Super-Scaffold_100001	18590493	18590773	280	g_33133	g_33134
Super-Scaffold_100001	18593163	18593856	693	g_33134	g_33135
Super-Scaffold_100001	18599792	18602572	2780	g_33135	g_33136
Super-Scaffold_100001	18606473	18610553	4080	g_33136	g_33137
Super-Scaffold_100001	18613387	18622582	9195	g_33137	g_33138
Super-Scaffold_100001	18623076	18656212	33136	g_33138	g_33141
Super-Scaffold_100001	18668871	18670486	1615	g_33141	g_33142
Super-Scaffold_100001	18674951	18684736	9785	g_33142	g_33143
Super-Scaffold_100001	18692382	18699282	6900	g_33143	g_33144
Super-Scaffold_100001	18707236	18731747	24511	g_33144	g_33145
Super-Scaffold_100001	18731980	18736004	4024	g_33145	g_33146
Super-Scaffold_100001	18745409	18753579	8170	g_33146	g_33148
Super-Scaffold_100001	18758410	18760384	1974	g_33148	g_33149
Super-Scaffold_100001	18770900	18778055	7155	g_33149	g_33150
Super-Scaffold_100001	18782464	18782830	366	g_33150	g_33151
Super-Scaffold_100001	18787809	18789571	1762	g_33151	g_33152
Super-Scaffold_100001	18797028	18799144	2116	g_33152	g_33153
Super-Scaffold_100001	18802376	18835210	32834	g_33153	g_33154
Super-Scaffold_100001	18851829	18858916	7087	g_33154	g_45560
Super-Scaffold_100001	18865217	18866525	1308	g_45560	g_33155
Super-Scaffold_100001	18873317	18874240	923	g_33155	g_33156
Super-Scaffold_100001	18891423	18897078	5655	g_33156	g_33158
Super-Scaffold_100001	18915471	18922872	7401	g_33158	g_33159
Super-Scaffold_100001	18924150	18935488	11338	g_33159	g_33160
Super-Scaffold_100001	18940973	18942289	1316	g_33160	g_33161
Super-Scaffold_100001	18946469	18948419	1950	g_33161	g_33162
Super-Scaffold_100001	18953151	18955015	1864	g_33162	g_33163
Super-Scaffold_100001	18959270	18962042	2772	g_33163	g_33164
Super-Scaffold_100001	18975338	18980045	4707	g_33164	g_33165
Super-Scaffold_100001	18986547	18988913	2366	g_33165	g_45561
Super-Scaffold_100001	18997537	18999875	2338	g_45561	g_33166
Super-Scaffold_100001	19001721	19003065	1344	g_33166	g_33167
Super-Scaffold_100001	19006997	19011336	4339	g_33167	g_33168
Super-Scaffold_100001	19028223	19045262	17039	g_33168	g_33169
Super-Scaffold_100001	19067583	19087526	19943	g_33169	g_33170
Super-Scaffold_100001	19099578	19129811	30233	g_33170	g_33171
Super-Scaffold_100001	19130098	19135510	5412	g_33171	g_33172
Super-Scaffold_100001	19145450	19146538	1088	g_33172	g_33173
Super-Scaffold_100001	19150451	19152437	1986	g_33173	g_33174
Super-Scaffold_100001	19155931	19159175	3244	g_33174	g_33175
Super-Scaffold_100001	19183030	19185456	2426	g_33175	g_42653
Super-Scaffold_100001	19186475	19189549	3074	g_42653	g_33177
Super-Scaffold_100001	19197608	19206492	8884	g_33177	g_33178
Super-Scaffold_100001	19215973	19219553	3580	g_33178	g_33179
Super-Scaffold_100001	19223526	19225311	1785	g_33179	g_33180
Super-Scaffold_100001	19245532	19250291	4759	g_33180	g_33181
Super-Scaffold_100001	19255351	19263128	7777	g_33181	g_33182
Super-Scaffold_100001	19268609	19272322	3713	g_33182	g_33183
Super-Scaffold_100001	19274236	19278653	4417	g_33183	g_45562
Super-Scaffold_100001	19280693	19304256	23563	g_45562	g_33184
Super-Scaffold_100001	19313171	19323221	10050	g_33184	g_33185
Super-Scaffold_100001	19326796	19350644	23848	g_42654	g_33186
Super-Scaffold_100001	19351767	19355264	3497	g_33186	g_33187
Super-Scaffold_100001	19357044	19358818	1774	g_33187	g_45563
Super-Scaffold_100001	19365072	19366625	1553	g_45563	g_33188
Super-Scaffold_100001	19368576	19370493	1917	g_33188	g_33189
Super-Scaffold_100001	19375347	19397580	22233	g_33189	g_33191
Super-Scaffold_100001	19400895	19408709	7814	g_33191	g_33192
Super-Scaffold_100001	19417279	19418761	1482	g_33192	g_33193
Super-Scaffold_100001	19438370	19455765	17395	g_33193	g_33194
Super-Scaffold_100001	19459273	19467057	7784	g_33194	g_33195
Super-Scaffold_100001	19478431	19485654	7223	g_33195	g_45564
Super-Scaffold_100001	19493840	19495802	1962	g_45564	g_45565
Super-Scaffold_100001	19514681	19517951	3270	g_45565	g_45566
Super-Scaffold_100001	19541565	19543951	2386	g_45566	g_33196
Super-Scaffold_100001	19550088	19600563	50475	g_33196	g_33197
Super-Scaffold_100001	19628693	19631985	3292	g_33197	g_45567
Super-Scaffold_100001	19639850	19641690	1840	g_45567	g_33198
Super-Scaffold_100001	19651801	19679877	28076	g_33198	g_33200
Super-Scaffold_100001	19686061	19686615	554	g_33200	g_45568
Super-Scaffold_100001	19688938	19689471	533	g_45568	g_33201
Super-Scaffold_100001	19698480	19701221	2741	g_33201	g_33202
Super-Scaffold_100001	19710369	19715952	5583	g_33202	g_45569
Super-Scaffold_100001	19725148	19757912	32764	g_45569	g_33203
Super-Scaffold_100001	19758112	19764748	6636	g_33203	g_33204
Super-Scaffold_100001	19768898	19770676	1778	g_33204	g_33205
Super-Scaffold_100001	19772206	19802919	30713	g_33205	g_33206
Super-Scaffold_100001	19803176	19912396	109220	g_33206	g_33207
Super-Scaffold_100001	19915494	20126469	210975	g_33207	g_42659
Super-Scaffold_100001	20126798	20133863	7065	g_42659	g_33210
Super-Scaffold_100001	20134081	20194378	60297	g_33210	g_33211
Super-Scaffold_100001	20194722	20564005	369283	g_33211	g_33213
Super-Scaffold_100001	20567293	20600715	33422	g_33213	g_33214
Super-Scaffold_100001	20611867	20617062	5195	g_33214	g_33215
Super-Scaffold_100001	20633854	20650230	16376	g_33215	g_45570
Super-Scaffold_100001	20669580	20945183	275603	g_45570	g_33218
Super-Scaffold_100001	20945452	20956075	10623	g_33218	g_33219
Super-Scaffold_100001	20956710	21015965	59255	g_33219	g_33221
Super-Scaffold_100001	21016597	21305611	289014	g_33221	g_33222
Super-Scaffold_100001	21308306	21313401	5095	g_33222	g_33223
Super-Scaffold_100001	21318745	21325872	7127	g_33223	g_33224
Super-Scaffold_100001	21327040	21327541	501	g_33224	g_33225
Super-Scaffold_100001	21329088	21330349	1261	g_33225	g_33226
Super-Scaffold_100001	21333036	21334126	1090	g_33226	g_33227
Super-Scaffold_100001	21342932	21343745	813	g_33227	g_33228
Super-Scaffold_100001	21346338	21349714	3376	g_33228	g_33229
Super-Scaffold_100001	21351154	21355390	4236	g_33229	g_33230
Super-Scaffold_100001	21366819	21415856	49037	g_33230	g_33232
Super-Scaffold_100001	21424725	21427291	2566	g_33232	g_45571
Super-Scaffold_100001	21439527	21442513	2986	g_45571	g_33233
Super-Scaffold_100001	21456006	21459044	3038	g_33233	g_33234
Super-Scaffold_100001	21463310	21467316	4006	g_33234	g_33235
Super-Scaffold_100001	21474620	21477589	2969	g_33235	g_33236
Super-Scaffold_100001	21480468	21483615	3147	g_33236	g_33237
Super-Scaffold_100001	21483818	21496211	12393	g_33237	g_33238
Super-Scaffold_100001	21503195	21505240	2045	g_33238	g_33239
Super-Scaffold_100001	21509442	21514743	5301	g_33239	g_45572
Super-Scaffold_100001	21520420	21521124	704	g_45572	g_45573
Super-Scaffold_100001	21522701	21525699	2998	g_45573	g_33240
Super-Scaffold_100001	21532416	21535500	3084	g_33240	g_45574
Super-Scaffold_100001	21537975	21539400	1425	g_45574	g_33241
Super-Scaffold_100001	21547688	21549621	1933	g_33241	g_33242
Super-Scaffold_100001	21551203	21571869	20666	g_33242	g_33243
Super-Scaffold_100001	21578572	21746289	167717	g_33243	g_33246
Super-Scaffold_100001	21781583	21963231	181648	g_33246	g_33248
Super-Scaffold_100001	21985773	21990038	4265	g_33248	g_33249
Super-Scaffold_100001	21990442	22005758	15316	g_33249	g_33250
Super-Scaffold_100001	22006558	22019473	12915	g_33250	g_33251
Super-Scaffold_100001	22024076	22029651	5575	g_33251	g_33252
Super-Scaffold_100001	22032571	22035256	2685	g_33252	g_33253
Super-Scaffold_100001	22053023	22133614	80591	g_33253	g_33254
Super-Scaffold_100001	22137960	22139553	1593	g_33254	g_45575
Super-Scaffold_100001	22141769	22145421	3652	g_45575	g_33255
Super-Scaffold_100001	22147404	22148903	1499	g_33255	g_33256
Super-Scaffold_100001	22171373	22187531	16158	g_33256	g_33257
Super-Scaffold_100001	22192659	22194121	1462	g_33257	g_33258
Super-Scaffold_100001	22199088	22221195	22107	g_33258	g_33259
Super-Scaffold_100001	22223003	22230772	7769	g_33259	g_33260
Super-Scaffold_100001	22241910	22246933	5023	g_33260	g_33261
Super-Scaffold_100001	22259616	22263825	4209	g_33261	g_33262
Super-Scaffold_100001	22269664	22270141	477	g_33262	g_45576
Super-Scaffold_100001	22271598	22280561	8963	g_45576	g_45577
Super-Scaffold_100001	22293570	22294082	512	g_45577	g_33263
Super-Scaffold_100001	22296000	22296513	513	g_33263	g_33264
Super-Scaffold_100001	22299982	22307797	7815	g_33264	g_33265
Super-Scaffold_100001	22320733	22391765	71032	g_33265	g_33271
Super-Scaffold_100001	22392091	22413042	20951	g_33271	g_33274
Super-Scaffold_100001	22438901	22461951	23050	g_33274	g_33278
Super-Scaffold_100001	22472831	22474463	1632	g_33278	g_33279
Super-Scaffold_100001	22480554	22556923	76369	g_33279	g_33281
Super-Scaffold_100001	22576205	22576467	262	g_33281	g_33282
Super-Scaffold_100001	22577069	22582528	5459	g_33282	g_33283
Super-Scaffold_100001	22592016	22600784	8768	g_33283	g_33284
Super-Scaffold_100001	22610327	22612121	1794	g_33284	g_33285
Super-Scaffold_100001	22614392	22636439	22047	g_33285	g_33286
Super-Scaffold_100001	22642547	22655882	13335	g_33286	g_33287
Super-Scaffold_100001	22657450	22668874	11424	g_33287	g_33288
Super-Scaffold_100001	22676115	22676905	790	g_33288	g_33289
Super-Scaffold_100001	22687897	22692090	4193	g_33289	g_33290
Super-Scaffold_100001	22695581	22699238	3657	g_33290	g_33291
Super-Scaffold_100001	22706387	22706480	93	g_33291	g_33292
Super-Scaffold_100001	22710022	22711559	1537	g_33292	g_33293
Super-Scaffold_100001	22714011	22724646	10635	g_33293	g_33295
Super-Scaffold_100001	22725792	22733107	7315	g_33295	g_45578
Super-Scaffold_100001	22736844	22740281	3437	g_45578	g_33296
Super-Scaffold_100001	22742414	22914877	172463	g_33296	g_33301
Super-Scaffold_100001	22931791	22936045	4254	g_33301	g_33302
Super-Scaffold_100001	22963048	22966463	3415	g_33302	g_33303
Super-Scaffold_100001	22973599	22988049	14450	g_33303	g_33305
Super-Scaffold_100001	22988448	22989359	911	g_33305	g_33306
Super-Scaffold_100001	23003532	23006334	2802	g_33306	g_33307
Super-Scaffold_100001	23006636	23006714	78	g_33307	g_33308
Super-Scaffold_100001	23012462	23017161	4699	g_33308	g_33309
Super-Scaffold_100001	23026742	23044962	18220	g_33309	g_33310
Super-Scaffold_100001	23056523	23063714	7191	g_33310	g_33311
Super-Scaffold_100001	23087773	23130471	42698	g_33311	g_33314
Super-Scaffold_100001	23147125	23147278	153	g_33314	g_33315
Super-Scaffold_100001	23155252	23199159	43907	g_33315	g_33318
Super-Scaffold_100001	23203739	23205059	1320	g_33318	g_33319
Super-Scaffold_100001	23208843	23212289	3446	g_33319	g_33320
Super-Scaffold_100001	23229266	23234171	4905	g_33320	g_33321
Super-Scaffold_100001	23241120	23243397	2277	g_33321	g_33322
Super-Scaffold_100001	23252203	23254923	2720	g_33322	g_33323
Super-Scaffold_100001	23274266	23460541	186275	g_33323	g_33330
Super-Scaffold_100001	23462352	23463487	1135	g_33330	g_45579
Super-Scaffold_100001	23466767	23534350	67583	g_45579	g_33333
Super-Scaffold_100001	23535696	23646771	111075	g_33333	g_33336
Super-Scaffold_100001	23650697	23651478	781	g_33336	g_33337
Super-Scaffold_100001	23655049	23656861	1812	g_33337	g_33338
Super-Scaffold_100001	23657419	23661122	3703	g_33338	g_33339
Super-Scaffold_100001	23661454	23681987	20533	g_33339	g_33340
Super-Scaffold_100001	23699375	23703564	4189	g_33340	g_33341
Super-Scaffold_100001	23721634	23726721	5087	g_33341	g_33343
Super-Scaffold_100001	23741879	23770008	28129	g_33343	g_33344
Super-Scaffold_100001	23775391	23777909	2518	g_33344	g_33345
Super-Scaffold_100001	23783320	23831677	48357	g_33345	g_33347
Super-Scaffold_100001	23857424	24019026	161602	g_33347	g_42687
Super-Scaffold_100001	24019247	24088752	69505	g_42687	g_42688
Super-Scaffold_100001	24089003	24121055	32052	g_42688	g_33355
Super-Scaffold_100001	24122945	24131783	8838	g_33355	g_42689
Super-Scaffold_100001	24132628	24146791	14163	g_42689	g_42690
Super-Scaffold_100001	24148114	24163646	15532	g_42691	g_33359
Super-Scaffold_100001	24166723	24171452	4729	g_33359	g_33360
Super-Scaffold_100001	24181230	24223844	42614	g_33360	g_33361
Super-Scaffold_100001	24231815	24247168	15353	g_33361	g_33362
Super-Scaffold_100001	24264386	24301673	37287	g_33362	g_33363
Super-Scaffold_100001	24326830	24330832	4002	g_33363	g_33364
Super-Scaffold_100001	24334915	24380310	45395	g_33364	g_33366
Super-Scaffold_100001	24380615	24512173	131558	g_33366	g_33369
Super-Scaffold_100001	24518743	24533176	14433	g_33369	g_33370
Super-Scaffold_100001	24545016	24597817	52801	g_33370	g_33371
Super-Scaffold_100001	24601908	24603447	1539	g_33371	g_33372
Super-Scaffold_100001	24623248	24626901	3653	g_33372	g_33373
Super-Scaffold_100001	24628523	24631736	3213	g_33373	g_33374
Super-Scaffold_100001	24662298	24666132	3834	g_33374	g_33375
Super-Scaffold_100001	24670729	24674820	4091	g_33375	g_33376
Super-Scaffold_100001	24689376	24691523	2147	g_33376	g_33377
Super-Scaffold_100001	24700467	24708042	7575	g_33377	g_33379
Super-Scaffold_100001	24767256	24800421	33165	g_33379	g_33381
Super-Scaffold_100001	24801201	24806116	4915	g_33381	g_33382
Super-Scaffold_100001	24815972	24816807	835	g_33382	g_33383
Super-Scaffold_100001	24819259	24821213	1954	g_33383	g_45580
Super-Scaffold_100001	24858043	24859215	1172	g_45580	g_33384
Super-Scaffold_100001	24868227	24873225	4998	g_33384	g_33385
Super-Scaffold_100001	24879318	24896996	17678	g_33385	g_33386
Super-Scaffold_100001	24898115	24938384	40269	g_33386	g_33387
Super-Scaffold_100001	24955000	25067493	112493	g_33387	g_33389
Super-Scaffold_100001	25070884	25095521	24637	g_33389	g_33390
Super-Scaffold_100001	25096831	25102749	5918	g_33390	g_33391
Super-Scaffold_100001	25114316	25122543	8227	g_33391	g_33392
Super-Scaffold_100001	25122812	25145029	22217	g_33392	g_33394
Super-Scaffold_100001	25145319	25159120	13801	g_33394	g_33395
Super-Scaffold_100001	25186084	25195524	9440	g_33395	g_33396
Super-Scaffold_100001	25199366	25202394	3028	g_33396	g_33397
Super-Scaffold_100001	25221119	25223093	1974	g_33397	g_33398
Super-Scaffold_100001	25224282	25227087	2805	g_33398	g_33399
Super-Scaffold_100001	25235885	25237028	1143	g_33399	g_33400
Super-Scaffold_100001	25237832	25239129	1297	g_33400	g_33401
Super-Scaffold_100001	25256215	25259457	3242	g_33401	g_33402
Super-Scaffold_100001	25259843	25279905	20062	g_33402	g_33403
Super-Scaffold_100001	25289758	25294529	4771	g_33403	g_33404
Super-Scaffold_100001	25295052	25300303	5251	g_33404	g_33405
Super-Scaffold_100001	25306567	25319684	13117	g_33405	g_33406
Super-Scaffold_100001	25323240	25328758	5518	g_33406	g_33407
Super-Scaffold_100001	25332437	25418862	86425	g_33407	g_33409
Super-Scaffold_100001	25421688	25427064	5376	g_33409	g_33410
Super-Scaffold_100001	25429499	25432960	3461	g_33410	g_33411
Super-Scaffold_100001	25449842	25494953	45111	g_33411	g_33413
Super-Scaffold_100001	25495171	25631331	136160	g_33413	g_33417
Super-Scaffold_100001	25631726	25763629	131903	g_33417	g_33422
Super-Scaffold_100001	25763901	25787784	23883	g_33422	g_33424
Super-Scaffold_100001	25788086	25807404	19318	g_33424	g_33425
Super-Scaffold_100001	25807610	25886507	78897	g_33425	g_33429
Super-Scaffold_100001	25886740	25957619	70879	g_33429	g_33430
Super-Scaffold_100001	25967001	25968076	1075	g_33430	g_45581
Super-Scaffold_100001	25968327	25977193	8866	g_45581	g_33431
Super-Scaffold_100001	25990510	25992193	1683	g_33431	g_33432
Super-Scaffold_100001	25992942	25993124	182	g_33432	g_33433
Super-Scaffold_100001	25993765	26000802	7037	g_33433	g_45582
Super-Scaffold_100001	26003882	26009299	5417	g_42704	g_33434
Super-Scaffold_100001	26016609	26049279	32670	g_33434	g_33435
Super-Scaffold_100001	26061372	26070229	8857	g_33435	g_33436
Super-Scaffold_100001	26082435	26091003	8568	g_33436	g_33437
Super-Scaffold_100001	26095812	26100624	4812	g_33437	g_33438
Super-Scaffold_100001	26118753	26173229	54476	g_33438	g_33440
Super-Scaffold_100001	26194125	26200416	6291	g_33440	g_33441
Super-Scaffold_100001	26212939	26219270	6331	g_33441	g_33442
Super-Scaffold_100001	26238764	26255910	17146	g_33442	g_33443
Super-Scaffold_100001	26266924	26270396	3472	g_33443	g_33444
Super-Scaffold_100001	26283337	26289696	6359	g_33444	g_33445
Super-Scaffold_100001	26298853	26302166	3313	g_33445	g_33446
Super-Scaffold_100001	26323052	26350706	27654	g_33446	g_33447
Super-Scaffold_100001	26353462	26357044	3582	g_33447	g_33448
Super-Scaffold_100001	26366653	26387534	20881	g_33448	g_33449
Super-Scaffold_100001	26398138	26405427	7289	g_33449	g_33450
Super-Scaffold_100001	26412803	26424046	11243	g_33450	g_33451
Super-Scaffold_100001	26445915	26483250	37335	g_33451	g_33453
Super-Scaffold_100001	26498376	26507075	8699	g_33453	g_33454
Super-Scaffold_100001	26515303	26525897	10594	g_33454	g_33455
Super-Scaffold_100001	26532223	26533157	934	g_33455	g_33456
Super-Scaffold_100001	26547397	26562668	15271	g_33456	g_45583
Super-Scaffold_100001	26582364	26592035	9671	g_45583	g_33457
Super-Scaffold_100001	26618169	26626421	8252	g_33457	g_33458
Super-Scaffold_100001	26634678	26635198	520	g_33458	g_33459
Super-Scaffold_100001	26641225	26653571	12346	g_33459	g_33460
Super-Scaffold_100001	26656971	26660638	3667	g_33460	g_45584
Super-Scaffold_100001	26670794	26674531	3737	g_45584	g_33461
Super-Scaffold_100001	26681718	26697499	15781	g_33461	g_33462
Super-Scaffold_100001	26701843	26705824	3981	g_33462	g_33463
Super-Scaffold_100001	26711698	26712798	1100	g_33463	g_33464
Super-Scaffold_100001	26714256	26719768	5512	g_33464	g_45585
Super-Scaffold_100001	26727056	26734976	7920	g_45585	g_45586
Super-Scaffold_100001	26740819	26744125	3306	g_45586	g_33465
Super-Scaffold_100001	26751247	26754818	3571	g_33465	g_33466
Super-Scaffold_100001	26764989	26766548	1559	g_33466	g_33467
Super-Scaffold_100001	26769719	26774565	4846	g_33467	g_33468
Super-Scaffold_100001	26776871	26780275	3404	g_33468	g_33469
Super-Scaffold_100001	26781102	26786254	5152	g_33469	g_33470
Super-Scaffold_100001	26790408	26794023	3615	g_33470	g_33471
Super-Scaffold_100001	26801087	26810852	9765	g_33471	g_45587
Super-Scaffold_100001	26813725	26831652	17927	g_45587	g_33472
Super-Scaffold_100001	26843124	26852762	9638	g_33472	g_45588
Super-Scaffold_100001	26862498	26865978	3480	g_45588	g_33473
Super-Scaffold_100001	26872090	26874227	2137	g_33473	g_33474
Super-Scaffold_100001	26878604	26880973	2369	g_33474	g_33475
Super-Scaffold_100001	26884240	26885744	1504	g_33475	g_45589
Super-Scaffold_100001	26889059	26892462	3403	g_45589	g_45590
Super-Scaffold_100001	26908411	26935090	26679	g_45590	g_33476
Super-Scaffold_100001	26935362	26954035	18673	g_33476	g_33477
Super-Scaffold_100001	26989416	26995545	6129	g_33477	g_33478
Super-Scaffold_100001	27011969	27021172	9203	g_33478	g_33479
Super-Scaffold_100001	27025715	27053513	27798	g_33479	g_33480
Super-Scaffold_100001	27062758	27068648	5890	g_33480	g_33481
Super-Scaffold_100001	27074375	27076933	2558	g_33481	g_33482
Super-Scaffold_100001	27092860	27118944	26084	g_33482	g_33483
Super-Scaffold_100001	27144390	27147178	2788	g_33483	g_33484
Super-Scaffold_100001	27148295	27149987	1692	g_33484	g_33485
Super-Scaffold_100001	27151875	27153989	2114	g_33485	g_33486
Super-Scaffold_100001	27159026	27167567	8541	g_33486	g_33487
Super-Scaffold_100001	27169544	27173238	3694	g_33487	g_33488
Super-Scaffold_100001	27191868	27195443	3575	g_33488	g_33489
Super-Scaffold_100001	27196420	27210324	13904	g_33489	g_33490
Super-Scaffold_100001	27218933	27221337	2404	g_33490	g_33491
Super-Scaffold_100001	27234822	27238836	4014	g_33491	g_33492
Super-Scaffold_100001	27253562	27268752	15190	g_33492	g_33493
Super-Scaffold_100001	27274693	27278876	4183	g_33493	g_33494
Super-Scaffold_100001	27281220	27340903	59683	g_33494	g_33498
Super-Scaffold_100001	27341139	27377104	35965	g_33498	g_33500
Super-Scaffold_100001	27380142	27384597	4455	g_33500	g_33501
Super-Scaffold_100001	27393886	27395357	1471	g_33501	g_45591
Super-Scaffold_100001	27396941	27398625	1684	g_45591	g_33502
Super-Scaffold_100001	27400515	27403102	2587	g_33502	g_33503
Super-Scaffold_100001	27405774	27408401	2627	g_33503	g_33504
Super-Scaffold_100001	27408628	27408899	271	g_33504	g_33505
Super-Scaffold_100001	27433244	27446993	13749	g_33505	g_33506
Super-Scaffold_100001	27447355	27510275	62920	g_33506	g_33509
Super-Scaffold_100001	27510517	27567712	57195	g_33509	g_33512
Super-Scaffold_100001	27570216	27601794	31578	g_33512	g_33514
Super-Scaffold_100001	27602717	27603801	1084	g_33514	g_33515
Super-Scaffold_100001	27605461	27608598	3137	g_33515	g_33516
Super-Scaffold_100001	27615247	27616486	1239	g_33516	g_45592
Super-Scaffold_100001	27619339	27624553	5214	g_45592	g_33517
Super-Scaffold_100001	27624978	27630440	5462	g_33517	g_33518
Super-Scaffold_100001	27650783	27811950	161167	g_33518	g_33519
Super-Scaffold_100001	27812231	27815039	2808	g_33519	g_33520
Super-Scaffold_100001	27815323	27901247	85924	g_33520	g_33523
Super-Scaffold_100001	27901459	27916752	15293	g_33523	g_33524
Super-Scaffold_100001	27917066	27928046	10980	g_33524	g_33525
Super-Scaffold_100001	27929017	27991927	62910	g_33525	g_33526
Super-Scaffold_100001	28010581	28021266	10685	g_33526	g_33527
Super-Scaffold_100001	28038127	28076729	38602	g_33527	g_33528
Super-Scaffold_100001	28088105	28278066	189961	g_33528	g_33533
Super-Scaffold_100001	28293320	28304710	11390	g_33533	g_33534
Super-Scaffold_100001	28306011	28316537	10526	g_33534	g_33535
Super-Scaffold_100001	28326676	28329064	2388	g_33535	g_33536
Super-Scaffold_100001	28333271	28344493	11222	g_33536	g_33537
Super-Scaffold_100001	28346068	28346368	300	g_33537	g_45593
Super-Scaffold_100001	28354484	28356561	2077	g_45593	g_33538
Super-Scaffold_100001	28359088	28363239	4151	g_33538	g_33539
Super-Scaffold_100001	28369584	28378863	9279	g_33539	g_33540
Super-Scaffold_100001	28386113	28395065	8952	g_33540	g_33541
Super-Scaffold_100001	28399298	28423723	24425	g_33541	g_33543
Super-Scaffold_100001	28437323	28469621	32298	g_33543	g_33545
Super-Scaffold_100001	28488581	28499822	11241	g_33545	g_33546
Super-Scaffold_100001	28500088	28500639	551	g_33546	g_45594
Super-Scaffold_100001	28505984	28551089	45105	g_45594	g_33548
Super-Scaffold_100001	28565288	28568509	3221	g_33548	g_33550
Super-Scaffold_100001	28572568	28579267	6699	g_33550	g_33551
Super-Scaffold_100001	28605169	28832022	226853	g_33551	g_33552
Super-Scaffold_100001	28834337	28992861	158524	g_33552	g_42733
Super-Scaffold_100001	28993070	29019775	26705	g_42733	g_33554
Super-Scaffold_100001	29020119	29077969	57850	g_33554	g_33555
Super-Scaffold_100001	29100730	29102596	1866	g_33555	g_33556
Super-Scaffold_100001	29110937	29118487	7550	g_33556	g_33557
Super-Scaffold_100001	29120921	29122851	1930	g_33557	g_33558
Super-Scaffold_100001	29129956	29140132	10176	g_33558	g_33559
Super-Scaffold_100001	29144728	29146496	1768	g_33559	g_33560
Super-Scaffold_100001	29151152	29155346	4194	g_33560	g_45595
Super-Scaffold_100001	29163106	29164744	1638	g_45595	g_45596
Super-Scaffold_100001	29175539	29182029	6490	g_45596	g_33561
Super-Scaffold_100001	29203171	29206898	3727	g_33561	g_33562
Super-Scaffold_100001	29217770	29275076	57306	g_33562	g_42734
Super-Scaffold_100001	29275348	29279456	4108	g_42734	g_33565
Super-Scaffold_100001	29290066	29291765	1699	g_33565	g_33566
Super-Scaffold_100001	29294878	29296810	1932	g_33566	g_33567
Super-Scaffold_100001	29302385	29305358	2973	g_33567	g_33568
Super-Scaffold_100001	29324464	29330276	5812	g_33568	g_33569
Super-Scaffold_100001	29333070	29355938	22868	g_33569	g_33570
Super-Scaffold_100001	29372270	29383689	11419	g_33570	g_33571
Super-Scaffold_100001	29390057	29414019	23962	g_33571	g_33572
Super-Scaffold_100001	29415681	29416817	1136	g_33572	g_33573
Super-Scaffold_100001	29425460	29443310	17850	g_33573	g_33574
Super-Scaffold_100001	29446715	29447750	1035	g_33574	g_33575
Super-Scaffold_100001	29454386	29457957	3571	g_33575	g_33576
Super-Scaffold_100001	29473600	29486422	12822	g_33576	g_33577
Super-Scaffold_100001	29486796	29499020	12224	g_33577	g_33578
Super-Scaffold_100001	29499793	29515961	16168	g_33578	g_33580
Super-Scaffold_100001	29521606	29523209	1603	g_33580	g_33581
Super-Scaffold_100001	29531660	29536377	4717	g_33581	g_33582
Super-Scaffold_100001	29544254	29555463	11209	g_33582	g_33583
Super-Scaffold_100001	29585492	29600957	15465	g_33583	g_33584
Super-Scaffold_100001	29601956	29611933	9977	g_33585	g_33586
Super-Scaffold_100001	29618545	29626409	7864	g_33586	g_33587
Super-Scaffold_100001	29630979	29633144	2165	g_33587	g_33588
Super-Scaffold_100001	29639646	29643930	4284	g_33588	g_33589
Super-Scaffold_100001	29648925	29660759	11834	g_33589	g_33590
Super-Scaffold_100001	29669308	29679673	10365	g_33590	g_33592
Super-Scaffold_100001	29702805	29707070	4265	g_33592	g_33593
Super-Scaffold_100001	29717169	29724316	7147	g_33593	g_33594
Super-Scaffold_100001	29745156	29785793	40637	g_33594	g_33596
Super-Scaffold_100001	29805352	29807534	2182	g_33596	g_33597
Super-Scaffold_100001	29818311	29827593	9282	g_33597	g_45597
Super-Scaffold_100001	29830395	29833021	2626	g_45597	g_33598
Super-Scaffold_100001	29834580	29839136	4556	g_33598	g_33599
Super-Scaffold_100001	29841822	29843015	1193	g_33599	g_33600
Super-Scaffold_100001	29851851	29853876	2025	g_33600	g_33601
Super-Scaffold_100001	29855726	29857395	1669	g_33601	g_33602
Super-Scaffold_100001	29859018	29860405	1387	g_33602	g_33603
Super-Scaffold_100001	29865009	29871092	6083	g_33603	g_33604
Super-Scaffold_100001	29872798	29888235	15437	g_33604	g_33606
Super-Scaffold_100001	29891458	29935097	43639	g_33606	g_45598
Super-Scaffold_100001	29942503	30034695	92192	g_45598	g_33608
Super-Scaffold_100001	30040824	30048185	7361	g_33608	g_33609
Super-Scaffold_100001	30055303	30062730	7427	g_33609	g_33610
Super-Scaffold_100001	30084554	30086667	2113	g_33610	g_33611
Super-Scaffold_100001	30101393	30104007	2614	g_33611	g_33612
Super-Scaffold_100001	30110413	30128454	18041	g_33612	g_45599
Super-Scaffold_100001	30128930	30133057	4127	g_45599	g_33613
Super-Scaffold_100001	30136044	30145053	9009	g_33613	g_33614
Super-Scaffold_100001	30159155	30161630	2475	g_33614	g_33615
Super-Scaffold_100001	30171123	30177553	6430	g_33615	g_33616
Super-Scaffold_100001	30233212	30237515	4303	g_33616	g_33617
Super-Scaffold_100001	30338968	30350603	11635	g_33617	g_45600
Super-Scaffold_100001	30356836	30364289	7453	g_45600	g_33618
Super-Scaffold_100001	30365878	30366025	147	g_33618	g_33619
Super-Scaffold_100001	30368289	30368480	191	g_33619	g_33620
Super-Scaffold_100001	30369220	30597500	228280	g_33620	g_33625
Super-Scaffold_100001	30618163	30689578	71415	g_33625	g_33627
Super-Scaffold_100001	30707247	30709062	1815	g_33627	g_33628
Super-Scaffold_100001	30731106	30740532	9426	g_33628	g_33629
Super-Scaffold_100001	30744287	30748475	4188	g_33629	g_33630
Super-Scaffold_100001	30749767	30758298	8531	g_33630	g_33632
Super-Scaffold_100001	30763895	30775457	11562	g_42743	g_33633
Super-Scaffold_100001	30781027	30783353	2326	g_42744	g_33634
Super-Scaffold_100001	30788182	30792481	4299	g_33634	g_33635
Super-Scaffold_100001	30794483	30796842	2359	g_33635	g_33636
Super-Scaffold_100001	30798820	30799357	537	g_33636	g_33637
Super-Scaffold_100001	30805689	30813706	8017	g_33637	g_33638
Super-Scaffold_100001	30818311	30835533	17222	g_33638	g_33639
Super-Scaffold_100001	30836273	30841896	5623	g_33639	g_33640
Super-Scaffold_100001	30844528	30853510	8982	g_33640	g_33641
Super-Scaffold_100001	30866020	30876672	10652	g_33641	g_45601
Super-Scaffold_100001	30891375	31311141	419766	g_45601	g_33647
Super-Scaffold_100001	31315796	31321542	5746	g_33647	g_33648
Super-Scaffold_100001	31322819	31327217	4398	g_33648	g_33649
Super-Scaffold_100001	31335918	31338451	2533	g_33649	g_33650
Super-Scaffold_100001	31339476	31340218	742	g_33650	g_33651
Super-Scaffold_100001	31341306	31345506	4200	g_33651	g_45602
Super-Scaffold_100001	31362659	31433972	71313	g_45602	g_33654
Super-Scaffold_100001	31435669	31549724	114055	g_33654	g_33657
Super-Scaffold_100001	31553437	31558324	4887	g_33657	g_33658
Super-Scaffold_100001	31567485	31569441	1956	g_33658	g_33659
Super-Scaffold_100001	31569692	31596101	26409	g_33659	g_33661
Super-Scaffold_100001	31611343	31626839	15496	g_33661	g_33662
Super-Scaffold_100001	31630511	31687357	56846	g_33662	g_33666
Super-Scaffold_100001	31687629	31726948	39319	g_33666	g_33667
Super-Scaffold_100001	31732683	31735338	2655	g_33667	g_33668
Super-Scaffold_100001	31739393	31743866	4473	g_33668	g_33669
Super-Scaffold_100001	31744617	31753675	9058	g_33669	g_33670
Super-Scaffold_100001	31760224	31766299	6075	g_33670	g_45603
Super-Scaffold_100001	31776915	31784134	7219	g_45603	g_45604
Super-Scaffold_100001	31787947	31802248	14301	g_45604	g_33671
Super-Scaffold_100001	31802733	31811556	8823	g_33671	g_33673
Super-Scaffold_100001	31812041	31815999	3958	g_33673	g_45605
Super-Scaffold_100001	31816484	31926248	109764	g_45605	g_33675
Super-Scaffold_100001	31945361	31950156	4795	g_33675	g_33676
Super-Scaffold_100001	31952497	31952961	464	g_33676	g_33677
Super-Scaffold_100001	31953317	31953508	191	g_33677	g_33678
Super-Scaffold_100001	31953810	31955803	1993	g_33678	g_33679
Super-Scaffold_100001	31956498	31957265	767	g_33679	g_45606
Super-Scaffold_100001	31962830	31965684	2854	g_45606	g_33680
Super-Scaffold_100001	31979700	31981148	1448	g_33680	g_33681
Super-Scaffold_100001	31985805	31989025	3220	g_33681	g_33682
Super-Scaffold_100001	32013801	32026240	12439	g_33682	g_33683
Super-Scaffold_100001	32027409	32043508	16099	g_33683	g_33684
Super-Scaffold_100001	32046911	32052818	5907	g_33684	g_33685
Super-Scaffold_100001	32055970	32057522	1552	g_33685	g_33686
Super-Scaffold_100001	32062731	32067262	4531	g_33686	g_33687
Super-Scaffold_100001	32076142	32150370	74228	g_33687	g_33688
Super-Scaffold_100001	32168594	32205619	37025	g_33688	g_33690
Super-Scaffold_100001	32229375	32234315	4940	g_33690	g_33691
Super-Scaffold_100001	32241025	32243585	2560	g_33691	g_33692
Super-Scaffold_100001	32247454	32250095	2641	g_42754	g_33693
Super-Scaffold_100001	32250385	32267622	17237	g_33693	g_33694
Super-Scaffold_100001	32285630	32354086	68456	g_33694	g_33697
Super-Scaffold_100001	32357569	32362803	5234	g_33697	g_45607
Super-Scaffold_100001	32379268	32385578	6310	g_45607	g_33698
Super-Scaffold_100001	32405798	32474321	68523	g_33698	g_33699
Super-Scaffold_100001	32476847	32479898	3051	g_33699	g_33700
Super-Scaffold_100001	32498152	32532826	34674	g_33700	g_33701
Super-Scaffold_100001	32538603	32543947	5344	g_33701	g_33702
Super-Scaffold_100001	32544165	32550388	6223	g_33702	g_33703
Super-Scaffold_100001	32550690	32566480	15790	g_33703	g_33704
Super-Scaffold_100001	32566737	32568752	2015	g_33704	g_33706
Super-Scaffold_100001	32569180	32606857	37677	g_33706	g_33708
Super-Scaffold_100001	32607138	32647939	40801	g_33708	g_33709
Super-Scaffold_100001	32652517	32715946	63429	g_33709	g_33710
Super-Scaffold_100001	32716164	32722589	6425	g_33710	g_33711
Super-Scaffold_100001	32802853	32804582	1729	g_33711	g_45608
Super-Scaffold_100001	32822543	32918864	96321	g_45608	g_33715
Super-Scaffold_100001	32924499	32929853	5354	g_33715	g_33716
Super-Scaffold_100001	32930056	32931984	1928	g_33716	g_33717
Super-Scaffold_100001	32932328	32937679	5351	g_33717	g_33718
Super-Scaffold_100001	32950689	33185914	235225	g_33718	g_33722
Super-Scaffold_100001	33196511	33239647	43136	g_33722	g_33726
Super-Scaffold_100001	33243801	33251369	7568	g_33726	g_33727
Super-Scaffold_100001	33267292	33347040	79748	g_33727	g_33731
Super-Scaffold_100001	33347534	33371761	24227	g_33731	g_33732
Super-Scaffold_100001	33372153	33394261	22108	g_33732	g_33733
Super-Scaffold_100001	33394488	33399230	4742	g_33733	g_42769
Super-Scaffold_100001	33399457	33399635	178	g_42769	g_33734
Super-Scaffold_100001	33412216	33430743	18527	g_33734	g_33735
Super-Scaffold_100001	33437833	33442454	4621	g_33735	g_33736
Super-Scaffold_100001	33449890	33452904	3014	g_33736	g_45609
Super-Scaffold_100001	33455237	33457945	2708	g_45609	g_33737
Super-Scaffold_100001	33459701	33462066	2365	g_33737	g_33738
Super-Scaffold_100001	33468429	33468963	534	g_33738	g_33739
Super-Scaffold_100001	33469211	33472406	3195	g_33739	g_33740
Super-Scaffold_100001	33473221	33474477	1256	g_33740	g_33741
Super-Scaffold_100001	33476060	33478732	2672	g_33741	g_33742
Super-Scaffold_100001	33480300	33482730	2430	g_33742	g_33743
Super-Scaffold_100001	33484307	33487580	3273	g_33743	g_33744
Super-Scaffold_100001	33488384	33490160	1776	g_33744	g_33745
Super-Scaffold_100001	33509928	33515693	5765	g_33745	g_33746
Super-Scaffold_100001	33518686	33530410	11724	g_33746	g_33747
Super-Scaffold_100001	33531114	33655350	124236	g_33747	g_33751
Super-Scaffold_100001	33658683	33660060	1377	g_33751	g_45610
Super-Scaffold_100001	33668299	33673432	5133	g_45610	g_33752
Super-Scaffold_100001	33675876	33678316	2440	g_33752	g_33753
Super-Scaffold_100001	33681115	33684435	3320	g_33753	g_33754
Super-Scaffold_100001	33688710	33689160	450	g_33754	g_33755
Super-Scaffold_100001	33689672	33702926	13254	g_33755	g_45611
Super-Scaffold_100001	33707097	33708778	1681	g_45611	g_33756
Super-Scaffold_100001	33726791	33730440	3649	g_33756	g_33757
Super-Scaffold_100001	33730694	33734441	3747	g_33757	g_33758
Super-Scaffold_100001	33753682	33777305	23623	g_33758	g_33759
Super-Scaffold_100001	33777634	33834831	57197	g_33759	g_33764
Super-Scaffold_100001	33835103	33838523	3420	g_33764	g_33765
Super-Scaffold_100001	33838723	33856086	17363	g_33765	g_33767
Super-Scaffold_100001	33856334	33875195	18861	g_33767	g_33768
Super-Scaffold_100001	33875506	33908328	32822	g_33768	g_33771
Super-Scaffold_100001	33925625	33948959	23334	g_33771	g_33772
Super-Scaffold_100001	33949177	33970826	21649	g_33772	g_33773
Super-Scaffold_100001	33971464	33974434	2970	g_42776	g_33774
Super-Scaffold_100001	33974821	34005686	30865	g_33774	g_33775
Super-Scaffold_100001	34009438	34016433	6995	g_33775	g_33776
Super-Scaffold_100001	34024051	34036369	12318	g_33776	g_33778
Super-Scaffold_100001	34036629	34047439	10810	g_33778	g_33779
Super-Scaffold_100001	34076715	34095877	19162	g_33779	g_33780
Super-Scaffold_100001	34119016	34128054	9038	g_33780	g_33781
Super-Scaffold_100001	34139119	34142159	3040	g_33781	g_33782
Super-Scaffold_100001	34156358	34179532	23174	g_33782	g_42780
Super-Scaffold_100001	34179789	34204201	24412	g_42780	g_33786
Super-Scaffold_100001	34208201	34267599	59398	g_33786	g_33788
Super-Scaffold_100001	34267994	34328707	60713	g_33788	g_42788
Super-Scaffold_100001	34328907	34345799	16892	g_42788	g_33790
Super-Scaffold_100001	34348711	34393551	44840	g_33790	g_33793
Super-Scaffold_100001	34393871	34434575	40704	g_33793	g_33797
Super-Scaffold_100001	34434817	34435770	953	g_33797	g_33798
Super-Scaffold_100001	34436276	34470254	33978	g_33798	g_42794
Super-Scaffold_100001	34470466	34542335	71869	g_42794	g_33801
Super-Scaffold_100001	34544203	34555000	10797	g_33801	g_33802
Super-Scaffold_100001	34555374	34676531	121157	g_33802	g_42803
Super-Scaffold_100001	34676977	34767944	90967	g_42803	g_33814
Super-Scaffold_100001	34773955	34799821	25866	g_33814	g_33816
Super-Scaffold_100001	34802336	34812481	10145	g_33816	g_45612
Super-Scaffold_100001	34854841	34863373	8532	g_45612	g_33817
Super-Scaffold_100001	34874174	35047906	173732	g_33817	g_33818
Super-Scaffold_100001	35064973	35206688	141715	g_33818	g_33822
Super-Scaffold_100001	35206894	35209741	2847	g_33822	g_33823
Super-Scaffold_100001	35210034	35276595	66561	g_33823	g_33826
Super-Scaffold_100001	35276948	35304007	27059	g_33826	g_33828
Super-Scaffold_100001	35306165	35331427	25262	g_42808	g_42809
Super-Scaffold_100001	35331657	35341083	9426	g_42809	g_33829
Super-Scaffold_100001	35341283	35356767	15484	g_33829	g_42812
Super-Scaffold_100001	35357015	35406385	49370	g_42812	g_33831
Super-Scaffold_100001	35429073	35432442	3369	g_33831	g_33832
Super-Scaffold_100001	35439695	35465377	25682	g_33832	g_33833
Super-Scaffold_100001	35465649	35467960	2311	g_33833	g_33834
Super-Scaffold_100001	35481281	35488839	7558	g_33834	g_33835
Super-Scaffold_100001	35489183	35553762	64579	g_33835	g_33839
Super-Scaffold_100001	35554238	35570486	16248	g_33839	g_33840
Super-Scaffold_100001	35589413	35688670	99257	g_33840	g_33843
Super-Scaffold_100001	35719249	35726243	6994	g_33843	g_33844
Super-Scaffold_100001	35726773	35758653	31880	g_33844	g_33845
Super-Scaffold_100001	35759811	35768558	8747	g_33845	g_33846
Super-Scaffold_100001	35769430	35775495	6065	g_33846	g_33847
Super-Scaffold_100001	35776370	35804499	28129	g_33847	g_33849
Super-Scaffold_100001	35809436	35819780	10344	g_33849	g_33851
Super-Scaffold_100001	35820349	35820888	539	g_33851	g_33852
Super-Scaffold_100001	35821601	35825542	3941	g_33852	g_33853
Super-Scaffold_100001	35846200	35847965	1765	g_33853	g_33854
Super-Scaffold_100001	35855686	35866280	10594	g_33854	g_33855
Super-Scaffold_100001	35876680	35986492	109812	g_33855	g_33857
Super-Scaffold_100001	36006260	36010571	4311	g_33857	g_33859
Super-Scaffold_100001	36038962	36286581	247619	g_33859	g_33865
Super-Scaffold_100001	36286958	36368866	81908	g_33865	g_33866
Super-Scaffold_100001	36369444	36408400	38956	g_33866	g_42817
Super-Scaffold_100001	36408666	36465731	57065	g_42817	g_33870
Super-Scaffold_100001	36466081	36504103	38022	g_33870	g_33873
Super-Scaffold_100001	36504585	36511005	6420	g_33873	g_33874
Super-Scaffold_100001	36520702	36576885	56183	g_33874	g_33876
Super-Scaffold_100001	36586622	36591665	5043	g_33876	g_45613
Super-Scaffold_100001	36593024	36655273	62249	g_45613	g_33878
Super-Scaffold_100001	36666269	36684162	17893	g_33878	g_33879
Super-Scaffold_100001	36691534	36718396	26862	g_33879	g_33882
Super-Scaffold_100001	36719851	36723816	3965	g_33882	g_45614
Super-Scaffold_100001	36727430	36738672	11242	g_45614	g_33883
Super-Scaffold_100001	36751588	36753468	1880	g_33883	g_33885
Super-Scaffold_100001	36757057	36778791	21734	g_33885	g_33886
Super-Scaffold_100001	36798184	36835832	37648	g_33886	g_42818
Super-Scaffold_100001	36837094	36886892	49798	g_42818	g_33891
Super-Scaffold_100001	36887869	36943494	55625	g_33891	g_33892
Super-Scaffold_100001	36943718	36997643	53925	g_33892	g_33893
Super-Scaffold_100001	36997939	37045534	47595	g_33893	g_33894
Super-Scaffold_100001	37045755	37050584	4829	g_33894	g_33895
Super-Scaffold_100001	37099723	37103417	3694	g_33895	g_33896
Super-Scaffold_100001	37105046	37109697	4651	g_33896	g_33897
Super-Scaffold_100001	37110410	37116148	5738	g_33897	g_33899
Super-Scaffold_100001	37122651	37125207	2556	g_33899	g_45615
Super-Scaffold_100001	37129685	37140563	10878	g_45615	g_33900
Super-Scaffold_100001	37145694	37170303	24609	g_33900	g_33901
Super-Scaffold_100001	37175478	37298773	123295	g_33901	g_33905
Super-Scaffold_100001	37318422	37323745	5323	g_33905	g_33906
Super-Scaffold_100001	37337773	37351348	13575	g_33906	g_33907
Super-Scaffold_100001	37359672	37367872	8200	g_33907	g_33908
Super-Scaffold_100001	37425759	37430868	5109	g_33908	g_33909
Super-Scaffold_100001	37437000	37437049	49	g_33909	g_33910
Super-Scaffold_100001	37439291	37443609	4318	g_33910	g_33911
Super-Scaffold_100001	37448108	37448228	120	g_33911	g_33912
Super-Scaffold_100001	37448629	37448683	54	g_33912	g_33913
Super-Scaffold_100001	37454525	37464517	9992	g_33913	g_33914
Super-Scaffold_100001	37475081	37517128	42047	g_33914	g_33916
Super-Scaffold_100001	37517436	37528043	10607	g_33916	g_33917
Super-Scaffold_100001	37530548	37536799	6251	g_33917	g_33918
Super-Scaffold_100001	37555533	37558644	3111	g_33918	g_33919
Super-Scaffold_100001	37562157	37562766	609	g_33919	g_33920
Super-Scaffold_100001	37570981	37648339	77358	g_33920	g_33921
Super-Scaffold_100001	37649145	37790446	141301	g_33921	g_33924
Super-Scaffold_100001	37790760	37976372	185612	g_33924	g_33929
Super-Scaffold_100001	37986927	37988525	1598	g_33929	g_33930
Super-Scaffold_100001	37989103	38066233	77130	g_33930	g_33933
Super-Scaffold_100001	38075519	38271865	196346	g_33933	g_33934
Super-Scaffold_100001	38323692	38399876	76184	g_33934	g_42830
Super-Scaffold_100001	38401009	38445663	44654	g_42830	g_33936
Super-Scaffold_100001	38475399	38480723	5324	g_33936	g_33937
Super-Scaffold_100001	38480950	38484829	3879	g_33937	g_45616
Super-Scaffold_100001	38486263	38488334	2071	g_45616	g_33938
Super-Scaffold_100001	38488642	38491959	3317	g_33938	g_33939
Super-Scaffold_100001	38493552	38497846	4294	g_33939	g_33940
Super-Scaffold_100001	38521717	38530491	8774	g_33940	g_45617
Super-Scaffold_100001	38558291	38568091	9800	g_45617	g_33941
Super-Scaffold_100001	38568759	38576493	7734	g_33941	g_33942
Super-Scaffold_100001	38590346	38643529	53183	g_33942	g_33944
Super-Scaffold_100001	38674783	38682464	7681	g_33944	g_33945
Super-Scaffold_100001	38682814	38683584	770	g_33945	g_33946
Super-Scaffold_100001	38693742	38759744	66002	g_33946	g_33947
Super-Scaffold_100001	38772007	38778718	6711	g_33947	g_45618
Super-Scaffold_100001	38782282	38787905	5623	g_45618	g_42832
Super-Scaffold_100001	38788387	38788835	448	g_42832	g_33949
Super-Scaffold_100001	38792020	38817435	25415	g_33949	g_33950
Super-Scaffold_100001	38831900	38900745	68845	g_33950	g_33951
Super-Scaffold_100001	38916830	39016201	99371	g_33951	g_33954
Super-Scaffold_100001	39027732	39035146	7414	g_33954	g_33955
Super-Scaffold_100001	39057392	39071451	14059	g_33955	g_33956
Super-Scaffold_100001	39090098	39242534	152436	g_33956	g_42833
Super-Scaffold_100001	39244087	39351739	107652	g_42833	g_33959
Super-Scaffold_100001	39357652	39361153	3501	g_33959	g_33961
Super-Scaffold_100001	39375275	39391669	16394	g_33961	g_33962
Super-Scaffold_100001	39392418	39402212	9794	g_33962	g_33964
Super-Scaffold_100001	39402840	39402859	19	g_33964	g_33965
Super-Scaffold_100001	39403725	39513740	110015	g_33965	g_33969
Super-Scaffold_100001	39547899	39551408	3509	g_33969	g_33970
Super-Scaffold_100001	39556371	39627716	71345	g_33970	g_33971
Super-Scaffold_100001	39634298	39897413	263115	g_33971	g_33976
Super-Scaffold_100001	39919932	40086485	166553	g_33976	g_33979
Super-Scaffold_100001	40087087	40109129	22042	g_33979	g_33980
Super-Scaffold_100001	40113560	40117268	3708	g_33980	g_45619
Super-Scaffold_100001	40123117	40139947	16830	g_45619	g_33982
Super-Scaffold_100001	40146027	40146716	689	g_33982	g_33983
Super-Scaffold_100001	40147252	40148614	1362	g_33983	g_33984
Super-Scaffold_100001	40157779	40174609	16830	g_33984	g_33986
Super-Scaffold_100001	40174977	40175596	619	g_33986	g_33987
Super-Scaffold_100001	40175976	40265418	89442	g_33987	g_33989
Super-Scaffold_100001	40265720	40275674	9954	g_33989	g_33991
Super-Scaffold_100001	40276787	40396048	119261	g_33991	g_33995
Super-Scaffold_100001	40396398	40396937	539	g_33995	g_33996
Super-Scaffold_100001	40397239	40412864	15625	g_33996	g_33997
Super-Scaffold_100001	40413070	40436085	23015	g_33997	g_33998
Super-Scaffold_100001	40441242	40555475	114233	g_33998	g_34002
Super-Scaffold_100001	40555684	40639346	83662	g_34002	g_34004
Super-Scaffold_100001	40641190	40727198	86008	g_34004	g_34005
Super-Scaffold_100001	40747812	40756373	8561	g_34005	g_34006
Super-Scaffold_100001	40756915	40758230	1315	g_34006	g_34007
Super-Scaffold_100001	40764584	40767053	2469	g_34007	g_34008
Super-Scaffold_100001	40768942	40778961	10019	g_34008	g_34009
Super-Scaffold_100001	40780602	40788349	7747	g_34009	g_34010
Super-Scaffold_100001	40792641	40804229	11588	g_34010	g_34011
Super-Scaffold_100001	40815577	40820774	5197	g_34011	g_34012
Super-Scaffold_100001	40822562	40856789	34227	g_34012	g_34013
Super-Scaffold_100001	40857607	40863214	5607	g_34013	g_34014
Super-Scaffold_100001	40864023	40887461	23438	g_34014	g_34015
Super-Scaffold_100001	40887742	40978565	90823	g_34015	g_34016
Super-Scaffold_100001	40982657	41053734	71077	g_34016	g_34018
Super-Scaffold_100001	41057869	41144381	86512	g_34018	g_34022
Super-Scaffold_100001	41145895	41146486	591	g_34022	g_34021
Super-Scaffold_100001	41148841	41284315	135474	g_34021	g_34023
Super-Scaffold_100001	41284638	41323923	39285	g_34023	g_34024
Super-Scaffold_100001	41327004	41487587	160583	g_34024	g_34025
Super-Scaffold_100001	41498065	41533319	35254	g_34025	g_34027
Super-Scaffold_100001	41542139	41546677	4538	g_34027	g_34029
Super-Scaffold_100001	41564194	41579504	15310	g_34029	g_34030
Super-Scaffold_100001	41580127	41594478	14351	g_34030	g_34032
Super-Scaffold_100001	41620751	41629372	8621	g_34032	g_34033
Super-Scaffold_100001	41642815	41644741	1926	g_34033	g_34034
Super-Scaffold_100001	41652772	41655904	3132	g_34034	g_34035
Super-Scaffold_100001	41669039	41669540	501	g_34035	g_34036
Super-Scaffold_100001	41683440	41685660	2220	g_34036	g_34037
Super-Scaffold_100001	41686112	41686850	738	g_34037	g_45620
Super-Scaffold_100001	41701934	41744744	42810	g_45620	g_42852
Super-Scaffold_100001	41744965	41745903	938	g_42852	g_34040
Super-Scaffold_100001	41746553	41818098	71545	g_34040	g_34044
Super-Scaffold_100001	41818445	41886857	68412	g_34044	g_34046
Super-Scaffold_100001	41887708	41888317	609	g_34046	g_34047
Super-Scaffold_100001	41888733	41889438	705	g_34047	g_34048
Super-Scaffold_100001	41889857	41898179	8322	g_34048	g_34049
Super-Scaffold_100001	41898514	41900194	1680	g_34049	g_34050
Super-Scaffold_100001	41900946	41934183	33237	g_34050	g_34051
Super-Scaffold_100001	41934602	41935492	890	g_34051	g_34052
Super-Scaffold_100001	41936217	41950397	14180	g_34052	g_34053
Super-Scaffold_100001	41951023	41967073	16050	g_34053	g_34054
Super-Scaffold_100001	41967345	41968628	1283	g_34054	g_45621
Super-Scaffold_100001	41970685	41971791	1106	g_45621	g_34055
Super-Scaffold_100001	41972135	41972280	145	g_34055	g_34056
Super-Scaffold_100001	41972822	41972880	58	g_34056	g_34057
Super-Scaffold_100001	41973215	41974895	1680	g_34057	g_34058
Super-Scaffold_100001	41975647	42041149	65502	g_34058	g_34059
Super-Scaffold_100001	42041454	42181784	140330	g_34059	g_34062
Super-Scaffold_100001	42184801	42184916	115	g_34062	g_34063
Super-Scaffold_100001	42186382	42234377	47995	g_34063	g_34065
Super-Scaffold_100001	42235222	42235348	126	g_34065	g_34066
Super-Scaffold_100001	42235572	42269607	34035	g_34066	g_34067
Super-Scaffold_100001	42270125	42320461	50336	g_34067	g_42858
Super-Scaffold_100001	42320799	42326318	5519	g_42858	g_34069
Super-Scaffold_100001	42326965	42364159	37194	g_34069	g_34070
Super-Scaffold_100001	42364536	42471392	106856	g_34070	g_34074
Super-Scaffold_100001	42471649	42472172	523	g_34074	g_42860
Super-Scaffold_100001	42472411	42472442	31	g_42860	g_34075
Super-Scaffold_100001	42473203	42473603	400	g_34075	g_42861
Super-Scaffold_100001	42473956	42474080	124	g_42861	g_34076
Super-Scaffold_100001	42474538	42474608	70	g_34076	g_34077
Super-Scaffold_100001	42474850	42492017	17167	g_34077	g_34079
Super-Scaffold_100001	42492289	42568764	76475	g_34079	g_34080
Super-Scaffold_100001	42569000	42653719	84719	g_34080	g_34082
Super-Scaffold_100001	42657702	42823328	165626	g_34082	g_42865
Super-Scaffold_100001	42826732	42864890	38158	g_42865	g_34087
Super-Scaffold_100001	42865357	42885228	19871	g_34087	g_34088
Super-Scaffold_100001	42887185	42929388	42203	g_34088	g_34089
Super-Scaffold_100001	42929957	42930160	203	g_34089	g_34090
Super-Scaffold_100001	42931303	42931378	75	g_34090	g_34091
Super-Scaffold_100001	42932301	43011369	79068	g_34091	g_34092
Super-Scaffold_100001	43012247	43076128	63881	g_34092	g_34095
Super-Scaffold_100001	43076568	43080984	4416	g_34095	g_42870
Super-Scaffold_100001	43081901	43115543	33642	g_42870	g_34097
Super-Scaffold_100004	48929	125204	76275	g_1385	g_1386
Super-Scaffold_100004	126163	129564	3401	g_1386	g_42998
Super-Scaffold_100004	132989	234416	101427	g_42998	g_1391
Super-Scaffold_100004	239301	280536	41235	g_1391	g_37429
Super-Scaffold_100004	281462	284396	2934	g_37429	g_1393
Super-Scaffold_100004	289795	330478	40683	g_1393	g_1394
Super-Scaffold_100004	334110	536280	202170	g_1394	g_1402
Super-Scaffold_100004	537194	537255	61	g_1402	g_1403
Super-Scaffold_100004	537803	537855	52	g_1403	g_1404
Super-Scaffold_100004	538694	649163	110469	g_1404	g_37433
Super-Scaffold_100004	649405	709467	60062	g_37433	g_37434
Super-Scaffold_100004	709715	711027	1312	g_37434	g_1407
Super-Scaffold_100004	711266	762994	51728	g_1407	g_1408
Super-Scaffold_100004	764250	764435	185	g_1408	g_1409
Super-Scaffold_100004	766180	766733	553	g_1409	g_1410
Super-Scaffold_100004	767866	770141	2275	g_1410	g_1411
Super-Scaffold_100004	770542	775549	5007	g_1411	g_1412
Super-Scaffold_100004	775803	856800	80997	g_1412	g_1413
Super-Scaffold_100004	857240	857292	52	g_1413	g_1414
Super-Scaffold_100004	857837	857898	61	g_1414	g_1415
Super-Scaffold_100004	858473	884301	25828	g_1415	g_1416
Super-Scaffold_100004	885905	952057	66152	g_1416	g_1417
Super-Scaffold_100004	953092	953871	779	g_1417	g_1418
Super-Scaffold_100004	954287	965333	11046	g_1418	g_1419
Super-Scaffold_100004	965611	967827	2216	g_1419	g_1420
Super-Scaffold_100004	968060	968891	831	g_1420	g_1421
Super-Scaffold_100004	969100	969331	231	g_1421	g_1422
Super-Scaffold_100004	969582	1120461	150879	g_1422	g_1425
Super-Scaffold_100004	1120955	1194170	73215	g_1425	g_1426
Super-Scaffold_100004	1195342	1196075	733	g_1426	g_1427
Super-Scaffold_100004	1196878	1224619	27741	g_1427	g_1430
Super-Scaffold_100004	1225623	1247501	21878	g_1430	g_1431
Super-Scaffold_100004	1247646	1271632	23986	g_37437	g_1434
Super-Scaffold_100004	1272046	1272113	67	g_1434	g_1435
Super-Scaffold_100004	1273194	1282352	9158	g_1435	g_1436
Super-Scaffold_100004	1283215	1414955	131740	g_1436	g_1437
Super-Scaffold_100004	1415833	1417845	2012	g_1437	g_1438
Super-Scaffold_100004	1420447	1590126	169679	g_1438	g_1440
Super-Scaffold_100004	1590545	1611942	21397	g_1440	g_1442
Super-Scaffold_100004	1612553	1612748	195	g_1442	g_1443
Super-Scaffold_100004	1613450	1614948	1498	g_1443	g_1444
Super-Scaffold_100004	1615781	1673279	57498	g_1444	g_1445
Super-Scaffold_100004	1675502	1675910	408	g_1445	g_42999
Super-Scaffold_100004	1677831	1677922	91	g_42999	g_1446
Super-Scaffold_100004	1679034	1679356	322	g_1446	g_1447
Super-Scaffold_100004	1680549	1680606	57	g_1447	g_1448
Super-Scaffold_100004	1680920	1736032	55112	g_1448	g_1449
Super-Scaffold_100004	1736319	1741341	5022	g_1449	g_1450
Super-Scaffold_100004	1742645	1744608	1963	g_1450	g_1452
Super-Scaffold_100004	1745684	1818852	73168	g_1452	g_1455
Super-Scaffold_100004	1819887	1946423	126536	g_1455	g_1458
Super-Scaffold_100004	1947730	1973664	25934	g_1458	g_1459
Super-Scaffold_100004	1976301	1990707	14406	g_1459	g_1460
Super-Scaffold_100004	1991066	2053705	62639	g_1460	g_1461
Super-Scaffold_100004	2054646	2062288	7642	g_1461	g_1462
Super-Scaffold_100004	2065945	2138207	72262	g_1462	g_1463
Super-Scaffold_100004	2138707	2138769	62	g_1463	g_1464
Super-Scaffold_100004	2139353	2152283	12930	g_1464	g_1465
Super-Scaffold_100004	2153563	2195227	41664	g_1465	g_1466
Super-Scaffold_100004	2196714	2196839	125	g_1466	g_1467
Super-Scaffold_100004	2198560	2244129	45569	g_1467	g_1468
Super-Scaffold_100004	2245787	2273204	27417	g_1468	g_1470
Super-Scaffold_100004	2274430	2439821	165391	g_1470	g_1472
Super-Scaffold_100004	2440224	2440673	449	g_1472	g_1473
Super-Scaffold_100004	2441123	2494151	53028	g_1473	g_1474
Super-Scaffold_100004	2495284	2566722	71438	g_1474	g_1476
Super-Scaffold_100004	2571166	2581544	10378	g_1476	g_1477
Super-Scaffold_100004	2582257	2588082	5825	g_1477	g_1478
Super-Scaffold_100004	2594213	2667720	73507	g_1478	g_1479
Super-Scaffold_100004	2668211	2669214	1003	g_1479	g_1481
Super-Scaffold_100004	2669617	2679179	9562	g_1481	g_1482
Super-Scaffold_100004	2679823	2679909	86	g_1482	g_1483
Super-Scaffold_100004	2680307	2680371	64	g_1483	g_1484
Super-Scaffold_100004	2681051	2739406	58355	g_1484	g_1486
Super-Scaffold_100004	2756156	2775030	18874	g_1486	g_1487
Super-Scaffold_100004	2786616	2800575	13959	g_1487	g_1488
Super-Scaffold_100004	2806946	2812761	5815	g_1488	g_1489
Super-Scaffold_100004	2822701	2825291	2590	g_1489	g_43000
Super-Scaffold_100004	2838987	2866408	27421	g_43000	g_1490
Super-Scaffold_100004	2868785	2871145	2360	g_1490	g_1491
Super-Scaffold_100004	2875550	2913057	37507	g_1491	g_1492
Super-Scaffold_100004	2930407	2969217	38810	g_1492	g_1495
Super-Scaffold_100004	2988240	3001134	12894	g_1495	g_1496
Super-Scaffold_100004	3001505	3025961	24456	g_1496	g_37449
Super-Scaffold_100004	3026230	3050788	24558	g_37449	g_1497
Super-Scaffold_100004	3051045	3090355	39310	g_1497	g_1499
Super-Scaffold_100004	3091243	3115612	24369	g_1499	g_1500
Super-Scaffold_100004	3119517	3122370	2853	g_1500	g_1501
Super-Scaffold_100004	3155640	3160339	4699	g_1501	g_1502
Super-Scaffold_100004	3165498	3166688	1190	g_1502	g_1503
Super-Scaffold_100004	3178185	3181143	2958	g_1503	g_1504
Super-Scaffold_100004	3196878	3197480	602	g_1504	g_1505
Super-Scaffold_100004	3199303	3204839	5536	g_1505	g_1506
Super-Scaffold_100004	3215048	3224692	9644	g_37450	g_1507
Super-Scaffold_100004	3232155	3234455	2300	g_1507	g_1508
Super-Scaffold_100004	3236282	3291249	54967	g_1508	g_1509
Super-Scaffold_100004	3291497	3299111	7614	g_1509	g_1510
Super-Scaffold_100004	3301093	3310885	9792	g_1510	g_1511
Super-Scaffold_100004	3327079	3382753	55674	g_1511	g_1512
Super-Scaffold_100004	3383082	3388940	5858	g_1512	g_1513
Super-Scaffold_100004	3393538	3415027	21489	g_1513	g_1514
Super-Scaffold_100004	3415296	3416483	1187	g_1514	g_1515
Super-Scaffold_100004	3420117	3420269	152	g_1515	g_1516
Super-Scaffold_100004	3420706	3435990	15284	g_1516	g_1518
Super-Scaffold_100004	3446334	3446526	192	g_1518	g_1519
Super-Scaffold_100004	3448092	3450550	2458	g_1519	g_1520
Super-Scaffold_100004	3465387	3470747	5360	g_1520	g_1522
Super-Scaffold_100004	3483502	3497992	14490	g_1522	g_1525
Super-Scaffold_100004	3506989	3507181	192	g_1525	g_1526
Super-Scaffold_100004	3508711	3509662	951	g_1526	g_1527
Super-Scaffold_100004	3521865	3525443	3578	g_1527	g_1528
Super-Scaffold_100004	3543946	3544897	951	g_1528	g_1529
Super-Scaffold_100004	3560799	3560864	65	g_1529	g_1530
Super-Scaffold_100004	3574447	3576873	2426	g_1530	g_1531
Super-Scaffold_100004	3587193	3587385	192	g_1531	g_1532
Super-Scaffold_100004	3588951	3591230	2279	g_1532	g_1533
Super-Scaffold_100004	3607569	3631700	24131	g_1533	g_1534
Super-Scaffold_100004	3636063	3649639	13576	g_1534	g_1535
Super-Scaffold_100004	3649956	3651143	1187	g_1535	g_1536
Super-Scaffold_100004	3654786	3654938	152	g_1536	g_1537
Super-Scaffold_100004	3655375	3672730	17355	g_1537	g_37451
Super-Scaffold_100004	3672951	3674807	1856	g_37451	g_1540
Super-Scaffold_100004	3688755	3688820	65	g_1540	g_1541
Super-Scaffold_100004	3696951	3697902	951	g_1541	g_1542
Super-Scaffold_100004	3711070	3761680	50610	g_1542	g_1544
Super-Scaffold_100004	3761895	3830899	69004	g_1544	g_1547
Super-Scaffold_100004	3832782	3896458	63676	g_1547	g_1548
Super-Scaffold_100004	3896682	3965051	68369	g_1548	g_1550
Super-Scaffold_100004	3965386	3976439	11053	g_1550	g_1551
Super-Scaffold_100004	3985154	4015902	30748	g_1551	g_1554
Super-Scaffold_100004	4016852	4055838	38986	g_1554	g_1555
Super-Scaffold_100004	4065237	4065771	534	g_1555	g_1556
Super-Scaffold_100004	4083508	4133382	49874	g_1556	g_1557
Super-Scaffold_100004	4134770	4171477	36707	g_1557	g_1559
Super-Scaffold_100004	4172316	4176229	3913	g_1559	g_1560
Super-Scaffold_100004	4176447	4207521	31074	g_1560	g_1562
Super-Scaffold_100004	4209012	4225653	16641	g_1562	g_1563
Super-Scaffold_100004	4226063	4296338	70275	g_1563	g_1565
Super-Scaffold_100004	4301187	4337993	36806	g_1565	g_1567
Super-Scaffold_100004	4345280	4351242	5962	g_1567	g_1568
Super-Scaffold_100004	4356809	4359410	2601	g_1568	g_1569
Super-Scaffold_100004	4389238	4401374	12136	g_1569	g_1570
Super-Scaffold_100004	4419696	4424455	4759	g_1570	g_1571
Super-Scaffold_100004	4424703	4435312	10609	g_1571	g_1572
Super-Scaffold_100004	4439130	4449120	9990	g_1572	g_1573
Super-Scaffold_100004	4449834	4466072	16238	g_1573	g_1574
Super-Scaffold_100004	4485898	4512689	26791	g_1574	g_1575
Super-Scaffold_100004	4513060	4523387	10327	g_1575	g_1576
Super-Scaffold_100004	4530479	4581201	50722	g_1576	g_1578
Super-Scaffold_100004	4581578	4585312	3734	g_1578	g_1579
Super-Scaffold_100004	4589147	4593076	3929	g_1579	g_1580
Super-Scaffold_100004	4597626	4600564	2938	g_1580	g_1581
Super-Scaffold_100004	4603840	4607451	3611	g_1581	g_1582
Super-Scaffold_100004	4628855	4797768	168913	g_1582	g_1583
Super-Scaffold_100004	4798475	5128654	330179	g_1583	g_1586
Super-Scaffold_100004	5129773	5155306	25533	g_1586	g_1587
Super-Scaffold_100004	5157895	5179356	21461	g_1587	g_1588
Super-Scaffold_100004	5179559	5245000	65441	g_1588	g_1589
Super-Scaffold_100004	5245305	5245438	133	g_1589	g_1590
Super-Scaffold_100004	5246058	5260351	14293	g_1590	g_1591
Super-Scaffold_100004	5261397	5309532	48135	g_1591	g_1592
Super-Scaffold_100004	5311217	5320809	9592	g_1592	g_43001
Super-Scaffold_100004	5321241	5360401	39160	g_43001	g_1594
Super-Scaffold_100004	5363058	5387958	24900	g_1594	g_37454
Super-Scaffold_100004	5388197	5447830	59633	g_37454	g_1596
Super-Scaffold_100004	5448906	5452983	4077	g_1596	g_1597
Super-Scaffold_100004	5453279	5491150	37871	g_1597	g_1599
Super-Scaffold_100004	5492184	5493224	1040	g_1599	g_1600
Super-Scaffold_100004	5493457	5555970	62513	g_1600	g_1601
Super-Scaffold_100004	5556547	5557427	880	g_1601	g_1602
Super-Scaffold_100004	5557879	5612730	54851	g_1602	g_1604
Super-Scaffold_100004	5613260	5689663	76403	g_1604	g_1606
Super-Scaffold_100004	5689929	5871958	182029	g_1606	g_1607
Super-Scaffold_100004	5875123	5875158	35	g_1607	g_43002
Super-Scaffold_100004	5875382	5986517	111135	g_43002	g_1608
Super-Scaffold_100004	5986942	5987075	133	g_1608	g_1609
Super-Scaffold_100004	5987398	6076813	89415	g_1609	g_1612
Super-Scaffold_100004	6082935	6089343	6408	g_1612	g_1613
Super-Scaffold_100004	6093233	6093281	48	g_1613	g_43003
Super-Scaffold_100004	6094881	6099402	4521	g_43003	g_1614
Super-Scaffold_100004	6100712	6201968	101256	g_1614	g_1617
Super-Scaffold_100004	6202330	6218601	16271	g_1617	g_1618
Super-Scaffold_100004	6219167	6297179	78012	g_1618	g_1619
Super-Scaffold_100004	6299302	6406055	106753	g_1619	g_37457
Super-Scaffold_100004	6406333	6418853	12520	g_37457	g_1621
Super-Scaffold_100004	6419761	6444363	24602	g_1621	g_1622
Super-Scaffold_100004	6453925	6593655	139730	g_1622	g_1625
Super-Scaffold_100004	6595514	6607962	12448	g_1625	g_1626
Super-Scaffold_100004	6608366	6608366	0	g_1626	g_1627
Super-Scaffold_100004	6608779	6656658	47879	g_1627	g_1628
Super-Scaffold_100004	6658654	6678141	19487	g_1628	g_1629
Super-Scaffold_100004	6679194	6698589	19395	g_1629	g_1630
Super-Scaffold_100004	6702563	6714751	12188	g_1630	g_1631
Super-Scaffold_100004	6715041	6731273	16232	g_1631	g_1632
Super-Scaffold_100004	6731530	6757635	26105	g_1632	g_1633
Super-Scaffold_100004	6758545	6758765	220	g_1633	g_1634
Super-Scaffold_100004	6760405	6760547	142	g_1634	g_1635
Super-Scaffold_100004	6762416	6822496	60080	g_1635	g_1636
Super-Scaffold_100004	6823264	6824642	1378	g_1636	g_1637
Super-Scaffold_100004	6825666	6923385	97719	g_1637	g_1640
Super-Scaffold_100004	6925851	6926228	377	g_1640	g_1641
Super-Scaffold_100004	6928135	6939376	11241	g_1641	g_1642
Super-Scaffold_100004	6939726	7035831	96105	g_1642	g_1644
Super-Scaffold_100004	7037951	7083875	45924	g_1644	g_1646
Super-Scaffold_100004	7084543	7160346	75803	g_1646	g_1651
Super-Scaffold_100004	7162457	7170582	8125	g_1651	g_1652
Super-Scaffold_100004	7170860	7171057	197	g_1652	g_1653
Super-Scaffold_100004	7172094	7173636	1542	g_1653	g_1655
Super-Scaffold_100004	7173842	7183459	9617	g_1655	g_1656
Super-Scaffold_100004	7184864	7589561	404697	g_1656	g_1658
Super-Scaffold_100004	7590240	7594939	4699	g_37465	g_1659
Super-Scaffold_100004	7596056	7717770	121714	g_1659	g_1663
Super-Scaffold_100004	7718527	7763066	44539	g_1663	g_1665
Super-Scaffold_100004	7763344	7916512	153168	g_1665	g_1667
Super-Scaffold_100004	7917696	7969572	51876	g_1667	g_1669
Super-Scaffold_100004	7971071	7977518	6447	g_1669	g_1670
Super-Scaffold_100004	7977835	7990590	12755	g_1670	g_1671
Super-Scaffold_100004	7990811	7990917	106	g_1671	g_1672
Super-Scaffold_100004	7991696	7992032	336	g_1672	g_1673
Super-Scaffold_100004	7992592	7997082	4490	g_1673	g_1674
Super-Scaffold_100004	7997894	8003737	5843	g_1674	g_1675
Super-Scaffold_100004	8003976	8035222	31246	g_1675	g_1678
Super-Scaffold_100004	8035605	8039202	3597	g_1678	g_1679
Super-Scaffold_100004	8042654	8042864	210	g_1679	g_43004
Super-Scaffold_100004	8045532	8084966	39434	g_43004	g_1681
Super-Scaffold_100004	8085412	8086047	635	g_1681	g_1682
Super-Scaffold_100004	8086588	8115775	29187	g_1682	g_1683
Super-Scaffold_100004	8116260	8117681	1421	g_1683	g_1684
Super-Scaffold_100004	8121020	8136653	15633	g_1684	g_1685
Super-Scaffold_100004	8137670	8137964	294	g_1685	g_1686
Super-Scaffold_100004	8138848	8229007	90159	g_1686	g_1687
Super-Scaffold_100004	8231928	8349440	117512	g_1687	g_1690
Super-Scaffold_100004	8352753	8352892	139	g_1690	g_1691
Super-Scaffold_100004	8354415	8359357	4942	g_1691	g_1692
Super-Scaffold_100004	8360151	8388130	27979	g_1692	g_1694
Super-Scaffold_100004	8388477	8388940	463	g_1694	g_1695
Super-Scaffold_100004	8389770	8405148	15378	g_1695	g_37470
Super-Scaffold_100004	8405369	8530335	124966	g_37470	g_1696
Super-Scaffold_100004	8531291	8573589	42298	g_1696	g_1697
Super-Scaffold_100004	8577572	8781015	203443	g_1697	g_1700
Super-Scaffold_100004	8781347	8810134	28787	g_1700	g_1701
Super-Scaffold_100004	8814554	8893951	79397	g_1701	g_1702
Super-Scaffold_100004	8894163	8946201	52038	g_1702	g_1703
Super-Scaffold_100004	8948789	9077079	128290	g_1703	g_1706
Super-Scaffold_100004	9077309	9082768	5459	g_1706	g_1707
Super-Scaffold_100004	9084534	9123581	39047	g_1707	g_1708
Super-Scaffold_100004	9124090	9124404	314	g_1708	g_1709
Super-Scaffold_100004	9126296	9152052	25756	g_1709	g_1710
Super-Scaffold_100004	9156045	9169870	13825	g_1710	g_1711
Super-Scaffold_100004	9170487	9184865	14378	g_1711	g_1712
Super-Scaffold_100004	9185092	9191353	6261	g_1712	g_1714
Super-Scaffold_100004	9191919	9192001	82	g_1714	g_1715
Super-Scaffold_100004	9192942	9212644	19702	g_1715	g_1719
Super-Scaffold_100004	9213417	9225966	12549	g_1719	g_1720
Super-Scaffold_100004	9230178	9237069	6891	g_1720	g_1721
Super-Scaffold_100004	9237575	9238072	497	g_1721	g_43005
Super-Scaffold_100004	9243291	9330424	87133	g_43005	g_1723
Super-Scaffold_100004	9330723	9360876	30153	g_1723	g_1724
Super-Scaffold_100004	9363203	9429055	65852	g_1724	g_1725
Super-Scaffold_100004	9429273	9460533	31260	g_1725	g_1726
Super-Scaffold_100004	9460829	9461414	585	g_1726	g_1727
Super-Scaffold_100004	9462265	9565689	103424	g_1727	g_1728
Super-Scaffold_100004	9566201	9653386	87185	g_1728	g_1729
Super-Scaffold_100004	9653781	9671575	17794	g_1729	g_1730
Super-Scaffold_100004	9673965	9692658	18693	g_1730	g_1731
Super-Scaffold_100004	9693515	9693657	142	g_1731	g_1732
Super-Scaffold_100004	9694109	9703641	9532	g_1732	g_37474
Super-Scaffold_100004	9704096	9802347	98251	g_37474	g_1736
Super-Scaffold_100004	9802796	9803324	528	g_1736	g_1737
Super-Scaffold_100004	9804097	9843408	39311	g_1737	g_1740
Super-Scaffold_100004	9853449	9874602	21153	g_1740	g_1741
Super-Scaffold_100004	9882178	9936789	54611	g_1741	g_1743
Super-Scaffold_100004	9955166	9981808	26642	g_1743	g_43006
Super-Scaffold_100004	10024833	10025141	308	g_43006	g_1744
Super-Scaffold_100004	10036328	10050315	13987	g_37475	g_1745
Super-Scaffold_100004	10063752	10067523	3771	g_1745	g_1746
Super-Scaffold_100004	10075785	10080231	4446	g_1746	g_1747
Super-Scaffold_100004	10086164	10100377	14213	g_1747	g_1748
Super-Scaffold_100004	10101210	10103003	1793	g_1748	g_1749
Super-Scaffold_100004	10104136	10104161	25	g_1749	g_1750
Super-Scaffold_100004	10105762	10114564	8802	g_1750	g_1751
Super-Scaffold_100004	10120375	10122923	2548	g_1751	g_1752
Super-Scaffold_100004	10155817	10158979	3162	g_1752	g_43007
Super-Scaffold_100004	10179951	10191213	11262	g_43007	g_1753
Super-Scaffold_100004	10191584	10224896	33312	g_1753	g_1755
Super-Scaffold_100004	10227262	10253794	26532	g_1755	g_1756
Super-Scaffold_100004	10255222	10255279	57	g_1756	g_1757
Super-Scaffold_100004	10256614	10257093	479	g_1757	g_1758
Super-Scaffold_100004	10259622	10282387	22765	g_1758	g_1759
Super-Scaffold_100004	10283076	10347844	64768	g_1759	g_1761
Super-Scaffold_100004	10348248	10348423	175	g_1761	g_1762
Super-Scaffold_100004	10349742	10423661	73919	g_1762	g_1766
Super-Scaffold_100004	10423912	10473981	50069	g_1766	g_1767
Super-Scaffold_100004	10474460	11005634	531174	g_1767	g_1770
Super-Scaffold_100004	11040952	11069772	28820	g_1770	g_1771
Super-Scaffold_100004	11074239	11091208	16969	g_1771	g_1772
Super-Scaffold_100004	11096658	11112241	15583	g_1772	g_43008
Super-Scaffold_100004	11178538	11188848	10310	g_43008	g_1773
Super-Scaffold_100004	11191256	11227501	36245	g_1773	g_1775
Super-Scaffold_100004	11243339	11247534	4195	g_1775	g_1776
Super-Scaffold_100004	11256468	11294830	38362	g_1776	g_1777
Super-Scaffold_100004	11314822	11319067	4245	g_1777	g_1778
Super-Scaffold_100004	11326762	11332028	5266	g_1778	g_43009
Super-Scaffold_100004	11343990	11516576	172586	g_43009	g_1780
Super-Scaffold_100004	11551340	11566338	14998	g_1780	g_1781
Super-Scaffold_100004	11580189	11586892	6703	g_1781	g_1782
Super-Scaffold_100004	11589608	11609290	19682	g_1782	g_1783
Super-Scaffold_100004	11638090	11657601	19511	g_1783	g_1784
Super-Scaffold_100004	11667951	11672365	4414	g_1784	g_1785
Super-Scaffold_100004	11678689	11680157	1468	g_1785	g_1786
Super-Scaffold_100004	11685565	11689625	4060	g_1786	g_1787
Super-Scaffold_100004	11689969	11694900	4931	g_1787	g_1788
Super-Scaffold_100004	11696156	11697765	1609	g_1788	g_1789
Super-Scaffold_100004	11708163	11709733	1570	g_1789	g_1790
Super-Scaffold_100004	11714436	11718034	3598	g_1790	g_1791
Super-Scaffold_100004	11724714	11728562	3848	g_1791	g_1792
Super-Scaffold_100004	11736184	11748061	11877	g_1792	g_1793
Super-Scaffold_100004	11756950	11758242	1292	g_1793	g_1794
Super-Scaffold_100004	11761738	11762190	452	g_1794	g_1795
Super-Scaffold_100004	11766431	11792059	25628	g_1795	g_1796
Super-Scaffold_100004	11809087	11870071	60984	g_1796	g_1797
Super-Scaffold_100004	11881247	11884024	2777	g_1797	g_1798
Super-Scaffold_100004	11884827	11886235	1408	g_1798	g_1799
Super-Scaffold_100004	11887874	11946189	58315	g_1799	g_43010
Super-Scaffold_100004	11962773	11978705	15932	g_43010	g_1800
Super-Scaffold_100004	11979490	11988853	9363	g_1800	g_1802
Super-Scaffold_100004	11993681	11994887	1206	g_1802	g_1803
Super-Scaffold_100004	12001576	12002786	1210	g_1803	g_1804
Super-Scaffold_100004	12010189	12012294	2105	g_1804	g_43011
Super-Scaffold_100004	12014202	12017743	3541	g_43011	g_1805
Super-Scaffold_100004	12019083	12021784	2701	g_1805	g_1806
Super-Scaffold_100004	12022050	12037828	15778	g_1806	g_1807
Super-Scaffold_100004	12045199	12094161	48962	g_1807	g_1809
Super-Scaffold_100004	12094628	12098804	4176	g_1809	g_1810
Super-Scaffold_100004	12099649	12116126	16477	g_1810	g_1811
Super-Scaffold_100004	12132269	12150902	18633	g_1811	g_1812
Super-Scaffold_100004	12153027	12177592	24565	g_1812	g_1813
Super-Scaffold_100004	12187369	12199338	11969	g_1813	g_1815
Super-Scaffold_100004	12200222	12204178	3956	g_1815	g_1816
Super-Scaffold_100004	12206423	12208865	2442	g_1816	g_1817
Super-Scaffold_100004	12215862	12239755	23893	g_1817	g_1818
Super-Scaffold_100004	12265601	12276713	11112	g_1818	g_1819
Super-Scaffold_100004	12284322	12287483	3161	g_1819	g_1820
Super-Scaffold_100004	12288946	12298438	9492	g_1820	g_1821
Super-Scaffold_100004	12299672	12301817	2145	g_1821	g_1822
Super-Scaffold_100004	12315908	12322153	6245	g_1822	g_37488
Super-Scaffold_100004	12325731	12344876	19145	g_37488	g_1823
Super-Scaffold_100004	12345178	12351766	6588	g_1823	g_37492
Super-Scaffold_100004	12352167	12368128	15961	g_37492	g_1826
Super-Scaffold_100004	12368376	12372136	3760	g_1826	g_1827
Super-Scaffold_100004	12372558	12388349	15791	g_1827	g_1829
Super-Scaffold_100004	12388615	12392709	4094	g_1829	g_1830
Super-Scaffold_100004	12392912	12397879	4967	g_1830	g_1831
Super-Scaffold_100004	12398142	12430021	31879	g_1831	g_1834
Super-Scaffold_100004	12430353	12495835	65482	g_1834	g_1837
Super-Scaffold_100004	12499430	12504391	4961	g_1837	g_1838
Super-Scaffold_100004	12512834	12515337	2503	g_1838	g_1839
Super-Scaffold_100004	12522920	12525649	2729	g_1839	g_1840
Super-Scaffold_100004	12531328	12533538	2210	g_1840	g_1841
Super-Scaffold_100004	12536041	12539083	3042	g_1841	g_1842
Super-Scaffold_100004	12557817	12560926	3109	g_1842	g_1843
Super-Scaffold_100004	12563296	12563699	403	g_1843	g_1844
Super-Scaffold_100004	12566367	12571100	4733	g_1844	g_1845
Super-Scaffold_100004	12571900	12574700	2800	g_1845	g_1846
Super-Scaffold_100004	12576438	12600799	24361	g_1846	g_1847
Super-Scaffold_100004	12601869	12602731	862	g_1847	g_1848
Super-Scaffold_100004	12617709	12625730	8021	g_1848	g_1849
Super-Scaffold_100004	12642434	12645864	3430	g_1849	g_1850
Super-Scaffold_100004	12652171	12661159	8988	g_1850	g_1851
Super-Scaffold_100004	12672573	12679227	6654	g_1851	g_1852
Super-Scaffold_100004	12689329	12695844	6515	g_1852	g_1853
Super-Scaffold_100004	12699893	12705604	5711	g_1853	g_1854
Super-Scaffold_100004	12733755	12742078	8323	g_1854	g_1855
Super-Scaffold_100004	12746235	12747410	1175	g_1855	g_1856
Super-Scaffold_100004	12753047	12760448	7401	g_1856	g_1857
Super-Scaffold_100004	12765642	12819869	54227	g_1857	g_1858
Super-Scaffold_100004	12820903	12835527	14624	g_1858	g_1859
Super-Scaffold_100004	12836947	12865980	29033	g_37497	g_1860
Super-Scaffold_100004	12867578	12874571	6993	g_1860	g_1861
Super-Scaffold_100004	12877023	12882292	5269	g_1861	g_1862
Super-Scaffold_100004	12884054	12886381	2327	g_1862	g_1863
Super-Scaffold_100004	12894469	12908615	14146	g_1863	g_1864
Super-Scaffold_100004	12915417	12925516	10099	g_1864	g_1865
Super-Scaffold_100004	12930592	12932505	1913	g_1865	g_1866
Super-Scaffold_100004	12939053	12954259	15206	g_1866	g_1868
Super-Scaffold_100004	12963174	12965909	2735	g_1868	g_1869
Super-Scaffold_100004	12967409	12969988	2579	g_1869	g_43012
Super-Scaffold_100004	12977492	12978145	653	g_43012	g_1870
Super-Scaffold_100004	12983624	13034314	50690	g_1870	g_1871
Super-Scaffold_100004	13035399	13047051	11652	g_1871	g_1872
Super-Scaffold_100004	13060648	13064710	4062	g_1872	g_1873
Super-Scaffold_100004	13072856	13076971	4115	g_1873	g_1874
Super-Scaffold_100004	13077381	13088588	11207	g_1874	g_1875
Super-Scaffold_100004	13088800	13124413	35613	g_1875	g_1876
Super-Scaffold_100004	13150966	13155797	4831	g_1876	g_43013
Super-Scaffold_100004	13163639	13170139	6500	g_43013	g_1877
Super-Scaffold_100004	13171407	13175805	4398	g_1877	g_1878
Super-Scaffold_100004	13179381	13181663	2282	g_1878	g_1879
Super-Scaffold_100004	13213579	13219627	6048	g_1879	g_43014
Super-Scaffold_100004	13219974	13223675	3701	g_43014	g_1880
Super-Scaffold_100004	13223983	13349106	125123	g_1880	g_1884
Super-Scaffold_100004	13349741	13370940	21199	g_1884	g_1885
Super-Scaffold_100004	13376363	13442880	66517	g_1885	g_1890
Super-Scaffold_100004	13443140	13498077	54937	g_1890	g_1891
Super-Scaffold_100004	13498376	13535369	36993	g_1891	g_1892
Super-Scaffold_100004	13540397	13562761	22364	g_1892	g_1894
Super-Scaffold_100004	13579890	13584652	4762	g_1894	g_1895
Super-Scaffold_100004	13587455	13596697	9242	g_1895	g_1897
Super-Scaffold_100004	13604628	13605830	1202	g_1897	g_1898
Super-Scaffold_100004	13617111	13618760	1649	g_1898	g_1899
Super-Scaffold_100004	13629827	13668394	38567	g_1899	g_1901
Super-Scaffold_100004	13677443	13714551	37108	g_1901	g_37516
Super-Scaffold_100004	13714766	13738469	23703	g_37516	g_1904
Super-Scaffold_100004	13762483	13765927	3444	g_1904	g_1905
Super-Scaffold_100004	13775893	13779785	3892	g_1905	g_1906
Super-Scaffold_100004	13783137	13788037	4900	g_1906	g_1908
Super-Scaffold_100004	13797942	13802093	4151	g_1908	g_1909
Super-Scaffold_100004	13806495	13820451	13956	g_1909	g_1910
Super-Scaffold_100004	13823378	13828392	5014	g_1910	g_1911
Super-Scaffold_100004	13849775	13868500	18725	g_1911	g_1912
Super-Scaffold_100004	13869955	13978204	108249	g_1912	g_1920
Super-Scaffold_100004	13980230	14048401	68171	g_1920	g_1922
Super-Scaffold_100004	14048658	14220326	171668	g_1922	g_37528
Super-Scaffold_100004	14220541	14224663	4122	g_37528	g_37529
Super-Scaffold_100004	14224881	14228554	3673	g_37529	g_1924
Super-Scaffold_100004	14228787	14380751	151964	g_1924	g_1926
Super-Scaffold_100004	14380960	14436582	55622	g_1926	g_1927
Super-Scaffold_100004	14438629	14439350	721	g_1927	g_1928
Super-Scaffold_100004	14447638	14467669	20031	g_1928	g_1929
Super-Scaffold_100004	14482931	14491307	8376	g_1929	g_1930
Super-Scaffold_100004	14497584	14501017	3433	g_1930	g_1931
Super-Scaffold_100004	14501781	14504003	2222	g_1931	g_1932
Super-Scaffold_100004	14512702	14558401	45699	g_1932	g_1933
Super-Scaffold_100004	14565394	14586183	20789	g_1933	g_43015
Super-Scaffold_100004	14610810	14745721	134911	g_43015	g_1935
Super-Scaffold_100004	14745930	14756448	10518	g_1935	g_1936
Super-Scaffold_100004	14758832	14759382	550	g_1936	g_43016
Super-Scaffold_100004	14761082	14764469	3387	g_43016	g_1937
Super-Scaffold_100004	14768441	14768713	272	g_1937	g_1938
Super-Scaffold_100004	14770861	14772634	1773	g_1938	g_1939
Super-Scaffold_100004	14773933	14798319	24386	g_1939	g_1940
Super-Scaffold_100004	14804901	14806362	1461	g_1940	g_1941
Super-Scaffold_100004	14819377	14840588	21211	g_1941	g_1942
Super-Scaffold_100004	14842471	14845242	2771	g_1942	g_1943
Super-Scaffold_100004	14867893	14884105	16212	g_1943	g_1944
Super-Scaffold_100004	14884332	14895434	11102	g_1944	g_1945
Super-Scaffold_100004	14909966	14921850	11884	g_1945	g_1946
Super-Scaffold_100004	14923088	14943909	20821	g_1946	g_1947
Super-Scaffold_100004	14946690	14991461	44771	g_37532	g_1948
Super-Scaffold_100004	14993344	14998945	5601	g_1948	g_1949
Super-Scaffold_100004	15001162	15010875	9713	g_1949	g_1951
Super-Scaffold_100004	15016821	15030213	13392	g_1951	g_1954
Super-Scaffold_100004	15030527	15033818	3291	g_1954	g_1955
Super-Scaffold_100004	15059325	15087379	28054	g_1955	g_1956
Super-Scaffold_100004	15099078	15103028	3950	g_1956	g_1957
Super-Scaffold_100004	15105331	15106591	1260	g_1957	g_1958
Super-Scaffold_100004	15111819	15114998	3179	g_1958	g_1959
Super-Scaffold_100004	15146115	15151532	5417	g_1959	g_1960
Super-Scaffold_100004	15152851	15155400	2549	g_1960	g_1961
Super-Scaffold_100004	15172887	15196745	23858	g_1961	g_1963
Super-Scaffold_100004	15197209	15198709	1500	g_1963	g_43017
Super-Scaffold_100004	15201047	15205197	4150	g_43017	g_37537
Super-Scaffold_100004	15207045	15207973	928	g_37537	g_1964
Super-Scaffold_100004	15211041	15214432	3391	g_1964	g_1965
Super-Scaffold_100004	15216118	15265249	49131	g_1965	g_1966
Super-Scaffold_100004	15268920	15278573	9653	g_1966	g_1967
Super-Scaffold_100004	15285436	15307618	22182	g_1967	g_1969
Super-Scaffold_100004	15308865	15337098	28233	g_1969	g_1970
Super-Scaffold_100004	15338210	15350343	12133	g_1970	g_1972
Super-Scaffold_100004	15352337	15360936	8599	g_1972	g_1973
Super-Scaffold_100004	15362504	15363924	1420	g_1973	g_1974
Super-Scaffold_100004	15369469	15375849	6380	g_1974	g_1975
Super-Scaffold_100004	15380981	15396256	15275	g_1975	g_1976
Super-Scaffold_100004	15407315	15409149	1834	g_1976	g_1977
Super-Scaffold_100004	15411563	15415632	4069	g_1977	g_1978
Super-Scaffold_100004	15425285	15426372	1087	g_1978	g_1979
Super-Scaffold_100004	15426575	15629589	203014	g_1979	g_1981
Super-Scaffold_100004	15630356	15642875	12519	g_1981	g_1982
Super-Scaffold_100004	15643930	15644022	92	g_1982	g_43018
Super-Scaffold_100004	15645068	15726513	81445	g_43018	g_1984
Super-Scaffold_100004	15729451	15750547	21096	g_37542	g_1985
Super-Scaffold_100004	15762730	15802227	39497	g_1985	g_1986
Super-Scaffold_100004	15805814	15831056	25242	g_1986	g_1987
Super-Scaffold_100004	15838984	15852477	13493	g_1987	g_1988
Super-Scaffold_100004	15852905	15900485	47580	g_1988	g_1991
Super-Scaffold_100004	15909936	15910530	594	g_1991	g_1992
Super-Scaffold_100004	15911395	15911527	132	g_1992	g_43019
Super-Scaffold_100004	15913046	15915023	1977	g_43019	g_1993
Super-Scaffold_100004	15923274	15934358	11084	g_1993	g_1994
Super-Scaffold_100004	15941916	15948831	6915	g_1994	g_1995
Super-Scaffold_100004	15955442	15956906	1464	g_1995	g_1996
Super-Scaffold_100004	15960375	15979121	18746	g_1996	g_1998
Super-Scaffold_100004	15983085	15987131	4046	g_1998	g_1999
Super-Scaffold_100004	15990350	15995200	4850	g_1999	g_2000
Super-Scaffold_100004	16003272	16051426	48154	g_2000	g_2002
Super-Scaffold_100004	16053163	16055833	2670	g_2002	g_2003
Super-Scaffold_100004	16061884	16063221	1337	g_2003	g_2004
Super-Scaffold_100004	16067251	16070690	3439	g_2004	g_2005
Super-Scaffold_100004	16097013	16099450	2437	g_2005	g_2006
Super-Scaffold_100004	16100797	16102571	1774	g_2006	g_2007
Super-Scaffold_100004	16106307	16107843	1536	g_2007	g_2008
Super-Scaffold_100004	16129328	16131367	2039	g_2008	g_2009
Super-Scaffold_100004	16136902	16141841	4939	g_2009	g_2010
Super-Scaffold_100004	16146457	16233885	87428	g_2010	g_2013
Super-Scaffold_100004	16234205	16413733	179528	g_2013	g_2015
Super-Scaffold_100004	16414371	16415240	869	g_2015	g_2016
Super-Scaffold_100004	16420291	16420884	593	g_2016	g_2017
Super-Scaffold_100004	16427133	16429743	2610	g_2017	g_2018
Super-Scaffold_100004	16440087	16441241	1154	g_2018	g_2019
Super-Scaffold_100004	16443466	16445856	2390	g_2019	g_2020
Super-Scaffold_100004	16448200	16450866	2666	g_2020	g_2021
Super-Scaffold_100004	16451981	16460028	8047	g_2021	g_2022
Super-Scaffold_100004	16464862	16516705	51843	g_2022	g_2024
Super-Scaffold_100004	16530773	16537465	6692	g_2024	g_2025
Super-Scaffold_100004	16539904	16557867	17963	g_2025	g_2026
Super-Scaffold_100004	16559297	16571279	11982	g_2026	g_2027
Super-Scaffold_100004	16580285	16584559	4274	g_2027	g_2028
Super-Scaffold_100004	16592266	16601631	9365	g_2028	g_2029
Super-Scaffold_100004	16602985	16619320	16335	g_2029	g_2030
Super-Scaffold_100004	16620396	16621163	767	g_2030	g_2031
Super-Scaffold_100004	16621540	16623442	1902	g_2031	g_37551
Super-Scaffold_100004	16624269	16627294	3025	g_37551	g_2033
Super-Scaffold_100004	16631488	16639623	8135	g_2033	g_2034
Super-Scaffold_100004	16641688	16645839	4151	g_2034	g_2035
Super-Scaffold_100004	16656410	16674400	17990	g_2035	g_37552
Super-Scaffold_100004	16674738	16849956	175218	g_37552	g_2040
Super-Scaffold_100004	16851821	16890596	38775	g_2040	g_2042
Super-Scaffold_100004	16892184	16939194	47010	g_2042	g_2046
Super-Scaffold_100004	16939863	17005825	65962	g_2046	g_2049
Super-Scaffold_100004	17008296	17009990	1694	g_2049	g_2050
Super-Scaffold_100004	17017818	17022719	4901	g_2050	g_2051
Super-Scaffold_100004	17026987	17030187	3200	g_2051	g_2052
Super-Scaffold_100004	17030798	17033721	2923	g_2052	g_2053
Super-Scaffold_100004	17036447	17038164	1717	g_2053	g_2054
Super-Scaffold_100004	17050406	17055020	4614	g_2054	g_2055
Super-Scaffold_100004	17060055	17061237	1182	g_2055	g_2056
Super-Scaffold_100004	17062868	17071301	8433	g_2056	g_2057
Super-Scaffold_100004	17074835	17076998	2163	g_2057	g_43020
Super-Scaffold_100004	17091236	17114399	23163	g_43020	g_2059
Super-Scaffold_100004	17121639	17124694	3055	g_2059	g_2060
Super-Scaffold_100004	17125269	17158462	33193	g_2060	g_2063
Super-Scaffold_100004	17170229	17177348	7119	g_2063	g_2064
Super-Scaffold_100004	17178199	17186373	8174	g_2064	g_2065
Super-Scaffold_100004	17190427	17193276	2849	g_2065	g_2066
Super-Scaffold_100004	17203999	17214739	10740	g_2066	g_2067
Super-Scaffold_100004	17215611	17217908	2297	g_2067	g_2068
Super-Scaffold_100004	17220700	17221435	735	g_2068	g_2069
Super-Scaffold_100004	17224096	17224973	877	g_2069	g_2070
Super-Scaffold_100004	17237383	17237579	196	g_2070	g_43021
Super-Scaffold_100004	17237785	17246008	8223	g_43021	g_2071
Super-Scaffold_100004	17265986	17300758	34772	g_2071	g_2072
Super-Scaffold_100004	17301426	17330819	29393	g_2072	g_2073
Super-Scaffold_100004	17331355	17403419	72064	g_2073	g_2075
Super-Scaffold_100004	17408502	17410467	1965	g_2075	g_2076
Super-Scaffold_100004	17410994	17414238	3244	g_2076	g_43022
Super-Scaffold_100004	17416873	17418031	1158	g_43022	g_2077
Super-Scaffold_100004	17419075	17420209	1134	g_2077	g_2078
Super-Scaffold_100004	17424718	17434729	10011	g_2078	g_2079
Super-Scaffold_100004	17438436	17439618	1182	g_2079	g_2080
Super-Scaffold_100004	17442894	17448176	5282	g_2080	g_2081
Super-Scaffold_100004	17449949	17453033	3084	g_2081	g_2082
Super-Scaffold_100004	17456869	17473122	16253	g_2082	g_2084
Super-Scaffold_100004	17473478	17473488	10	g_2084	g_2085
Super-Scaffold_100004	17474190	17474691	501	g_2085	g_2086
Super-Scaffold_100004	17475634	17485006	9372	g_2086	g_2087
Super-Scaffold_100004	17494667	17528838	34171	g_2087	g_2089
Super-Scaffold_100004	17529146	17543180	14034	g_2089	g_2091
Super-Scaffold_100004	17565763	17566142	379	g_2091	g_2092
Super-Scaffold_100004	17570976	17573328	2352	g_2092	g_2093
Super-Scaffold_100004	17576936	17613168	36232	g_2093	g_2095
Super-Scaffold_100004	17617711	17632758	15047	g_2095	g_2096
Super-Scaffold_100004	17661546	17672526	10980	g_2096	g_2097
Super-Scaffold_100004	17687022	17688905	1883	g_2097	g_2098
Super-Scaffold_100004	17704315	17722719	18404	g_2098	g_37565
Super-Scaffold_100004	17731965	17737826	5861	g_2100	g_2101
Super-Scaffold_100004	17759124	17764422	5298	g_2101	g_2102
Super-Scaffold_100004	17765793	17769451	3658	g_2102	g_2103
Super-Scaffold_100004	17775665	17777361	1696	g_2103	g_2104
Super-Scaffold_100004	17778960	17780708	1748	g_2104	g_2105
Super-Scaffold_100004	17789479	17792296	2817	g_2105	g_2106
Super-Scaffold_100004	17793247	17795457	2210	g_2106	g_2107
Super-Scaffold_100004	17797615	17801300	3685	g_2107	g_2108
Super-Scaffold_100004	17802649	17804273	1624	g_2108	g_2109
Super-Scaffold_100004	17812100	17814596	2496	g_2109	g_43023
Super-Scaffold_100004	17816444	17817699	1255	g_43023	g_2110
Super-Scaffold_100004	17819362	17819979	617	g_2110	g_2111
Super-Scaffold_100004	17827451	17828010	559	g_2111	g_43024
Super-Scaffold_100004	17828822	17846334	17512	g_43024	g_2113
Super-Scaffold_100004	17846594	17849059	2465	g_2113	g_2114
Super-Scaffold_100004	17859107	17860996	1889	g_2114	g_2115
Super-Scaffold_100004	17861289	17863798	2509	g_2115	g_2116
Super-Scaffold_100004	17879700	17887652	7952	g_2116	g_2118
Super-Scaffold_100004	17904889	17909044	4155	g_2118	g_2119
Super-Scaffold_100004	17913521	17916696	3175	g_2119	g_2120
Super-Scaffold_100004	17918983	17920058	1075	g_2120	g_2121
Super-Scaffold_100004	17922641	17923623	982	g_2121	g_2122
Super-Scaffold_100004	17924291	17927046	2755	g_2122	g_2123
Super-Scaffold_100004	17940665	17944352	3687	g_37566	g_2124
Super-Scaffold_100004	17948989	17954699	5710	g_2124	g_2125
Super-Scaffold_100004	17968852	17976270	7418	g_2125	g_2126
Super-Scaffold_100004	17977022	17983387	6365	g_2126	g_2127
Super-Scaffold_100004	17991213	17993753	2540	g_2127	g_2128
Super-Scaffold_100004	17994013	17995315	1302	g_2128	g_2129
Super-Scaffold_100004	18003286	18052520	49234	g_2129	g_2130
Super-Scaffold_100004	18054343	18057412	3069	g_2130	g_43025
Super-Scaffold_100004	18063290	18066625	3335	g_43025	g_2131
Super-Scaffold_100004	18066885	18091687	24802	g_2131	g_2133
Super-Scaffold_100004	18094058	18105058	11000	g_2133	g_37569
Super-Scaffold_100004	18105276	18187618	82342	g_37569	g_2136
Super-Scaffold_100004	18196291	18196345	54	g_2136	g_2137
Super-Scaffold_100004	18196545	18199612	3067	g_2137	g_2138
Super-Scaffold_100004	18216553	18221687	5134	g_2138	g_43026
Super-Scaffold_100004	18228472	18241703	13231	g_43026	g_2139
Super-Scaffold_100004	18246447	18254073	7626	g_2139	g_2140
Super-Scaffold_100004	18256811	18260482	3671	g_2140	g_2141
Super-Scaffold_100004	18263712	18265680	1968	g_2141	g_2142
Super-Scaffold_100004	18267644	18269775	2131	g_2142	g_2143
Super-Scaffold_100004	18271878	18272881	1003	g_2143	g_2144
Super-Scaffold_100004	18276700	18281337	4637	g_2144	g_2145
Super-Scaffold_100004	18287412	18331198	43786	g_2145	g_2147
Super-Scaffold_100004	18331503	18393987	62484	g_2147	g_2149
Super-Scaffold_100004	18395072	18396903	1831	g_2149	g_2150
Super-Scaffold_100004	18402134	18404059	1925	g_2150	g_2151
Super-Scaffold_100004	18404676	18407200	2524	g_2151	g_2152
Super-Scaffold_100004	18414569	18474173	59604	g_2152	g_2154
Super-Scaffold_100004	18476236	18478338	2102	g_2154	g_2155
Super-Scaffold_100004	18486772	18492910	6138	g_2155	g_2157
Super-Scaffold_100004	18512552	18526624	14072	g_2157	g_2158
Super-Scaffold_100004	18533057	18535774	2717	g_2158	g_2159
Super-Scaffold_100004	18536651	18540950	4299	g_2159	g_2160
Super-Scaffold_100004	18541849	18545417	3568	g_2160	g_2161
Super-Scaffold_100004	18546325	18552968	6643	g_2161	g_2162
Super-Scaffold_100004	18553720	18560104	6384	g_2162	g_2163
Super-Scaffold_100004	18593679	18641658	47979	g_2163	g_2166
Super-Scaffold_100004	18641990	18658713	16723	g_2166	g_2168
Super-Scaffold_100004	18658964	18669515	10551	g_2168	g_2169
Super-Scaffold_100004	18671606	18681173	9567	g_2169	g_2170
Super-Scaffold_100004	18681634	18683303	1669	g_2170	g_2171
Super-Scaffold_100004	18683677	18715142	31465	g_2171	g_37583
Super-Scaffold_100004	18715354	18741328	25974	g_37583	g_2173
Super-Scaffold_100004	18748416	18750327	1911	g_2173	g_2174
Super-Scaffold_100004	18756682	18773532	16850	g_2174	g_2175
Super-Scaffold_100004	18774803	18822396	47593	g_2175	g_2176
Super-Scaffold_100004	18833299	18844985	11686	g_2176	g_2177
Super-Scaffold_100004	18855260	18857921	2661	g_2177	g_2178
Super-Scaffold_100004	18859802	18860863	1061	g_2178	g_2179
Super-Scaffold_100004	18864498	18867499	3001	g_2179	g_43027
Super-Scaffold_100004	18867816	18868840	1024	g_43027	g_2180
Super-Scaffold_100004	18876516	18878997	2481	g_2180	g_2181
Super-Scaffold_100004	18882582	18883530	948	g_2181	g_2182
Super-Scaffold_100004	18886711	18901179	14468	g_2182	g_2183
Super-Scaffold_100004	18902492	18903097	605	g_2183	g_2184
Super-Scaffold_100004	18903486	18904533	1047	g_2184	g_2185
Super-Scaffold_100004	18908927	18939938	31011	g_2185	g_2187
Super-Scaffold_100004	18954151	18954288	137	g_2187	g_2188
Super-Scaffold_100004	18954665	18956881	2216	g_2188	g_2189
Super-Scaffold_100004	18960513	18962116	1603	g_2189	g_2190
Super-Scaffold_100004	18967856	18968301	445	g_2190	g_2191
Super-Scaffold_100004	18969278	18969825	547	g_2191	g_2192
Super-Scaffold_100004	18971110	18972315	1205	g_2192	g_2193
Super-Scaffold_100004	18981961	18986797	4836	g_2193	g_2194
Super-Scaffold_100004	18995059	18997356	2297	g_2194	g_2195
Super-Scaffold_100004	19012130	19026602	14472	g_2195	g_2197
Super-Scaffold_100004	19029803	19034410	4607	g_2197	g_2198
Super-Scaffold_100004	19038435	19040412	1977	g_2198	g_43028
Super-Scaffold_100004	19043443	19044811	1368	g_43028	g_2199
Super-Scaffold_100004	19052680	19054915	2235	g_2199	g_2200
Super-Scaffold_100004	19058890	19060867	1977	g_2200	g_43029
Super-Scaffold_100004	19064384	19066457	2073	g_43029	g_2201
Super-Scaffold_100004	19070968	19073041	2073	g_2201	g_2202
Super-Scaffold_100004	19076965	19078104	1139	g_2202	g_2203
Super-Scaffold_100004	19080056	19081595	1539	g_2203	g_2204
Super-Scaffold_100004	19083750	19097665	13915	g_2204	g_2205
Super-Scaffold_100004	19101195	19103441	2246	g_2205	g_43030
Super-Scaffold_100004	19109105	19111813	2708	g_43030	g_2206
Super-Scaffold_100004	19113804	19127754	13950	g_2206	g_2207
Super-Scaffold_100004	19129749	19131604	1855	g_2207	g_2208
Super-Scaffold_100004	19133704	19142776	9072	g_2208	g_2209
Super-Scaffold_100004	19151767	19153270	1503	g_2209	g_2210
Super-Scaffold_100004	19155917	19161070	5153	g_2210	g_2211
Super-Scaffold_100004	19167478	19171159	3681	g_2211	g_43031
Super-Scaffold_100004	19174328	19176491	2163	g_43031	g_2212
Super-Scaffold_100004	19182061	19183528	1467	g_2212	g_2213
Super-Scaffold_100004	19187974	19191652	3678	g_2213	g_43032
Super-Scaffold_100004	19198988	19200785	1797	g_43032	g_43033
Super-Scaffold_100004	19202198	19203638	1440	g_43033	g_2214
Super-Scaffold_100004	19212897	19218711	5814	g_2214	g_2215
Super-Scaffold_100004	19222141	19222921	780	g_2215	g_2216
Super-Scaffold_100004	19224858	19229463	4605	g_2216	g_2217
Super-Scaffold_100004	19229672	19237721	8049	g_2217	g_2218
Super-Scaffold_100004	19252173	19256852	4679	g_2218	g_2219
Super-Scaffold_100004	19257790	19261147	3357	g_2219	g_2220
Super-Scaffold_100004	19267476	19268095	619	g_2220	g_2221
Super-Scaffold_100004	19270500	19273614	3114	g_2221	g_2222
Super-Scaffold_100004	19279293	19281497	2204	g_2222	g_2223
Super-Scaffold_100004	19285486	19288589	3103	g_2223	g_2224
Super-Scaffold_100004	19293095	19297456	4361	g_2224	g_2225
Super-Scaffold_100004	19297830	19301414	3584	g_2225	g_2226
Super-Scaffold_100004	19319425	19321430	2005	g_2226	g_2227
Super-Scaffold_100004	19330324	19343329	13005	g_2227	g_43034
Super-Scaffold_100004	19349915	19354814	4899	g_43034	g_43035
Super-Scaffold_100004	19361174	19363999	2825	g_43035	g_2228
Super-Scaffold_100004	19376132	19381117	4985	g_2228	g_2229
Super-Scaffold_100004	19403719	19658630	254911	g_2229	g_2231
Super-Scaffold_100004	19665475	19670086	4611	g_2231	g_2232
Super-Scaffold_100004	19670469	19672290	1821	g_2232	g_2233
Super-Scaffold_100004	19681245	19688150	6905	g_2233	g_2234
Super-Scaffold_100004	19694290	19729351	35061	g_2234	g_2236
Super-Scaffold_100004	19735684	19742370	6686	g_2236	g_2237
Super-Scaffold_100004	19744769	19745246	477	g_2237	g_43039
Super-Scaffold_100004	19747666	19748144	478	g_43039	g_43038
Super-Scaffold_100004	19750558	19751037	479	g_43038	g_2238
Super-Scaffold_100004	19753445	19754878	1433	g_2238	g_2239
Super-Scaffold_100004	19757301	19758308	1007	g_2239	g_2240
Super-Scaffold_100004	19760782	19763390	2608	g_2240	g_43036
Super-Scaffold_100004	19765678	19768141	2463	g_43036	g_43037
Super-Scaffold_100004	19773033	19779297	6264	g_43037	g_2241
Super-Scaffold_100004	19780808	19866878	86070	g_2241	g_37590
Super-Scaffold_100004	19867090	19912349	45259	g_37590	g_2242
Super-Scaffold_100004	19914748	19916878	2130	g_2242	g_43040
Super-Scaffold_100004	19919301	20039083	119782	g_43040	g_2244
Super-Scaffold_100004	20041500	20062858	21358	g_2244	g_2246
Super-Scaffold_100004	20063697	20087585	23888	g_2246	g_2248
Super-Scaffold_100004	20089780	20091113	1333	g_2248	g_2249
Super-Scaffold_100004	20093524	20101094	7570	g_2249	g_2250
Super-Scaffold_100004	20103499	20121170	17671	g_2250	g_2251
Super-Scaffold_100004	20123578	20126377	2799	g_2251	g_43041
Super-Scaffold_100004	20128797	20130910	2113	g_43041	g_43042
Super-Scaffold_100004	20133327	20327257	193930	g_43042	g_37591
Super-Scaffold_100004	20327475	20338014	10539	g_37591	g_2252
Super-Scaffold_100004	20338517	20357416	18899	g_2252	g_43043
Super-Scaffold_100004	20358465	20366895	8430	g_43043	g_43044
Super-Scaffold_100004	20379846	20403035	23189	g_43044	g_2253
Super-Scaffold_100004	20425060	20455103	30043	g_2253	g_2254
Super-Scaffold_100004	20476764	20501724	24960	g_2254	g_2255
Super-Scaffold_100004	20502059	20502137	78	g_2255	g_2256
Super-Scaffold_100004	20502635	20525576	22941	g_2256	g_2258
Super-Scaffold_100004	20538443	20581494	43051	g_2258	g_43045
Super-Scaffold_100004	20581979	20632333	50354	g_43045	g_2259
Super-Scaffold_100004	20649558	20666916	17358	g_2259	g_2260
Super-Scaffold_100004	20676869	20695052	18183	g_2260	g_2261
Super-Scaffold_100004	20721807	20731912	10105	g_2261	g_2262
Super-Scaffold_100004	20733275	20748826	15551	g_2262	g_2264
Super-Scaffold_100004	20751176	20753953	2777	g_2264	g_2265
Super-Scaffold_100004	20759529	20798158	38629	g_2265	g_2266
Super-Scaffold_100004	20807960	20810341	2381	g_2266	g_2267
Super-Scaffold_100004	20825657	20838381	12724	g_2267	g_2268
Super-Scaffold_100004	20844300	20848545	4245	g_2268	g_2269
Super-Scaffold_100004	20848835	20849186	351	g_2269	g_2270
Super-Scaffold_100004	20861211	20865645	4434	g_2270	g_2271
Super-Scaffold_100004	20865899	20868815	2916	g_2271	g_2272
Super-Scaffold_100004	20869087	20876990	7903	g_2272	g_2273
Super-Scaffold_100004	20879703	20886841	7138	g_2273	g_2274
Super-Scaffold_100004	20887784	20891304	3520	g_2274	g_2275
Super-Scaffold_100004	20892599	20892687	88	g_2275	g_43046
Super-Scaffold_100004	20893415	20899160	5745	g_43046	g_2276
Super-Scaffold_100004	20900727	20902023	1296	g_2276	g_2277
Super-Scaffold_100004	20906361	20908190	1829	g_2277	g_2278
Super-Scaffold_100004	20909939	20913305	3366	g_2278	g_2279
Super-Scaffold_100004	20921352	20931558	10206	g_2279	g_2280
Super-Scaffold_100004	20940846	20943594	2748	g_2280	g_2281
Super-Scaffold_100004	20944602	20946629	2027	g_2281	g_2283
Super-Scaffold_100004	20948099	20949966	1867	g_2283	g_2284
Super-Scaffold_100004	20955045	20958431	3386	g_2284	g_37594
Super-Scaffold_100004	20958838	20962600	3762	g_37594	g_2286
Super-Scaffold_100004	20973588	20983092	9504	g_2286	g_2287
Super-Scaffold_100004	20986340	20989345	3005	g_2287	g_2288
Super-Scaffold_100004	20992585	20998216	5631	g_2288	g_2289
Super-Scaffold_100004	20999661	21003439	3778	g_2289	g_2290
Super-Scaffold_100004	21004874	21015220	10346	g_2290	g_2291
Super-Scaffold_100004	21019803	21024916	5113	g_2291	g_2292
Super-Scaffold_100004	21026353	21027279	926	g_2292	g_2293
Super-Scaffold_100004	21033846	21055135	21289	g_2293	g_2294
Super-Scaffold_100004	21061027	21074426	13399	g_2294	g_37595
Super-Scaffold_100004	21078206	21090619	12413	g_2295	g_2297
Super-Scaffold_100004	21092542	21097168	4626	g_2297	g_43047
Super-Scaffold_100004	21105257	21107656	2399	g_43047	g_2298
Super-Scaffold_100004	21111865	21112048	183	g_2298	g_2299
Super-Scaffold_100004	21115427	21115758	331	g_2299	g_43048
Super-Scaffold_100004	21118786	21124124	5338	g_43048	g_2300
Super-Scaffold_100004	21138030	21173272	35242	g_2300	g_2302
Super-Scaffold_100004	21177832	21188114	10282	g_2302	g_2303
Super-Scaffold_100004	21199612	21204610	4998	g_2303	g_2304
Super-Scaffold_100004	21210113	21213776	3663	g_2304	g_2305
Super-Scaffold_100004	21218130	21219871	1741	g_2305	g_2306
Super-Scaffold_100004	21225779	21226256	477	g_2306	g_2307
Super-Scaffold_100004	21233298	21235964	2666	g_2307	g_2308
Super-Scaffold_100004	21238780	21241780	3000	g_2308	g_43049
Super-Scaffold_100004	21243666	21247132	3466	g_43049	g_2309
Super-Scaffold_100004	21260579	21266534	5955	g_2309	g_43050
Super-Scaffold_100004	21278234	21281270	3036	g_43050	g_2311
Super-Scaffold_100004	21288976	21290311	1335	g_2311	g_2312
Super-Scaffold_100004	21294508	21311502	16994	g_2312	g_2313
Super-Scaffold_100004	21313871	21315023	1152	g_2313	g_2314
Super-Scaffold_100004	21318727	21320723	1996	g_2314	g_43051
Super-Scaffold_100004	21330844	21350048	19204	g_43051	g_2315
Super-Scaffold_100004	21363196	21384930	21734	g_2315	g_2316
Super-Scaffold_100004	21389535	21400426	10891	g_2316	g_2317
Super-Scaffold_100004	21406202	21428349	22147	g_2317	g_2318
Super-Scaffold_100004	21446489	21456204	9715	g_2318	g_2319
Super-Scaffold_100004	21458018	21498439	40421	g_2319	g_2321
Super-Scaffold_100004	21518364	21531181	12817	g_2321	g_2322
Super-Scaffold_100004	21555323	21567284	11961	g_2322	g_2323
Super-Scaffold_100004	21567529	21745004	177475	g_2323	g_2329
Super-Scaffold_100004	21754425	21857202	102777	g_2329	g_2331
Super-Scaffold_100004	21857474	22102552	245078	g_2331	g_2334
Super-Scaffold_100004	22104096	22109143	5047	g_2334	g_2335
Super-Scaffold_100004	22109346	22164493	55147	g_2335	g_2338
Super-Scaffold_100004	22164801	22238895	74094	g_2338	g_2340
Super-Scaffold_100004	22239776	22253225	13449	g_2340	g_2341
Super-Scaffold_100004	22253428	22341183	87755	g_2341	g_2343
Super-Scaffold_100004	22350005	22367607	17602	g_2343	g_2344
Super-Scaffold_100004	22383060	22384458	1398	g_2344	g_2345
Super-Scaffold_100004	22409724	22420380	10656	g_2345	g_2346
Super-Scaffold_100004	22428547	22444372	15825	g_2346	g_43052
Super-Scaffold_100004	22444827	22450409	5582	g_43052	g_2347
Super-Scaffold_100004	22451077	22454940	3863	g_2347	g_2348
Super-Scaffold_100004	22455731	22462110	6379	g_2348	g_2349
Super-Scaffold_100004	22469585	22470441	856	g_2349	g_2350
Super-Scaffold_100004	22479649	22480229	580	g_2350	g_2351
Super-Scaffold_100004	22484176	22484859	683	g_2351	g_2352
Super-Scaffold_100004	22486615	22489325	2710	g_2352	g_2353
Super-Scaffold_100004	22492280	22494151	1871	g_2353	g_2354
Super-Scaffold_100004	22506175	22509878	3703	g_2354	g_2355
Super-Scaffold_100004	22515527	22517885	2358	g_2355	g_2356
Super-Scaffold_100004	22526553	22533870	7317	g_2356	g_2357
Super-Scaffold_100004	22535348	22547046	11698	g_2357	g_2359
Super-Scaffold_100004	22547477	22550320	2843	g_2359	g_2360
Super-Scaffold_100004	22551143	22555239	4096	g_2360	g_2361
Super-Scaffold_100004	22568848	22574873	6025	g_2361	g_2362
Super-Scaffold_100004	22578717	22580657	1940	g_2362	g_2363
Super-Scaffold_100004	22588638	22591014	2376	g_2363	g_43053
Super-Scaffold_100004	22604496	22606127	1631	g_43053	g_2364
Super-Scaffold_100004	22611082	22625098	14016	g_2364	g_2365
Super-Scaffold_100004	22628028	22631348	3320	g_2365	g_2366
Super-Scaffold_100004	22647098	22653241	6143	g_2366	g_2367
Super-Scaffold_100004	22653513	22658823	5310	g_2367	g_2368
Super-Scaffold_100004	22667097	22669848	2751	g_2368	g_2369
Super-Scaffold_100004	22674054	22676109	2055	g_2369	g_43054
Super-Scaffold_100004	22689642	22731200	41558	g_43054	g_2371
Super-Scaffold_100004	22753833	22811489	57656	g_2371	g_2372
Super-Scaffold_100004	22813690	22837300	23610	g_2372	g_2374
Super-Scaffold_100004	22839680	22899437	59757	g_2374	g_2376
Super-Scaffold_100004	22912237	22913305	1068	g_2376	g_2377
Super-Scaffold_100004	22916812	22918126	1314	g_2377	g_2378
Super-Scaffold_100004	22920390	22922555	2165	g_2378	g_2379
Super-Scaffold_100004	22924042	22927337	3295	g_2379	g_2380
Super-Scaffold_100004	22930463	22931586	1123	g_2380	g_43055
Super-Scaffold_100004	22936523	22938769	2246	g_43055	g_2381
Super-Scaffold_100004	22950962	22953580	2618	g_2381	g_43056
Super-Scaffold_100004	22979136	22981460	2324	g_43056	g_2382
Super-Scaffold_100004	22985854	22988442	2588	g_2382	g_2383
Super-Scaffold_100004	22997576	23006748	9172	g_2383	g_2384
Super-Scaffold_100004	23012466	23023931	11465	g_2384	g_2385
Super-Scaffold_100004	23041926	23047956	6030	g_2385	g_2386
Super-Scaffold_100004	23049088	23051358	2270	g_2386	g_2387
Super-Scaffold_100004	23056899	23065346	8447	g_2387	g_2388
Super-Scaffold_100004	23075854	23079427	3573	g_2388	g_43057
Super-Scaffold_100004	23083345	23086821	3476	g_43057	g_2389
Super-Scaffold_100004	23089785	23090135	350	g_2389	g_2390
Super-Scaffold_100004	23097140	23100562	3422	g_2390	g_2391
Super-Scaffold_100004	23102868	23105344	2476	g_2391	g_2392
Super-Scaffold_100004	23107368	23119009	11641	g_2392	g_2393
Super-Scaffold_100004	23134714	23142139	7425	g_2393	g_43058
Super-Scaffold_100004	23143983	23148947	4964	g_43058	g_2395
Super-Scaffold_100004	23154873	23165285	10412	g_2395	g_2396
Super-Scaffold_100004	23176002	23182198	6196	g_2396	g_2397
Super-Scaffold_100004	23184642	23194407	9765	g_2397	g_2398
Super-Scaffold_100004	23197192	23197995	803	g_2398	g_37611
Super-Scaffold_100004	23198273	23223624	25351	g_37611	g_2401
Super-Scaffold_100004	23224751	23227980	3229	g_2401	g_2402
Super-Scaffold_100004	23232927	23237818	4891	g_2402	g_2403
Super-Scaffold_100004	23245989	23251032	5043	g_2403	g_2404
Super-Scaffold_100004	23254611	23256757	2146	g_2404	g_43059
Super-Scaffold_100004	23260572	23264827	4255	g_43059	g_2405
Super-Scaffold_100004	23268155	23271020	2865	g_2405	g_2406
Super-Scaffold_100004	23271622	23275851	4229	g_2406	g_2407
Super-Scaffold_100004	23279932	23286968	7036	g_2407	g_43060
Super-Scaffold_100004	23293790	23310350	16560	g_43060	g_2408
Super-Scaffold_100004	23314416	23319286	4870	g_2408	g_2409
Super-Scaffold_100004	23327186	23333267	6081	g_2409	g_43061
Super-Scaffold_100004	23333845	23336724	2879	g_43061	g_2410
Super-Scaffold_100004	23337785	23359368	21583	g_2410	g_2412
Super-Scaffold_100004	23375470	23380856	5386	g_2412	g_43062
Super-Scaffold_100004	23382751	23384233	1482	g_43062	g_2413
Super-Scaffold_100004	23389131	23391012	1881	g_2413	g_2414
Super-Scaffold_100004	23391236	23409654	18418	g_2414	g_2416
Super-Scaffold_100004	23419787	23423756	3969	g_2416	g_2417
Super-Scaffold_100004	23427702	23429234	1532	g_2417	g_43063
Super-Scaffold_100004	23432511	23446405	13894	g_43063	g_2418
Super-Scaffold_100004	23491020	23498433	7413	g_2418	g_2419
Super-Scaffold_100004	23509348	23512740	3392	g_2419	g_2420
Super-Scaffold_100004	23516582	23525487	8905	g_2420	g_43064
Super-Scaffold_100004	23525723	23532015	6292	g_43064	g_2423
Super-Scaffold_100004	23541631	23589391	47760	g_2423	g_43065
Super-Scaffold_100004	23601692	23605398	3706	g_43065	g_43066
Super-Scaffold_100004	23613784	23623276	9492	g_43066	g_2425
Super-Scaffold_100004	23625771	23628404	2633	g_2425	g_2426
Super-Scaffold_100004	23631189	23634617	3428	g_2426	g_2427
Super-Scaffold_100004	23640643	23642819	2176	g_2427	g_2428
Super-Scaffold_100004	23647101	23661807	14706	g_2428	g_2429
Super-Scaffold_100004	23679467	23686644	7177	g_2429	g_2430
Super-Scaffold_100004	23687714	23708106	20392	g_2430	g_2432
Super-Scaffold_100004	23709002	23753112	44110	g_2432	g_2437
Super-Scaffold_100004	23753435	23772642	19207	g_2437	g_2438
Super-Scaffold_100004	23796850	23802568	5718	g_2438	g_43067
Super-Scaffold_100004	23824613	23826978	2365	g_43067	g_2439
Super-Scaffold_100004	23830253	23913522	83269	g_2439	g_2441
Super-Scaffold_100004	23934660	24008605	73945	g_2441	g_37621
Super-Scaffold_100004	24008838	24019678	10840	g_37621	g_2445
Super-Scaffold_100004	24019929	24022372	2443	g_2445	g_2446
Super-Scaffold_100004	24022644	24045846	23202	g_2446	g_2447
Super-Scaffold_100004	24049168	24057004	7836	g_2447	g_2448
Super-Scaffold_100004	24059705	24080678	20973	g_2448	g_2449
Super-Scaffold_100004	24080920	24115640	34720	g_2449	g_37625
Super-Scaffold_100004	24115894	24127084	11190	g_37625	g_2452
Super-Scaffold_100004	24128436	24131643	3207	g_2452	g_2453
Super-Scaffold_100004	24141998	24144682	2684	g_2453	g_2454
Super-Scaffold_100004	24148930	24151421	2491	g_2454	g_2455
Super-Scaffold_100004	24173256	24177610	4354	g_2455	g_2456
Super-Scaffold_100004	24179045	24181235	2190	g_2456	g_2457
Super-Scaffold_100004	24185680	24193009	7329	g_2457	g_43068
Super-Scaffold_100004	24194400	24196677	2277	g_43068	g_2458
Super-Scaffold_100004	24208169	24209538	1369	g_2458	g_2459
Super-Scaffold_100004	24209744	24209926	182	g_2459	g_2460
Super-Scaffold_100004	24213383	24215431	2048	g_2460	g_43069
Super-Scaffold_100004	24240846	24244321	3475	g_43069	g_2461
Super-Scaffold_100004	24249873	24261584	11711	g_2461	g_2462
Super-Scaffold_100004	24273603	24274876	1273	g_2462	g_2463
Super-Scaffold_100004	24283351	24285992	2641	g_2463	g_2464
Super-Scaffold_100004	24296288	24320111	23823	g_2464	g_2465
Super-Scaffold_100004	24373445	24462701	89256	g_2465	g_2467
Super-Scaffold_100004	24480868	24481524	656	g_2467	g_2468
Super-Scaffold_100004	24483194	24495255	12061	g_2468	g_2469
Super-Scaffold_100004	24496614	24497724	1110	g_2469	g_43070
Super-Scaffold_100004	24501309	24505876	4567	g_43070	g_2470
Super-Scaffold_100004	24514305	24522422	8117	g_2470	g_2471
Super-Scaffold_100004	24531188	24532424	1236	g_2471	g_2472
Super-Scaffold_100004	24543173	24556038	12865	g_2472	g_2473
Super-Scaffold_100004	24556445	24559246	2801	g_2473	g_2474
Super-Scaffold_100004	24571218	24588265	17047	g_2474	g_2475
Super-Scaffold_100004	24588759	24592621	3862	g_2475	g_2476
Super-Scaffold_100004	24598881	24600848	1967	g_2476	g_2477
Super-Scaffold_100004	24609146	24610167	1021	g_2477	g_2478
Super-Scaffold_100004	24621879	24636453	14574	g_2478	g_2479
Super-Scaffold_100004	24653011	24653283	272	g_2479	g_43071
Super-Scaffold_100004	24663431	24669443	6012	g_43071	g_2480
Super-Scaffold_100004	24679745	24683257	3512	g_2480	g_43072
Super-Scaffold_100004	24695209	24722092	26883	g_43072	g_2481
Super-Scaffold_100004	24723150	24744138	20988	g_2481	g_2483
Super-Scaffold_100004	24744353	24800301	55948	g_2483	g_2486
Super-Scaffold_100004	24814970	24817149	2179	g_2486	g_2487
Super-Scaffold_100004	24834989	24836974	1985	g_2487	g_2488
Super-Scaffold_100004	24843209	24846844	3635	g_2488	g_2489
Super-Scaffold_100004	24852239	24852997	758	g_2489	g_2490
Super-Scaffold_100004	24854914	24864484	9570	g_2490	g_2491
Super-Scaffold_100004	24865440	24869161	3721	g_2491	g_37633
Super-Scaffold_100004	24869810	24872019	2209	g_37633	g_2492
Super-Scaffold_100004	24880317	24882238	1921	g_2492	g_2493
Super-Scaffold_100004	24889656	24897533	7877	g_2493	g_2494
Super-Scaffold_100004	24902335	24906101	3766	g_2494	g_2495
Super-Scaffold_100004	24919544	24922935	3391	g_2495	g_2496
Super-Scaffold_100004	24927461	24929777	2316	g_2496	g_2497
Super-Scaffold_100004	24933096	24934475	1379	g_2497	g_2498
Super-Scaffold_100004	24935798	24936627	829	g_2498	g_2499
Super-Scaffold_100004	24939689	24966792	27103	g_2499	g_2501
Super-Scaffold_100004	24967769	24968461	692	g_2501	g_2502
Super-Scaffold_100004	24969954	24971534	1580	g_2502	g_2503
Super-Scaffold_100004	24982040	24990429	8389	g_2503	g_2504
Super-Scaffold_100004	24993467	25029396	35929	g_37634	g_2505
Super-Scaffold_100004	25038854	25045818	6964	g_2505	g_2506
Super-Scaffold_100004	25064027	25408597	344570	g_2506	g_2515
Super-Scaffold_100004	25409307	25435213	25906	g_2515	g_37638
Super-Scaffold_100004	25435413	25441534	6121	g_37638	g_2516
Super-Scaffold_100004	25441935	25462488	20553	g_2516	g_2517
Super-Scaffold_100004	25462739	25468890	6151	g_2517	g_2518
Super-Scaffold_100004	25469129	25675326	206197	g_2518	g_37641
Super-Scaffold_100004	25675625	25691886	16261	g_37641	g_2522
Super-Scaffold_100004	25717181	25950839	233658	g_2522	g_2526
Super-Scaffold_100004	25956082	25957928	1846	g_2526	g_2527
Super-Scaffold_100004	25964363	25964737	374	g_2527	g_2528
Super-Scaffold_100004	25972934	25973654	720	g_2528	g_2529
Super-Scaffold_100004	25975081	25976338	1257	g_2529	g_2530
Super-Scaffold_100004	25978635	25980001	1366	g_2530	g_2531
Super-Scaffold_100004	25982750	26022482	39732	g_2531	g_2532
Super-Scaffold_100004	26046293	26290738	244445	g_2532	g_2536
Super-Scaffold_100004	26292411	26415864	123453	g_2536	g_2540
Super-Scaffold_100004	26416163	26497982	81819	g_2540	g_2541
Super-Scaffold_100004	26523079	26545704	22625	g_2541	g_2542
Super-Scaffold_100004	26552380	26601393	49013	g_2542	g_2544
Super-Scaffold_100004	26607947	26609921	1974	g_2544	g_2545
Super-Scaffold_100004	26618078	26621144	3066	g_2545	g_2546
Super-Scaffold_100004	26633112	26636582	3470	g_2546	g_2547
Super-Scaffold_100004	26644682	26646865	2183	g_2547	g_2548
Super-Scaffold_100004	26649521	26653816	4295	g_2548	g_2549
Super-Scaffold_100004	26658408	26753291	94883	g_2549	g_2550
Super-Scaffold_100004	26753524	26770191	16667	g_2550	g_2551
Super-Scaffold_100004	26773996	26778309	4313	g_2551	g_2552
Super-Scaffold_100004	26788674	26790905	2231	g_2552	g_43073
Super-Scaffold_100004	26798213	26801339	3126	g_43073	g_2553
Super-Scaffold_100004	26803819	26807280	3461	g_2553	g_2554
Super-Scaffold_100004	26817330	26848640	31310	g_2554	g_2555
Super-Scaffold_100004	26849557	26954791	105234	g_2555	g_2557
Super-Scaffold_100004	26955105	27016469	61364	g_2557	g_2561
Super-Scaffold_100004	27027568	27034146	6578	g_2561	g_2562
Super-Scaffold_100004	27035962	27046350	10388	g_2562	g_2563
Super-Scaffold_100004	27065278	27067088	1810	g_2563	g_2564
Super-Scaffold_100004	27069286	27071986	2700	g_2564	g_2565
Super-Scaffold_100004	27074385	27074807	422	g_2565	g_2566
Super-Scaffold_100004	27079675	27081872	2197	g_2566	g_2567
Super-Scaffold_100004	27084094	27086261	2167	g_2567	g_2568
Super-Scaffold_100004	27095446	27096938	1492	g_2568	g_2569
Super-Scaffold_100004	27133038	27135347	2309	g_2569	g_2570
Super-Scaffold_100004	27145850	27671215	525365	g_2570	g_2571
Super-Scaffold_100004	27671616	27679852	8236	g_2571	g_2572
Super-Scaffold_100004	27680277	27702791	22514	g_2572	g_2573
Super-Scaffold_100004	27768892	27902614	133722	g_2573	g_2575
Super-Scaffold_100004	27927463	28019618	92155	g_2575	g_2576
Super-Scaffold_100004	28023055	28054948	31893	g_2576	g_2577
Super-Scaffold_100004	28064836	28090963	26127	g_2577	g_2579
Super-Scaffold_100004	28092795	28096280	3485	g_2579	g_2580
Super-Scaffold_100004	28101705	28138015	36310	g_2580	g_2581
Super-Scaffold_100004	28158588	28165869	7281	g_2581	g_2582
Super-Scaffold_100004	28182334	28185479	3145	g_2582	g_2583
Super-Scaffold_100004	28186417	28193269	6852	g_2583	g_2584
Super-Scaffold_100004	28194207	28198919	4712	g_2584	g_2585
Super-Scaffold_100004	28212675	28220452	7777	g_2585	g_2586
Super-Scaffold_100004	28239220	28295315	56095	g_2586	g_2587
Super-Scaffold_100004	28302154	28321171	19017	g_2587	g_2588
Super-Scaffold_100004	28321509	28352126	30617	g_2588	g_2589
Super-Scaffold_100004	28352368	28478506	126138	g_2589	g_2592
Super-Scaffold_100004	28480347	28699405	219058	g_2592	g_2594
Super-Scaffold_100004	28700862	28702929	2067	g_2594	g_2595
Super-Scaffold_100004	28704161	28946460	242299	g_2595	g_2596
Super-Scaffold_100004	28950061	28952402	2341	g_2596	g_2597
Super-Scaffold_100004	28957071	28961423	4352	g_2597	g_2599
Super-Scaffold_100004	28964612	28981128	16516	g_2599	g_2600
Super-Scaffold_100004	28981364	29007324	25960	g_2600	g_2602
Super-Scaffold_100004	29007530	29016054	8524	g_2602	g_2603
Super-Scaffold_100004	29016335	29044688	28353	g_2603	g_2604
Super-Scaffold_100004	29044951	29139793	94842	g_2604	g_2605
Super-Scaffold_100004	29142026	29163901	21875	g_2605	g_2606
Super-Scaffold_100004	29176228	29186640	10412	g_2606	g_2607
Super-Scaffold_100004	29207568	29211903	4335	g_2607	g_2608
Super-Scaffold_100004	29216716	29220204	3488	g_2608	g_2609
Super-Scaffold_100004	29225711	29246683	20972	g_2609	g_2610
Super-Scaffold_100004	29249439	29250962	1523	g_2610	g_2611
Super-Scaffold_100004	29256386	29257697	1311	g_2611	g_2612
Super-Scaffold_100004	29264361	29265877	1516	g_2612	g_2613
Super-Scaffold_100004	29270080	29276396	6316	g_2613	g_43074
Super-Scaffold_100004	29339543	29350319	10776	g_43074	g_2614
Super-Scaffold_100004	29350519	29397690	47171	g_2614	g_2615
Super-Scaffold_100004	29400375	29439621	39246	g_2615	g_2616
Super-Scaffold_100004	29439830	29465196	25366	g_2616	g_2617
Super-Scaffold_100004	29484672	29485066	394	g_2617	g_2618
Super-Scaffold_100004	29497646	29531704	34058	g_2618	g_2619
Super-Scaffold_100004	29547748	29580885	33137	g_2619	g_2620
Super-Scaffold_100004	29581169	29594585	13416	g_2620	g_2621
Super-Scaffold_100004	29609967	29642183	32216	g_2621	g_2622
Super-Scaffold_100004	29665777	29729680	63903	g_2622	g_2623
Super-Scaffold_100004	29735384	29737509	2125	g_2623	g_2624
Super-Scaffold_100004	29743826	29906979	163153	g_2624	g_2627
Super-Scaffold_100004	29915223	29919663	4440	g_2627	g_43075
Super-Scaffold_100004	29920947	30159435	238488	g_43075	g_2630
Super-Scaffold_100004	30159845	30173601	13756	g_2630	g_2631
Super-Scaffold_100004	30197560	30207054	9494	g_2631	g_2632
Super-Scaffold_100004	30230409	30553446	323037	g_2632	g_2636
Super-Scaffold_100004	30564404	30613549	49145	g_2636	g_2638
Super-Scaffold_100004	30613860	30630685	16825	g_2638	g_2639
Super-Scaffold_100004	30630897	30715779	84882	g_2639	g_2642
Super-Scaffold_100004	30750929	30757217	6288	g_2642	g_2644
Super-Scaffold_100004	30757489	30791595	34106	g_2644	g_2645
Super-Scaffold_100004	30797334	30827094	29760	g_2645	g_43076
Super-Scaffold_100004	30828631	30830898	2267	g_43076	g_2646
Super-Scaffold_100004	30841455	30850517	9062	g_2646	g_2647
Super-Scaffold_100004	30851158	30854193	3035	g_2647	g_2648
Super-Scaffold_100004	30854819	30862773	7954	g_2648	g_2649
Super-Scaffold_100004	30886126	30899018	12892	g_2649	g_2650
Super-Scaffold_100004	30899251	30901329	2078	g_2650	g_2651
Super-Scaffold_100004	30904102	30906025	1923	g_2651	g_2652
Super-Scaffold_100004	30914428	30916284	1856	g_2652	g_43077
Super-Scaffold_100004	30921995	30949226	27231	g_43077	g_2655
Super-Scaffold_100004	30949663	30969230	19567	g_2655	g_2656
Super-Scaffold_100004	30971126	31073545	102419	g_2656	g_2658
Super-Scaffold_100004	31076004	31180385	104381	g_2658	g_2661
Super-Scaffold_100004	31182758	31185418	2660	g_2661	g_2662
Super-Scaffold_100004	31187826	31192419	4593	g_2662	g_2663
Super-Scaffold_100004	31195103	31200855	5752	g_2663	g_2664
Super-Scaffold_100004	31201565	31233496	31931	g_2664	g_37678
Super-Scaffold_100004	31233723	31236568	2845	g_37678	g_2667
Super-Scaffold_100004	31236846	31250857	14011	g_2667	g_2668
Super-Scaffold_100004	31251246	31261817	10571	g_2668	g_2669
Super-Scaffold_100004	31262119	31325704	63585	g_37679	g_2672
Super-Scaffold_100004	31327277	31333955	6678	g_2672	g_2673
Super-Scaffold_100004	31341052	31385125	44073	g_2673	g_2675
Super-Scaffold_100004	31395105	31418751	23646	g_2675	g_2676
Super-Scaffold_100004	31437849	31445904	8055	g_2676	g_2677
Super-Scaffold_100004	31459078	31479534	20456	g_2677	g_2679
Super-Scaffold_100004	31480505	31486181	5676	g_2679	g_2680
Super-Scaffold_100004	31486519	31523490	36971	g_2680	g_2683
Super-Scaffold_100004	31523759	31542299	18540	g_2683	g_2685
Super-Scaffold_100004	31555009	31591396	36387	g_2685	g_2689
Super-Scaffold_100004	31597817	31598835	1018	g_2689	g_2690
Super-Scaffold_100004	31600760	31603742	2982	g_2690	g_2691
Super-Scaffold_100004	31603954	31604385	431	g_2691	g_2692
Super-Scaffold_100004	31614855	31616346	1491	g_2692	g_2693
Super-Scaffold_100004	31629610	31630752	1142	g_2693	g_2694
Super-Scaffold_100004	31639096	31692523	53427	g_2694	g_2696
Super-Scaffold_100004	31692909	31719576	26667	g_2696	g_2697
Super-Scaffold_100004	31719926	31731743	11817	g_2697	g_2698
Super-Scaffold_100004	31754336	31758932	4596	g_2698	g_2699
Super-Scaffold_100004	31760014	31796090	36076	g_2699	g_2702
Super-Scaffold_100004	31796332	31957614	161282	g_2702	g_2704
Super-Scaffold_100004	31958126	32014656	56530	g_2704	g_2705
Super-Scaffold_100004	32017011	32017602	591	g_2705	g_2706
Super-Scaffold_100004	32019116	32039833	20717	g_2706	g_2707
Super-Scaffold_100004	32044768	32220490	175722	g_2707	g_2711
Super-Scaffold_100004	32227517	32406143	178626	g_2711	g_2713
Super-Scaffold_100004	32425893	32471899	46006	g_2713	g_2714
Super-Scaffold_100004	32472198	32478240	6042	g_2714	g_2715
Super-Scaffold_100004	32484411	32484978	567	g_2715	g_2716
Super-Scaffold_100004	32497248	32499134	1886	g_2716	g_2717
Super-Scaffold_100004	32500736	32503424	2688	g_2717	g_2718
Super-Scaffold_100004	32508910	32534786	25876	g_2718	g_2720
Super-Scaffold_100004	32536297	32575144	38847	g_2720	g_2722
Super-Scaffold_100004	32615538	32619395	3857	g_2722	g_43078
Super-Scaffold_100004	32624796	32625547	751	g_43078	g_2723
Super-Scaffold_100004	32639820	32645257	5437	g_2723	g_2724
Super-Scaffold_100004	32659648	32752717	93069	g_2724	g_2727
Super-Scaffold_100004	32753114	32829391	76277	g_2727	g_2731
Super-Scaffold_100004	32830239	32830428	189	g_2731	g_2732
Super-Scaffold_100004	32830964	32834402	3438	g_2732	g_2733
Super-Scaffold_100004	32836140	32851935	15795	g_2733	g_2735
Super-Scaffold_100004	32852378	32854034	1656	g_2735	g_2736
Super-Scaffold_100004	32854546	32859562	5016	g_2736	g_2737
Super-Scaffold_100004	32860263	32869811	9548	g_2737	g_2738
Super-Scaffold_100004	32870377	33098169	227792	g_2738	g_2742
Super-Scaffold_100004	33108492	33117644	9152	g_2742	g_2743
Super-Scaffold_100004	33117943	33118167	224	g_2743	g_2744
Super-Scaffold_100004	33133356	33163151	29795	g_2744	g_2745
Super-Scaffold_100004	33164659	33170392	5733	g_2745	g_2746
Super-Scaffold_100004	33170649	33182885	12236	g_2746	g_37702
Super-Scaffold_100004	33183145	33210491	27346	g_37702	g_2747
Super-Scaffold_100004	33219055	33220192	1137	g_2747	g_2748
Super-Scaffold_100004	33229903	33245372	15469	g_2748	g_2749
Super-Scaffold_100005	2383	3555	1172	g_40115	g_40116
Super-Scaffold_100005	4223	5733	1510	g_40116	g_40117
Super-Scaffold_100005	6572	35623	29051	g_40117	g_40118
Super-Scaffold_100005	35925	44362	8437	g_40118	g_23920
Super-Scaffold_100005	44814	63547	18733	g_23920	g_23921
Super-Scaffold_100005	65047	112409	47362	g_40119	g_23924
Super-Scaffold_100005	113125	137344	24219	g_23924	g_23927
Super-Scaffold_100005	153203	156680	3477	g_23927	g_23929
Super-Scaffold_100005	170347	172009	1662	g_23929	g_23930
Super-Scaffold_100005	190813	193023	2210	g_23930	g_23931
Super-Scaffold_100005	202433	202753	320	g_23932	g_23933
Super-Scaffold_100005	204342	221182	16840	g_23933	g_23934
Super-Scaffold_100005	229254	230821	1567	g_23934	g_23935
Super-Scaffold_100005	241087	241539	452	g_23935	g_23936
Super-Scaffold_100005	242207	242434	227	g_23936	g_23937
Super-Scaffold_100005	243611	246202	2591	g_23937	g_23938
Super-Scaffold_100005	266859	272071	5212	g_23938	g_23939
Super-Scaffold_100005	280902	284222	3320	g_23940	g_23941
Super-Scaffold_100005	302304	316710	14406	g_23941	g_23942
Super-Scaffold_100005	318272	324933	6661	g_23942	g_23943
Super-Scaffold_100005	342471	357988	15517	g_23943	g_23944
Super-Scaffold_100005	362032	382685	20653	g_23944	g_23945
Super-Scaffold_100005	407762	414638	6876	g_23945	g_23948
Super-Scaffold_100005	415372	416902	1530	g_23948	g_23949
Super-Scaffold_100005	419665	423308	3643	g_23949	g_23952
Super-Scaffold_100005	424183	426903	2720	g_23952	g_23953
Super-Scaffold_100005	428057	428654	597	g_23953	g_23954
Super-Scaffold_100005	429058	433072	4014	g_23954	g_23955
Super-Scaffold_100005	451408	455379	3971	g_23955	g_23956
Super-Scaffold_100005	456170	461892	5722	g_23956	g_23959
Super-Scaffold_100005	463652	477740	14088	g_23959	g_23960
Super-Scaffold_100005	477946	586033	108087	g_23960	g_23965
Super-Scaffold_100005	594603	597383	2780	g_23965	g_23967
Super-Scaffold_100005	617289	630660	13371	g_23967	g_23968
Super-Scaffold_100005	655144	657497	2353	g_23968	g_23969
Super-Scaffold_100005	659440	659477	37	g_23969	g_44861
Super-Scaffold_100005	660343	660377	34	g_44861	g_44862
Super-Scaffold_100005	661510	661547	37	g_44862	g_44863
Super-Scaffold_100005	663904	683708	19804	g_44863	g_23970
Super-Scaffold_100005	697308	711089	13781	g_23970	g_23972
Super-Scaffold_100005	737728	782480	44752	g_23972	g_23974
Super-Scaffold_100005	782917	784766	1849	g_23974	g_23975
Super-Scaffold_100005	785020	785708	688	g_23975	g_23976
Super-Scaffold_100005	785914	808747	22833	g_23976	g_23978
Super-Scaffold_100005	809322	832255	22933	g_23978	g_23980
Super-Scaffold_100005	839855	850476	10621	g_23980	g_23982
Super-Scaffold_100005	851634	858505	6871	g_23982	g_23983
Super-Scaffold_100005	866159	886282	20123	g_23983	g_23984
Super-Scaffold_100005	889059	912925	23866	g_23984	g_23986
Super-Scaffold_100005	913593	913723	130	g_23986	g_23987
Super-Scaffold_100005	914145	972268	58123	g_23987	g_23990
Super-Scaffold_100005	972897	1076137	103240	g_23990	g_23991
Super-Scaffold_100005	1077714	1134538	56824	g_23991	g_23993
Super-Scaffold_100005	1135650	1206322	70672	g_23993	g_23994
Super-Scaffold_100005	1207836	1208427	591	g_23994	g_23995
Super-Scaffold_100005	1210782	1261530	50748	g_23995	g_23996
Super-Scaffold_100005	1261793	1345009	83216	g_23996	g_23997
Super-Scaffold_100005	1367149	1394199	27050	g_23997	g_23998
Super-Scaffold_100005	1416711	1439854	23143	g_23998	g_24001
Super-Scaffold_100005	1447047	1458379	11332	g_24001	g_44864
Super-Scaffold_100005	1459320	1514868	55548	g_44864	g_24002
Super-Scaffold_100005	1539111	1553447	14336	g_40132	g_24003
Super-Scaffold_100005	1568330	1617281	48951	g_24003	g_24004
Super-Scaffold_100005	1646535	1949523	302988	g_24004	g_24007
Super-Scaffold_100005	1950083	1974671	24588	g_24007	g_24008
Super-Scaffold_100005	1975231	2012496	37265	g_24008	g_24011
Super-Scaffold_100005	2012804	2134323	121519	g_24011	g_24013
Super-Scaffold_100005	2147114	2201085	53971	g_24013	g_24015
Super-Scaffold_100005	2203870	2256762	52892	g_24015	g_24016
Super-Scaffold_100005	2258198	2291675	33477	g_24016	g_40138
Super-Scaffold_100005	2291887	2296088	4201	g_40138	g_24017
Super-Scaffold_100005	2296390	2296424	34	g_24017	g_24018
Super-Scaffold_100005	2296726	2331968	35242	g_24018	g_24020
Super-Scaffold_100005	2332495	2332517	22	g_24020	g_44865
Super-Scaffold_100005	2333785	2345265	11480	g_44865	g_24021
Super-Scaffold_100005	2384213	2395368	11155	g_24021	g_24022
Super-Scaffold_100005	2395601	2398472	2871	g_24022	g_24023
Super-Scaffold_100005	2400148	2449023	48875	g_24023	g_24026
Super-Scaffold_100005	2450099	2465276	15177	g_24026	g_24027
Super-Scaffold_100005	2465734	2476842	11108	g_24027	g_44866
Super-Scaffold_100005	2487948	2952195	464247	g_44866	g_24029
Super-Scaffold_100005	2952821	2953027	206	g_24029	g_24030
Super-Scaffold_100005	2953326	2970049	16723	g_24030	g_24033
Super-Scaffold_100005	2970681	3135171	164490	g_24033	g_24038
Super-Scaffold_100005	3135740	3140352	4612	g_24038	g_24040
Super-Scaffold_100005	3152075	3158538	6463	g_24040	g_24041
Super-Scaffold_100005	3159191	3210056	50865	g_24041	g_24043
Super-Scaffold_100005	3211006	3211161	155	g_24043	g_24044
Super-Scaffold_100005	3211757	3212946	1189	g_24044	g_24045
Super-Scaffold_100005	3214631	3238968	24337	g_24045	g_24047
Super-Scaffold_100005	3242168	3328035	85867	g_24047	g_24048
Super-Scaffold_100005	3329117	3403052	73935	g_24048	g_24050
Super-Scaffold_100005	3404177	3470564	66387	g_24050	g_24052
Super-Scaffold_100005	3473059	3506132	33073	g_24052	g_24053
Super-Scaffold_100005	3509055	3509101	46	g_24053	g_24054
Super-Scaffold_100005	3509623	3695616	185993	g_24054	g_24061
Super-Scaffold_100005	3698452	3733602	35150	g_24061	g_24062
Super-Scaffold_100005	3733904	3754655	20751	g_24062	g_24063
Super-Scaffold_100005	3776130	3780231	4101	g_24063	g_44867
Super-Scaffold_100005	3794655	3795598	943	g_44867	g_24064
Super-Scaffold_100005	3802126	3859416	57290	g_24064	g_24066
Super-Scaffold_100005	3863040	3869724	6684	g_24066	g_44868
Super-Scaffold_100005	3874174	3976097	101923	g_44868	g_24070
Super-Scaffold_100005	3976909	4096494	119585	g_24070	g_24072
Super-Scaffold_100005	4115137	4226819	111682	g_24072	g_24077
Super-Scaffold_100005	4238644	4315389	76745	g_24077	g_24080
Super-Scaffold_100005	4327774	4335107	7333	g_24080	g_44869
Super-Scaffold_100005	4344025	4347561	3536	g_44869	g_24081
Super-Scaffold_100005	4349033	4349421	388	g_24081	g_24082
Super-Scaffold_100005	4363427	4365892	2465	g_24082	g_24083
Super-Scaffold_100005	4374349	4380505	6156	g_24083	g_44870
Super-Scaffold_100005	4384668	4391067	6399	g_44870	g_24084
Super-Scaffold_100005	4393345	4394125	780	g_24084	g_44871
Super-Scaffold_100005	4397443	4434623	37180	g_44871	g_24087
Super-Scaffold_100005	4479365	4482896	3531	g_24087	g_24088
Super-Scaffold_100005	4499116	4503335	4219	g_24088	g_24089
Super-Scaffold_100005	4513967	4524243	10276	g_24089	g_24090
Super-Scaffold_100005	4554485	4598499	44014	g_24090	g_24092
Super-Scaffold_100005	4598699	4603111	4412	g_24092	g_24093
Super-Scaffold_100005	4673613	4680518	6905	g_24093	g_24094
Super-Scaffold_100005	4719616	4731981	12365	g_24094	g_44872
Super-Scaffold_100005	4767244	4890901	123657	g_44872	g_24099
Super-Scaffold_100005	4891143	4905242	14099	g_24099	g_24100
Super-Scaffold_100005	4921994	4924121	2127	g_24100	g_24101
Super-Scaffold_100005	4936533	4938339	1806	g_24101	g_24102
Super-Scaffold_100005	4951588	4957863	6275	g_24102	g_24103
Super-Scaffold_100005	4968357	4969216	859	g_24103	g_44873
Super-Scaffold_100005	4972486	4975165	2679	g_44873	g_24104
Super-Scaffold_100005	4983720	4984078	358	g_24104	g_24105
Super-Scaffold_100005	4986170	4987324	1154	g_24105	g_24106
Super-Scaffold_100005	4989760	4993477	3717	g_24106	g_24108
Super-Scaffold_100005	5006107	5009821	3714	g_24108	g_24109
Super-Scaffold_100005	5010324	5010981	657	g_24109	g_24110
Super-Scaffold_100005	5012645	5022772	10127	g_24110	g_24111
Super-Scaffold_100005	5023290	5023947	657	g_24111	g_24112
Super-Scaffold_100005	5025611	5035861	10250	g_24112	g_24113
Super-Scaffold_100005	5036364	5037021	657	g_24113	g_24114
Super-Scaffold_100005	5038685	5050109	11424	g_24114	g_24116
Super-Scaffold_100005	5051773	5119321	67548	g_24116	g_24118
Super-Scaffold_100005	5124047	5127993	3946	g_24118	g_44874
Super-Scaffold_100005	5147393	5165564	18171	g_44874	g_24120
Super-Scaffold_100005	5169260	5189662	20402	g_24120	g_24121
Super-Scaffold_100005	5215791	5217216	1425	g_24121	g_24122
Super-Scaffold_100005	5224781	5288009	63228	g_24122	g_24124
Super-Scaffold_100005	5294037	5297626	3589	g_24124	g_24125
Super-Scaffold_100005	5301717	5302826	1109	g_24125	g_24126
Super-Scaffold_100005	5311538	5319252	7714	g_24126	g_24127
Super-Scaffold_100005	5319764	5320415	651	g_24127	g_24128
Super-Scaffold_100005	5322079	5329466	7387	g_24128	g_24129
Super-Scaffold_100005	5338005	5341441	3436	g_24129	g_44875
Super-Scaffold_100005	5351583	5356874	5291	g_44875	g_24130
Super-Scaffold_100005	5358669	5360941	2272	g_24130	g_44876
Super-Scaffold_100005	5393525	5401859	8334	g_44876	g_24132
Super-Scaffold_100005	5403719	5413868	10149	g_24132	g_24133
Super-Scaffold_100005	5419020	5425880	6860	g_24133	g_44877
Super-Scaffold_100005	5438092	5442153	4061	g_44877	g_24134
Super-Scaffold_100005	5461267	5464504	3237	g_24134	g_24135
Super-Scaffold_100005	5468957	5472264	3307	g_24135	g_24136
Super-Scaffold_100005	5480352	5482037	1685	g_24136	g_44878
Super-Scaffold_100005	5482705	5500085	17380	g_44878	g_24138
Super-Scaffold_100005	5509111	5513638	4527	g_24138	g_24140
Super-Scaffold_100005	5515299	5526769	11470	g_24140	g_24141
Super-Scaffold_100005	5527281	5527981	700	g_24141	g_24142
Super-Scaffold_100005	5529645	5540875	11230	g_24142	g_24143
Super-Scaffold_100005	5542022	5553540	11518	g_24143	g_44879
Super-Scaffold_100005	5554052	5554759	707	g_44879	g_24144
Super-Scaffold_100005	5556423	5611947	55524	g_24144	g_24148
Super-Scaffold_100005	5612459	5684554	72095	g_24148	g_24152
Super-Scaffold_100005	5685066	5723501	38435	g_24152	g_24154
Super-Scaffold_100005	5724013	5750958	26945	g_24154	g_24155
Super-Scaffold_100005	5751461	5806072	54611	g_24155	g_24157
Super-Scaffold_100005	5817054	5819178	2124	g_24157	g_24158
Super-Scaffold_100005	5832320	5835303	2983	g_24158	g_24159
Super-Scaffold_100005	5869566	5883163	13597	g_24159	g_24160
Super-Scaffold_100005	5883654	6021652	137998	g_24160	g_24162
Super-Scaffold_100005	6040241	6130355	90114	g_24162	g_24165
Super-Scaffold_100005	6148505	6223838	75333	g_24165	g_24166
Super-Scaffold_100005	6240172	6261038	20866	g_24166	g_24168
Super-Scaffold_100005	6261295	6297653	36358	g_24168	g_24170
Super-Scaffold_100005	6298504	6339741	41237	g_24170	g_24172
Super-Scaffold_100005	6340043	6548622	208579	g_24172	g_24177
Super-Scaffold_100005	6549581	6592292	42711	g_24177	g_24180
Super-Scaffold_100005	6592615	6602737	10122	g_24180	g_24181
Super-Scaffold_100005	6603009	6662437	59428	g_24181	g_24184
Super-Scaffold_100005	6662676	6695637	32961	g_24184	g_24186
Super-Scaffold_100005	6696119	6745410	49291	g_24186	g_24188
Super-Scaffold_100005	6767456	6775161	7705	g_24188	g_24189
Super-Scaffold_100005	6775529	6782014	6485	g_24189	g_24190
Super-Scaffold_100005	6797431	6805685	8254	g_24190	g_24191
Super-Scaffold_100005	6822406	6839965	17559	g_24191	g_24192
Super-Scaffold_100005	6851806	6853751	1945	g_24192	g_24193
Super-Scaffold_100005	6861382	6863365	1983	g_24193	g_24194
Super-Scaffold_100005	6869004	6874625	5621	g_24194	g_24195
Super-Scaffold_100005	6895498	6895575	77	g_24195	g_24196
Super-Scaffold_100005	6895844	6895915	71	g_24196	g_24197
Super-Scaffold_100005	6896286	6959739	63453	g_24197	g_24199
Super-Scaffold_100005	6965156	6967534	2378	g_24199	g_24200
Super-Scaffold_100005	6971363	6973159	1796	g_24200	g_24201
Super-Scaffold_100005	6983045	6989499	6454	g_24201	g_24202
Super-Scaffold_100005	7018316	7023699	5383	g_24202	g_24203
Super-Scaffold_100005	7024361	7035648	11287	g_24203	g_24204
Super-Scaffold_100005	7036310	7045522	9212	g_24204	g_24205
Super-Scaffold_100005	7046184	7056863	10679	g_24205	g_24206
Super-Scaffold_100005	7060186	7067511	7325	g_24207	g_24208
Super-Scaffold_100005	7093683	7215309	121626	g_24208	g_24210
Super-Scaffold_100005	7215575	7273238	57663	g_24210	g_24212
Super-Scaffold_100005	7295880	7311461	15581	g_24212	g_44880
Super-Scaffold_100005	7319953	7343611	23658	g_44880	g_24213
Super-Scaffold_100005	7355655	7362607	6952	g_24213	g_44881
Super-Scaffold_100005	7367945	7373844	5899	g_44881	g_24215
Super-Scaffold_100005	7393827	7405642	11815	g_24215	g_24216
Super-Scaffold_100005	7406049	7418229	12180	g_24216	g_24217
Super-Scaffold_100005	7427771	7433726	5955	g_24217	g_24218
Super-Scaffold_100005	7434508	7452473	17965	g_24218	g_24219
Super-Scaffold_100005	7461668	7469077	7409	g_24219	g_44882
Super-Scaffold_100005	7469310	7507605	38295	g_44882	g_24222
Super-Scaffold_100005	7507814	7525545	17731	g_24222	g_24223
Super-Scaffold_100005	7525781	7530041	4260	g_24223	g_24224
Super-Scaffold_100005	7530463	7531381	918	g_24224	g_24225
Super-Scaffold_100005	7531605	7546631	15026	g_24225	g_24226
Super-Scaffold_100005	7546834	7625104	78270	g_24226	g_40166
Super-Scaffold_100005	7625376	7732760	107384	g_40166	g_24231
Super-Scaffold_100005	7733029	7733126	97	g_24231	g_40169
Super-Scaffold_100005	7733347	7750003	16656	g_40169	g_24232
Super-Scaffold_100005	7750212	7812642	62430	g_24232	g_24234
Super-Scaffold_100005	7812941	7844652	31711	g_24234	g_24236
Super-Scaffold_100005	7852156	7855113	2957	g_24236	g_24237
Super-Scaffold_100005	7876941	7885932	8991	g_24237	g_24238
Super-Scaffold_100005	7906938	7921995	15057	g_24238	g_24239
Super-Scaffold_100005	7922513	7949304	26791	g_24239	g_24240
Super-Scaffold_100005	7975634	7981613	5979	g_24240	g_44883
Super-Scaffold_100005	7987908	7994625	6717	g_44883	g_24241
Super-Scaffold_100005	7995044	8038298	43254	g_24241	g_24243
Super-Scaffold_100005	8049468	8099385	49917	g_24243	g_24244
Super-Scaffold_100005	8104541	8118171	13630	g_24244	g_24245
Super-Scaffold_100005	8121130	8183898	62768	g_24245	g_24246
Super-Scaffold_100005	8192582	8199136	6554	g_24246	g_24247
Super-Scaffold_100005	8221215	8224379	3164	g_24247	g_24248
Super-Scaffold_100005	8228787	8230677	1890	g_24248	g_24249
Super-Scaffold_100005	8248065	8261732	13667	g_24249	g_24250
Super-Scaffold_100005	8267654	8279292	11638	g_24250	g_24252
Super-Scaffold_100005	8298311	8318791	20480	g_24252	g_24253
Super-Scaffold_100005	8319562	8338554	18992	g_24253	g_24254
Super-Scaffold_100005	8339428	8339523	95	g_24254	g_24255
Super-Scaffold_100005	8340407	8362251	21844	g_24255	g_24256
Super-Scaffold_100005	8363134	8591472	228338	g_24256	g_24258
Super-Scaffold_100005	8611765	8615190	3425	g_24258	g_24259
Super-Scaffold_100005	8617141	8627349	10208	g_24259	g_24260
Super-Scaffold_100005	8629569	8646306	16737	g_24260	g_24263
Super-Scaffold_100005	8666139	8684081	17942	g_24263	g_24265
Super-Scaffold_100005	8684293	8687939	3646	g_24265	g_24266
Super-Scaffold_100005	8690288	8696662	6374	g_24266	g_24268
Super-Scaffold_100005	8696988	8743975	46987	g_24268	g_40175
Super-Scaffold_100005	8744273	8751788	7515	g_24271	g_40176
Super-Scaffold_100005	8752054	8826177	74123	g_40176	g_24272
Super-Scaffold_100005	8834809	8845474	10665	g_24272	g_24273
Super-Scaffold_100005	8846133	8852015	5882	g_24273	g_24274
Super-Scaffold_100005	8852680	8853367	687	g_24274	g_24275
Super-Scaffold_100005	8867869	8868827	958	g_24275	g_44884
Super-Scaffold_100005	8872068	8873744	1676	g_44884	g_24276
Super-Scaffold_100005	8879090	8909920	30830	g_24276	g_24278
Super-Scaffold_100005	8948318	8967101	18783	g_24278	g_24279
Super-Scaffold_100005	9035934	9052720	16786	g_24279	g_24280
Super-Scaffold_100005	9053866	9055028	1162	g_24280	g_24281
Super-Scaffold_100005	9058915	9059663	748	g_24281	g_24282
Super-Scaffold_100005	9062403	9065313	2910	g_24282	g_40182
Super-Scaffold_100005	9076912	9112923	36011	g_24283	g_24285
Super-Scaffold_100005	9113174	9139664	26490	g_24285	g_24286
Super-Scaffold_100005	9145220	9151505	6285	g_24286	g_24287
Super-Scaffold_100005	9157523	9192067	34544	g_24287	g_24288
Super-Scaffold_100005	9203004	9213808	10804	g_24288	g_44885
Super-Scaffold_100005	9231516	9249754	18238	g_44885	g_24289
Super-Scaffold_100005	9260910	9265659	4749	g_24289	g_24290
Super-Scaffold_100005	9274367	9277506	3139	g_24290	g_24291
Super-Scaffold_100005	9277745	9286153	8408	g_24291	g_44886
Super-Scaffold_100005	9293395	9297418	4023	g_44886	g_24292
Super-Scaffold_100005	9299676	9306376	6700	g_24292	g_24293
Super-Scaffold_100005	9306660	9312424	5764	g_24293	g_24294
Super-Scaffold_100005	9338559	9389628	51069	g_24294	g_40184
Super-Scaffold_100005	9390080	9442910	52830	g_40184	g_24296
Super-Scaffold_100005	9443489	9516896	73407	g_24296	g_24300
Super-Scaffold_100005	9517597	9521819	4222	g_24300	g_24301
Super-Scaffold_100005	9524236	9531948	7712	g_24301	g_24302
Super-Scaffold_100005	9533159	9543913	10754	g_24302	g_44887
Super-Scaffold_100005	9544383	9547066	2683	g_44887	g_24303
Super-Scaffold_100005	9549305	9551540	2235	g_24303	g_24304
Super-Scaffold_100005	9551838	9564385	12547	g_24304	g_24306
Super-Scaffold_100005	9565686	9575357	9671	g_24306	g_24307
Super-Scaffold_100005	9585228	9590314	5086	g_24307	g_44888
Super-Scaffold_100005	9594046	9596699	2653	g_44888	g_44889
Super-Scaffold_100005	9602328	9607328	5000	g_44889	g_24308
Super-Scaffold_100005	9615018	9622712	7694	g_24308	g_24309
Super-Scaffold_100005	9623594	9629383	5789	g_24309	g_24310
Super-Scaffold_100005	9631056	9644158	13102	g_24310	g_24311
Super-Scaffold_100005	9647458	9685683	38225	g_24311	g_40187
Super-Scaffold_100005	9685958	9692504	6546	g_40187	g_24312
Super-Scaffold_100005	9695232	9701918	6686	g_24312	g_24313
Super-Scaffold_100005	9708055	9764467	56412	g_24313	g_24316
Super-Scaffold_100005	9764793	9779402	14609	g_24316	g_24317
Super-Scaffold_100005	9780472	9796095	15623	g_24317	g_24318
Super-Scaffold_100005	9813173	9815274	2101	g_24318	g_24319
Super-Scaffold_100005	9825290	9831520	6230	g_24319	g_44890
Super-Scaffold_100005	9839041	9843894	4853	g_44890	g_24320
Super-Scaffold_100005	9848421	9850488	2067	g_24320	g_24321
Super-Scaffold_100005	9856118	9862765	6647	g_24321	g_24322
Super-Scaffold_100005	9876096	9880389	4293	g_24322	g_24323
Super-Scaffold_100005	9913619	9918117	4498	g_24323	g_24324
Super-Scaffold_100005	9932710	9956781	24071	g_24324	g_24325
Super-Scaffold_100005	9983967	10010232	26265	g_24325	g_24327
Super-Scaffold_100005	10012921	10013077	156	g_24327	g_24328
Super-Scaffold_100005	10016667	10017449	782	g_24328	g_24329
Super-Scaffold_100005	10020329	10028480	8151	g_24329	g_24330
Super-Scaffold_100005	10048627	10088865	40238	g_24330	g_24331
Super-Scaffold_100005	10090166	10107901	17735	g_24331	g_24332
Super-Scaffold_100005	10115755	10127809	12054	g_24332	g_24333
Super-Scaffold_100005	10130002	10132475	2473	g_24333	g_24334
Super-Scaffold_100005	10145669	10148613	2944	g_24334	g_24335
Super-Scaffold_100005	10161585	10164674	3089	g_24335	g_24336
Super-Scaffold_100005	10164883	10183016	18133	g_24336	g_24337
Super-Scaffold_100005	10183336	10193214	9878	g_24337	g_24339
Super-Scaffold_100005	10202507	10204958	2451	g_24339	g_24340
Super-Scaffold_100005	10205161	10235376	30215	g_24340	g_24341
Super-Scaffold_100005	10248063	10274495	26432	g_24341	g_24342
Super-Scaffold_100005	10276973	10279668	2695	g_24342	g_24343
Super-Scaffold_100005	10283023	10288673	5650	g_24343	g_24344
Super-Scaffold_100005	10304583	10308630	4047	g_24344	g_24345
Super-Scaffold_100005	10321690	10324449	2759	g_24345	g_24346
Super-Scaffold_100005	10327278	10334788	7510	g_24346	g_24347
Super-Scaffold_100005	10338556	10347695	9139	g_24347	g_24349
Super-Scaffold_100005	10352643	10360357	7714	g_24349	g_24350
Super-Scaffold_100005	10368944	10374347	5403	g_24350	g_24351
Super-Scaffold_100005	10382472	10406345	23873	g_24351	g_24352
Super-Scaffold_100005	10406623	10424099	17476	g_24352	g_24354
Super-Scaffold_100005	10424360	10424553	193	g_24354	g_24355
Super-Scaffold_100005	10437542	10443220	5678	g_24355	g_24356
Super-Scaffold_100005	10446196	10448649	2453	g_24356	g_24357
Super-Scaffold_100005	10449197	10450830	1633	g_24357	g_24358
Super-Scaffold_100005	10476831	10484022	7191	g_24358	g_24359
Super-Scaffold_100005	10487681	10489828	2147	g_24359	g_44891
Super-Scaffold_100005	10490067	10490583	516	g_44891	g_24360
Super-Scaffold_100005	10492587	10493590	1003	g_24360	g_24361
Super-Scaffold_100005	10498435	10500911	2476	g_24361	g_24362
Super-Scaffold_100005	10527051	10527575	524	g_24362	g_44892
Super-Scaffold_100005	10545284	10548509	3225	g_44892	g_24363
Super-Scaffold_100005	10549483	10560685	11202	g_24363	g_24364
Super-Scaffold_100005	10561659	10566729	5070	g_24364	g_24365
Super-Scaffold_100005	10590968	10594243	3275	g_24365	g_24366
Super-Scaffold_100005	10601457	10603896	2439	g_24366	g_24367
Super-Scaffold_100005	10607786	10615105	7319	g_24367	g_24368
Super-Scaffold_100005	10616298	10637597	21299	g_24368	g_24369
Super-Scaffold_100005	10658977	10661079	2102	g_24369	g_24370
Super-Scaffold_100005	10667785	10671169	3384	g_24370	g_24371
Super-Scaffold_100005	10674601	10677633	3032	g_24371	g_24372
Super-Scaffold_100005	10682778	10687273	4495	g_24372	g_24373
Super-Scaffold_100005	10694590	10698366	3776	g_24373	g_24374
Super-Scaffold_100005	10708248	10750279	42031	g_24374	g_44893
Super-Scaffold_100005	10758388	10761990	3602	g_44893	g_24376
Super-Scaffold_100005	10765541	10766747	1206	g_24376	g_24377
Super-Scaffold_100005	10767739	10777387	9648	g_24377	g_24378
Super-Scaffold_100005	10789885	10795686	5801	g_24378	g_24379
Super-Scaffold_100005	10798964	10812332	13368	g_24379	g_24380
Super-Scaffold_100005	10813620	10814635	1015	g_24380	g_24381
Super-Scaffold_100005	10819949	10820645	696	g_24381	g_24382
Super-Scaffold_100005	10824063	10830959	6896	g_24382	g_24384
Super-Scaffold_100005	10831849	10832171	322	g_24384	g_24385
Super-Scaffold_100005	10833730	10845609	11879	g_24385	g_24386
Super-Scaffold_100005	10850854	10855988	5134	g_24386	g_24387
Super-Scaffold_100005	10865256	10878924	13668	g_24387	g_24389
Super-Scaffold_100005	10879701	10944020	64319	g_40195	g_24390
Super-Scaffold_100005	10944244	10954051	9807	g_24390	g_24391
Super-Scaffold_100005	10983794	10984716	922	g_24391	g_44894
Super-Scaffold_100005	10987595	10993457	5862	g_44894	g_24392
Super-Scaffold_100005	10997317	11000563	3246	g_24392	g_24393
Super-Scaffold_100005	11002377	11003265	888	g_24393	g_24394
Super-Scaffold_100005	11006426	11007707	1281	g_24394	g_24395
Super-Scaffold_100005	11010861	11012690	1829	g_24395	g_24396
Super-Scaffold_100005	11014990	11017042	2052	g_24396	g_24397
Super-Scaffold_100005	11026497	11040178	13681	g_24397	g_24399
Super-Scaffold_100005	11057504	11087027	29523	g_24399	g_24401
Super-Scaffold_100005	11098126	11135249	37123	g_24401	g_24403
Super-Scaffold_100005	11157420	11157728	308	g_24403	g_24404
Super-Scaffold_100005	11157943	11161739	3796	g_24404	g_24405
Super-Scaffold_100005	11170830	11172429	1599	g_24405	g_24406
Super-Scaffold_100005	11175014	11176401	1387	g_24406	g_24407
Super-Scaffold_100005	11190783	11211610	20827	g_24407	g_24408
Super-Scaffold_100005	11211888	11231451	19563	g_24408	g_24410
Super-Scaffold_100005	11265830	11267424	1594	g_24410	g_24411
Super-Scaffold_100005	11276727	11278061	1334	g_24411	g_24412
Super-Scaffold_100005	11282881	11283913	1032	g_24412	g_24413
Super-Scaffold_100005	11297721	11301408	3687	g_24413	g_24414
Super-Scaffold_100005	11307172	11310417	3245	g_24414	g_24415
Super-Scaffold_100005	11329409	11330958	1549	g_24415	g_24416
Super-Scaffold_100005	11345040	11381706	36666	g_24416	g_24417
Super-Scaffold_100005	11397747	11401614	3867	g_24417	g_24418
Super-Scaffold_100005	11402654	11416872	14218	g_24418	g_24419
Super-Scaffold_100005	11418858	11421161	2303	g_24419	g_24420
Super-Scaffold_100005	11435916	11438722	2806	g_24420	g_24421
Super-Scaffold_100005	11440823	11441339	516	g_24421	g_24422
Super-Scaffold_100005	11442844	11446976	4132	g_24422	g_24423
Super-Scaffold_100005	11447716	11454937	7221	g_24423	g_44895
Super-Scaffold_100005	11472114	11495976	23862	g_44895	g_24425
Super-Scaffold_100005	11509090	11517065	7975	g_24425	g_24426
Super-Scaffold_100005	11517286	11519217	1931	g_24426	g_24427
Super-Scaffold_100005	11522402	11524245	1843	g_24427	g_24428
Super-Scaffold_100005	11531000	11532467	1467	g_24428	g_24429
Super-Scaffold_100005	11538297	11540884	2587	g_24429	g_24430
Super-Scaffold_100005	11541979	11543675	1696	g_24430	g_24431
Super-Scaffold_100005	11546133	11548742	2609	g_24431	g_44896
Super-Scaffold_100005	11551540	11552213	673	g_44896	g_24432
Super-Scaffold_100005	11552680	11555802	3122	g_24432	g_24433
Super-Scaffold_100005	11558263	11562106	3843	g_24433	g_24434
Super-Scaffold_100005	11562933	11568515	5582	g_24434	g_24435
Super-Scaffold_100005	11568982	11572175	3193	g_24435	g_24437
Super-Scaffold_100005	11574051	11576933	2882	g_24437	g_24438
Super-Scaffold_100005	11577451	11581134	3683	g_24438	g_44897
Super-Scaffold_100005	11581652	11583686	2034	g_44897	g_44898
Super-Scaffold_100005	11586374	11588984	2610	g_44898	g_24439
Super-Scaffold_100005	11598396	11621547	23151	g_24439	g_24440
Super-Scaffold_100005	11629610	11637487	7877	g_24440	g_24442
Super-Scaffold_100005	11643269	11644977	1708	g_24442	g_24443
Super-Scaffold_100005	11658365	11660230	1865	g_24443	g_24444
Super-Scaffold_100005	11665726	11667017	1291	g_24444	g_24445
Super-Scaffold_100005	11684418	11756212	71794	g_24445	g_24451
Super-Scaffold_100005	11756418	11771153	14735	g_24451	g_24453
Super-Scaffold_100005	11771446	11777234	5788	g_24453	g_24454
Super-Scaffold_100005	11783189	11783683	494	g_24454	g_24455
Super-Scaffold_100005	11785340	11785795	455	g_24455	g_24456
Super-Scaffold_100005	11789479	11791777	2298	g_24456	g_24457
Super-Scaffold_100005	11798450	11801064	2614	g_24457	g_24458
Super-Scaffold_100005	11802793	11804297	1504	g_24458	g_24459
Super-Scaffold_100005	11812965	11825212	12247	g_24459	g_24460
Super-Scaffold_100005	11831348	11833044	1696	g_24460	g_24461
Super-Scaffold_100005	11851473	11855031	3558	g_24461	g_44899
Super-Scaffold_100005	11855588	11858733	3145	g_44899	g_24462
Super-Scaffold_100005	11877896	11880092	2196	g_24462	g_24463
Super-Scaffold_100005	11883364	11884269	905	g_24463	g_24464
Super-Scaffold_100005	11890941	11895933	4992	g_24464	g_24465
Super-Scaffold_100005	11897674	11901055	3381	g_24465	g_24466
Super-Scaffold_100005	11908535	11914497	5962	g_24466	g_24467
Super-Scaffold_100005	11915153	11922355	7202	g_24467	g_24468
Super-Scaffold_100005	11931030	11933419	2389	g_24468	g_24469
Super-Scaffold_100005	11943633	11947155	3522	g_24469	g_24470
Super-Scaffold_100005	11953739	11955902	2163	g_24470	g_44900
Super-Scaffold_100005	11963820	11965080	1260	g_44900	g_44901
Super-Scaffold_100005	11969149	11971059	1910	g_44901	g_24471
Super-Scaffold_100005	11972853	11976064	3211	g_24471	g_24472
Super-Scaffold_100005	11989936	11992028	2092	g_24472	g_24473
Super-Scaffold_100005	11996618	11998578	1960	g_24473	g_24474
Super-Scaffold_100005	12007586	12008602	1016	g_24474	g_24475
Super-Scaffold_100005	12017886	12023798	5912	g_24475	g_24476
Super-Scaffold_100005	12025930	12026907	977	g_24476	g_24477
Super-Scaffold_100005	12033213	12042994	9781	g_24477	g_24478
Super-Scaffold_100005	12051621	12052735	1114	g_24478	g_44902
Super-Scaffold_100005	12053022	12061804	8782	g_44902	g_24479
Super-Scaffold_100005	12067716	12073267	5551	g_24479	g_24480
Super-Scaffold_100005	12075201	12077530	2329	g_24480	g_24481
Super-Scaffold_100005	12089271	12101433	12162	g_24481	g_24482
Super-Scaffold_100005	12115739	12118339	2600	g_24482	g_24483
Super-Scaffold_100005	12130616	12131555	939	g_24483	g_24484
Super-Scaffold_100005	12132958	12134172	1214	g_24484	g_24485
Super-Scaffold_100005	12138593	12139569	976	g_24485	g_24486
Super-Scaffold_100005	12148065	12150449	2384	g_24486	g_24487
Super-Scaffold_100005	12154204	12168053	13849	g_24487	g_24488
Super-Scaffold_100005	12176389	12178254	1865	g_24488	g_24489
Super-Scaffold_100005	12181968	12186090	4122	g_24489	g_24490
Super-Scaffold_100005	12192222	12198198	5976	g_24490	g_24491
Super-Scaffold_100005	12219012	12230124	11112	g_24491	g_24492
Super-Scaffold_100005	12234713	12284032	49319	g_24492	g_24493
Super-Scaffold_100005	12291867	12294348	2481	g_24493	g_24494
Super-Scaffold_100005	12295848	12297129	1281	g_24494	g_44903
Super-Scaffold_100005	12303092	12304619	1527	g_44903	g_24495
Super-Scaffold_100005	12318106	12351734	33628	g_24495	g_24496
Super-Scaffold_100005	12357424	12381186	23762	g_24496	g_24497
Super-Scaffold_100005	12389781	12402918	13137	g_24497	g_44904
Super-Scaffold_100005	12405692	12423476	17784	g_44904	g_24499
Super-Scaffold_100005	12428831	12451180	22349	g_24499	g_24500
Super-Scaffold_100005	12464441	12466484	2043	g_24500	g_24501
Super-Scaffold_100005	12477143	12479490	2347	g_24501	g_24502
Super-Scaffold_100005	12485866	12489879	4013	g_24502	g_24503
Super-Scaffold_100005	12504202	12506817	2615	g_24503	g_24504
Super-Scaffold_100005	12511703	12520988	9285	g_24504	g_24505
Super-Scaffold_100005	12536369	12541516	5147	g_24505	g_24506
Super-Scaffold_100005	12546561	12569922	23361	g_24506	g_24508
Super-Scaffold_100005	12571811	12571856	45	g_24508	g_24509
Super-Scaffold_100005	12574212	12576863	2651	g_24509	g_24510
Super-Scaffold_100005	12580568	12580864	296	g_24510	g_24511
Super-Scaffold_100005	12586867	12588408	1541	g_24511	g_24512
Super-Scaffold_100005	12602909	12605033	2124	g_24512	g_24513
Super-Scaffold_100005	12612754	12648335	35581	g_24513	g_24514
Super-Scaffold_100005	12673832	12677117	3285	g_24514	g_24515
Super-Scaffold_100005	12698642	12701371	2729	g_24515	g_24516
Super-Scaffold_100005	12708336	12709548	1212	g_24516	g_24517
Super-Scaffold_100005	12714939	12715484	545	g_24517	g_24518
Super-Scaffold_100005	12724831	12738235	13404	g_24518	g_24519
Super-Scaffold_100005	12759850	12764371	4521	g_24519	g_24520
Super-Scaffold_100005	12783956	12784471	515	g_24520	g_24521
Super-Scaffold_100005	12786064	12788217	2153	g_24521	g_24522
Super-Scaffold_100005	12799972	12801404	1432	g_24522	g_24523
Super-Scaffold_100005	12804115	12805788	1673	g_24523	g_24524
Super-Scaffold_100005	12807364	12808337	973	g_24524	g_24525
Super-Scaffold_100005	12810899	12813114	2215	g_24525	g_44905
Super-Scaffold_100005	12814253	12817540	3287	g_44905	g_44906
Super-Scaffold_100005	12824569	12887317	62748	g_44906	g_24531
Super-Scaffold_100005	12892427	12896025	3598	g_24531	g_24532
Super-Scaffold_100005	12899363	12901531	2168	g_24532	g_24533
Super-Scaffold_100005	12906607	12908747	2140	g_24533	g_44907
Super-Scaffold_100005	12914237	12919577	5340	g_44907	g_24534
Super-Scaffold_100005	12925857	12927644	1787	g_24534	g_44908
Super-Scaffold_100005	12929402	12933373	3971	g_44908	g_24535
Super-Scaffold_100005	12935397	12962880	27483	g_24535	g_24536
Super-Scaffold_100005	12978020	12989341	11321	g_24536	g_44909
Super-Scaffold_100005	13005695	13032485	26790	g_44909	g_24537
Super-Scaffold_100005	13037677	13042845	5168	g_24537	g_24538
Super-Scaffold_100005	13049479	13116471	66992	g_24538	g_24539
Super-Scaffold_100005	13151578	13257086	105508	g_24539	g_24541
Super-Scaffold_100005	13257340	13363898	106558	g_24541	g_40207
Super-Scaffold_100005	13367201	13392600	25399	g_40207	g_24542
Super-Scaffold_100005	13426714	13444051	17337	g_24543	g_24544
Super-Scaffold_100005	13444341	13465647	21306	g_24544	g_24546
Super-Scaffold_100005	13478915	13544116	65201	g_24546	g_24548
Super-Scaffold_100005	13557346	13654647	97301	g_24548	g_40215
Super-Scaffold_100005	13655036	13679610	24574	g_40215	g_24554
Super-Scaffold_100005	13679813	13744522	64709	g_24554	g_24556
Super-Scaffold_100005	13756066	13787035	30969	g_24556	g_24557
Super-Scaffold_100005	13804769	13822315	17546	g_24557	g_24558
Super-Scaffold_100005	13822536	13833588	11052	g_24558	g_24559
Super-Scaffold_100005	13837033	13838174	1141	g_24559	g_24560
Super-Scaffold_100005	13839723	13840983	1260	g_24560	g_24561
Super-Scaffold_100005	13847786	13848640	854	g_24561	g_24562
Super-Scaffold_100005	13850843	13850958	115	g_24562	g_24563
Super-Scaffold_100005	13860082	13864525	4443	g_24563	g_44910
Super-Scaffold_100005	13869625	13876658	7033	g_44910	g_24564
Super-Scaffold_100005	13882887	13885811	2924	g_24564	g_44911
Super-Scaffold_100005	13888345	13895944	7599	g_44911	g_24565
Super-Scaffold_100005	13899789	13926984	27195	g_24565	g_24566
Super-Scaffold_100005	13932026	13950171	18145	g_24566	g_40219
Super-Scaffold_100005	13950377	13962692	12315	g_40219	g_40221
Super-Scaffold_100005	13962979	14016014	53035	g_40221	g_40222
Super-Scaffold_100005	14016256	14212539	196283	g_40222	g_40229
Super-Scaffold_100005	14212868	14237872	25004	g_40229	g_24579
Super-Scaffold_100005	14244405	14306857	62452	g_24579	g_24582
Super-Scaffold_100005	14313435	14356747	43312	g_40233	g_24585
Super-Scaffold_100005	14357019	14472529	115510	g_24585	g_24589
Super-Scaffold_100005	14501549	14507879	6330	g_24589	g_24590
Super-Scaffold_100005	14511874	14523571	11697	g_24590	g_24592
Super-Scaffold_100005	14538466	14589670	51204	g_24592	g_24597
Super-Scaffold_100005	14604311	14608774	4463	g_24597	g_24598
Super-Scaffold_100005	14623086	14623095	9	g_24599	g_24600
Super-Scaffold_100005	14623505	14670973	47468	g_24600	g_24602
Super-Scaffold_100005	14672217	14689398	17181	g_24602	g_24604
Super-Scaffold_100005	14702519	14705338	2819	g_24604	g_44912
Super-Scaffold_100005	14712724	14713897	1173	g_44912	g_24605
Super-Scaffold_100005	14715441	14718533	3092	g_24605	g_24606
Super-Scaffold_100005	14725023	14740055	15032	g_24606	g_24607
Super-Scaffold_100005	14745379	14749380	4001	g_24607	g_24608
Super-Scaffold_100005	14751645	14758108	6463	g_24608	g_44913
Super-Scaffold_100005	14758885	14778532	19647	g_44913	g_24609
Super-Scaffold_100005	14779919	14782640	2721	g_24609	g_44914
Super-Scaffold_100005	14784494	14788454	3960	g_44914	g_24610
Super-Scaffold_100005	14791574	14794526	2952	g_24610	g_24611
Super-Scaffold_100005	14805973	14812026	6053	g_24611	g_24612
Super-Scaffold_100005	14819817	14826619	6802	g_24612	g_24613
Super-Scaffold_100005	14833382	14835044	1662	g_24613	g_24614
Super-Scaffold_100005	14836941	14840223	3282	g_24614	g_24615
Super-Scaffold_100005	14843563	14846495	2932	g_24615	g_24616
Super-Scaffold_100005	14849212	14849770	558	g_24616	g_24617
Super-Scaffold_100005	14855685	14861692	6007	g_24617	g_24618
Super-Scaffold_100005	14880942	14886397	5455	g_24618	g_44915
Super-Scaffold_100005	14891888	14892588	700	g_44915	g_24620
Super-Scaffold_100005	14900472	14913752	13280	g_24620	g_24623
Super-Scaffold_100005	14916000	14917561	1561	g_24623	g_24624
Super-Scaffold_100005	14920696	14924349	3653	g_24624	g_44916
Super-Scaffold_100005	14930661	14932026	1365	g_44916	g_24625
Super-Scaffold_100005	14934340	14938458	4118	g_24625	g_24626
Super-Scaffold_100005	14943844	14947761	3917	g_24626	g_24627
Super-Scaffold_100005	14955068	14960317	5249	g_24627	g_24628
Super-Scaffold_100005	14962400	14970001	7601	g_24628	g_24629
Super-Scaffold_100005	14977384	14981617	4233	g_24629	g_24630
Super-Scaffold_100005	14991899	14995855	3956	g_24630	g_40244
Super-Scaffold_100005	14996142	14999162	3020	g_40244	g_24631
Super-Scaffold_100005	15004821	15008921	4100	g_24631	g_24632
Super-Scaffold_100005	15016371	15100720	84349	g_24632	g_24634
Super-Scaffold_100005	15102753	15111927	9174	g_24634	g_24635
Super-Scaffold_100005	15113967	15135450	21483	g_40247	g_24636
Super-Scaffold_100005	15139682	15145188	5506	g_24636	g_24637
Super-Scaffold_100005	15146162	15199530	53368	g_24637	g_24639
Super-Scaffold_100005	15201688	15204747	3059	g_24639	g_24640
Super-Scaffold_100005	15220633	15256241	35608	g_24640	g_24641
Super-Scaffold_100005	15259581	15264545	4964	g_24641	g_24642
Super-Scaffold_100005	15271821	15285980	14159	g_24642	g_24643
Super-Scaffold_100005	15287083	15296566	9483	g_24643	g_24644
Super-Scaffold_100005	15297520	15299302	1782	g_24644	g_24645
Super-Scaffold_100005	15303800	15304968	1168	g_24645	g_24646
Super-Scaffold_100005	15306430	15332152	25722	g_24646	g_24647
Super-Scaffold_100005	15348923	15365853	16930	g_24647	g_24649
Super-Scaffold_100005	15388675	15398779	10104	g_24649	g_24651
Super-Scaffold_100005	15404402	15407700	3298	g_24651	g_24652
Super-Scaffold_100005	15411961	15416294	4333	g_24652	g_24653
Super-Scaffold_100005	15419320	15430233	10913	g_24653	g_24654
Super-Scaffold_100005	15430496	15479835	49339	g_24654	g_24656
Super-Scaffold_100005	15486181	15492456	6275	g_24656	g_24657
Super-Scaffold_100005	15521963	15587830	65867	g_24657	g_40252
Super-Scaffold_100005	15588048	15603362	15314	g_40252	g_40253
Super-Scaffold_100005	15603610	15612713	9103	g_40253	g_24660
Super-Scaffold_100005	15640266	15643825	3559	g_24660	g_24661
Super-Scaffold_100005	15657488	15659987	2499	g_24661	g_24662
Super-Scaffold_100005	15664055	15673604	9549	g_24662	g_24663
Super-Scaffold_100005	15688068	15689772	1704	g_24663	g_24664
Super-Scaffold_100005	15694864	15757686	62822	g_24664	g_24667
Super-Scaffold_100005	15785125	15787264	2139	g_24667	g_24668
Super-Scaffold_100005	15799281	15820317	21036	g_24668	g_24669
Super-Scaffold_100005	15822068	15880518	58450	g_24669	g_24671
Super-Scaffold_100005	15888790	15890808	2018	g_24671	g_24672
Super-Scaffold_100005	15897413	15905671	8258	g_24672	g_24673
Super-Scaffold_100005	15928796	15936948	8152	g_24673	g_24674
Super-Scaffold_100005	15971365	16066005	94640	g_24674	g_24678
Super-Scaffold_100005	16071938	16076767	4829	g_24678	g_24679
Super-Scaffold_100005	16077030	16086233	9203	g_24679	g_24680
Super-Scaffold_100005	16087108	16088113	1005	g_24680	g_44917
Super-Scaffold_100005	16094925	16095367	442	g_44917	g_24681
Super-Scaffold_100005	16107957	16114511	6554	g_24681	g_24683
Super-Scaffold_100005	16126412	16217804	91392	g_24683	g_24684
Super-Scaffold_100005	16222489	16236045	13556	g_24684	g_24685
Super-Scaffold_100005	16239664	16265526	25862	g_24685	g_24687
Super-Scaffold_100005	16265939	16293906	27967	g_24687	g_24689
Super-Scaffold_100005	16294136	16301001	6865	g_24689	g_24690
Super-Scaffold_100005	16301399	16305496	4097	g_24690	g_24691
Super-Scaffold_100005	16305717	16315665	9948	g_24691	g_24693
Super-Scaffold_100005	16315982	16316540	558	g_24693	g_24694
Super-Scaffold_100005	16316800	16324923	8123	g_24694	g_24695
Super-Scaffold_100005	16325692	16352012	26320	g_24695	g_24697
Super-Scaffold_100005	16370490	16470620	100130	g_24697	g_24698
Super-Scaffold_100005	16483584	16485212	1628	g_24698	g_44918
Super-Scaffold_100005	16485484	16502526	17042	g_44918	g_40265
Super-Scaffold_100005	16502735	16591830	89095	g_40265	g_40269
Super-Scaffold_100005	16592057	16613294	21237	g_40269	g_24701
Super-Scaffold_100005	16633958	16642957	8999	g_24701	g_44919
Super-Scaffold_100005	16646154	16659252	13098	g_44919	g_24703
Super-Scaffold_100005	16665296	16670451	5155	g_24703	g_24704
Super-Scaffold_100005	16673777	16679736	5959	g_24704	g_24705
Super-Scaffold_100005	16684918	16724233	39315	g_24705	g_24708
Super-Scaffold_100005	16738181	16744671	6490	g_24708	g_24709
Super-Scaffold_100005	16763450	16764312	862	g_24709	g_24710
Super-Scaffold_100005	16766026	16768730	2704	g_24710	g_24711
Super-Scaffold_100005	16772968	16776626	3658	g_24711	g_24712
Super-Scaffold_100005	16780364	16780683	319	g_24712	g_24713
Super-Scaffold_100005	16785564	16788051	2487	g_24713	g_24714
Super-Scaffold_100005	16797903	16816419	18516	g_24714	g_24715
Super-Scaffold_100005	16816697	16838838	22141	g_24715	g_24717
Super-Scaffold_100005	16839923	16851324	11401	g_24717	g_24719
Super-Scaffold_100005	16852196	16855168	2972	g_24719	g_24720
Super-Scaffold_100005	16860460	16861243	783	g_24720	g_24721
Super-Scaffold_100005	16871467	16875099	3632	g_24721	g_24722
Super-Scaffold_100005	16877394	16880840	3446	g_24722	g_24723
Super-Scaffold_100005	16898666	16903046	4380	g_24723	g_24724
Super-Scaffold_100005	16911178	16912800	1622	g_24724	g_24725
Super-Scaffold_100005	16914221	16914646	425	g_24725	g_24726
Super-Scaffold_100005	16915917	16916142	225	g_24726	g_24727
Super-Scaffold_100005	16917701	16919845	2144	g_24727	g_24728
Super-Scaffold_100005	16925126	16927348	2222	g_24728	g_44920
Super-Scaffold_100005	16952915	16956986	4071	g_44920	g_24729
Super-Scaffold_100005	16972894	16977540	4646	g_24729	g_24730
Super-Scaffold_100005	16978826	16979561	735	g_24730	g_24731
Super-Scaffold_100005	16982560	16983453	893	g_24731	g_24732
Super-Scaffold_100005	16998199	17007045	8846	g_24732	g_24733
Super-Scaffold_100005	17013315	17024580	11265	g_24733	g_24734
Super-Scaffold_100005	17026547	17032270	5723	g_24734	g_24735
Super-Scaffold_100005	17057731	17060724	2993	g_24735	g_24736
Super-Scaffold_100005	17063948	17064933	985	g_24736	g_24737
Super-Scaffold_100005	17069648	17072029	2381	g_24737	g_24738
Super-Scaffold_100005	17073773	17082654	8881	g_24738	g_24739
Super-Scaffold_100005	17084881	17093625	8744	g_24739	g_44921
Super-Scaffold_100005	17095367	17097308	1941	g_44921	g_24740
Super-Scaffold_100005	17099542	17112466	12924	g_24740	g_24741
Super-Scaffold_100005	17114190	17122880	8690	g_24741	g_24742
Super-Scaffold_100005	17125117	17125993	876	g_24742	g_44922
Super-Scaffold_100005	17129699	17131717	2018	g_44922	g_24743
Super-Scaffold_100005	17132826	17137099	4273	g_24743	g_24744
Super-Scaffold_100005	17154801	17159823	5022	g_24744	g_24745
Super-Scaffold_100005	17164069	17177938	13869	g_24745	g_40275
Super-Scaffold_100005	17178207	17224609	46402	g_40275	g_24748
Super-Scaffold_100005	17224950	17248863	23913	g_24748	g_24749
Super-Scaffold_100005	17269738	17276583	6845	g_24749	g_24750
Super-Scaffold_100005	17280356	17290534	10178	g_24750	g_24751
Super-Scaffold_100005	17304007	17307765	3758	g_24751	g_24752
Super-Scaffold_100005	17312074	17315539	3465	g_24752	g_24753
Super-Scaffold_100005	17320972	17321803	831	g_24753	g_24754
Super-Scaffold_100005	17332165	17337848	5683	g_24754	g_24755
Super-Scaffold_100005	17346961	17358526	11565	g_24755	g_24756
Super-Scaffold_100005	17364244	17370722	6478	g_24756	g_24757
Super-Scaffold_100005	17385403	17386195	792	g_24757	g_24758
Super-Scaffold_100005	17389662	17391614	1952	g_24758	g_24759
Super-Scaffold_100005	17392526	17394400	1874	g_24759	g_24760
Super-Scaffold_100005	17397645	17400712	3067	g_24760	g_24761
Super-Scaffold_100005	17423741	17435749	12008	g_24761	g_24762
Super-Scaffold_100005	17436829	17443684	6855	g_24762	g_24763
Super-Scaffold_100005	17443959	17448297	4338	g_24763	g_44923
Super-Scaffold_100005	17453931	17458975	5044	g_44923	g_24764
Super-Scaffold_100005	17467521	17470257	2736	g_24764	g_24765
Super-Scaffold_100005	17472968	17477837	4869	g_24765	g_24766
Super-Scaffold_100005	17486416	17489239	2823	g_24766	g_24767
Super-Scaffold_100005	17496014	17507380	11366	g_24767	g_24768
Super-Scaffold_100005	17515085	17517832	2747	g_24768	g_44924
Super-Scaffold_100005	17523432	17525486	2054	g_44924	g_24769
Super-Scaffold_100005	17563912	17568100	4188	g_24769	g_24770
Super-Scaffold_100005	17570595	17709662	139067	g_24770	g_24776
Super-Scaffold_100005	17743813	17769055	25242	g_24776	g_24778
Super-Scaffold_100005	17772627	18025749	253122	g_24778	g_24790
Super-Scaffold_100005	18026108	18033510	7402	g_24790	g_24791
Super-Scaffold_100005	18042033	18044556	2523	g_24791	g_24792
Super-Scaffold_100005	18044951	18051363	6412	g_24792	g_24793
Super-Scaffold_100005	18057022	18057705	683	g_24793	g_24794
Super-Scaffold_100005	18058502	18060554	2052	g_24794	g_24795
Super-Scaffold_100005	18068265	18070673	2408	g_24795	g_24796
Super-Scaffold_100005	18077520	18080113	2593	g_24796	g_24797
Super-Scaffold_100005	18083376	18084971	1595	g_24797	g_44925
Super-Scaffold_100005	18090180	18091171	991	g_44925	g_24798
Super-Scaffold_100005	18094462	18095493	1031	g_24798	g_44926
Super-Scaffold_100005	18096397	18103689	7292	g_44926	g_24800
Super-Scaffold_100005	18104025	18104283	258	g_24800	g_24801
Super-Scaffold_100005	18105774	18108244	2470	g_24801	g_24799
Super-Scaffold_100005	18124112	18129857	5745	g_24799	g_24802
Super-Scaffold_100005	18199546	18203569	4023	g_24802	g_24803
Super-Scaffold_100005	18206413	18244123	37710	g_24803	g_40294
Super-Scaffold_100005	18244344	18251130	6786	g_40294	g_24806
Super-Scaffold_100005	18252089	18262236	10147	g_24806	g_24807
Super-Scaffold_100005	18263441	18265484	2043	g_24807	g_24808
Super-Scaffold_100005	18301135	18302925	1790	g_24808	g_24809
Super-Scaffold_100005	18318952	18339435	20483	g_24809	g_24810
Super-Scaffold_100005	18356594	18361129	4535	g_24810	g_24811
Super-Scaffold_100005	18365015	18369849	4834	g_24811	g_24812
Super-Scaffold_100005	18371822	18540601	168779	g_24812	g_24817
Super-Scaffold_100005	18540882	18785136	244254	g_24817	g_24820
Super-Scaffold_100005	18790086	18812762	22676	g_24820	g_24821
Super-Scaffold_100005	18813799	18859027	45228	g_24821	g_24822
Super-Scaffold_100005	18883339	18927996	44657	g_24822	g_24823
Super-Scaffold_100005	18935637	18941485	5848	g_24823	g_24824
Super-Scaffold_100005	18943227	18948610	5383	g_24824	g_24825
Super-Scaffold_100005	18967401	18978240	10839	g_24825	g_24826
Super-Scaffold_100005	18979747	19009733	29986	g_24826	g_24827
Super-Scaffold_100005	19031330	19038448	7118	g_24827	g_24828
Super-Scaffold_100005	19049022	19059605	10583	g_24828	g_24829
Super-Scaffold_100005	19068691	19071436	2745	g_24829	g_44927
Super-Scaffold_100005	19074985	19082033	7048	g_44927	g_24830
Super-Scaffold_100005	19090092	19098339	8247	g_24830	g_24831
Super-Scaffold_100005	19118436	19122002	3566	g_24831	g_40299
Super-Scaffold_100005	19122223	19142621	20398	g_40299	g_24832
Super-Scaffold_100005	19145269	19147414	2145	g_24832	g_24833
Super-Scaffold_100005	19147653	19208824	61171	g_24833	g_24834
Super-Scaffold_100005	19227772	19256460	28688	g_24834	g_24836
Super-Scaffold_100005	19267811	19269926	2115	g_24836	g_24837
Super-Scaffold_100005	19280750	19285787	5037	g_24837	g_24838
Super-Scaffold_100005	19286005	19286037	32	g_24838	g_44928
Super-Scaffold_100005	19290248	19291309	1061	g_44928	g_44929
Super-Scaffold_100005	19300881	19302952	2071	g_44929	g_24839
Super-Scaffold_100005	19308677	19309655	978	g_24839	g_44930
Super-Scaffold_100005	19315261	19318257	2996	g_44930	g_40300
Super-Scaffold_100005	19322203	19359323	37120	g_24840	g_24842
Super-Scaffold_100005	19361000	19387116	26116	g_24843	g_24846
Super-Scaffold_100005	19403338	19424588	21250	g_24846	g_24847
Super-Scaffold_100005	19446067	19472929	26862	g_24847	g_24848
Super-Scaffold_100005	19477976	19486141	8165	g_24848	g_24849
Super-Scaffold_100005	19491669	19493550	1881	g_24849	g_24850
Super-Scaffold_100005	19495280	19498355	3075	g_24850	g_24851
Super-Scaffold_100005	19504551	19518983	14432	g_24851	g_24852
Super-Scaffold_100005	19523960	19524661	701	g_24852	g_44931
Super-Scaffold_100005	19536735	19542916	6181	g_44931	g_24853
Super-Scaffold_100005	19543170	19546306	3136	g_24853	g_24854
Super-Scaffold_100005	19569730	19575993	6263	g_24854	g_24855
Super-Scaffold_100005	19578254	19583150	4896	g_24855	g_24856
Super-Scaffold_100005	19583653	19593559	9906	g_24856	g_24857
Super-Scaffold_100005	19609207	19639901	30694	g_24857	g_24858
Super-Scaffold_100005	19640309	19705794	65485	g_24858	g_24860
Super-Scaffold_100005	19706636	19797716	91080	g_24860	g_40302
Super-Scaffold_100005	19797916	19845604	47688	g_40302	g_24863
Super-Scaffold_100005	19845843	20180688	334845	g_24863	g_24868
Super-Scaffold_100005	20182025	20218179	36154	g_24868	g_24869
Super-Scaffold_100005	20231044	20232705	1661	g_24869	g_24870
Super-Scaffold_100005	20234859	20237649	2790	g_24870	g_24871
Super-Scaffold_100005	20239964	20241968	2004	g_24871	g_24872
Super-Scaffold_100005	20244361	20246798	2437	g_24872	g_24873
Super-Scaffold_100005	20247250	20247826	576	g_24873	g_24874
Super-Scaffold_100005	20248695	20249072	377	g_24874	g_24875
Super-Scaffold_100005	20249335	20252227	2892	g_24875	g_44932
Super-Scaffold_100005	20256560	20264985	8425	g_44932	g_24876
Super-Scaffold_100005	20274402	20282294	7892	g_24876	g_24877
Super-Scaffold_100005	20290566	20295402	4836	g_24877	g_24878
Super-Scaffold_100005	20301397	20304205	2808	g_24878	g_24879
Super-Scaffold_100005	20310726	20359531	48805	g_24879	g_24880
Super-Scaffold_100005	20364218	20365456	1238	g_24880	g_24881
Super-Scaffold_100005	20366901	20370293	3392	g_24881	g_24882
Super-Scaffold_100005	20379627	20386986	7359	g_24882	g_24883
Super-Scaffold_100005	20408325	20427344	19019	g_24883	g_40305
Super-Scaffold_100005	20427976	20525688	97712	g_40305	g_24885
Super-Scaffold_100005	20525990	20576433	50443	g_24885	g_24888
Super-Scaffold_100005	20578678	20583577	4899	g_24888	g_24889
Super-Scaffold_100005	20594516	20599976	5460	g_24889	g_24890
Super-Scaffold_100005	20608321	20609821	1500	g_24890	g_24891
Super-Scaffold_100005	20610045	20613537	3492	g_24891	g_24892
Super-Scaffold_100005	20613758	20626002	12244	g_24892	g_40307
Super-Scaffold_100005	20626313	20635033	8720	g_40307	g_24895
Super-Scaffold_100005	20655789	20673211	17422	g_24895	g_24896
Super-Scaffold_100005	20674570	20677142	2572	g_24896	g_24897
Super-Scaffold_100005	20698527	20700268	1741	g_24897	g_24898
Super-Scaffold_100005	20701314	20703589	2275	g_24898	g_24899
Super-Scaffold_100005	20718753	20783191	64438	g_24899	g_24901
Super-Scaffold_100005	20792620	20795437	2817	g_24901	g_44933
Super-Scaffold_100005	20816647	20849186	32539	g_44933	g_24902
Super-Scaffold_100005	20863587	20940088	76501	g_24902	g_24904
Super-Scaffold_100005	20942027	20973900	31873	g_24904	g_24905
Super-Scaffold_100005	20991897	21011791	19894	g_40312	g_24906
Super-Scaffold_100005	21014467	21020048	5581	g_24906	g_24907
Super-Scaffold_100005	21109537	21138975	29438	g_24907	g_24908
Super-Scaffold_100005	21139214	21215628	76414	g_24908	g_24909
Super-Scaffold_100005	21216887	21220145	3258	g_24909	g_24910
Super-Scaffold_100005	21221176	21224929	3753	g_24910	g_44934
Super-Scaffold_100005	21227021	21229420	2399	g_44934	g_24911
Super-Scaffold_100005	21235295	21237806	2511	g_24911	g_24912
Super-Scaffold_100005	21250785	21269772	18987	g_24912	g_24913
Super-Scaffold_100005	21273738	21340622	66884	g_24913	g_24914
Super-Scaffold_100005	21343828	21344849	1021	g_24914	g_24915
Super-Scaffold_100005	21347798	21383975	36177	g_24915	g_24916
Super-Scaffold_100005	21391447	21406900	15453	g_24916	g_24918
Super-Scaffold_100005	21410589	21421818	11229	g_24918	g_24919
Super-Scaffold_100005	21427549	21430686	3137	g_24919	g_44935
Super-Scaffold_100005	21434961	21438745	3784	g_44935	g_24920
Super-Scaffold_100005	21439595	21493281	53686	g_24920	g_40317
Super-Scaffold_100005	21494222	21960236	466014	g_40317	g_24928
Super-Scaffold_100005	21965532	21967939	2407	g_24928	g_24929
Super-Scaffold_100005	21969329	21970578	1249	g_24929	g_44936
Super-Scaffold_100005	21981616	21982979	1363	g_44936	g_24930
Super-Scaffold_100005	21986346	21988699	2353	g_24930	g_24931
Super-Scaffold_100005	21991270	21993335	2065	g_24931	g_24932
Super-Scaffold_100005	21998052	22002125	4073	g_24932	g_24933
Super-Scaffold_100005	22003235	22005825	2590	g_24933	g_24934
Super-Scaffold_100005	22007075	22009159	2084	g_24934	g_24935
Super-Scaffold_100005	22013955	22018324	4369	g_24935	g_24936
Super-Scaffold_100005	22025329	22030480	5151	g_24936	g_24937
Super-Scaffold_100005	22032702	22034000	1298	g_24937	g_24938
Super-Scaffold_100005	22040585	22042491	1906	g_24938	g_24939
Super-Scaffold_100005	22043229	22044697	1468	g_24939	g_24940
Super-Scaffold_100005	22046492	22050636	4144	g_24940	g_24941
Super-Scaffold_100005	22056051	22059765	3714	g_24941	g_44937
Super-Scaffold_100005	22067269	22079822	12553	g_44937	g_24942
Super-Scaffold_100005	22081527	22102349	20822	g_24942	g_24943
Super-Scaffold_100005	22122577	22126852	4275	g_24943	g_24944
Super-Scaffold_100005	22132847	22137986	5139	g_24944	g_24945
Super-Scaffold_100005	22141937	22145622	3685	g_24945	g_24946
Super-Scaffold_100005	22149194	22153021	3827	g_24946	g_24947
Super-Scaffold_100005	22158904	22164244	5340	g_24947	g_24948
Super-Scaffold_100005	22173634	22179905	6271	g_24948	g_44938
Super-Scaffold_100005	22183155	22185181	2026	g_44938	g_44939
Super-Scaffold_100005	22188010	22192619	4609	g_44939	g_24949
Super-Scaffold_100005	22201189	22206042	4853	g_24949	g_24950
Super-Scaffold_100005	22216790	22252885	36095	g_24950	g_24952
Super-Scaffold_100005	22279835	22298762	18927	g_24952	g_24953
Super-Scaffold_100005	22299655	22311419	11764	g_24953	g_24954
Super-Scaffold_100005	22315920	22317520	1600	g_24954	g_24955
Super-Scaffold_100005	22343521	22347564	4043	g_24955	g_24956
Super-Scaffold_100005	22394851	22456380	61529	g_24956	g_24958
Super-Scaffold_100005	22457444	22504382	46938	g_24958	g_40326
Super-Scaffold_100005	22504795	22512723	7928	g_40326	g_24959
Super-Scaffold_100005	22513907	22617544	103637	g_24959	g_24960
Super-Scaffold_100005	22623537	22628634	5097	g_24960	g_44940
Super-Scaffold_100005	22634554	22639888	5334	g_44940	g_24961
Super-Scaffold_100005	22644539	22650050	5511	g_24961	g_24962
Super-Scaffold_100005	22657705	22660759	3054	g_24962	g_24963
Super-Scaffold_100005	22661382	22664895	3513	g_24963	g_24964
Super-Scaffold_100005	22673421	22684953	11532	g_24964	g_24965
Super-Scaffold_100005	22685411	22700569	15158	g_24965	g_24966
Super-Scaffold_100005	22703181	22709993	6812	g_24966	g_24967
Super-Scaffold_100005	22710208	22711494	1286	g_24967	g_24968
Super-Scaffold_100005	22712147	22725013	12866	g_24968	g_24970
Super-Scaffold_100005	22730897	22736147	5250	g_24970	g_24971
Super-Scaffold_100005	22739926	22745950	6024	g_24971	g_24972
Super-Scaffold_100005	22746279	22746392	113	g_24972	g_24973
Super-Scaffold_100005	22767439	22773806	6367	g_24973	g_24974
Super-Scaffold_100005	22780612	22785090	4478	g_24974	g_24975
Super-Scaffold_100005	22786688	22789863	3175	g_24975	g_24976
Super-Scaffold_100005	22791005	22796079	5074	g_24976	g_24977
Super-Scaffold_100005	22796597	22801578	4981	g_24977	g_24978
Super-Scaffold_100005	22806769	22817335	10566	g_24978	g_24979
Super-Scaffold_100005	22837404	22870308	32904	g_24979	g_24980
Super-Scaffold_100005	22873439	22878897	5458	g_24980	g_24982
Super-Scaffold_100005	22879310	22935191	55881	g_24982	g_24985
Super-Scaffold_100005	22937917	22939236	1319	g_24985	g_24986
Super-Scaffold_100005	22945622	22947386	1764	g_24986	g_24987
Super-Scaffold_100005	22952464	22954593	2129	g_24987	g_24988
Super-Scaffold_100005	22983638	23051487	67849	g_24988	g_24989
Super-Scaffold_100005	23055195	23098537	43342	g_24989	g_24990
Super-Scaffold_100005	23100114	23107937	7823	g_24990	g_24991
Super-Scaffold_100005	23109901	23113664	3763	g_24991	g_24992
Super-Scaffold_100005	23116765	23121699	4934	g_24992	g_24993
Super-Scaffold_100005	23126731	23175009	48278	g_24993	g_40330
Super-Scaffold_100005	23175742	23279866	104124	g_40330	g_24995
Super-Scaffold_100005	23283841	23296391	12550	g_24995	g_24996
Super-Scaffold_100005	23303678	23315559	11881	g_24996	g_24997
Super-Scaffold_100005	23319967	23340769	20802	g_24997	g_40331
Super-Scaffold_100005	23340984	23370545	29561	g_40331	g_24999
Super-Scaffold_100005	23381304	23387214	5910	g_24999	g_25000
Super-Scaffold_100005	23389018	23402602	13584	g_25000	g_25001
Super-Scaffold_100005	23402823	23405972	3149	g_25001	g_25002
Super-Scaffold_100005	23408478	23410101	1623	g_25002	g_25003
Super-Scaffold_100005	23413841	23416094	2253	g_25003	g_25004
Super-Scaffold_100005	23420918	23422378	1460	g_25004	g_25005
Super-Scaffold_100005	23424897	23428048	3151	g_25005	g_25006
Super-Scaffold_100005	23432103	23433583	1480	g_25006	g_44941
Super-Scaffold_100005	23449093	23452601	3508	g_44941	g_44942
Super-Scaffold_100005	23459580	23471600	12020	g_44942	g_25007
Super-Scaffold_100005	23480092	23486668	6576	g_25007	g_25009
Super-Scaffold_100005	23488679	23489155	476	g_25009	g_25010
Super-Scaffold_100005	23493904	23496765	2861	g_25010	g_44943
Super-Scaffold_100005	23499278	23500753	1475	g_44943	g_25011
Super-Scaffold_100005	23501966	23505060	3094	g_25011	g_44944
Super-Scaffold_100005	23509206	23510027	821	g_44944	g_25012
Super-Scaffold_100005	23512144	23517634	5490	g_25012	g_25013
Super-Scaffold_100005	23522147	23524424	2277	g_25013	g_25014
Super-Scaffold_100005	23543074	23553285	10211	g_25014	g_25015
Super-Scaffold_100005	23558574	23560395	1821	g_25015	g_44945
Super-Scaffold_100005	23566908	23584431	17523	g_44945	g_25016
Super-Scaffold_100005	23602349	23604695	2346	g_25016	g_25017
Super-Scaffold_100005	23620892	23632954	12062	g_25017	g_25019
Super-Scaffold_100005	23639371	23644926	5555	g_40335	g_25020
Super-Scaffold_100005	23647409	23648963	1554	g_25020	g_25021
Super-Scaffold_100005	23656963	23657726	763	g_25021	g_25022
Super-Scaffold_100005	23660046	23660167	121	g_25022	g_25023
Super-Scaffold_100005	23674454	23681288	6834	g_25023	g_40336
Super-Scaffold_100005	23681581	23714906	33325	g_40336	g_25026
Super-Scaffold_100005	23716624	23718891	2267	g_25026	g_25027
Super-Scaffold_100005	23719226	23729945	10719	g_25027	g_25028
Super-Scaffold_100005	23730829	23736250	5421	g_25028	g_25029
Super-Scaffold_100005	23737167	23743902	6735	g_25029	g_25030
Super-Scaffold_100005	23744768	23750851	6083	g_25030	g_25031
Super-Scaffold_100005	23751738	23754194	2456	g_25031	g_25032
Super-Scaffold_100005	23757337	23758482	1145	g_25032	g_44946
Super-Scaffold_100005	23762757	23765889	3132	g_44946	g_25033
Super-Scaffold_100005	23767519	23769772	2253	g_25033	g_25034
Super-Scaffold_100005	23775806	23777497	1691	g_25034	g_25035
Super-Scaffold_100005	23791165	23791987	822	g_25035	g_25036
Super-Scaffold_100005	23815898	23816920	1022	g_25036	g_44947
Super-Scaffold_100005	23824311	23832781	8470	g_44947	g_25037
Super-Scaffold_100005	23834897	23839082	4185	g_25037	g_25038
Super-Scaffold_100005	23842834	23848996	6162	g_25038	g_25039
Super-Scaffold_100005	23854148	23857355	3207	g_25039	g_25040
Super-Scaffold_100005	23857639	23857745	106	g_25040	g_25041
Super-Scaffold_100005	23876644	23884903	8259	g_25041	g_25042
Super-Scaffold_100005	23890836	23896494	5658	g_25042	g_25043
Super-Scaffold_100005	23903961	23911075	7114	g_25043	g_25044
Super-Scaffold_100005	23926116	23930787	4671	g_25044	g_25045
Super-Scaffold_100005	23935694	23950605	14911	g_25045	g_44948
Super-Scaffold_100005	23952051	24074315	122264	g_44948	g_25050
Super-Scaffold_100005	24084329	24098600	14271	g_25050	g_25051
Super-Scaffold_100005	24122260	24125409	3149	g_25051	g_44949
Super-Scaffold_100005	24129563	24161347	31784	g_44949	g_25052
Super-Scaffold_100005	24167056	24170316	3260	g_25052	g_25053
Super-Scaffold_100005	24183106	24190516	7410	g_25053	g_25054
Super-Scaffold_100005	24207594	24245946	38352	g_25054	g_25055
Super-Scaffold_100005	24260457	24265457	5000	g_25057	g_25058
Super-Scaffold_100005	24267564	24281008	13444	g_25058	g_25059
Super-Scaffold_100005	24282933	24288205	5272	g_25059	g_44950
Super-Scaffold_100005	24291577	24297235	5658	g_44950	g_25060
Super-Scaffold_100005	24299132	24301827	2695	g_25060	g_44951
Super-Scaffold_100005	24306617	24307364	747	g_44951	g_25061
Super-Scaffold_100005	24309051	24314822	5771	g_25061	g_25062
Super-Scaffold_100005	24317299	24318791	1492	g_25062	g_25063
Super-Scaffold_100005	24320586	24322684	2098	g_25063	g_25064
Super-Scaffold_100005	24334314	24336471	2157	g_25064	g_44952
Super-Scaffold_100005	24341915	24343568	1653	g_44952	g_44953
Super-Scaffold_100005	24345376	24346799	1423	g_44953	g_44954
Super-Scaffold_100005	24350175	24353832	3657	g_44954	g_25065
Super-Scaffold_100005	24358530	24441798	83268	g_25065	g_25067
Super-Scaffold_100005	24456855	24538192	81337	g_25067	g_25069
Super-Scaffold_100005	24561662	24583744	22082	g_25069	g_25070
Super-Scaffold_100005	24584064	24601671	17607	g_25070	g_25072
Super-Scaffold_100005	24601946	24621099	19153	g_25072	g_25073
Super-Scaffold_100005	24621884	24751301	129417	g_25073	g_25077
Super-Scaffold_100005	24753177	24805959	52782	g_25077	g_25078
Super-Scaffold_100005	24808123	24839469	31346	g_25078	g_25079
Super-Scaffold_100005	24845291	24865154	19863	g_25079	g_25080
Super-Scaffold_100005	24870746	24874851	4105	g_25080	g_25081
Super-Scaffold_100005	24882627	24887658	5031	g_25081	g_25082
Super-Scaffold_100005	24895699	24899471	3772	g_25082	g_44955
Super-Scaffold_100005	24901311	24911889	10578	g_44955	g_25083
Super-Scaffold_100005	24921711	24926221	4510	g_25083	g_25084
Super-Scaffold_100005	24953229	24960513	7284	g_25084	g_25085
Super-Scaffold_100005	24998413	25234020	235607	g_25085	g_40350
Super-Scaffold_100005	25234232	25296819	62587	g_40350	g_25092
Super-Scaffold_100005	25298338	25298770	432	g_25092	g_25093
Super-Scaffold_100005	25299192	25299265	73	g_25093	g_25094
Super-Scaffold_100005	25300086	25300160	74	g_25094	g_25095
Super-Scaffold_100005	25300378	25301939	1561	g_25095	g_25096
Super-Scaffold_100005	25314081	25468917	154836	g_25096	g_25097
Super-Scaffold_100005	25469183	25658119	188936	g_25097	g_25098
Super-Scaffold_100005	25660631	25679514	18883	g_25098	g_25099
Super-Scaffold_100005	25697445	25719565	22120	g_25099	g_25100
Super-Scaffold_100005	25722303	25724097	1794	g_25100	g_25101
Super-Scaffold_100005	25727639	25734307	6668	g_25101	g_25102
Super-Scaffold_100005	25740127	25742753	2626	g_25102	g_25103
Super-Scaffold_100005	25757408	25761745	4337	g_25103	g_25104
Super-Scaffold_100005	25767599	25770439	2840	g_25104	g_25105
Super-Scaffold_100005	25782830	25785687	2857	g_25105	g_44956
Super-Scaffold_100005	25789509	25790771	1262	g_44956	g_25106
Super-Scaffold_100005	25794138	25794824	686	g_25106	g_25107
Super-Scaffold_100005	25796503	25800474	3971	g_25107	g_44957
Super-Scaffold_100005	25809746	25829476	19730	g_44957	g_25108
Super-Scaffold_100005	25835633	25840175	4542	g_25108	g_25109
Super-Scaffold_100005	25843210	25867873	24663	g_25109	g_25110
Super-Scaffold_100005	25884359	25895040	10681	g_25110	g_25111
Super-Scaffold_100005	25906487	25915693	9206	g_25111	g_25112
Super-Scaffold_100005	25918533	25920653	2120	g_25112	g_25113
Super-Scaffold_100005	25936334	25937365	1031	g_25113	g_25114
Super-Scaffold_100005	25940359	25942230	1871	g_25114	g_25115
Super-Scaffold_100005	25945053	25949153	4100	g_25115	g_25116
Super-Scaffold_100005	25952028	25953784	1756	g_25116	g_25117
Super-Scaffold_100005	25958546	25959154	608	g_25117	g_25118
Super-Scaffold_100005	25966807	25967518	711	g_25118	g_25119
Super-Scaffold_100005	25971076	25975383	4307	g_25119	g_25120
Super-Scaffold_100005	25975847	25977728	1881	g_25120	g_25121
Super-Scaffold_100005	25984697	25991090	6393	g_25121	g_25122
Super-Scaffold_100005	25996794	25999318	2524	g_25122	g_25123
Super-Scaffold_100005	26008065	26010697	2632	g_25123	g_25124
Super-Scaffold_100005	26023846	26029500	5654	g_25124	g_25125
Super-Scaffold_100005	26029838	26034637	4799	g_25125	g_25126
Super-Scaffold_100005	26053122	26063884	10762	g_25126	g_25127
Super-Scaffold_100005	26069975	26079016	9041	g_25127	g_25128
Super-Scaffold_100005	26085140	26109029	23889	g_25128	g_25129
Super-Scaffold_100005	26114623	26138180	23557	g_25129	g_25130
Super-Scaffold_100005	26150011	26155496	5485	g_25130	g_25131
Super-Scaffold_100005	26160818	26162878	2060	g_25131	g_25132
Super-Scaffold_100005	26168481	26170173	1692	g_25132	g_25133
Super-Scaffold_100005	26171557	26222809	51252	g_25133	g_25136
Super-Scaffold_100005	26223063	26227301	4238	g_25136	g_25137
Super-Scaffold_100005	26258246	26262483	4237	g_25137	g_25138
Super-Scaffold_100005	26269229	26273083	3854	g_25138	g_25139
Super-Scaffold_100005	26275345	26279181	3836	g_25139	g_25140
Super-Scaffold_100005	26301634	26304499	2865	g_25140	g_44958
Super-Scaffold_100005	26309869	26376494	66625	g_44958	g_25142
Super-Scaffold_100005	26376709	26382101	5392	g_25142	g_25143
Super-Scaffold_100005	26387569	26388869	1300	g_25143	g_44959
Super-Scaffold_100005	26401115	26414527	13412	g_44959	g_40357
Super-Scaffold_100005	26414760	26422552	7792	g_40357	g_25144
Super-Scaffold_100005	26433680	26441183	7503	g_25144	g_25145
Super-Scaffold_100005	26441566	26443176	1610	g_25145	g_25146
Super-Scaffold_100005	26510299	26511869	1570	g_25146	g_25147
Super-Scaffold_100005	26515111	26516593	1482	g_25147	g_44960
Super-Scaffold_100005	26518145	26522492	4347	g_44960	g_44961
Super-Scaffold_100005	26525044	26528622	3578	g_44961	g_25148
Super-Scaffold_100005	26533760	26681475	147715	g_25148	g_25149
Super-Scaffold_100005	26681840	26789751	107911	g_25149	g_25151
Super-Scaffold_100005	26790263	26964878	174615	g_25151	g_25153
Super-Scaffold_100005	26965093	26988285	23192	g_25153	g_25154
Super-Scaffold_100005	26989034	27043268	54234	g_25154	g_25155
Super-Scaffold_100005	27044205	27046582	2377	g_25155	g_25156
Super-Scaffold_100005	27048925	27059036	10111	g_25156	g_40362
Super-Scaffold_100005	27059320	27066035	6715	g_40362	g_25158
Super-Scaffold_100005	27067624	27130362	62738	g_25158	g_25161
Super-Scaffold_100005	27146865	27161100	14235	g_25161	g_25162
Super-Scaffold_100005	27163274	27164187	913	g_25162	g_25163
Super-Scaffold_100005	27166756	27203866	37110	g_25163	g_25164
Super-Scaffold_100005	27224863	27270652	45789	g_25164	g_25166
Super-Scaffold_100005	27292384	27309091	16707	g_25166	g_25167
Super-Scaffold_100005	27316589	27318446	1857	g_25167	g_25168
Super-Scaffold_100005	27327124	27328139	1015	g_25168	g_25169
Super-Scaffold_100005	27353368	27353992	624	g_25169	g_25170
Super-Scaffold_100005	27354273	27357150	2877	g_25170	g_25171
Super-Scaffold_100005	27374113	27375063	950	g_25171	g_25172
Super-Scaffold_100005	27377487	27379113	1626	g_25172	g_25173
Super-Scaffold_100005	27382699	27389803	7104	g_25173	g_25174
Super-Scaffold_100005	27403703	27410520	6817	g_25174	g_25175
Super-Scaffold_100005	27415896	27422133	6237	g_25175	g_25176
Super-Scaffold_100005	27430338	27445001	14663	g_25176	g_25177
Super-Scaffold_100005	27461697	27471619	9922	g_25177	g_25178
Super-Scaffold_100005	27472299	27475185	2886	g_25178	g_40364
Super-Scaffold_100005	27475463	27627992	152529	g_40364	g_25182
Super-Scaffold_100005	27632099	27633006	907	g_25182	g_25183
Super-Scaffold_100005	27639279	27641189	1910	g_25183	g_44962
Super-Scaffold_100005	27656476	27659036	2560	g_44962	g_25184
Super-Scaffold_100005	27660995	27744396	83401	g_25184	g_25187
Super-Scaffold_100005	27753053	27875189	122136	g_25187	g_25188
Super-Scaffold_100005	27875479	27877296	1817	g_40367	g_25189
Super-Scaffold_100005	27877706	27878027	321	g_25189	g_25190
Super-Scaffold_100005	27880584	27912267	31683	g_25190	g_25191
Super-Scaffold_100005	27937379	27940743	3364	g_25191	g_25192
Super-Scaffold_100005	27949963	27956627	6664	g_25193	g_25194
Super-Scaffold_100005	27958623	28014097	55474	g_25194	g_25196
Super-Scaffold_100005	28016367	28058686	42319	g_25196	g_40368
Super-Scaffold_100005	28058982	28080525	21543	g_40368	g_25200
Super-Scaffold_100005	28096673	28099860	3187	g_25200	g_25201
Super-Scaffold_100005	28105156	28119997	14841	g_25201	g_25202
Super-Scaffold_100005	28130236	28212334	82098	g_25202	g_25204
Super-Scaffold_100005	28237474	28315004	77530	g_25204	g_25206
Super-Scaffold_100005	28315264	28323834	8570	g_25206	g_25207
Super-Scaffold_100005	28324079	28353421	29342	g_25207	g_40372
Super-Scaffold_100005	28353630	28372911	19281	g_40372	g_25208
Super-Scaffold_100005	28373141	28381713	8572	g_25208	g_25209
Super-Scaffold_100005	28381961	28390676	8715	g_25209	g_25210
Super-Scaffold_100005	28390912	28421926	31014	g_25210	g_25211
Super-Scaffold_100005	28436591	28443249	6658	g_25211	g_25213
Super-Scaffold_100005	28452601	28484392	31791	g_25213	g_25214
Super-Scaffold_100005	28501825	28503464	1639	g_25214	g_25215
Super-Scaffold_100005	28510502	28564757	54255	g_25215	g_25217
Super-Scaffold_100005	28566772	28575617	8845	g_25217	g_25218
Super-Scaffold_100005	28577393	28578134	741	g_25218	g_25219
Super-Scaffold_100005	28579099	28620430	41331	g_25219	g_25221
Super-Scaffold_100005	28623732	28634609	10877	g_25221	g_25222
Super-Scaffold_100005	28653187	28654456	1269	g_25222	g_44963
Super-Scaffold_100005	28656247	28666312	10065	g_44963	g_25223
Super-Scaffold_100005	28673887	28688611	14724	g_25223	g_25225
Super-Scaffold_100005	28691508	28691896	388	g_25225	g_25226
Super-Scaffold_100005	28693485	28725260	31775	g_25226	g_25228
Super-Scaffold_100005	28725496	28752131	26635	g_25228	g_25229
Super-Scaffold_100005	28783630	28893414	109784	g_25229	g_25231
Super-Scaffold_100005	28897637	28899591	1954	g_25231	g_25232
Super-Scaffold_100005	28912591	28914899	2308	g_25232	g_44964
Super-Scaffold_100005	28920146	28953746	33600	g_44964	g_25233
Super-Scaffold_100005	28968401	28970071	1670	g_25233	g_25234
Super-Scaffold_100005	28985017	29004368	19351	g_25234	g_44965
Super-Scaffold_100005	29007366	29019927	12561	g_44965	g_25236
Super-Scaffold_100005	29023403	29038993	15590	g_25236	g_40378
Super-Scaffold_100005	29039247	29039381	134	g_40378	g_25237
Super-Scaffold_100005	29040076	29082173	42097	g_25237	g_25238
Super-Scaffold_100005	29083072	29114774	31702	g_25238	g_25240
Super-Scaffold_100005	29180708	29201073	20365	g_25240	g_25242
Super-Scaffold_100005	29201408	29201522	114	g_25242	g_25243
Super-Scaffold_100005	29201987	29313173	111186	g_25243	g_25246
Super-Scaffold_100005	29434565	29476323	41758	g_25246	g_25247
Super-Scaffold_100005	29490736	29493595	2859	g_25247	g_25248
Super-Scaffold_100005	29497969	29536805	38836	g_25248	g_25250
Super-Scaffold_100005	29552167	29597905	45738	g_25250	g_25251
Super-Scaffold_100005	29621480	29656035	34555	g_25251	g_25252
Super-Scaffold_100005	29662652	29700575	37923	g_25252	g_25255
Super-Scaffold_100005	29715147	29717637	2490	g_25255	g_25256
Super-Scaffold_100005	29722302	29743610	21308	g_25256	g_25257
Super-Scaffold_100005	29762071	29800429	38358	g_25257	g_25259
Super-Scaffold_100005	29803152	29827269	24117	g_25259	g_25261
Super-Scaffold_100005	29858960	29860778	1818	g_25261	g_44966
Super-Scaffold_100005	29875334	29882842	7508	g_44966	g_25262
Super-Scaffold_100005	29897587	29898779	1192	g_25262	g_25263
Super-Scaffold_100005	29900115	29901054	939	g_25263	g_25264
Super-Scaffold_100005	29903769	29906102	2333	g_25264	g_25265
Super-Scaffold_100005	29923801	29929393	5592	g_25265	g_25266
Super-Scaffold_100005	29933006	29934828	1822	g_25266	g_25267
Super-Scaffold_100005	29940657	29969893	29236	g_25267	g_25268
Super-Scaffold_100005	29981385	30018879	37494	g_25268	g_25269
Super-Scaffold_100005	30021432	30026126	4694	g_25269	g_25270
Super-Scaffold_100005	30041437	30044930	3493	g_25270	g_25271
Super-Scaffold_100005	30056513	30065542	9029	g_25271	g_25272
Super-Scaffold_100005	30065775	30086658	20883	g_25272	g_25273
Super-Scaffold_100005	30087304	30136860	49556	g_25273	g_25276
Super-Scaffold_100005	30157484	30183586	26102	g_25276	g_25277
Super-Scaffold_100005	30183846	30235475	51629	g_25277	g_25280
Super-Scaffold_100005	30333352	30336174	2822	g_25280	g_44967
Super-Scaffold_100005	30345208	30375743	30535	g_44967	g_25281
Super-Scaffold_100005	30402491	30416954	14463	g_25281	g_25283
Super-Scaffold_100005	30426263	30441420	15157	g_25283	g_25284
Super-Scaffold_100005	30441686	30487074	45388	g_25284	g_25285
Super-Scaffold_100005	30487415	30493180	5765	g_25285	g_25286
Super-Scaffold_100005	30493521	30498751	5230	g_25286	g_25287
Super-Scaffold_100005	30499377	30537275	37898	g_25287	g_25288
Super-Scaffold_100005	30537553	30542821	5268	g_25288	g_25289
Super-Scaffold_100005	30543270	30619131	75861	g_25289	g_25290
Super-Scaffold_100005	30619382	30681988	62606	g_25290	g_25294
Super-Scaffold_100005	30682350	30684803	2453	g_25294	g_25295
Super-Scaffold_100005	30699538	30717925	18387	g_25295	g_25296
Super-Scaffold_100005	30718296	30753446	35150	g_25296	g_25297
Super-Scaffold_100005	30753922	30756294	2372	g_25297	g_44968
Super-Scaffold_100005	30758760	30790353	31593	g_44968	g_25299
Super-Scaffold_100005	30790589	30790699	110	g_25299	g_25300
Super-Scaffold_100005	30812250	30830624	18374	g_25300	g_25301
Super-Scaffold_100005	30835309	30842387	7078	g_25301	g_25302
Super-Scaffold_100005	30842590	30934245	91655	g_25302	g_25305
Super-Scaffold_100005	30939087	30991290	52203	g_25305	g_25307
Super-Scaffold_100005	31013769	31025966	12197	g_25307	g_25308
Super-Scaffold_100005	31026166	31033143	6977	g_25308	g_25309
Super-Scaffold_100005	31036558	31069595	33037	g_25309	g_25310
Super-Scaffold_100005	31070158	31182051	111893	g_25310	g_25312
Super-Scaffold_100005	31187834	31198320	10486	g_25312	g_25313
Super-Scaffold_100005	31213782	31226754	12972	g_25313	g_25315
Super-Scaffold_100005	31232441	31239440	6999	g_25315	g_25316
Super-Scaffold_100005	31337999	31373244	35245	g_25316	g_25317
Super-Scaffold_100005	31373885	31379761	5876	g_25317	g_44969
Super-Scaffold_100005	31380402	31397563	17161	g_44969	g_44970
Super-Scaffold_100005	31398204	31422441	24237	g_44970	g_25318
Super-Scaffold_100005	31428026	31431609	3583	g_25318	g_25319
Super-Scaffold_100005	31432250	31438367	6117	g_25319	g_25320
Super-Scaffold_100005	31440606	31458683	18077	g_25320	g_25321
Super-Scaffold_100005	31461245	31481571	20326	g_40390	g_25322
Super-Scaffold_100005	31482419	31482493	74	g_25322	g_25323
Super-Scaffold_100005	31483341	31514675	31334	g_25323	g_25324
Super-Scaffold_100005	31516441	31615338	98897	g_25324	g_25327
Super-Scaffold_100005	31637965	31649646	11681	g_25327	g_44971
Super-Scaffold_100005	31657976	31662378	4402	g_44971	g_44972
Super-Scaffold_100005	31694808	31704758	9950	g_44972	g_25328
Super-Scaffold_100005	31726018	31728199	2181	g_25328	g_25329
Super-Scaffold_100005	31733124	31737632	4508	g_25329	g_25330
Super-Scaffold_100005	31749907	31755615	5708	g_25330	g_25331
Super-Scaffold_100005	31773571	31788691	15120	g_25331	g_25332
Super-Scaffold_100005	31803302	31812166	8864	g_25332	g_25333
Super-Scaffold_100005	31818098	31850503	32405	g_25333	g_25335
Super-Scaffold_100005	31850742	31869834	19092	g_25335	g_25336
Super-Scaffold_100005	31890209	31900612	10403	g_25336	g_25337
Super-Scaffold_100005	31911897	31915100	3203	g_25337	g_25338
Super-Scaffold_100005	31924904	31930017	5113	g_25338	g_25339
Super-Scaffold_100005	31942287	31994643	52356	g_25339	g_25341
Super-Scaffold_100005	31998930	32079600	80670	g_25341	g_25342
Super-Scaffold_100005	32093369	32103800	10431	g_25342	g_25343
Super-Scaffold_100005	32106202	32127441	21239	g_25343	g_25344
Super-Scaffold_100005	32127974	32128177	203	g_25344	g_44973
Super-Scaffold_100005	32129080	32159078	29998	g_44973	g_25345
Super-Scaffold_100005	32160148	32185233	25085	g_25345	g_25347
Super-Scaffold_100005	32185538	32235736	50198	g_25347	g_25348
Super-Scaffold_100005	32250388	32278607	28219	g_25348	g_25349
Super-Scaffold_100005	32282791	32325059	42268	g_25349	g_25350
Super-Scaffold_100005	32345029	32347420	2391	g_25350	g_25351
Super-Scaffold_100005	32349000	32358933	9933	g_25351	g_44974
Super-Scaffold_100005	32360513	32368418	7905	g_44974	g_25352
Super-Scaffold_100005	32376474	32379755	3281	g_25352	g_44975
Super-Scaffold_100005	32382986	32403226	20240	g_44975	g_25353
Super-Scaffold_100005	32403438	32412732	9294	g_25353	g_25354
Super-Scaffold_100005	32417105	32419388	2283	g_25354	g_25355
Super-Scaffold_100005	32421264	32438274	17010	g_25355	g_25356
Super-Scaffold_100005	32439676	32450089	10413	g_25356	g_25357
Super-Scaffold_100005	32456788	32529676	72888	g_25357	g_25359
Super-Scaffold_100005	32531435	32538420	6985	g_25359	g_25360
Super-Scaffold_100005	32583288	32609343	26055	g_25360	g_25361
Super-Scaffold_100005	32613838	32621461	7623	g_25361	g_25362
Super-Scaffold_100005	32646181	32647038	857	g_25362	g_25363
Super-Scaffold_100005	32660204	32662929	2725	g_25363	g_25364
Super-Scaffold_100005	32664563	32683322	18759	g_25364	g_25365
Super-Scaffold_100005	32693110	32695216	2106	g_25365	g_25367
Super-Scaffold_100005	32696397	32697830	1433	g_25367	g_25368
Super-Scaffold_100005	32711365	32750272	38907	g_25368	g_25370
Super-Scaffold_100005	32756587	32770513	13926	g_25370	g_25371
Super-Scaffold_100005	32795247	32795555	308	g_25371	g_25372
Super-Scaffold_100005	32795836	32828261	32425	g_25372	g_25373
Super-Scaffold_100005	32845701	32876510	30809	g_25373	g_25375
Super-Scaffold_100005	32876893	32887405	10512	g_25375	g_25376
Super-Scaffold_100005	32887677	32888678	1001	g_25376	g_25377
Super-Scaffold_100005	32888956	32900727	11771	g_25377	g_44976
Super-Scaffold_100005	32912476	33027092	114616	g_44976	g_25380
Super-Scaffold_100005	33029236	33038964	9728	g_25380	g_25381
Super-Scaffold_100005	33041456	33052662	11206	g_25381	g_25382
Super-Scaffold_100005	33054974	33081310	26336	g_25382	g_25384
Super-Scaffold_100005	33083698	33101444	17746	g_25384	g_25385
Super-Scaffold_100005	33101794	33115712	13918	g_25385	g_25386
Super-Scaffold_100005	33123017	33209372	86355	g_25386	g_25389
Super-Scaffold_100005	33245092	33246442	1350	g_25389	g_25391
Super-Scaffold_100005	33251116	33255312	4196	g_25391	g_25392
Super-Scaffold_100005	33255680	33256631	951	g_25392	g_44977
Super-Scaffold_100005	33256849	33267649	10800	g_44977	g_25393
Super-Scaffold_100005	33282499	33314199	31700	g_25393	g_25395
Super-Scaffold_100005	33319617	33370796	51179	g_25395	g_25397
Super-Scaffold_100005	33371593	33425637	54044	g_25397	g_25399
Super-Scaffold_100005	33425879	33470504	44625	g_25399	g_25400
Super-Scaffold_100005	33471085	33497794	26709	g_25400	g_25401
Super-Scaffold_100005	33498778	33498950	172	g_25401	g_25402
Super-Scaffold_100005	33499846	33531519	31673	g_25402	g_25404
Super-Scaffold_100005	33537278	33557837	20559	g_25404	g_25405
Super-Scaffold_100005	33559637	33574550	14913	g_25405	g_25409
Super-Scaffold_100005	33574909	33614496	39587	g_25409	g_25411
Super-Scaffold_100005	33617086	33638752	21666	g_25411	g_25412
Super-Scaffold_100005	33643902	33654266	10364	g_25412	g_44978
Super-Scaffold_100005	33683208	33686686	3478	g_44978	g_25413
Super-Scaffold_100005	33702589	33703016	427	g_25413	g_44979
Super-Scaffold_100005	33718064	33722805	4741	g_44979	g_25414
Super-Scaffold_100005	33726151	33728898	2747	g_25414	g_25415
Super-Scaffold_100005	33742219	33745327	3108	g_25415	g_25416
Super-Scaffold_100005	33748852	33750453	1601	g_25416	g_25417
Super-Scaffold_100005	33762698	33774842	12144	g_25417	g_25419
Super-Scaffold_100005	33775840	33776118	278	g_25419	g_25420
Super-Scaffold_100005	33778099	33811189	33090	g_25420	g_25421
Super-Scaffold_100005	33827388	33858449	31061	g_25421	g_25422
Super-Scaffold_100005	33879177	33900291	21114	g_25422	g_44980
Super-Scaffold_100005	33907808	33914324	6516	g_44980	g_25423
Super-Scaffold_100005	33919854	33932706	12852	g_25423	g_25424
Super-Scaffold_100005	33938933	33957700	18767	g_25424	g_25425
Super-Scaffold_100005	33973925	33977509	3584	g_25425	g_25426
Super-Scaffold_100005	33977943	33985188	7245	g_25426	g_25427
Super-Scaffold_100005	33993612	34060824	67212	g_25427	g_25428
Super-Scaffold_100005	34067251	34083189	15938	g_25428	g_25429
Super-Scaffold_100005	34083437	34085303	1866	g_25429	g_25430
Super-Scaffold_100005	34089951	34096970	7019	g_25430	g_25431
Super-Scaffold_100005	34104798	34108649	3851	g_25431	g_25432
Super-Scaffold_100005	34138232	34139102	870	g_25432	g_40401
Super-Scaffold_100005	34139341	34168460	29119	g_40401	g_25433
Super-Scaffold_100005	34185052	34191163	6111	g_25433	g_25434
Super-Scaffold_100005	34217802	34276538	58736	g_25434	g_25436
Super-Scaffold_100005	34282530	34297626	15096	g_25436	g_25437
Super-Scaffold_100005	34301411	34320759	19348	g_25437	g_25438
Super-Scaffold_100005	34330377	34341201	10824	g_25438	g_44981
Super-Scaffold_100005	34348818	34351069	2251	g_44981	g_25439
Super-Scaffold_100005	34361554	34388076	26522	g_25439	g_25440
Super-Scaffold_100005	34398162	34412921	14759	g_25440	g_25441
Super-Scaffold_100005	34418642	34455680	37038	g_25441	g_25442
Super-Scaffold_100005	34456012	34485882	29870	g_25442	g_25444
Super-Scaffold_100005	34492448	34509709	17261	g_25444	g_40404
Super-Scaffold_100005	34509987	34512294	2307	g_40404	g_25445
Super-Scaffold_100005	34512539	34634810	122271	g_25445	g_25448
Super-Scaffold_100005	34635772	34638036	2264	g_25448	g_25449
Super-Scaffold_100005	34676887	34715367	38480	g_25449	g_25451
Super-Scaffold_100005	34715570	34748920	33350	g_25451	g_25452
Super-Scaffold_100005	34749375	34774666	25291	g_25452	g_25453
Super-Scaffold_100005	34775398	34775437	39	g_25453	g_44982
Super-Scaffold_100005	34778040	34871060	93020	g_44982	g_25454
Super-Scaffold_100005	34883450	34897043	13593	g_25454	g_25455
Super-Scaffold_100005	34911972	34930001	18029	g_25455	g_44983
Super-Scaffold_100005	34944491	34951145	6654	g_44983	g_25456
Super-Scaffold_100005	34964426	34984724	20298	g_25456	g_25457
Super-Scaffold_100005	34985131	35015163	30032	g_25457	g_25458
Super-Scaffold_100005	35016440	35018266	1826	g_25458	g_25459
Super-Scaffold_100005	35018547	35018892	345	g_25459	g_25460
Super-Scaffold_100005	35032023	35045149	13126	g_25460	g_25461
Super-Scaffold_100005	35058361	35072254	13893	g_25461	g_25462
Super-Scaffold_100005	35076037	35211751	135714	g_25462	g_25465
Super-Scaffold_100005	35261891	35285797	23906	g_25465	g_25466
Super-Scaffold_100005	35306069	35313714	7645	g_25466	g_25467
Super-Scaffold_100005	35325776	35342217	16441	g_25467	g_25468
Super-Scaffold_100005	35343812	35384340	40528	g_25468	g_25469
Super-Scaffold_100005	35384555	35391456	6901	g_25469	g_25471
Super-Scaffold_100005	35410714	35415776	5062	g_25471	g_25472
Super-Scaffold_100005	35422595	35423398	803	g_25472	g_25473
Super-Scaffold_100005	35447952	35472601	24649	g_25473	g_25475
Super-Scaffold_100005	35473693	35522035	48342	g_25475	g_25477
Super-Scaffold_100005	35542630	35568268	25638	g_25477	g_25479
Super-Scaffold_100005	35581242	35583792	2550	g_25479	g_25480
Super-Scaffold_100005	35588123	35595889	7766	g_25480	g_25481
Super-Scaffold_100005	35604446	35610972	6526	g_25481	g_25482
Super-Scaffold_100005	35615244	35616068	824	g_25482	g_25483
Super-Scaffold_100005	35631205	35633356	2151	g_25483	g_25484
Super-Scaffold_100005	35646480	35685768	39288	g_25484	g_25486
Super-Scaffold_100005	35685986	35698519	12533	g_25486	g_25487
Super-Scaffold_100005	35698779	35713510	14731	g_25487	g_25488
Super-Scaffold_100005	35713863	35803433	89570	g_25488	g_25489
Super-Scaffold_100005	35803654	35867861	64207	g_25489	g_25491
Super-Scaffold_100005	35868298	35904405	36107	g_25491	g_25492
Super-Scaffold_100005	35909776	35916642	6866	g_25492	g_25493
Super-Scaffold_100005	35916854	35941913	25059	g_25493	g_25494
Super-Scaffold_100005	35944268	35944859	591	g_25494	g_25495
Super-Scaffold_100005	35946373	35957665	11292	g_25495	g_25497
Super-Scaffold_100005	35958135	35958675	540	g_25497	g_25498
Super-Scaffold_100005	35959296	35991090	31794	g_25498	g_25500
Super-Scaffold_100005	35991320	36012006	20686	g_25500	g_25501
Super-Scaffold_100005	36024055	36036025	11970	g_25501	g_25502
Super-Scaffold_100005	36043984	36079764	35780	g_25502	g_25503
Super-Scaffold_100005	36094732	36157105	62373	g_25503	g_25504
Super-Scaffold_100005	36157788	36172859	15071	g_25504	g_44984
Super-Scaffold_100005	36178413	36200395	21982	g_44984	g_25505
Super-Scaffold_100005	36204102	36216014	11912	g_25505	g_25506
Super-Scaffold_100005	36224323	36229772	5449	g_25506	g_25507
Super-Scaffold_100005	36241667	36255431	13764	g_25507	g_25508
Super-Scaffold_100005	36256774	36271124	14350	g_25508	g_25510
Super-Scaffold_100005	36281581	36336106	54525	g_25510	g_25512
Super-Scaffold_100005	36343579	36349342	5763	g_25512	g_44985
Super-Scaffold_100005	36355401	36364644	9243	g_44985	g_25513
Super-Scaffold_100005	36368816	36371898	3082	g_25513	g_25514
Super-Scaffold_100005	36373555	36410963	37408	g_25514	g_25516
Super-Scaffold_100005	36411214	36426092	14878	g_25516	g_25519
Super-Scaffold_100005	36444783	36450631	5848	g_25519	g_44986
Super-Scaffold_100005	36456124	36470433	14309	g_44986	g_25520
Super-Scaffold_100005	36473987	36480396	6409	g_25520	g_44987
Super-Scaffold_100005	36482997	36488536	5539	g_44987	g_25521
Super-Scaffold_100005	36513585	36519848	6263	g_25521	g_25522
Super-Scaffold_100005	36520306	36529481	9175	g_25522	g_25523
Super-Scaffold_100005	36604419	36611761	7342	g_25523	g_25524
Super-Scaffold_100005	36611982	36665392	53410	g_25524	g_25526
Super-Scaffold_100005	36666420	36712409	45989	g_25526	g_25528
Super-Scaffold_100005	36714630	36727543	12913	g_25528	g_44988
Super-Scaffold_100005	36744345	36745872	1527	g_44988	g_25529
Super-Scaffold_100005	36746477	36848947	102470	g_25529	g_25532
Super-Scaffold_100005	36866326	36908727	42401	g_25532	g_25534
Super-Scaffold_100005	36909320	37082112	172792	g_25534	g_25538
Super-Scaffold_100005	37102599	37104629	2030	g_25538	g_25539
Super-Scaffold_100005	37104844	37105687	843	g_25539	g_25540
Super-Scaffold_100005	37114754	37117420	2666	g_25540	g_25541
Super-Scaffold_100005	37131295	37140653	9358	g_25541	g_44989
Super-Scaffold_100005	37177314	37184574	7260	g_44989	g_25542
Super-Scaffold_100005	37185278	37190528	5250	g_25542	g_25543
Super-Scaffold_100005	37199753	37216391	16638	g_25543	g_44990
Super-Scaffold_100005	37223235	37228025	4790	g_44990	g_25544
Super-Scaffold_100005	37228432	37232370	3938	g_25544	g_25545
Super-Scaffold_100005	37247474	37248920	1446	g_25545	g_25546
Super-Scaffold_100005	37257331	37261108	3777	g_25546	g_25548
Super-Scaffold_100005	37267799	37306251	38452	g_25548	g_25550
Super-Scaffold_100005	37313475	37322992	9517	g_25550	g_25551
Super-Scaffold_100005	37325401	37328246	2845	g_25551	g_25552
Super-Scaffold_100005	37345112	37351640	6528	g_25552	g_44991
Super-Scaffold_100005	37357384	37369388	12004	g_44991	g_25553
Super-Scaffold_100005	37370211	37379981	9770	g_25553	g_25554
Super-Scaffold_100005	37387536	37407410	19874	g_25554	g_25557
Super-Scaffold_100005	37425135	37433528	8393	g_25557	g_25558
Super-Scaffold_100005	37435768	37460973	25205	g_25558	g_25560
Super-Scaffold_100005	37461413	37476127	14714	g_25560	g_25561
Super-Scaffold_100005	37476525	37528057	51532	g_25561	g_25565
Super-Scaffold_100005	37528356	37576849	48493	g_25565	g_25566
Super-Scaffold_100005	37590617	37616493	25876	g_25566	g_25567
Super-Scaffold_100005	37616804	37624681	7877	g_25567	g_25568
Super-Scaffold_100005	37624965	37650393	25428	g_25568	g_25571
Super-Scaffold_100005	37650785	37673575	22790	g_25571	g_25573
Super-Scaffold_100005	37673931	37691139	17208	g_25573	g_25575
Super-Scaffold_100005	37698872	37719294	20422	g_25575	g_25576
Super-Scaffold_100005	37720448	37726937	6489	g_25576	g_44992
Super-Scaffold_100005	37730751	37746677	15926	g_44992	g_25577
Super-Scaffold_100005	37747003	37755503	8500	g_25577	g_25578
Super-Scaffold_100005	37778668	37822360	43692	g_25578	g_25581
Super-Scaffold_100005	37822563	37826953	4390	g_25581	g_25582
Super-Scaffold_100005	37827180	37832116	4936	g_25582	g_44993
Super-Scaffold_100005	37832367	37860129	27762	g_44993	g_40425
Super-Scaffold_100005	37860446	37867733	7287	g_40425	g_25583
Super-Scaffold_100005	37868725	37933585	64860	g_25583	g_40426
Super-Scaffold_100005	37933827	38019245	85418	g_40426	g_25587
Super-Scaffold_100005	38028677	38095597	66920	g_25587	g_25594
Super-Scaffold_100005	38095851	38106633	10782	g_25594	g_25596
Super-Scaffold_100005	38107057	38144416	37359	g_40432	g_25597
Super-Scaffold_100005	38144718	38145901	1183	g_25597	g_25598
Super-Scaffold_100005	38146149	38168447	22298	g_25598	g_25599
Super-Scaffold_100005	38171055	38188582	17527	g_25599	g_25600
Super-Scaffold_100005	38189208	38232213	43005	g_25600	g_40434
Super-Scaffold_100005	38233497	38292956	59459	g_25602	g_25603
Super-Scaffold_100005	38295709	38329424	33715	g_25603	g_25604
Super-Scaffold_100005	38330040	38334595	4555	g_25604	g_44994
Super-Scaffold_100005	38334807	38347065	12258	g_44994	g_25605
Super-Scaffold_100005	38351716	38353401	1685	g_25605	g_25606
Super-Scaffold_100005	38355271	38405304	50033	g_25606	g_25607
Super-Scaffold_100005	38408131	38408533	402	g_25607	g_44995
Super-Scaffold_100005	38412202	38427487	15285	g_44995	g_25608
Super-Scaffold_100005	38429186	38434773	5587	g_25608	g_44996
Super-Scaffold_100005	38435291	38436005	714	g_44996	g_40435
Super-Scaffold_100005	38436862	38493943	57081	g_40435	g_25610
Super-Scaffold_100005	38494386	38498468	4082	g_25610	g_25611
Super-Scaffold_100005	38501334	38503467	2133	g_25611	g_25612
Super-Scaffold_100005	38503712	38524380	20668	g_25612	g_25613
Super-Scaffold_100005	38550094	38552740	2646	g_25613	g_44997
Super-Scaffold_100005	38556594	38609695	53101	g_44997	g_25616
Super-Scaffold_100005	38616901	38623355	6454	g_25616	g_25617
Super-Scaffold_100005	38634156	38639800	5644	g_25617	g_25618
Super-Scaffold_100005	38640798	38653309	12511	g_25618	g_25619
Super-Scaffold_100005	38666651	38683483	16832	g_25619	g_25620
Super-Scaffold_100005	38689651	38748217	58566	g_25620	g_25621
Super-Scaffold_100005	38748426	38752456	4030	g_25621	g_25622
Super-Scaffold_100005	38779993	38782898	2905	g_25622	g_25623
Super-Scaffold_100005	38785237	38801263	16026	g_25623	g_25624
Super-Scaffold_100005	38801562	38877368	75806	g_25624	g_25626
Super-Scaffold_100005	38903984	38988871	84887	g_25626	g_25627
Super-Scaffold_100005	38989852	38992749	2897	g_25627	g_40441
Super-Scaffold_100005	38993273	39000577	7304	g_40441	g_25629
Super-Scaffold_100006	44633	50024	5391	g_41861	g_2753
Super-Scaffold_100006	55133	65145	10012	g_2753	g_2754
Super-Scaffold_100006	71607	93438	21831	g_2754	g_2755
Super-Scaffold_100006	93917	98808	4891	g_2755	g_2757
Super-Scaffold_100006	99320	137504	38184	g_2757	g_2759
Super-Scaffold_100006	154542	156251	1709	g_2759	g_2760
Super-Scaffold_100006	156766	163254	6488	g_2760	g_2762
Super-Scaffold_100006	180961	181004	43	g_2762	g_2763
Super-Scaffold_100006	181549	181574	25	g_2763	g_2764
Super-Scaffold_100006	182209	182567	358	g_2764	g_2765
Super-Scaffold_100006	197571	197732	161	g_2765	g_2766
Super-Scaffold_100006	199096	201091	1995	g_2766	g_41863
Super-Scaffold_100006	201375	207564	6189	g_41863	g_2767
Super-Scaffold_100006	253372	258306	4934	g_2767	g_41865
Super-Scaffold_100006	258959	270580	11621	g_41865	g_2770
Super-Scaffold_100006	271059	296565	25506	g_2770	g_2772
Super-Scaffold_100006	327687	2364627	2036940	g_2772	g_2777
Super-Scaffold_100006	2371086	2409584	38498	g_2777	g_2778
Super-Scaffold_100006	2413137	2488658	75521	g_2778	g_2781
Super-Scaffold_100006	2499910	2529488	29578	g_2781	g_2782
Super-Scaffold_100006	2548234	2550255	2021	g_2782	g_2783
Super-Scaffold_100006	2551041	2579703	28662	g_2783	g_2785
Super-Scaffold_100006	2582833	2589912	7079	g_2785	g_2786
Super-Scaffold_100006	2590325	2659648	69323	g_2786	g_2790
Super-Scaffold_100006	2660043	2673874	13831	g_2790	g_2792
Super-Scaffold_100006	2674512	2687753	13241	g_2792	g_2793
Super-Scaffold_100006	2764317	2768711	4394	g_2793	g_2794
Super-Scaffold_100006	2775574	2787826	12252	g_2794	g_2796
Super-Scaffold_100006	2793973	2804967	10994	g_2796	g_2798
Super-Scaffold_100006	2821674	2824698	3024	g_2798	g_2799
Super-Scaffold_100006	2827008	2828815	1807	g_2799	g_2800
Super-Scaffold_100006	2844261	2845793	1532	g_2800	g_2801
Super-Scaffold_100006	2856128	2883911	27783	g_2801	g_2802
Super-Scaffold_100006	2888394	2914754	26360	g_2802	g_2803
Super-Scaffold_100006	2915773	2934653	18880	g_2803	g_2804
Super-Scaffold_100006	2935057	2949756	14699	g_2804	g_2805
Super-Scaffold_100006	2950490	2987820	37330	g_2805	g_2806
Super-Scaffold_100006	2997907	3002494	4587	g_2806	g_2807
Super-Scaffold_100006	3003162	3013299	10137	g_2807	g_2808
Super-Scaffold_100006	3019481	3025422	5941	g_2808	g_2810
Super-Scaffold_100006	3025880	3025928	48	g_2810	g_2811
Super-Scaffold_100006	3029093	3030050	957	g_2811	g_2812
Super-Scaffold_100006	3033658	3080067	46409	g_2812	g_2813
Super-Scaffold_100006	3090495	3091706	1211	g_2813	g_2814
Super-Scaffold_100006	3098875	3115040	16165	g_2814	g_2815
Super-Scaffold_100006	3127826	3189580	61754	g_2815	g_2817
Super-Scaffold_100006	3201613	3205841	4228	g_2817	g_2819
Super-Scaffold_100006	3206332	3223032	16700	g_2819	g_41870
Super-Scaffold_100006	3223238	3250027	26789	g_41870	g_2824
Super-Scaffold_100006	3250530	3252577	2047	g_2824	g_2826
Super-Scaffold_100006	3253771	3255569	1798	g_2826	g_2827
Super-Scaffold_100006	3255907	3255992	85	g_2827	g_2828
Super-Scaffold_100006	3257221	3261540	4319	g_2828	g_2829
Super-Scaffold_100006	3269057	3270514	1457	g_2829	g_2830
Super-Scaffold_100006	3282350	3283969	1619	g_2830	g_2831
Super-Scaffold_100006	3287249	3335464	48215	g_2831	g_2833
Super-Scaffold_100006	3344264	3363755	19491	g_2833	g_2834
Super-Scaffold_100006	3388133	3389344	1211	g_2834	g_2835
Super-Scaffold_100006	3389613	3404418	14805	g_2835	g_2836
Super-Scaffold_100006	3404624	3467013	62389	g_2836	g_2838
Super-Scaffold_100006	3467300	3467393	93	g_2838	g_2839
Super-Scaffold_100006	3467671	3499828	32157	g_2839	g_41874
Super-Scaffold_100006	3500043	3597342	97299	g_41874	g_2843
Super-Scaffold_100006	3597554	3645219	47665	g_2843	g_2845
Super-Scaffold_100006	3657510	3663602	6092	g_2845	g_2846
Super-Scaffold_100006	3669375	3677035	7660	g_2846	g_43079
Super-Scaffold_100006	3680480	3684803	4323	g_43079	g_43080
Super-Scaffold_100006	3688832	3722281	33449	g_43080	g_43081
Super-Scaffold_100006	3724643	3757876	33233	g_43081	g_2848
Super-Scaffold_100006	3766315	3783443	17128	g_2848	g_2850
Super-Scaffold_100006	3786903	3805243	18340	g_2850	g_2851
Super-Scaffold_100006	3806990	3810052	3062	g_2851	g_43082
Super-Scaffold_100006	3814113	3828457	14344	g_43082	g_2852
Super-Scaffold_100006	3831956	3842477	10521	g_2852	g_43083
Super-Scaffold_100006	3844889	3850453	5564	g_43083	g_43084
Super-Scaffold_100006	3855641	3863280	7639	g_43084	g_2853
Super-Scaffold_100006	3866162	3866274	112	g_2853	g_2854
Super-Scaffold_100006	3867309	3876656	9347	g_2854	g_2856
Super-Scaffold_100006	3881971	3903012	21041	g_2856	g_2857
Super-Scaffold_100006	3906486	3907404	918	g_2857	g_43085
Super-Scaffold_100006	3910741	3914036	3295	g_43085	g_43086
Super-Scaffold_100006	3922876	3947526	24650	g_43086	g_2858
Super-Scaffold_100006	3951458	3972934	21476	g_2858	g_43087
Super-Scaffold_100006	3980730	3988362	7632	g_43087	g_43088
Super-Scaffold_100006	3992395	4012951	20556	g_43088	g_2859
Super-Scaffold_100006	4016419	4022326	5907	g_2859	g_43089
Super-Scaffold_100006	4026357	4033153	6796	g_43089	g_2860
Super-Scaffold_100006	4036221	4038678	2457	g_2860	g_43090
Super-Scaffold_100006	4046581	4067362	20781	g_43090	g_2861
Super-Scaffold_100006	4070838	4079500	8662	g_2861	g_2862
Super-Scaffold_100006	4104717	4109052	4335	g_2862	g_2863
Super-Scaffold_100006	4149237	4157617	8380	g_2863	g_2864
Super-Scaffold_100006	4165728	4168781	3053	g_2864	g_2865
Super-Scaffold_100006	4170103	4175230	5127	g_2865	g_43091
Super-Scaffold_100006	4176873	4184476	7603	g_43091	g_2867
Super-Scaffold_100006	4191061	4191607	546	g_2867	g_2868
Super-Scaffold_100006	4197703	4202662	4959	g_2868	g_2869
Super-Scaffold_100006	4217432	4302491	85059	g_2869	g_2875
Super-Scaffold_100006	4302925	4332104	29179	g_2875	g_2876
Super-Scaffold_100006	4332487	4362695	30208	g_2876	g_2878
Super-Scaffold_100006	4362949	4439888	76939	g_2878	g_2882
Super-Scaffold_100006	4460363	4473842	13479	g_2882	g_2883
Super-Scaffold_100006	4475108	4500348	25240	g_2883	g_2884
Super-Scaffold_100006	4501892	4503524	1632	g_2884	g_2885
Super-Scaffold_100006	4505646	4546998	41352	g_2885	g_2886
Super-Scaffold_100006	4554655	4565320	10665	g_2886	g_2887
Super-Scaffold_100006	4565607	4571844	6237	g_2887	g_2888
Super-Scaffold_100006	4580048	4655783	75735	g_2888	g_2892
Super-Scaffold_100006	4669517	4834726	165209	g_2892	g_2893
Super-Scaffold_100006	4835665	4848933	13268	g_2893	g_2894
Super-Scaffold_100006	4851351	4857005	5654	g_2894	g_43092
Super-Scaffold_100006	4857703	4861185	3482	g_43092	g_43093
Super-Scaffold_100006	4864596	4936055	71459	g_43093	g_2896
Super-Scaffold_100006	4937866	4982626	44760	g_2896	g_2897
Super-Scaffold_100006	4994539	4999672	5133	g_2897	g_41885
Super-Scaffold_100006	5006534	5017880	11346	g_41885	g_2898
Super-Scaffold_100006	5029767	5036094	6327	g_2898	g_2900
Super-Scaffold_100006	5044032	5054176	10144	g_2900	g_2901
Super-Scaffold_100006	5054592	5076537	21945	g_2901	g_2905
Super-Scaffold_100006	5076779	5087744	10965	g_2905	g_2906
Super-Scaffold_100006	5098968	5102203	3235	g_2906	g_2907
Super-Scaffold_100006	5111805	5117619	5814	g_2907	g_2908
Super-Scaffold_100006	5119345	5195107	75762	g_2908	g_2909
Super-Scaffold_100006	5208636	5211894	3258	g_2909	g_2910
Super-Scaffold_100006	5216948	5217925	977	g_2910	g_2911
Super-Scaffold_100006	5220122	5222864	2742	g_2911	g_2912
Super-Scaffold_100006	5224484	5454552	230068	g_2912	g_2916
Super-Scaffold_100006	5458596	5463366	4770	g_2916	g_2918
Super-Scaffold_100006	5463674	5469661	5987	g_2918	g_2920
Super-Scaffold_100006	5473951	5558009	84058	g_2920	g_2921
Super-Scaffold_100006	5558239	5570551	12312	g_2921	g_2923
Super-Scaffold_100006	5570940	5580532	9592	g_2923	g_2924
Super-Scaffold_100006	5581290	5769883	188593	g_2924	g_2931
Super-Scaffold_100006	5770878	5785758	14880	g_2931	g_2932
Super-Scaffold_100006	5786021	5799276	13255	g_2932	g_2933
Super-Scaffold_100006	5799527	5812143	12616	g_2933	g_2934
Super-Scaffold_100006	5835286	5841051	5765	g_2934	g_2935
Super-Scaffold_100006	5842082	5884091	42009	g_2935	g_2938
Super-Scaffold_100006	5892591	5929299	36708	g_2938	g_2940
Super-Scaffold_100006	5948541	5968234	19693	g_2940	g_2943
Super-Scaffold_100006	5974166	5990549	16383	g_2943	g_2945
Super-Scaffold_100006	5999457	6019073	19616	g_2945	g_2948
Super-Scaffold_100006	6019834	6020750	916	g_2948	g_43094
Super-Scaffold_100006	6024957	6028902	3945	g_43094	g_2950
Super-Scaffold_100006	6036197	6053628	17431	g_2950	g_2953
Super-Scaffold_100006	6060916	6081286	20370	g_2953	g_2956
Super-Scaffold_100006	6088577	6105917	17340	g_2956	g_2958
Super-Scaffold_100006	6113209	6116449	3240	g_2958	g_43095
Super-Scaffold_100006	6137335	6144761	7426	g_43095	g_2959
Super-Scaffold_100006	6147702	6195173	47471	g_41891	g_2961
Super-Scaffold_100006	6198949	6271508	72559	g_2961	g_2966
Super-Scaffold_100006	6272545	6273310	765	g_2966	g_2967
Super-Scaffold_100006	6281179	6292021	10842	g_2967	g_2969
Super-Scaffold_100006	6304141	6304243	102	g_2969	g_2970
Super-Scaffold_100006	6304512	6306129	1617	g_2970	g_2971
Super-Scaffold_100006	6325997	6329028	3031	g_2971	g_2972
Super-Scaffold_100006	6331477	6334413	2936	g_2972	g_2973
Super-Scaffold_100006	6347738	6350802	3064	g_2973	g_2974
Super-Scaffold_100006	6353227	6354746	1519	g_2974	g_2975
Super-Scaffold_100006	6356708	6364951	8243	g_2975	g_2978
Super-Scaffold_100006	6365866	6372141	6275	g_2978	g_2979
Super-Scaffold_100006	6376565	6410438	33873	g_2979	g_2981
Super-Scaffold_100006	6423338	6453134	29796	g_2981	g_2982
Super-Scaffold_100006	6459089	6473277	14188	g_2982	g_2984
Super-Scaffold_100006	6477151	6493307	16156	g_2984	g_2987
Super-Scaffold_100006	6497659	6499634	1975	g_2987	g_2988
Super-Scaffold_100006	6502498	6517961	15463	g_2988	g_2989
Super-Scaffold_100006	6522703	6526161	3458	g_2989	g_2990
Super-Scaffold_100006	6530503	6532326	1823	g_2990	g_2991
Super-Scaffold_100006	6569831	6657233	87402	g_2991	g_2994
Super-Scaffold_100006	6667434	6678540	11106	g_2994	g_2995
Super-Scaffold_100006	6690894	6697877	6983	g_2995	g_2996
Super-Scaffold_100006	6699914	6703920	4006	g_2996	g_41895
Super-Scaffold_100006	6704330	6709844	5514	g_41895	g_2998
Super-Scaffold_100006	6711793	6715872	4079	g_2998	g_2999
Super-Scaffold_100006	6730788	6750497	19709	g_2999	g_3000
Super-Scaffold_100006	6785414	6790694	5280	g_3000	g_3001
Super-Scaffold_100006	6802583	6813260	10677	g_3001	g_3003
Super-Scaffold_100006	6813568	6839141	25573	g_3003	g_3005
Super-Scaffold_100006	6854903	6859053	4150	g_3005	g_43096
Super-Scaffold_100006	6870114	6871078	964	g_43096	g_3006
Super-Scaffold_100006	6874579	6877233	2654	g_3006	g_3007
Super-Scaffold_100006	6882315	6883191	876	g_3007	g_3008
Super-Scaffold_100006	6887342	6933772	46430	g_3008	g_41898
Super-Scaffold_100006	6934035	6934910	875	g_41898	g_3009
Super-Scaffold_100006	6935974	6942623	6649	g_3009	g_3010
Super-Scaffold_100006	6949467	6953873	4406	g_3010	g_3011
Super-Scaffold_100006	6963802	6965738	1936	g_3011	g_3012
Super-Scaffold_100006	6983329	6989801	6472	g_3012	g_43097
Super-Scaffold_100006	6998359	6999063	704	g_43097	g_3013
Super-Scaffold_100006	7005681	7012790	7109	g_3013	g_3014
Super-Scaffold_100006	7021256	7024336	3080	g_3014	g_43098
Super-Scaffold_100006	7042746	7043265	519	g_43098	g_3015
Super-Scaffold_100006	7048270	7062216	13946	g_3015	g_3016
Super-Scaffold_100006	7065566	7067142	1576	g_3016	g_43099
Super-Scaffold_100006	7071845	7074184	2339	g_43099	g_3017
Super-Scaffold_100006	7081891	7083306	1415	g_3017	g_43100
Super-Scaffold_100006	7092789	7093790	1001	g_43100	g_43101
Super-Scaffold_100006	7100623	7101708	1085	g_43101	g_3018
Super-Scaffold_100006	7108636	7110601	1965	g_3018	g_3019
Super-Scaffold_100006	7112806	7114709	1903	g_3019	g_3020
Super-Scaffold_100006	7140783	7148740	7957	g_3020	g_43102
Super-Scaffold_100006	7205851	7214859	9008	g_43102	g_3021
Super-Scaffold_100006	7220236	7223068	2832	g_3021	g_3022
Super-Scaffold_100006	7225744	7231862	6118	g_3022	g_3023
Super-Scaffold_100006	7240683	7247170	6487	g_3023	g_3024
Super-Scaffold_100006	7257258	7262415	5157	g_3024	g_3026
Super-Scaffold_100006	7273316	7281167	7851	g_3026	g_3027
Super-Scaffold_100006	7282038	7284538	2500	g_3027	g_3028
Super-Scaffold_100006	7288459	7295027	6568	g_3028	g_3029
Super-Scaffold_100006	7315511	7319337	3826	g_3029	g_3030
Super-Scaffold_100006	7325312	7359858	34546	g_3030	g_3033
Super-Scaffold_100006	7360268	7360363	95	g_3033	g_3034
Super-Scaffold_100006	7369012	7387682	18670	g_3034	g_3035
Super-Scaffold_100006	7409850	7412524	2674	g_3035	g_3036
Super-Scaffold_100006	7415252	7418525	3273	g_3036	g_3037
Super-Scaffold_100006	7428197	7439548	11351	g_3037	g_3038
Super-Scaffold_100006	7458303	7459081	778	g_3038	g_3039
Super-Scaffold_100006	7478810	7485022	6212	g_3039	g_3040
Super-Scaffold_100006	7497092	7515600	18508	g_3040	g_3041
Super-Scaffold_100006	7524769	7555676	30907	g_3041	g_3042
Super-Scaffold_100006	7568836	7582221	13385	g_3042	g_3043
Super-Scaffold_100006	7586554	7598035	11481	g_41904	g_3044
Super-Scaffold_100006	7605756	7607460	1704	g_3044	g_3045
Super-Scaffold_100006	7625800	7650237	24437	g_3045	g_3046
Super-Scaffold_100006	7650638	7658639	8001	g_3046	g_3047
Super-Scaffold_100006	7698085	7702010	3925	g_3047	g_3048
Super-Scaffold_100006	7708935	7712867	3932	g_3048	g_3049
Super-Scaffold_100006	7717672	7719834	2162	g_3049	g_3050
Super-Scaffold_100006	7730116	7740385	10269	g_3050	g_3051
Super-Scaffold_100006	7752418	7756966	4548	g_3051	g_3052
Super-Scaffold_100006	7760131	7763261	3130	g_3052	g_3053
Super-Scaffold_100006	7766406	7768371	1965	g_3053	g_3054
Super-Scaffold_100006	7772069	7774418	2349	g_3054	g_43103
Super-Scaffold_100006	7799001	7799736	735	g_43103	g_3055
Super-Scaffold_100006	7820458	7820850	392	g_3055	g_3056
Super-Scaffold_100006	7826904	7829331	2427	g_3056	g_43104
Super-Scaffold_100006	7834523	7844508	9985	g_43104	g_41907
Super-Scaffold_100006	7844708	7909884	65176	g_41907	g_3062
Super-Scaffold_100006	7918756	7922939	4183	g_3062	g_3063
Super-Scaffold_100006	7923301	7946853	23552	g_3063	g_3064
Super-Scaffold_100006	7964251	7968710	4459	g_3064	g_3066
Super-Scaffold_100006	7971772	7975556	3784	g_3066	g_3067
Super-Scaffold_100006	7984614	8006426	21812	g_3067	g_3071
Super-Scaffold_100006	8006695	8009575	2880	g_3071	g_3072
Super-Scaffold_100006	8009901	8010121	220	g_3072	g_3073
Super-Scaffold_100006	8010369	8019796	9427	g_3073	g_41911
Super-Scaffold_100006	8020047	8020453	406	g_41911	g_41912
Super-Scaffold_100006	8020722	8037947	17225	g_41912	g_3077
Super-Scaffold_100006	8052189	8055151	2962	g_3077	g_43105
Super-Scaffold_100006	8060961	8068746	7785	g_43105	g_3078
Super-Scaffold_100006	8070659	8118341	47682	g_3078	g_3080
Super-Scaffold_100006	8132946	8158854	25908	g_3080	g_3082
Super-Scaffold_100006	8160959	8167511	6552	g_3082	g_3083
Super-Scaffold_100006	8167804	8172336	4532	g_3083	g_43106
Super-Scaffold_100006	8193475	8198004	4529	g_43106	g_3084
Super-Scaffold_100006	8207010	8207794	784	g_3084	g_3085
Super-Scaffold_100006	8233024	8246720	13696	g_3085	g_3086
Super-Scaffold_100006	8276681	8344054	67373	g_3086	g_3088
Super-Scaffold_100006	8344374	8352388	8014	g_3088	g_3090
Super-Scaffold_100006	8363783	8384023	20240	g_3090	g_43107
Super-Scaffold_100006	8409512	8420548	11036	g_43107	g_3092
Super-Scaffold_100006	8422576	8436809	14233	g_3092	g_3093
Super-Scaffold_100006	8438058	8441279	3221	g_3093	g_3094
Super-Scaffold_100006	8444649	8463774	19125	g_3094	g_3096
Super-Scaffold_100006	8464307	8472115	7808	g_3096	g_3097
Super-Scaffold_100006	8486297	8487671	1374	g_3097	g_3098
Super-Scaffold_100006	8498403	8498535	132	g_3098	g_3099
Super-Scaffold_100006	8501343	8501916	573	g_3099	g_3100
Super-Scaffold_100006	8502429	8512037	9608	g_3100	g_3101
Super-Scaffold_100006	8513341	8514573	1232	g_3101	g_43108
Super-Scaffold_100006	8525725	8552049	26324	g_43108	g_3104
Super-Scaffold_100006	8553608	8558208	4600	g_3104	g_3105
Super-Scaffold_100006	8575163	8582945	7782	g_3105	g_3106
Super-Scaffold_100006	8587842	8594730	6888	g_3106	g_43109
Super-Scaffold_100006	8604468	8606485	2017	g_43109	g_3107
Super-Scaffold_100006	8612145	8612597	452	g_3107	g_3108
Super-Scaffold_100006	8615975	8620221	4246	g_3108	g_3109
Super-Scaffold_100006	8622424	8624499	2075	g_3109	g_3110
Super-Scaffold_100006	8628547	8629182	635	g_3110	g_3111
Super-Scaffold_100006	8629673	8637359	7686	g_3111	g_3112
Super-Scaffold_100006	8638489	8656282	17793	g_3112	g_3113
Super-Scaffold_100006	8659271	8677306	18035	g_3113	g_3114
Super-Scaffold_100006	8679547	8689905	10358	g_3114	g_3115
Super-Scaffold_100006	8692359	8703485	11126	g_3115	g_3116
Super-Scaffold_100006	8707139	8709860	2721	g_3116	g_43110
Super-Scaffold_100006	8737314	8746421	9107	g_43110	g_3117
Super-Scaffold_100006	8748834	8753300	4466	g_3117	g_3118
Super-Scaffold_100006	8753518	8768797	15279	g_3118	g_3120
Super-Scaffold_100006	8769111	8835200	66089	g_3120	g_3121
Super-Scaffold_100006	8843830	8869156	25326	g_3121	g_3123
Super-Scaffold_100006	8895000	8899130	4130	g_3123	g_43111
Super-Scaffold_100006	8901421	8913734	12313	g_43111	g_3124
Super-Scaffold_100006	8930653	8978609	47956	g_3124	g_3125
Super-Scaffold_100006	8985139	8988605	3466	g_3125	g_3126
Super-Scaffold_100006	8990678	9004639	13961	g_3126	g_3127
Super-Scaffold_100006	9005322	9008216	2894	g_3127	g_3128
Super-Scaffold_100006	9009780	9012355	2575	g_3128	g_3129
Super-Scaffold_100006	9013790	9019582	5792	g_3129	g_3130
Super-Scaffold_100006	9021024	9024730	3706	g_3130	g_3131
Super-Scaffold_100006	9026177	9030490	4313	g_3131	g_3132
Super-Scaffold_100006	9031710	9033033	1323	g_3132	g_3133
Super-Scaffold_100006	9034817	9038526	3709	g_3133	g_3134
Super-Scaffold_100006	9039960	9041624	1664	g_3134	g_3135
Super-Scaffold_100006	9042235	9049494	7259	g_3135	g_3136
Super-Scaffold_100006	9051888	9053143	1255	g_3136	g_3137
Super-Scaffold_100006	9055862	9079967	24105	g_3137	g_3138
Super-Scaffold_100006	9082340	9083595	1255	g_3138	g_3139
Super-Scaffold_100006	9087247	9098621	11374	g_3139	g_3140
Super-Scaffold_100006	9100965	9111854	10889	g_3140	g_3142
Super-Scaffold_100006	9115189	9123932	8743	g_3142	g_3143
Super-Scaffold_100006	9125221	9145044	19823	g_3143	g_3144
Super-Scaffold_100006	9149258	9163536	14278	g_3144	g_3147
Super-Scaffold_100006	9167352	9188676	21324	g_3147	g_3149
Super-Scaffold_100006	9190517	9205251	14734	g_3149	g_3150
Super-Scaffold_100006	9206573	9247671	41098	g_3150	g_3152
Super-Scaffold_100006	9250924	9296856	45932	g_3152	g_3155
Super-Scaffold_100006	9300287	9311036	10749	g_3155	g_3156
Super-Scaffold_100006	9311542	9355480	43938	g_3156	g_3160
Super-Scaffold_100006	9358219	9381334	23115	g_3160	g_3161
Super-Scaffold_100006	9384168	9397750	13582	g_3161	g_3164
Super-Scaffold_100006	9410997	9424887	13890	g_3164	g_3165
Super-Scaffold_100006	9441564	9444627	3063	g_3165	g_43112
Super-Scaffold_100006	9448728	9453696	4968	g_43112	g_3166
Super-Scaffold_100006	9458493	9461293	2800	g_3166	g_3167
Super-Scaffold_100006	9468729	9482719	13990	g_3167	g_43113
Super-Scaffold_100006	9488522	9498365	9843	g_43113	g_3168
Super-Scaffold_100006	9499347	9501948	2601	g_3168	g_3169
Super-Scaffold_100006	9503248	9510188	6940	g_3169	g_3170
Super-Scaffold_100006	9511282	9515346	4064	g_3170	g_3171
Super-Scaffold_100006	9516641	9522417	5776	g_3171	g_3172
Super-Scaffold_100006	9523551	9528399	4848	g_3172	g_43114
Super-Scaffold_100006	9528911	9530736	1825	g_43114	g_43115
Super-Scaffold_100006	9531387	9537521	6134	g_43115	g_3173
Super-Scaffold_100006	9538062	9538913	851	g_3173	g_43116
Super-Scaffold_100006	9540388	9543976	3588	g_43116	g_3174
Super-Scaffold_100006	9545816	9548442	2626	g_3174	g_3175
Super-Scaffold_100006	9557075	9576656	19581	g_3175	g_3176
Super-Scaffold_100006	9594009	9649877	55868	g_3176	g_3178
Super-Scaffold_100006	9654935	9657658	2723	g_3178	g_3179
Super-Scaffold_100006	9659729	9819246	159517	g_3179	g_3184
Super-Scaffold_100006	9827590	9830115	2525	g_3184	g_3185
Super-Scaffold_100006	9832322	9834859	2537	g_3185	g_3186
Super-Scaffold_100006	9836363	9839177	2814	g_3186	g_3187
Super-Scaffold_100006	9847942	9875840	27898	g_3187	g_3188
Super-Scaffold_100006	9876145	9892772	16627	g_3188	g_3189
Super-Scaffold_100006	9893641	9901401	7760	g_3189	g_3190
Super-Scaffold_100006	9918391	9990680	72289	g_3190	g_3192
Super-Scaffold_100006	9992314	9994279	1965	g_3192	g_3193
Super-Scaffold_100006	9994650	10017263	22613	g_3193	g_3196
Super-Scaffold_100006	10017772	10023813	6041	g_3196	g_3197
Super-Scaffold_100006	10025440	10041437	15997	g_3197	g_3198
Super-Scaffold_100006	10045698	10049528	3830	g_3198	g_3199
Super-Scaffold_100006	10054814	10057995	3181	g_3199	g_3200
Super-Scaffold_100006	10062764	10065025	2261	g_3200	g_3201
Super-Scaffold_100006	10075386	10077786	2400	g_3201	g_3202
Super-Scaffold_100006	10080776	10081478	702	g_3202	g_3203
Super-Scaffold_100006	10085269	10090062	4793	g_3203	g_3204
Super-Scaffold_100006	10098022	10102641	4619	g_3204	g_3205
Super-Scaffold_100006	10117483	10119654	2171	g_3205	g_3206
Super-Scaffold_100006	10124260	10128618	4358	g_3206	g_3207
Super-Scaffold_100006	10140134	10182916	42782	g_3207	g_3209
Super-Scaffold_100006	10188201	10190320	2119	g_3209	g_3210
Super-Scaffold_100006	10195886	10218344	22458	g_3210	g_3211
Super-Scaffold_100006	10218646	10280744	62098	g_3211	g_3212
Super-Scaffold_100006	10281034	10382279	101245	g_3212	g_3214
Super-Scaffold_100006	10399238	10572726	173488	g_3214	g_3215
Super-Scaffold_100006	10573748	10584723	10975	g_3215	g_43117
Super-Scaffold_100006	10592022	10593237	1215	g_43117	g_43118
Super-Scaffold_100006	10597224	10599538	2314	g_43118	g_3216
Super-Scaffold_100006	10600205	10603727	3522	g_3216	g_3217
Super-Scaffold_100006	10613408	10619931	6523	g_3217	g_3218
Super-Scaffold_100006	10630773	10676412	45639	g_3218	g_3220
Super-Scaffold_100006	10677005	10682695	5690	g_3220	g_3221
Super-Scaffold_100006	10692758	10695445	2687	g_3221	g_3222
Super-Scaffold_100006	10704103	10742186	38083	g_3222	g_3223
Super-Scaffold_100006	10772507	10790703	18196	g_3223	g_3224
Super-Scaffold_100006	10806585	10808166	1581	g_3224	g_3225
Super-Scaffold_100006	10810188	10810825	637	g_3225	g_3226
Super-Scaffold_100006	10812749	10813167	418	g_3226	g_3227
Super-Scaffold_100006	10824686	10861810	37124	g_3227	g_3228
Super-Scaffold_100006	10873036	10890093	17057	g_3228	g_3229
Super-Scaffold_100006	10894337	10920267	25930	g_3229	g_3230
Super-Scaffold_100006	10922687	10948750	26063	g_3230	g_3232
Super-Scaffold_100006	10949871	10999086	49215	g_3232	g_3238
Super-Scaffold_100006	10999637	11149290	149653	g_3238	g_3248
Super-Scaffold_100006	11149490	11162810	13320	g_3248	g_3250
Super-Scaffold_100006	11163028	11168563	5535	g_3250	g_3251
Super-Scaffold_100006	11179083	11180235	1152	g_3251	g_3252
Super-Scaffold_100006	11181799	11183364	1565	g_3252	g_41951
Super-Scaffold_100006	11185400	11188567	3167	g_3253	g_3254
Super-Scaffold_100006	11193641	11209532	15891	g_3254	g_41952
Super-Scaffold_100006	11210863	11218861	7998	g_3255	g_3256
Super-Scaffold_100006	11219331	11222911	3580	g_3256	g_3257
Super-Scaffold_100006	11226265	11227205	940	g_3257	g_3258
Super-Scaffold_100006	11228113	11229805	1692	g_3258	g_3259
Super-Scaffold_100006	11284325	11295104	10779	g_3259	g_43119
Super-Scaffold_100006	11301639	11351302	49663	g_43119	g_3260
Super-Scaffold_100006	11351523	11362464	10941	g_3260	g_3262
Super-Scaffold_100006	11391672	11547042	155370	g_3262	g_3266
Super-Scaffold_100006	11547590	11556874	9284	g_3266	g_3267
Super-Scaffold_100006	11557449	11648355	90906	g_3267	g_3270
Super-Scaffold_100006	11649698	11665090	15392	g_3270	g_3271
Super-Scaffold_100006	11665371	11677326	11955	g_3271	g_3273
Super-Scaffold_100006	11680198	11719651	39453	g_3273	g_3274
Super-Scaffold_100006	11730310	11732186	1876	g_3274	g_3275
Super-Scaffold_100006	11732551	11736098	3547	g_3275	g_3276
Super-Scaffold_100006	11746657	11760120	13463	g_3276	g_3278
Super-Scaffold_100006	11780294	11795007	14713	g_3278	g_3279
Super-Scaffold_100006	11799531	11802571	3040	g_3279	g_3280
Super-Scaffold_100006	11812775	11840768	27993	g_3280	g_3281
Super-Scaffold_100006	11841781	11843835	2054	g_3281	g_3282
Super-Scaffold_100006	11848353	11857592	9239	g_3282	g_3283
Super-Scaffold_100006	11873598	11903936	30338	g_3283	g_3285
Super-Scaffold_100006	11904226	11975580	71354	g_3285	g_41967
Super-Scaffold_100006	11975996	11987897	11901	g_41967	g_3287
Super-Scaffold_100006	11988440	11996677	8237	g_3287	g_3288
Super-Scaffold_100006	12009303	12018453	9150	g_3288	g_3289
Super-Scaffold_100006	12022615	12026158	3543	g_3289	g_3290
Super-Scaffold_100006	12031690	12037331	5641	g_3290	g_3291
Super-Scaffold_100006	12039198	12039539	341	g_3291	g_3292
Super-Scaffold_100006	12040426	12041916	1490	g_3292	g_3293
Super-Scaffold_100006	12045649	12046578	929	g_3293	g_43120
Super-Scaffold_100006	12049975	12052626	2651	g_43120	g_3294
Super-Scaffold_100006	12056955	12058134	1179	g_3294	g_3295
Super-Scaffold_100006	12062670	12065601	2931	g_3295	g_3296
Super-Scaffold_100006	12089573	12104833	15260	g_3296	g_3297
Super-Scaffold_100006	12114498	12119030	4532	g_3297	g_3298
Super-Scaffold_100006	12135334	12137608	2274	g_3298	g_3299
Super-Scaffold_100006	12142064	12155043	12979	g_3299	g_3300
Super-Scaffold_100006	12170270	12173382	3112	g_3300	g_3301
Super-Scaffold_100006	12181997	12186469	4472	g_3301	g_3303
Super-Scaffold_100006	12192944	12218151	25207	g_3303	g_3305
Super-Scaffold_100006	12226901	12231089	4188	g_3305	g_43121
Super-Scaffold_100006	12237458	12242648	5190	g_43121	g_3306
Super-Scaffold_100006	12251591	12258058	6467	g_3306	g_3307
Super-Scaffold_100006	12266672	12271132	4460	g_3307	g_3309
Super-Scaffold_100006	12277582	12302815	25233	g_3309	g_3311
Super-Scaffold_100006	12311550	12315692	4142	g_3311	g_43122
Super-Scaffold_100006	12322085	12328775	6690	g_43122	g_3312
Super-Scaffold_100006	12342367	12342864	497	g_3312	g_3313
Super-Scaffold_100006	12350064	12351549	1485	g_3313	g_3314
Super-Scaffold_100006	12352688	12355350	2662	g_3314	g_3315
Super-Scaffold_100006	12361049	12364537	3488	g_3315	g_3316
Super-Scaffold_100006	12368400	12411787	43387	g_3316	g_3319
Super-Scaffold_100006	12416204	12420965	4761	g_3319	g_43123
Super-Scaffold_100006	12423769	12427540	3771	g_43123	g_3320
Super-Scaffold_100006	12434980	12454472	19492	g_3320	g_3321
Super-Scaffold_100006	12466945	12468515	1570	g_3321	g_3322
Super-Scaffold_100006	12473400	12477022	3622	g_3322	g_3323
Super-Scaffold_100006	12479766	12485041	5275	g_3323	g_3324
Super-Scaffold_100006	12489472	12503030	13558	g_3324	g_3326
Super-Scaffold_100006	12508081	12510343	2262	g_3326	g_3327
Super-Scaffold_100006	12515869	12519059	3190	g_3327	g_41969
Super-Scaffold_100006	12519289	12521184	1895	g_41969	g_3329
Super-Scaffold_100006	12532940	12538257	5317	g_3329	g_3330
Super-Scaffold_100006	12566692	12574074	7382	g_3330	g_3331
Super-Scaffold_100006	12577869	12580651	2782	g_3331	g_3332
Super-Scaffold_100006	12581079	12582119	1040	g_3332	g_3333
Super-Scaffold_100006	12582595	12598444	15849	g_3333	g_3334
Super-Scaffold_100006	12606109	12641738	35629	g_3334	g_3335
Super-Scaffold_100006	12654884	12655561	677	g_3335	g_43124
Super-Scaffold_100006	12668987	12669094	107	g_43124	g_43125
Super-Scaffold_100006	12674959	12682476	7517	g_43125	g_3337
Super-Scaffold_100006	12686011	12687865	1854	g_3337	g_3338
Super-Scaffold_100006	12692754	12704953	12199	g_3338	g_3340
Super-Scaffold_100006	12710009	12713485	3476	g_3340	g_3341
Super-Scaffold_100006	12727412	12728530	1118	g_3341	g_3342
Super-Scaffold_100006	12733962	12735143	1181	g_3342	g_3343
Super-Scaffold_100006	12736333	12738011	1678	g_3343	g_3344
Super-Scaffold_100006	12742596	12744347	1751	g_3344	g_3345
Super-Scaffold_100006	12754358	12758047	3689	g_3345	g_3346
Super-Scaffold_100006	12763383	12766580	3197	g_3346	g_3347
Super-Scaffold_100006	12783454	12785962	2508	g_3347	g_3348
Super-Scaffold_100006	12786927	12788575	1648	g_3348	g_3349
Super-Scaffold_100006	12789479	12791992	2513	g_3349	g_3350
Super-Scaffold_100006	12793537	12795176	1639	g_3350	g_3351
Super-Scaffold_100006	12800474	12805527	5053	g_3351	g_43126
Super-Scaffold_100006	12811686	12821108	9422	g_43126	g_3352
Super-Scaffold_100006	12821428	12871011	49583	g_3352	g_3353
Super-Scaffold_100006	12872262	12879599	7337	g_3353	g_3354
Super-Scaffold_100006	12881323	12893901	12578	g_3354	g_3355
Super-Scaffold_100006	12897752	12899532	1780	g_3355	g_3356
Super-Scaffold_100006	12900509	12902269	1760	g_3356	g_3357
Super-Scaffold_100006	12912705	12915465	2760	g_3357	g_3358
Super-Scaffold_100006	12918312	12918787	475	g_3358	g_3359
Super-Scaffold_100006	12919224	12933880	14656	g_3359	g_3361
Super-Scaffold_100006	12936978	12938625	1647	g_3361	g_3362
Super-Scaffold_100006	12943156	12945360	2204	g_3362	g_3363
Super-Scaffold_100006	12949110	12950767	1657	g_3363	g_43127
Super-Scaffold_100006	12955517	12957796	2279	g_43127	g_3364
Super-Scaffold_100006	12960875	12983770	22895	g_3364	g_3365
Super-Scaffold_100006	12985015	12999486	14471	g_3365	g_3367
Super-Scaffold_100006	13013774	13017208	3434	g_3367	g_3368
Super-Scaffold_100006	13042410	13052909	10499	g_3368	g_41971
Super-Scaffold_100006	13053154	13055517	2363	g_41971	g_3370
Super-Scaffold_100006	13060138	13069407	9269	g_3370	g_3371
Super-Scaffold_100006	13077469	13080444	2975	g_3371	g_3372
Super-Scaffold_100006	13090151	13090354	203	g_3372	g_43128
Super-Scaffold_100006	13090560	13092541	1981	g_43128	g_3373
Super-Scaffold_100006	13094521	13096170	1649	g_3373	g_3374
Super-Scaffold_100006	13100806	13114868	14062	g_3374	g_3375
Super-Scaffold_100006	13116382	13116973	591	g_3375	g_3376
Super-Scaffold_100006	13119328	13150523	31195	g_3376	g_3379
Super-Scaffold_100006	13151512	13153635	2123	g_3379	g_43129
Super-Scaffold_100006	13156035	13159581	3546	g_43129	g_43130
Super-Scaffold_100006	13161960	13162357	397	g_43130	g_3380
Super-Scaffold_100006	13162680	13169157	6477	g_3380	g_3381
Super-Scaffold_100006	13170332	13175317	4985	g_3381	g_3382
Super-Scaffold_100006	13176498	13189980	13482	g_3382	g_3383
Super-Scaffold_100006	13191300	13196664	5364	g_3383	g_43131
Super-Scaffold_100006	13197347	13204174	6827	g_43131	g_3384
Super-Scaffold_100006	13208050	13209101	1051	g_3384	g_43132
Super-Scaffold_100006	13211329	13211394	65	g_43132	g_43133
Super-Scaffold_100006	13212916	13217212	4296	g_43133	g_3385
Super-Scaffold_100006	13225314	13282193	56879	g_3385	g_3386
Super-Scaffold_100006	13282579	13290981	8402	g_3386	g_3387
Super-Scaffold_100006	13291322	13318745	27423	g_3387	g_3390
Super-Scaffold_100006	13319197	13324103	4906	g_3390	g_3391
Super-Scaffold_100006	13338304	13342117	3813	g_3391	g_3392
Super-Scaffold_100006	13342350	13369556	27206	g_3392	g_3394
Super-Scaffold_100006	13371952	13374248	2296	g_3394	g_3395
Super-Scaffold_100006	13397679	13410763	13084	g_3395	g_3396
Super-Scaffold_100006	13424308	13447508	23200	g_3396	g_3398
Super-Scaffold_100006	13452100	13487832	35732	g_3398	g_3400
Super-Scaffold_100006	13513830	13520074	6244	g_3400	g_3401
Super-Scaffold_100006	13536261	13540741	4480	g_3401	g_3402
Super-Scaffold_100006	13557457	13579481	22024	g_3402	g_3403
Super-Scaffold_100006	13599988	13615905	15917	g_3403	g_43134
Super-Scaffold_100006	13616126	13653527	37401	g_43134	g_41976
Super-Scaffold_100006	13653745	13699900	46155	g_41976	g_3405
Super-Scaffold_100006	13711755	13715108	3353	g_3405	g_3406
Super-Scaffold_100006	13715521	13724226	8705	g_3406	g_3408
Super-Scaffold_100006	13740872	13743830	2958	g_3408	g_3409
Super-Scaffold_100006	13749741	13754265	4524	g_3409	g_3410
Super-Scaffold_100006	13755909	13757196	1287	g_3410	g_3411
Super-Scaffold_100006	13763639	13767981	4342	g_3411	g_3412
Super-Scaffold_100006	13769141	13774585	5444	g_3412	g_3413
Super-Scaffold_100006	13775465	13777747	2282	g_3413	g_3414
Super-Scaffold_100006	13787517	13788638	1121	g_3414	g_43135
Super-Scaffold_100006	13791918	13794531	2613	g_43135	g_3415
Super-Scaffold_100006	13800026	13802367	2341	g_3415	g_3416
Super-Scaffold_100006	13821014	13826911	5897	g_3416	g_3417
Super-Scaffold_100006	13828895	13829960	1065	g_3417	g_3418
Super-Scaffold_100006	13831547	13847470	15923	g_3418	g_3419
Super-Scaffold_100006	13866341	13895959	29618	g_3419	g_3421
Super-Scaffold_100006	13896417	13924905	28488	g_3421	g_3423
Super-Scaffold_100006	13925249	13946952	21703	g_3423	g_3424
Super-Scaffold_100006	13958056	14105309	147253	g_3424	g_3427
Super-Scaffold_100006	14105605	14137778	32173	g_3427	g_3429
Super-Scaffold_100006	14139075	14141281	2206	g_3429	g_3430
Super-Scaffold_100006	14149890	14181150	31260	g_3430	g_41983
Super-Scaffold_100006	14181386	14191306	9920	g_41983	g_41984
Super-Scaffold_100006	14191674	14210357	18683	g_41984	g_3432
Super-Scaffold_100006	14210557	14215916	5359	g_3432	g_3433
Super-Scaffold_100006	14219630	14222533	2903	g_3433	g_3434
Super-Scaffold_100006	14227673	14230407	2734	g_3434	g_3435
Super-Scaffold_100006	14234315	14246731	12416	g_3435	g_3436
Super-Scaffold_100006	14247003	14250218	3215	g_3436	g_3437
Super-Scaffold_100006	14263266	14288407	25141	g_3437	g_3438
Super-Scaffold_100006	14289096	14290738	1642	g_3438	g_3439
Super-Scaffold_100006	14291442	14341248	49806	g_3439	g_41987
Super-Scaffold_100006	14341502	14391953	50451	g_41987	g_41988
Super-Scaffold_100006	14392219	14393306	1087	g_41988	g_3442
Super-Scaffold_100006	14414611	14418479	3868	g_3442	g_3443
Super-Scaffold_100006	14431262	14436466	5204	g_3443	g_3444
Super-Scaffold_100006	14441326	14445866	4540	g_3444	g_3445
Super-Scaffold_100006	14446503	14458028	11525	g_3445	g_41989
Super-Scaffold_100006	14458276	14460312	2036	g_41989	g_3446
Super-Scaffold_100006	14473947	14478712	4765	g_3446	g_3447
Super-Scaffold_100006	14490973	14494495	3522	g_3447	g_3448
Super-Scaffold_100006	14510457	14513748	3291	g_3448	g_3449
Super-Scaffold_100006	14520713	14522202	1489	g_3449	g_3450
Super-Scaffold_100006	14537682	14541960	4278	g_3450	g_3451
Super-Scaffold_100006	14543873	14544087	214	g_3451	g_43136
Super-Scaffold_100006	14557168	14559963	2795	g_43136	g_3452
Super-Scaffold_100006	14577852	14581257	3405	g_3452	g_3453
Super-Scaffold_100006	14588713	14600417	11704	g_3453	g_3454
Super-Scaffold_100006	14609250	14674970	65720	g_3454	g_3456
Super-Scaffold_100006	14676556	14676695	139	g_3456	g_3457
Super-Scaffold_100006	14680008	14686142	6134	g_3457	g_3455
Super-Scaffold_100006	14712433	14779169	66736	g_3455	g_3458
Super-Scaffold_100006	14782804	14787412	4608	g_3458	g_3459
Super-Scaffold_100006	14789868	14791255	1387	g_3459	g_3460
Super-Scaffold_100006	14811066	14815087	4021	g_3460	g_3461
Super-Scaffold_100006	14815437	14817392	1955	g_3461	g_3462
Super-Scaffold_100006	14818815	14822109	3294	g_3462	g_3463
Super-Scaffold_100006	14822711	14880631	57920	g_3463	g_3465
Super-Scaffold_100006	14889668	14891547	1879	g_3465	g_3466
Super-Scaffold_100006	14899211	14903409	4198	g_3466	g_3467
Super-Scaffold_100006	14913676	15022607	108931	g_3467	g_3471
Super-Scaffold_100006	15030793	15083064	52271	g_3471	g_3472
Super-Scaffold_100006	15103136	15104813	1677	g_3472	g_3473
Super-Scaffold_100006	15107270	15114381	7111	g_3473	g_3474
Super-Scaffold_100006	15120505	15122488	1983	g_3474	g_3475
Super-Scaffold_100006	15128485	15133902	5417	g_3475	g_3476
Super-Scaffold_100006	15135722	15136871	1149	g_3476	g_3477
Super-Scaffold_100006	15138803	15141156	2353	g_3477	g_43137
Super-Scaffold_100006	15144237	15145726	1489	g_43137	g_3478
Super-Scaffold_100006	15150080	15153579	3499	g_3478	g_3479
Super-Scaffold_100006	15156683	15161847	5164	g_3479	g_3480
Super-Scaffold_100006	15171741	15174587	2846	g_3480	g_43138
Super-Scaffold_100006	15176604	15177338	734	g_43138	g_3481
Super-Scaffold_100006	15182958	15183474	516	g_3481	g_3482
Super-Scaffold_100006	15190277	15196245	5968	g_3482	g_3483
Super-Scaffold_100006	15218665	15235229	16564	g_3483	g_3484
Super-Scaffold_100006	15243416	15250144	6728	g_3484	g_3485
Super-Scaffold_100006	15252508	15255754	3246	g_3485	g_3486
Super-Scaffold_100006	15264820	15278085	13265	g_3486	g_3487
Super-Scaffold_100006	15282489	15284922	2433	g_3487	g_3488
Super-Scaffold_100006	15291330	15293044	1714	g_3488	g_3489
Super-Scaffold_100006	15294092	15296315	2223	g_3489	g_3490
Super-Scaffold_100006	15296608	15297243	635	g_3490	g_3491
Super-Scaffold_100006	15298956	15299992	1036	g_3491	g_43139
Super-Scaffold_100006	15303433	15305387	1954	g_43139	g_3492
Super-Scaffold_100006	15306848	15314999	8151	g_3492	g_3495
Super-Scaffold_100006	15318330	15328414	10084	g_3495	g_3496
Super-Scaffold_100006	15335171	15337068	1897	g_3496	g_3497
Super-Scaffold_100006	15341017	15349279	8262	g_3497	g_3498
Super-Scaffold_100006	15353250	15354701	1451	g_3498	g_3499
Super-Scaffold_100006	15357803	15362849	5046	g_3499	g_3500
Super-Scaffold_100006	15363271	15366349	3078	g_3500	g_3501
Super-Scaffold_100006	15376678	15378014	1336	g_3501	g_3502
Super-Scaffold_100006	15378343	15380300	1957	g_3502	g_3503
Super-Scaffold_100006	15382127	15384065	1938	g_3503	g_3504
Super-Scaffold_100006	15390096	15395074	4978	g_3504	g_3505
Super-Scaffold_100006	15395385	15398561	3176	g_3505	g_43140
Super-Scaffold_100006	15403629	15409720	6091	g_43140	g_3506
Super-Scaffold_100006	15416842	15429795	12953	g_3506	g_3507
Super-Scaffold_100006	15435698	15443878	8180	g_3507	g_3508
Super-Scaffold_100006	15458791	15472887	14096	g_3508	g_3509
Super-Scaffold_100006	15473222	15473286	64	g_3509	g_3510
Super-Scaffold_100006	15502025	15505861	3836	g_3510	g_43141
Super-Scaffold_100006	15506154	15528157	22003	g_43141	g_3512
Super-Scaffold_100006	15542364	15567412	25048	g_3512	g_3513
Super-Scaffold_100006	15575622	15587008	11386	g_3513	g_43142
Super-Scaffold_100006	15591216	15592884	1668	g_43142	g_3514
Super-Scaffold_100006	15600806	15603852	3046	g_3514	g_3515
Super-Scaffold_100006	15610031	15610701	670	g_3515	g_3516
Super-Scaffold_100006	15610952	15615330	4378	g_3516	g_3517
Super-Scaffold_100006	15619174	15619409	235	g_42000	g_42001
Super-Scaffold_100006	15619942	15628957	9015	g_42001	g_3518
Super-Scaffold_100006	15633072	15639610	6538	g_3518	g_3519
Super-Scaffold_100006	15642022	15644470	2448	g_3519	g_3520
Super-Scaffold_100006	15647006	15649279	2273	g_3520	g_3521
Super-Scaffold_100006	15669190	15675765	6575	g_3521	g_3522
Super-Scaffold_100006	15681729	15682884	1155	g_3522	g_3523
Super-Scaffold_100006	15688716	15690546	1830	g_3523	g_3524
Super-Scaffold_100006	15693195	15695384	2189	g_3524	g_3525
Super-Scaffold_100006	15700589	15702050	1461	g_3525	g_3526
Super-Scaffold_100006	15702949	15707640	4691	g_3526	g_3527
Super-Scaffold_100006	15714327	15715069	742	g_3527	g_3528
Super-Scaffold_100006	15715320	15720664	5344	g_3528	g_3529
Super-Scaffold_100006	15721890	15722250	360	g_3529	g_3530
Super-Scaffold_100006	15731618	15733690	2072	g_3530	g_3531
Super-Scaffold_100006	15735097	15736816	1719	g_3531	g_3532
Super-Scaffold_100006	15741389	15744006	2617	g_3532	g_3533
Super-Scaffold_100006	15750735	15751801	1066	g_3533	g_3534
Super-Scaffold_100006	15754212	15756074	1862	g_3534	g_3535
Super-Scaffold_100006	15777502	15780171	2669	g_3535	g_3536
Super-Scaffold_100006	15784588	15786557	1969	g_3536	g_3537
Super-Scaffold_100006	15794691	15796365	1674	g_3537	g_3538
Super-Scaffold_100006	15798901	15804790	5889	g_3538	g_43143
Super-Scaffold_100006	15810879	15819240	8361	g_43143	g_3539
Super-Scaffold_100006	15823490	15829129	5639	g_3539	g_3540
Super-Scaffold_100006	15836901	15839742	2841	g_3540	g_43144
Super-Scaffold_100006	15846062	15849742	3680	g_43144	g_3541
Super-Scaffold_100006	15853612	15854507	895	g_3541	g_43145
Super-Scaffold_100006	15855979	15859107	3128	g_43145	g_3542
Super-Scaffold_100006	15864712	15887832	23120	g_3542	g_3543
Super-Scaffold_100006	15898697	15903044	4347	g_3543	g_3544
Super-Scaffold_100006	15906232	15922640	16408	g_3544	g_3545
Super-Scaffold_100006	15923776	15931144	7368	g_3545	g_3547
Super-Scaffold_100006	15931401	15931457	56	g_3547	g_43146
Super-Scaffold_100006	15939813	15940719	906	g_43146	g_3548
Super-Scaffold_100006	15945667	15949111	3444	g_3548	g_3549
Super-Scaffold_100006	15952445	15969700	17255	g_3549	g_3551
Super-Scaffold_100006	15989085	15992360	3275	g_3551	g_3552
Super-Scaffold_100006	16008986	16009570	584	g_3552	g_3553
Super-Scaffold_100006	16014679	16015654	975	g_3553	g_3554
Super-Scaffold_100006	16016951	16021243	4292	g_3554	g_43147
Super-Scaffold_100006	16025132	16026158	1026	g_43147	g_43148
Super-Scaffold_100006	16033750	16034443	693	g_43148	g_3555
Super-Scaffold_100006	16050646	16059264	8618	g_3555	g_3556
Super-Scaffold_100006	16071657	16076501	4844	g_3556	g_3557
Super-Scaffold_100006	16084477	16091400	6923	g_3557	g_43149
Super-Scaffold_100006	16091672	16097321	5649	g_43149	g_3558
Super-Scaffold_100006	16102661	16127170	24509	g_3558	g_3560
Super-Scaffold_100006	16161335	16161432	97	g_3560	g_3561
Super-Scaffold_100006	16161701	16176403	14702	g_3561	g_3562
Super-Scaffold_100006	16188184	16192700	4516	g_3562	g_3563
Super-Scaffold_100006	16206426	16207764	1338	g_3563	g_3564
Super-Scaffold_100006	16213298	16221836	8538	g_3564	g_3565
Super-Scaffold_100006	16224088	16234083	9995	g_3565	g_3566
Super-Scaffold_100006	16248798	16251340	2542	g_3566	g_43150
Super-Scaffold_100006	16251924	16263961	12037	g_43150	g_3567
Super-Scaffold_100006	16270556	16295314	24758	g_3567	g_3568
Super-Scaffold_100006	16304998	16308777	3779	g_3568	g_43151
Super-Scaffold_100006	16319000	16319547	547	g_43151	g_3569
Super-Scaffold_100006	16324893	16326523	1630	g_3569	g_3570
Super-Scaffold_100006	16332446	16334009	1563	g_3570	g_3571
Super-Scaffold_100006	16338929	16340028	1099	g_3571	g_43152
Super-Scaffold_100006	16346061	16351121	5060	g_43152	g_3572
Super-Scaffold_100006	16361245	16366050	4805	g_3572	g_3573
Super-Scaffold_100006	16377612	16380445	2833	g_3573	g_3574
Super-Scaffold_100006	16383517	16386128	2611	g_3574	g_3575
Super-Scaffold_100006	16392144	16396217	4073	g_3575	g_3577
Super-Scaffold_100006	16399881	16402160	2279	g_3577	g_3578
Super-Scaffold_100006	16405547	16424041	18494	g_3578	g_3580
Super-Scaffold_100006	16444699	16463493	18794	g_3580	g_3581
Super-Scaffold_100006	16464638	16476684	12046	g_3581	g_3582
Super-Scaffold_100006	16489155	16494645	5490	g_3582	g_3583
Super-Scaffold_100006	16501795	16504109	2314	g_3583	g_3584
Super-Scaffold_100006	16504402	16508681	4279	g_3584	g_3585
Super-Scaffold_100006	16516384	16520220	3836	g_3585	g_3586
Super-Scaffold_100006	16520577	16523839	3262	g_3586	g_43153
Super-Scaffold_100006	16524199	16527463	3264	g_43153	g_3587
Super-Scaffold_100006	16527823	16531345	3522	g_3587	g_43154
Super-Scaffold_100006	16531721	16535825	4104	g_43154	g_43155
Super-Scaffold_100006	16536201	16541504	5303	g_43155	g_3588
Super-Scaffold_100006	16541920	16551209	9289	g_3588	g_3589
Super-Scaffold_100006	16551668	16556453	4785	g_3589	g_43156
Super-Scaffold_100006	16556868	16564736	7868	g_43156	g_3591
Super-Scaffold_100006	16572268	16580664	8396	g_3591	g_3592
Super-Scaffold_100006	16584215	16587677	3462	g_3592	g_3593
Super-Scaffold_100006	16597536	16631849	34313	g_3593	g_3594
Super-Scaffold_100006	16632061	16633105	1044	g_3594	g_3595
Super-Scaffold_100006	16641452	16708566	67114	g_3595	g_3599
Super-Scaffold_100006	16708781	16709892	1111	g_3599	g_42011
Super-Scaffold_100006	16710326	16727709	17383	g_42011	g_3601
Super-Scaffold_100006	16738054	16747184	9130	g_3601	g_3602
Super-Scaffold_100006	16753531	16767006	13475	g_3602	g_3604
Super-Scaffold_100006	16774243	16777551	3308	g_3604	g_3605
Super-Scaffold_100006	16777775	16780905	3130	g_3605	g_3606
Super-Scaffold_100006	16788293	16803306	15013	g_3606	g_3607
Super-Scaffold_100006	16803696	16805169	1473	g_3607	g_3608
Super-Scaffold_100006	16806680	16832983	26303	g_3608	g_3611
Super-Scaffold_100006	16839266	16846189	6923	g_3611	g_3612
Super-Scaffold_100006	16856750	16864244	7494	g_3612	g_3613
Super-Scaffold_100006	16873608	16875551	1943	g_3613	g_3614
Super-Scaffold_100006	16878770	16882497	3727	g_3614	g_3615
Super-Scaffold_100006	16886858	16888544	1686	g_3615	g_43157
Super-Scaffold_100006	16892186	16899882	7696	g_43157	g_3616
Super-Scaffold_100006	16916153	16918041	1888	g_3616	g_3617
Super-Scaffold_100006	16927006	16932829	5823	g_3617	g_43158
Super-Scaffold_100006	16942883	16944505	1622	g_43158	g_3618
Super-Scaffold_100006	16950172	16951810	1638	g_3618	g_3619
Super-Scaffold_100006	16955446	16956515	1069	g_3619	g_3620
Super-Scaffold_100006	16957435	16962046	4611	g_3620	g_3622
Super-Scaffold_100006	16962966	16972923	9957	g_3622	g_3623
Super-Scaffold_100006	16973843	16978964	5121	g_3623	g_3625
Super-Scaffold_100006	16979884	16994626	14742	g_3625	g_3626
Super-Scaffold_100006	16999442	17004121	4679	g_3626	g_3627
Super-Scaffold_100006	17012007	17024857	12850	g_3627	g_3628
Super-Scaffold_100006	17027532	17036114	8582	g_3628	g_43159
Super-Scaffold_100006	17038696	17039903	1207	g_43159	g_3629
Super-Scaffold_100006	17041624	17049223	7599	g_3629	g_3630
Super-Scaffold_100006	17050189	17053738	3549	g_3630	g_43160
Super-Scaffold_100006	17063497	17065884	2387	g_43160	g_3631
Super-Scaffold_100006	17068375	17072461	4086	g_3631	g_3632
Super-Scaffold_100006	17076522	17079538	3016	g_3632	g_3633
Super-Scaffold_100006	17079840	17080066	226	g_3633	g_3634
Super-Scaffold_100006	17097280	17099562	2282	g_3634	g_3635
Super-Scaffold_100006	17100759	17136761	36002	g_3635	g_3638
Super-Scaffold_100006	17141504	17142757	1253	g_3638	g_3639
Super-Scaffold_100006	17146197	17148003	1806	g_3639	g_3640
Super-Scaffold_100006	17159710	17165067	5357	g_3640	g_3641
Super-Scaffold_100006	17179769	17181809	2040	g_3641	g_3642
Super-Scaffold_100006	17191294	17197084	5790	g_3642	g_3643
Super-Scaffold_100006	17197926	17201201	3275	g_3643	g_3644
Super-Scaffold_100006	17206096	17209697	3601	g_3644	g_3645
Super-Scaffold_100006	17228937	17231464	2527	g_3645	g_3646
Super-Scaffold_100006	17232566	17237802	5236	g_3646	g_3647
Super-Scaffold_100006	17238939	17240110	1171	g_3647	g_3648
Super-Scaffold_100006	17240583	17240866	283	g_3648	g_3649
Super-Scaffold_100006	17242045	17245667	3622	g_3649	g_3650
Super-Scaffold_100006	17246906	17252410	5504	g_3650	g_3651
Super-Scaffold_100006	17264032	17264454	422	g_3651	g_3652
Super-Scaffold_100006	17267359	17269589	2230	g_3652	g_3653
Super-Scaffold_100006	17270365	17274931	4566	g_3653	g_3654
Super-Scaffold_100006	17284526	17287198	2672	g_3654	g_3655
Super-Scaffold_100006	17291636	17292269	633	g_3655	g_3656
Super-Scaffold_100006	17293060	17293099	39	g_3656	g_3657
Super-Scaffold_100006	17296280	17308600	12320	g_3657	g_3658
Super-Scaffold_100006	17321886	17324656	2770	g_3658	g_3660
Super-Scaffold_100006	17339841	17343332	3491	g_3660	g_3661
Super-Scaffold_100006	17353157	17354118	961	g_3661	g_3662
Super-Scaffold_100006	17370761	17371649	888	g_3662	g_3663
Super-Scaffold_100006	17374969	17384551	9582	g_3663	g_3664
Super-Scaffold_100006	17386514	17402582	16068	g_3664	g_3665
Super-Scaffold_100006	17403986	17409215	5229	g_3665	g_43161
Super-Scaffold_100006	17419273	17427658	8385	g_43161	g_3666
Super-Scaffold_100006	17431349	17434559	3210	g_3666	g_43162
Super-Scaffold_100006	17449825	17451791	1966	g_43162	g_3667
Super-Scaffold_100006	17453458	17454390	932	g_3667	g_3668
Super-Scaffold_100006	17461678	17465001	3323	g_3668	g_3669
Super-Scaffold_100006	17472072	17472984	912	g_3669	g_3670
Super-Scaffold_100006	17491570	17498787	7217	g_3670	g_3671
Super-Scaffold_100006	17508210	17510842	2632	g_3671	g_3672
Super-Scaffold_100006	17519476	17525174	5698	g_3672	g_3673
Super-Scaffold_100006	17541654	17602538	60884	g_3673	g_3675
Super-Scaffold_100006	17605542	17606801	1259	g_3675	g_3676
Super-Scaffold_100006	17610083	17611764	1681	g_3676	g_3677
Super-Scaffold_100006	17611988	17624082	12094	g_3677	g_3679
Super-Scaffold_100006	17626675	17628242	1567	g_3679	g_43163
Super-Scaffold_100006	17638686	17651450	12764	g_43163	g_3680
Super-Scaffold_100006	17669521	17706747	37226	g_3680	g_3681
Super-Scaffold_100006	17709611	17710948	1337	g_3681	g_3682
Super-Scaffold_100006	17712996	17752485	39489	g_3682	g_3683
Super-Scaffold_100006	17752694	17766504	13810	g_3683	g_3684
Super-Scaffold_100006	17772996	17783733	10737	g_3684	g_3685
Super-Scaffold_100006	17783990	17797202	13212	g_3685	g_42018
Super-Scaffold_100006	17797468	17880518	83050	g_42018	g_3686
Super-Scaffold_100006	17893172	17903656	10484	g_3686	g_3687
Super-Scaffold_100006	17914035	17917495	3460	g_3687	g_3688
Super-Scaffold_100006	17924533	17930229	5696	g_3688	g_3689
Super-Scaffold_100006	17941572	17942699	1127	g_3689	g_3690
Super-Scaffold_100006	17951645	17955300	3655	g_3690	g_3691
Super-Scaffold_100006	17959523	17961960	2437	g_3691	g_43164
Super-Scaffold_100006	17973955	17976029	2074	g_43164	g_3692
Super-Scaffold_100006	17980220	17996508	16288	g_3692	g_3694
Super-Scaffold_100006	18001404	18011591	10187	g_3694	g_3695
Super-Scaffold_100006	18013333	18016632	3299	g_3695	g_43165
Super-Scaffold_100006	18017696	18029192	11496	g_43165	g_3696
Super-Scaffold_100006	18030638	18044757	14119	g_3696	g_3697
Super-Scaffold_100006	18046289	18048106	1817	g_3697	g_43166
Super-Scaffold_100006	18049570	18051387	1817	g_43166	g_43167
Super-Scaffold_100006	18052857	18054672	1815	g_43167	g_43168
Super-Scaffold_100006	18056136	18057117	981	g_43168	g_43169
Super-Scaffold_100006	18059449	18071064	11615	g_43169	g_3698
Super-Scaffold_100006	18079211	18094363	15152	g_3698	g_3699
Super-Scaffold_100006	18094779	18116960	22181	g_3699	g_3701
Super-Scaffold_100006	18117328	18121835	4507	g_3701	g_3702
Super-Scaffold_100006	18130967	18139244	8277	g_3702	g_3703
Super-Scaffold_100006	18163432	18164708	1276	g_3703	g_3704
Super-Scaffold_100006	18183280	18187379	4099	g_3704	g_3705
Super-Scaffold_100006	18224107	18230125	6018	g_3705	g_3706
Super-Scaffold_100006	18233457	18238859	5402	g_3706	g_3708
Super-Scaffold_100006	18239059	18247567	8508	g_3708	g_43170
Super-Scaffold_100006	18249629	18251555	1926	g_43170	g_3709
Super-Scaffold_100006	18252340	18263536	11196	g_3709	g_3710
Super-Scaffold_100006	18264968	18268161	3193	g_3710	g_3711
Super-Scaffold_100006	18270732	18272095	1363	g_3711	g_43171
Super-Scaffold_100006	18276325	18282034	5709	g_43171	g_43172
Super-Scaffold_100006	18283956	18288219	4263	g_43172	g_3712
Super-Scaffold_100006	18305774	18310202	4428	g_3712	g_3713
Super-Scaffold_100006	18318250	18323225	4975	g_3713	g_3714
Super-Scaffold_100006	18350292	18352885	2593	g_3714	g_43173
Super-Scaffold_100006	18353133	18359132	5999	g_43173	g_3715
Super-Scaffold_100006	18366536	18368199	1663	g_3715	g_3716
Super-Scaffold_100006	18377602	18380595	2993	g_3716	g_3717
Super-Scaffold_100006	18381823	18382456	633	g_3717	g_3718
Super-Scaffold_100006	18386703	18389276	2573	g_3718	g_3719
Super-Scaffold_100006	18398807	18405951	7144	g_3719	g_3720
Super-Scaffold_100006	18408879	18410843	1964	g_3720	g_3721
Super-Scaffold_100006	18417469	18417930	461	g_3721	g_3722
Super-Scaffold_100006	18421679	18442823	21144	g_3722	g_3723
Super-Scaffold_100006	18443218	18443390	172	g_3723	g_3724
Super-Scaffold_100006	18448045	18455298	7253	g_3724	g_3725
Super-Scaffold_100006	18455621	18465713	10092	g_3725	g_3726
Super-Scaffold_100006	18484546	18486811	2265	g_3726	g_3727
Super-Scaffold_100006	18488797	18490127	1330	g_3727	g_3728
Super-Scaffold_100006	18491855	18494949	3094	g_3728	g_3729
Super-Scaffold_100006	18497999	18501481	3482	g_3729	g_3730
Super-Scaffold_100006	18507712	18509980	2268	g_3730	g_3731
Super-Scaffold_100006	18511227	18523700	12473	g_3731	g_3732
Super-Scaffold_100006	18545786	18548928	3142	g_3732	g_3733
Super-Scaffold_100006	18552761	18557483	4722	g_3733	g_3734
Super-Scaffold_100006	18560260	18561069	809	g_3734	g_3735
Super-Scaffold_100006	18562981	18565645	2664	g_3735	g_3736
Super-Scaffold_100006	18568189	18568730	541	g_3736	g_43174
Super-Scaffold_100006	18570242	18574841	4599	g_43174	g_43175
Super-Scaffold_100006	18575658	18579088	3430	g_43175	g_43176
Super-Scaffold_100006	18585038	18587263	2225	g_43176	g_3737
Super-Scaffold_100006	18590267	18604194	13927	g_3737	g_3738
Super-Scaffold_100006	18623806	18645162	21356	g_3738	g_3739
Super-Scaffold_100006	18645929	18647220	1291	g_3739	g_3740
Super-Scaffold_100006	18649756	18653108	3352	g_3740	g_3741
Super-Scaffold_100006	18663827	18669377	5550	g_3741	g_3742
Super-Scaffold_100006	18671968	18689145	17177	g_3742	g_3744
Super-Scaffold_100006	18691660	18693038	1378	g_3744	g_43177
Super-Scaffold_100006	18694513	18708229	13716	g_43177	g_3746
Super-Scaffold_100006	18713358	18716760	3402	g_3746	g_3747
Super-Scaffold_100006	18718240	18724677	6437	g_3747	g_3748
Super-Scaffold_100006	18725867	18728259	2392	g_3748	g_42025
Super-Scaffold_100006	18730152	18734217	4065	g_3749	g_3750
Super-Scaffold_100006	18735964	18742060	6096	g_3750	g_3751
Super-Scaffold_100006	18743166	18747369	4203	g_3751	g_3752
Super-Scaffold_100006	18756880	18760243	3363	g_3752	g_3753
Super-Scaffold_100006	18772112	18774622	2510	g_3753	g_3754
Super-Scaffold_100006	18786593	18792191	5598	g_3754	g_3755
Super-Scaffold_100006	18806643	18820634	13991	g_3755	g_43178
Super-Scaffold_100006	18827942	18831986	4044	g_43178	g_3757
Super-Scaffold_100006	18836645	18845403	8758	g_3757	g_3758
Super-Scaffold_100006	18859883	18862910	3027	g_3758	g_3759
Super-Scaffold_100006	18864091	18864591	500	g_3759	g_3760
Super-Scaffold_100006	18871063	18876116	5053	g_3760	g_3761
Super-Scaffold_100006	18884915	18886523	1608	g_3761	g_3762
Super-Scaffold_100006	18891837	18895267	3430	g_3762	g_3763
Super-Scaffold_100006	18910079	18912967	2888	g_3763	g_3764
Super-Scaffold_100006	18913275	18929132	15857	g_3764	g_3765
Super-Scaffold_100006	18948543	18953309	4766	g_3765	g_3766
Super-Scaffold_100006	18953527	18970868	17341	g_3766	g_3767
Super-Scaffold_100006	18971374	18985714	14340	g_3767	g_3768
Super-Scaffold_100006	18988627	18997024	8397	g_3768	g_3769
Super-Scaffold_100006	18998868	19043376	44508	g_3769	g_3772
Super-Scaffold_100006	19083924	19090352	6428	g_3772	g_3773
Super-Scaffold_100006	19100870	19123839	22969	g_3773	g_3774
Super-Scaffold_100006	19127671	19129394	1723	g_3774	g_43179
Super-Scaffold_100006	19134446	19136272	1826	g_43179	g_43180
Super-Scaffold_100006	19153849	19155517	1668	g_43180	g_3775
Super-Scaffold_100006	19162033	19222128	60095	g_3775	g_3777
Super-Scaffold_100006	19242439	19246302	3863	g_3777	g_3778
Super-Scaffold_100006	19251293	19254074	2781	g_3778	g_3779
Super-Scaffold_100006	19256108	19260958	4850	g_3779	g_3780
Super-Scaffold_100006	19273199	19279486	6287	g_3780	g_3781
Super-Scaffold_100006	19284424	19285141	717	g_3781	g_43181
Super-Scaffold_100006	19290133	19291154	1021	g_43181	g_3782
Super-Scaffold_100006	19294237	19300145	5908	g_3782	g_3783
Super-Scaffold_100006	19304266	19306653	2387	g_3783	g_3784
Super-Scaffold_100006	19328421	19342284	13863	g_3784	g_3785
Super-Scaffold_100006	19345164	19345479	315	g_3785	g_3786
Super-Scaffold_100006	19349123	19349881	758	g_3786	g_43182
Super-Scaffold_100006	19353053	19354889	1836	g_43182	g_3787
Super-Scaffold_100006	19359048	19361621	2573	g_3787	g_3788
Super-Scaffold_100006	19363436	19367826	4390	g_3788	g_42032
Super-Scaffold_100006	19370473	19372786	2313	g_42032	g_3789
Super-Scaffold_100006	19378311	19380101	1790	g_3789	g_3790
Super-Scaffold_100006	19389553	19393555	4002	g_3790	g_3791
Super-Scaffold_100006	19407249	19408886	1637	g_3791	g_43183
Super-Scaffold_100006	19426406	19431684	5278	g_43183	g_3792
Super-Scaffold_100006	19436726	19439947	3221	g_3792	g_3793
Super-Scaffold_100006	19445903	19451191	5288	g_3793	g_3794
Super-Scaffold_100006	19473512	19477065	3553	g_3794	g_3795
Super-Scaffold_100006	19477358	19489556	12198	g_3795	g_43184
Super-Scaffold_100006	19494194	19575606	81412	g_43184	g_3797
Super-Scaffold_100006	19581204	19584736	3532	g_3797	g_3798
Super-Scaffold_100006	19597603	19608917	11314	g_3798	g_3799
Super-Scaffold_100006	19609246	19628014	18768	g_3799	g_3800
Super-Scaffold_100006	19638145	19648986	10841	g_3800	g_3801
Super-Scaffold_100006	19654224	19670135	15911	g_3801	g_3802
Super-Scaffold_100006	19674702	19677617	2915	g_3802	g_3803
Super-Scaffold_100006	19702018	19703582	1564	g_3803	g_3804
Super-Scaffold_100006	19704766	19706726	1960	g_3804	g_43185
Super-Scaffold_100006	19707676	19708125	449	g_43185	g_3805
Super-Scaffold_100006	19712719	19713701	982	g_3805	g_3806
Super-Scaffold_100006	19716319	19720576	4257	g_3806	g_3807
Super-Scaffold_100006	19722842	19727851	5009	g_3807	g_3808
Super-Scaffold_100006	19728522	19732825	4303	g_3808	g_3810
Super-Scaffold_100006	19733702	19739575	5873	g_3810	g_3811
Super-Scaffold_100006	19744875	19746355	1480	g_3811	g_43186
Super-Scaffold_100006	19753349	19759230	5881	g_43186	g_43187
Super-Scaffold_100006	19761499	19762918	1419	g_43187	g_43188
Super-Scaffold_100006	19769960	19775841	5881	g_43188	g_3812
Super-Scaffold_100006	19778110	19793062	14952	g_3812	g_3813
Super-Scaffold_100006	19795473	19796759	1286	g_3813	g_43189
Super-Scaffold_100006	19797634	19801694	4060	g_43189	g_3814
Super-Scaffold_100006	19803963	19809672	5709	g_3814	g_43190
Super-Scaffold_100006	19816688	19819806	3118	g_43190	g_3815
Super-Scaffold_100006	19825103	19832075	6972	g_3815	g_3816
Super-Scaffold_100006	19832958	19835054	2096	g_3816	g_3817
Super-Scaffold_100006	19839890	19856663	16773	g_3817	g_3819
Super-Scaffold_100006	19858504	19871328	12824	g_3819	g_3820
Super-Scaffold_100006	19874446	19876275	1829	g_3820	g_3821
Super-Scaffold_100006	19883909	19886643	2734	g_3821	g_3822
Super-Scaffold_100006	19888353	19889539	1186	g_3822	g_3823
Super-Scaffold_100006	19903792	19905524	1732	g_3823	g_3824
Super-Scaffold_100006	19907275	19908431	1156	g_3824	g_3825
Super-Scaffold_100006	19924800	19928136	3336	g_3825	g_3826
Super-Scaffold_100006	19929916	19964067	34151	g_3826	g_3828
Super-Scaffold_100006	19968362	19981678	13316	g_3828	g_3829
Super-Scaffold_100006	19985150	19988815	3665	g_3829	g_3830
Super-Scaffold_100006	19989968	19997816	7848	g_3830	g_3831
Super-Scaffold_100006	19998958	20002857	3899	g_3831	g_3832
Super-Scaffold_100006	20003978	20011110	7132	g_3832	g_3833
Super-Scaffold_100006	20012231	20018134	5903	g_3833	g_3834
Super-Scaffold_100006	20019252	20022544	3292	g_3834	g_3835
Super-Scaffold_100006	20023614	20094158	70544	g_3835	g_3837
Super-Scaffold_100006	20095389	20095449	60	g_3837	g_3838
Super-Scaffold_100006	20096150	20157057	60907	g_3838	g_3839
Super-Scaffold_100006	20160002	20162818	2816	g_3839	g_3841
Super-Scaffold_100006	20164410	20167023	2613	g_3841	g_3840
Super-Scaffold_100006	20170031	20171875	1844	g_3840	g_3842
Super-Scaffold_100006	20173330	20176064	2734	g_3842	g_3843
Super-Scaffold_100006	20178126	20179342	1216	g_3843	g_3844
Super-Scaffold_100006	20183589	20191183	7594	g_3844	g_3845
Super-Scaffold_100006	20192004	20196998	4994	g_3845	g_3846
Super-Scaffold_100006	20199362	20205867	6505	g_3846	g_43191
Super-Scaffold_100006	20207075	20209144	2069	g_43191	g_3847
Super-Scaffold_100006	20211160	20213335	2175	g_3847	g_3848
Super-Scaffold_100006	20216379	20218089	1710	g_3848	g_43192
Super-Scaffold_100006	20220253	20221690	1437	g_43192	g_3849
Super-Scaffold_100006	20234347	20236918	2571	g_3849	g_3850
Super-Scaffold_100006	20246918	20255144	8226	g_3850	g_3851
Super-Scaffold_100006	20255485	20266953	11468	g_3851	g_3852
Super-Scaffold_100006	20267345	20363785	96440	g_3852	g_3856
Super-Scaffold_100006	20381084	20381348	264	g_3856	g_43193
Super-Scaffold_100006	20382443	20569029	186586	g_43193	g_3858
Super-Scaffold_100006	20569268	20580577	11309	g_3858	g_3859
Super-Scaffold_100006	20581635	20587790	6155	g_3859	g_3860
Super-Scaffold_100006	20589052	20594506	5454	g_3860	g_3861
Super-Scaffold_100006	20600380	20605992	5612	g_3861	g_3862
Super-Scaffold_100006	20606252	20633018	26766	g_3862	g_3865
Super-Scaffold_100006	20644438	20656660	12222	g_3865	g_3866
Super-Scaffold_100006	20658764	20680926	22162	g_3866	g_3868
Super-Scaffold_100006	20695690	20699382	3692	g_3868	g_3869
Super-Scaffold_100006	20703191	20716885	13694	g_3869	g_3870
Super-Scaffold_100006	20720983	20744189	23206	g_3870	g_3872
Super-Scaffold_100006	20750029	20774039	24010	g_3872	g_3873
Super-Scaffold_100006	20778330	20790851	12521	g_3873	g_42041
Super-Scaffold_100006	20791195	20794704	3509	g_42041	g_3874
Super-Scaffold_100006	20797539	20802597	5058	g_3874	g_3875
Super-Scaffold_100006	20804474	20807791	3317	g_3875	g_3876
Super-Scaffold_100006	20819732	20821932	2200	g_3876	g_3877
Super-Scaffold_100006	20822921	20826515	3594	g_3877	g_3878
Super-Scaffold_100006	20829990	20831316	1326	g_3878	g_3879
Super-Scaffold_100006	20833823	20839318	5495	g_3879	g_3880
Super-Scaffold_100006	20840212	20843517	3305	g_3880	g_3881
Super-Scaffold_100006	20846376	20850305	3929	g_3881	g_42042
Super-Scaffold_100006	20852154	20853498	1344	g_3882	g_3883
Super-Scaffold_100006	20858759	20860525	1766	g_3883	g_43194
Super-Scaffold_100006	20860986	20861090	104	g_43194	g_3884
Super-Scaffold_100006	20869019	20874788	5769	g_3884	g_3885
Super-Scaffold_100006	20884251	20886372	2121	g_3885	g_3886
Super-Scaffold_100006	20889852	20890535	683	g_3886	g_3887
Super-Scaffold_100006	20897965	20900259	2294	g_3887	g_3888
Super-Scaffold_100006	20906809	20909216	2407	g_3888	g_3889
Super-Scaffold_100006	20909941	20916238	6297	g_3889	g_3890
Super-Scaffold_100006	20916576	20925258	8682	g_3890	g_3891
Super-Scaffold_100006	20955961	20966979	11018	g_3891	g_3892
Super-Scaffold_100006	20983772	21079431	95659	g_3892	g_3894
Super-Scaffold_100006	21176776	21178594	1818	g_3894	g_3895
Super-Scaffold_100006	21186000	21186473	473	g_3895	g_3896
Super-Scaffold_100006	21190117	21194203	4086	g_3896	g_3897
Super-Scaffold_100006	21195563	21196264	701	g_3897	g_3898
Super-Scaffold_100006	21205476	21210119	4643	g_3898	g_3899
Super-Scaffold_100006	21217316	21218953	1637	g_3899	g_43195
Super-Scaffold_100006	21223606	21224219	613	g_43195	g_3900
Super-Scaffold_100006	21226893	21230699	3806	g_3900	g_3902
Super-Scaffold_100006	21237103	21240422	3319	g_3902	g_3903
Super-Scaffold_100006	21243821	21261934	18113	g_3903	g_3904
Super-Scaffold_100006	21292204	21309781	17577	g_3904	g_3906
Super-Scaffold_100006	21313793	21325777	11984	g_3906	g_3907
Super-Scaffold_100006	21327104	21329587	2483	g_3907	g_43196
Super-Scaffold_100006	21341553	21382655	41102	g_43196	g_3909
Super-Scaffold_100006	21402897	21413564	10667	g_3909	g_3910
Super-Scaffold_100006	21414253	21431388	17135	g_3910	g_3911
Super-Scaffold_100006	21433641	21448061	14420	g_3911	g_3912
Super-Scaffold_100006	21455655	21514444	58789	g_3912	g_3914
Super-Scaffold_100006	21514653	21515609	956	g_3914	g_3915
Super-Scaffold_100006	21517843	21520326	2483	g_3915	g_43197
Super-Scaffold_100006	21540121	21586541	46420	g_43197	g_3916
Super-Scaffold_100006	21595077	21599147	4070	g_3916	g_3917
Super-Scaffold_100006	21600705	21602700	1995	g_3917	g_3918
Super-Scaffold_100006	21609678	21645767	36089	g_3918	g_3920
Super-Scaffold_100006	21664257	21719530	55273	g_3920	g_3923
Super-Scaffold_100006	21719787	21725088	5301	g_3923	g_3924
Super-Scaffold_100006	21734039	21736646	2607	g_3924	g_3925
Super-Scaffold_100006	21743518	22094069	350551	g_3925	g_3930
Super-Scaffold_100006	22095316	22101119	5803	g_3930	g_42047
Super-Scaffold_100006	22101352	22345215	243863	g_42047	g_3935
Super-Scaffold_100006	22345418	22351585	6167	g_3935	g_3936
Super-Scaffold_100006	22354873	22394110	39237	g_3936	g_3937
Super-Scaffold_100006	22395304	22395849	545	g_3937	g_3938
Super-Scaffold_100006	22396256	22415120	18864	g_3938	g_42051
Super-Scaffold_100006	22415377	22490287	74910	g_42051	g_3939
Super-Scaffold_100006	22492131	22514763	22632	g_3939	g_3940
Super-Scaffold_100006	22524246	22530330	6084	g_3940	g_3941
Super-Scaffold_100006	22548861	22557258	8397	g_3941	g_3942
Super-Scaffold_100006	22580259	22633029	52770	g_3942	g_3944
Super-Scaffold_100006	22639055	22796526	157471	g_3944	g_3946
Super-Scaffold_100006	22800026	22861105	61079	g_3946	g_3947
Super-Scaffold_100006	22861386	22877026	15640	g_3947	g_42056
Super-Scaffold_100006	22877322	22951060	73738	g_42056	g_3948
Super-Scaffold_100006	22955161	23111329	156168	g_3948	g_3949
Super-Scaffold_100006	23112216	23112698	482	g_3949	g_3950
Super-Scaffold_100006	23113474	23113517	43	g_3950	g_3951
Super-Scaffold_100006	23114191	23140472	26281	g_3951	g_3952
Super-Scaffold_100006	23147379	23206580	59201	g_3952	g_3953
Super-Scaffold_100006	23216732	23218283	1551	g_3953	g_43198
Super-Scaffold_100006	23225724	23259463	33739	g_43198	g_3954
Super-Scaffold_100006	23263353	23343830	80477	g_3954	g_3955
Super-Scaffold_100006	23478954	23528194	49240	g_3955	g_3957
Super-Scaffold_100006	23595546	23605062	9516	g_3957	g_3958
Super-Scaffold_100006	23606589	23608888	2299	g_3958	g_43199
Super-Scaffold_100006	23610580	23613723	3143	g_43199	g_42062
Super-Scaffold_100006	23614658	23621622	6964	g_42062	g_3960
Super-Scaffold_100006	23624203	23627769	3566	g_3960	g_42063
Super-Scaffold_100006	23628704	23635439	6735	g_42063	g_3962
Super-Scaffold_100006	23638020	23641585	3565	g_3962	g_42064
Super-Scaffold_100006	23642520	23735881	93361	g_42064	g_3966
Super-Scaffold_100006	23751827	23768221	16394	g_3966	g_3967
Super-Scaffold_100006	23783969	23823078	39109	g_3967	g_3968
Super-Scaffold_100006	23833651	23833686	35	g_3969	g_3970
Super-Scaffold_100006	23836067	23853476	17409	g_3970	g_43200
Super-Scaffold_100006	23859579	24014776	155197	g_43200	g_42066
Super-Scaffold_100006	24015102	24044329	29227	g_42066	g_3975
Super-Scaffold_100006	24051065	24054277	3212	g_3975	g_3976
Super-Scaffold_100006	24060393	24075921	15528	g_3976	g_3978
Super-Scaffold_100006	24079042	24114852	35810	g_3978	g_3980
Super-Scaffold_100006	24120302	24138135	17833	g_3980	g_3981
Super-Scaffold_100006	24255419	24374706	119287	g_3981	g_3982
Super-Scaffold_100006	24375140	24455780	80640	g_3982	g_3984
Super-Scaffold_100006	24476955	24519638	42683	g_3984	g_3986
Super-Scaffold_100006	24524931	24532258	7327	g_3986	g_3987
Super-Scaffold_100006	24544021	24564171	20150	g_3987	g_3988
Super-Scaffold_100006	24565127	24574730	9603	g_3988	g_3989
Super-Scaffold_100006	24586207	24586805	598	g_3989	g_43201
Super-Scaffold_100006	24590338	24595391	5053	g_43201	g_3990
Super-Scaffold_100006	24596212	24624159	27947	g_3990	g_3991
Super-Scaffold_100006	24626389	24631365	4976	g_3991	g_3992
Super-Scaffold_100006	24637349	24639672	2323	g_3992	g_3993
Super-Scaffold_100006	24641727	24644301	2574	g_3993	g_3994
Super-Scaffold_100006	24650641	24658170	7529	g_3994	g_3995
Super-Scaffold_100006	24663277	24666683	3406	g_3995	g_3996
Super-Scaffold_100006	24681025	24688641	7616	g_3996	g_3997
Super-Scaffold_100006	24690873	24694523	3650	g_3997	g_3998
Super-Scaffold_100006	24695671	24697013	1342	g_3998	g_3999
Super-Scaffold_100006	24698026	24699919	1893	g_3999	g_4000
Super-Scaffold_100006	24709960	24785355	75395	g_4000	g_4002
Super-Scaffold_100006	24785567	24871064	85497	g_4002	g_4003
Super-Scaffold_100006	24883979	24885053	1074	g_4003	g_4004
Super-Scaffold_100006	24885589	24887484	1895	g_4004	g_4005
Super-Scaffold_100006	24889202	24892268	3066	g_4005	g_43202
Super-Scaffold_100006	24895271	24929107	33836	g_43202	g_4007
Super-Scaffold_100006	24932172	24940701	8529	g_4007	g_43203
Super-Scaffold_100006	24943766	24950251	6485	g_43203	g_4008
Super-Scaffold_100006	24953319	24959965	6646	g_4008	g_4009
Super-Scaffold_100006	24963030	24971432	8402	g_4009	g_4010
Super-Scaffold_100006	24974501	24981341	6840	g_4010	g_4011
Super-Scaffold_100006	24984406	24989831	5425	g_4011	g_4012
Super-Scaffold_100006	24992224	24997509	5285	g_4012	g_4013
Super-Scaffold_100006	24999904	25001006	1102	g_4013	g_4014
Super-Scaffold_100006	25004448	25079098	74650	g_4014	g_4016
Super-Scaffold_100006	25087893	25090368	2475	g_4016	g_4017
Super-Scaffold_100006	25161376	25190692	29316	g_4017	g_4019
Super-Scaffold_100006	25213145	25258300	45155	g_4019	g_4020
Super-Scaffold_100006	25259646	25340111	80465	g_4020	g_4022
Super-Scaffold_100006	25347547	25363333	15786	g_4022	g_4023
Super-Scaffold_100006	25368035	25371043	3008	g_4023	g_43204
Super-Scaffold_100006	25373136	25375760	2624	g_43204	g_4024
Super-Scaffold_100006	25379193	25426447	47254	g_4024	g_4025
Super-Scaffold_100006	25436946	25457868	20922	g_4025	g_4026
Super-Scaffold_100006	25467166	25471322	4156	g_4026	g_4027
Super-Scaffold_100006	25479331	25481247	1916	g_4027	g_4028
Super-Scaffold_100006	25488393	25505506	17113	g_4028	g_4029
Super-Scaffold_100006	25510446	25513847	3401	g_4029	g_4030
Super-Scaffold_100006	25516672	25539898	23226	g_4030	g_42076
Super-Scaffold_100006	25543784	25549362	5578	g_42076	g_4031
Super-Scaffold_100006	25583269	25583824	555	g_4033	g_4034
Super-Scaffold_100006	25584294	25604809	20515	g_4034	g_4035
Super-Scaffold_100006	25610956	25611617	661	g_4035	g_4036
Super-Scaffold_100006	25613035	25615305	2270	g_4036	g_4037
Super-Scaffold_100006	25616855	25619146	2291	g_4037	g_4038
Super-Scaffold_100006	25623105	25623880	775	g_4038	g_4039
Super-Scaffold_100006	25628012	25630782	2770	g_4039	g_4040
Super-Scaffold_100006	25647667	25650480	2813	g_4040	g_43205
Super-Scaffold_100006	25659992	25665946	5954	g_43205	g_4041
Super-Scaffold_100006	25666323	25666597	274	g_4041	g_4042
Super-Scaffold_100006	25667771	25669068	1297	g_4042	g_43206
Super-Scaffold_100006	25674157	25674986	829	g_43206	g_4043
Super-Scaffold_100006	25678872	25679366	494	g_4043	g_4044
Super-Scaffold_100006	25679584	25681271	1687	g_4044	g_4045
Super-Scaffold_100006	25693311	25695355	2044	g_4045	g_4046
Super-Scaffold_100006	25699887	25703282	3395	g_4046	g_4047
Super-Scaffold_100006	25711729	25723764	12035	g_4047	g_4048
Super-Scaffold_100006	25723985	25853177	129192	g_4048	g_42077
Super-Scaffold_100006	25854544	25854964	420	g_42077	g_42078
Super-Scaffold_100006	25855314	25954586	99272	g_42078	g_4049
Super-Scaffold_100006	25958071	26021705	63634	g_4049	g_4050
Super-Scaffold_100006	26030740	26041179	10439	g_4050	g_4051
Super-Scaffold_100006	26041442	26130712	89270	g_4051	g_4056
Super-Scaffold_100006	26131011	26132081	1070	g_4056	g_4057
Super-Scaffold_100006	26132443	26157741	25298	g_4057	g_4058
Super-Scaffold_100006	26158619	26172831	14212	g_4058	g_4059
Super-Scaffold_100006	26173106	26197380	24274	g_4059	g_4060
Super-Scaffold_100006	26197892	26203822	5930	g_4060	g_4061
Super-Scaffold_100006	26207366	26228220	20854	g_4061	g_4062
Super-Scaffold_100006	26228681	26298948	70267	g_4062	g_4066
Super-Scaffold_100006	26299307	26308931	9624	g_4066	g_42086
Super-Scaffold_100006	26309158	26312278	3120	g_42086	g_42087
Super-Scaffold_100006	26312550	26381880	69330	g_42087	g_4070
Super-Scaffold_100006	26382314	26388415	6101	g_4070	g_4071
Super-Scaffold_100006	26404554	26456603	52049	g_4071	g_4072
Super-Scaffold_100006	26519207	26525407	6200	g_4072	g_4073
Super-Scaffold_100006	26535978	26614430	78452	g_4073	g_4075
Super-Scaffold_100006	26623050	26644119	21069	g_4075	g_4076
Super-Scaffold_100006	26661341	26712653	51312	g_4076	g_4077
Super-Scaffold_100006	26712985	26927721	214736	g_4077	g_4080
Super-Scaffold_100006	26940039	26980717	40678	g_4080	g_4081
Super-Scaffold_100006	26981049	27067457	86408	g_4081	g_4083
Super-Scaffold_100006	27087423	27111946	24523	g_4083	g_4084
Super-Scaffold_100006	27114631	27127562	12931	g_4084	g_43207
Super-Scaffold_100006	27150825	27201776	50951	g_43207	g_4088
Super-Scaffold_100006	27213735	27337077	123342	g_4088	g_4092
Super-Scaffold_100006	27337601	27339618	2017	g_4092	g_43208
Super-Scaffold_100006	27340131	27350299	10168	g_43208	g_4093
Super-Scaffold_100006	27350797	27445001	94204	g_4093	g_4098
Super-Scaffold_100006	27465584	27474489	8905	g_4098	g_4099
Super-Scaffold_100006	27502213	27568743	66530	g_4099	g_4101
Super-Scaffold_100006	27569579	27589817	20238	g_4101	g_4102
Super-Scaffold_100006	27595036	27625697	30661	g_4102	g_42102
Super-Scaffold_100006	27626494	27685943	59449	g_42102	g_4103
Super-Scaffold_100006	27688158	27706459	18301	g_4103	g_4104
Super-Scaffold_100006	27706698	27828186	121488	g_4104	g_42103
Super-Scaffold_100006	27828404	27828522	118	g_42103	g_4108
Super-Scaffold_100006	27833820	27858559	24739	g_4108	g_4110
Super-Scaffold_100006	27868316	27874332	6016	g_4110	g_4111
Super-Scaffold_100006	27879944	27891507	11563	g_4111	g_4112
Super-Scaffold_100006	27911774	28149280	237506	g_4112	g_4117
Super-Scaffold_100006	28150893	28167199	16306	g_4117	g_4118
Super-Scaffold_100006	28192835	28197843	5008	g_4118	g_4119
Super-Scaffold_100006	28198982	28243056	44074	g_4119	g_4120
Super-Scaffold_100006	28255822	28256254	432	g_4120	g_4121
Super-Scaffold_100006	28256820	28257840	1020	g_4121	g_4122
Super-Scaffold_100006	28258124	28269047	10923	g_4122	g_4123
Super-Scaffold_100006	28269493	28293764	24271	g_4123	g_4124
Super-Scaffold_100006	28319790	28382350	62560	g_4124	g_4127
Super-Scaffold_100006	28383624	28448558	64934	g_4127	g_4129
Super-Scaffold_100006	28454445	28561542	107097	g_4129	g_4132
Super-Scaffold_100006	28567019	28573065	6046	g_4132	g_4133
Super-Scaffold_100006	28576805	28580728	3923	g_4133	g_43209
Super-Scaffold_100006	28583279	28585334	2055	g_43209	g_4134
Super-Scaffold_100006	28588598	28600137	11539	g_4134	g_42106
Super-Scaffold_100006	28600424	28608152	7728	g_42106	g_4135
Super-Scaffold_100006	28628426	28631142	2716	g_4135	g_4136
Super-Scaffold_100006	28631375	28635436	4061	g_4136	g_4137
Super-Scaffold_100006	28642254	28643432	1178	g_4137	g_4138
Super-Scaffold_100006	28653319	28656433	3114	g_4138	g_4139
Super-Scaffold_100006	28671945	28698328	26383	g_4139	g_4140
Super-Scaffold_100006	28711683	28727446	15763	g_4140	g_4141
Super-Scaffold_100006	28728588	28738910	10322	g_4141	g_4143
Super-Scaffold_100006	28753049	28760897	7848	g_4143	g_4144
Super-Scaffold_100006	28766895	28848923	82028	g_4144	g_4147
Super-Scaffold_100006	28849510	28930380	80870	g_4147	g_4150
Super-Scaffold_100006	28942747	28944586	1839	g_4150	g_4151
Super-Scaffold_100006	28944807	28945777	970	g_4151	g_4152
Super-Scaffold_100006	28945995	28946070	75	g_4152	g_4153
Super-Scaffold_100006	28953638	29005987	52349	g_4153	g_4155
Super-Scaffold_100006	29015197	29017167	1970	g_4155	g_4156
Super-Scaffold_100006	29022382	29023318	936	g_4156	g_4157
Super-Scaffold_100006	29028990	29029687	697	g_4157	g_4158
Super-Scaffold_100006	29040343	29070534	30191	g_4158	g_4160
Super-Scaffold_100006	29094038	29136127	42089	g_4160	g_4163
Super-Scaffold_100006	29157978	29163889	5911	g_42115	g_4164
Super-Scaffold_100006	29174877	29195737	20860	g_4164	g_4166
Super-Scaffold_100006	29200002	29203828	3826	g_4166	g_4167
Super-Scaffold_100006	29206443	29234211	27768	g_4167	g_4168
Super-Scaffold_100006	29253450	29350769	97319	g_4168	g_4170
Super-Scaffold_100006	29351611	29453391	101780	g_4170	g_4179
Super-Scaffold_100006	29458005	29476964	18959	g_4179	g_43210
Super-Scaffold_100006	29482739	29548538	65799	g_43210	g_4180
Super-Scaffold_100006	29548801	29591261	42460	g_4180	g_4184
Super-Scaffold_100006	29591542	29591670	128	g_4184	g_4185
Super-Scaffold_100006	29593091	29669912	76821	g_4185	g_4187
Super-Scaffold_100006	29693911	29698179	4268	g_4187	g_4188
Super-Scaffold_100006	29705523	29707971	2448	g_4188	g_4189
Super-Scaffold_100006	29712572	29714879	2307	g_4189	g_4190
Super-Scaffold_100006	29725920	29729265	3345	g_4190	g_4191
Super-Scaffold_100006	29739374	29747274	7900	g_4191	g_4192
Super-Scaffold_100006	29753479	29754595	1116	g_4192	g_4193
Super-Scaffold_100006	29768045	29816382	48337	g_4193	g_4195
Super-Scaffold_100006	29820813	29823783	2970	g_4195	g_4196
Super-Scaffold_100006	29831855	29843789	11934	g_4196	g_4197
Super-Scaffold_100006	29852863	29854350	1487	g_4197	g_4198
Super-Scaffold_100006	29858451	29865556	7105	g_4198	g_4199
Super-Scaffold_100006	29897444	29899130	1686	g_4199	g_4200
Super-Scaffold_100006	29905918	29909631	3713	g_4200	g_4201
Super-Scaffold_100006	29919760	29922804	3044	g_4201	g_4202
Super-Scaffold_100006	29938174	29963326	25152	g_4202	g_4204
Super-Scaffold_100006	29970307	29971051	744	g_4204	g_4205
Super-Scaffold_100006	29979549	29986170	6621	g_4205	g_4207
Super-Scaffold_100006	30005908	30029891	23983	g_4207	g_4208
Super-Scaffold_100006	30035744	30039406	3662	g_4208	g_4209
Super-Scaffold_100006	30044844	30045888	1044	g_4209	g_42125
Super-Scaffold_100006	30061177	30065820	4643	g_4210	g_4211
Super-Scaffold_100006	30067489	30070786	3297	g_4211	g_4212
Super-Scaffold_100006	30073670	30076024	2354	g_4212	g_4213
Super-Scaffold_100006	30082214	30083562	1348	g_4213	g_4214
Super-Scaffold_100006	30089125	30109365	20240	g_4214	g_43211
Super-Scaffold_100006	30118358	30135510	17152	g_43211	g_4215
Super-Scaffold_100006	30141530	30177665	36135	g_4215	g_4217
Super-Scaffold_100006	30190455	30193356	2901	g_4217	g_4218
Super-Scaffold_100006	30210809	30222791	11982	g_4218	g_4219
Super-Scaffold_100006	30223033	30223089	56	g_4219	g_4220
Super-Scaffold_100006	30230169	30239448	9279	g_4220	g_43212
Super-Scaffold_100006	30240053	30247137	7084	g_43212	g_4221
Super-Scaffold_100006	30248939	30265667	16728	g_4221	g_4222
Super-Scaffold_100006	30273883	30280799	6916	g_4222	g_4223
Super-Scaffold_100006	30281086	30294863	13777	g_4223	g_42127
Super-Scaffold_100006	30295120	30307801	12681	g_42127	g_4226
Super-Scaffold_100006	30308184	30309658	1474	g_4226	g_4227
Super-Scaffold_100006	30310008	30387492	77484	g_4227	g_4230
Super-Scaffold_100006	30401862	30406165	4303	g_4230	g_4231
Super-Scaffold_100006	30409008	30411794	2786	g_4231	g_4232
Super-Scaffold_100006	30419915	30420110	195	g_4232	g_4233
Super-Scaffold_100006	30425843	30425910	67	g_4233	g_4234
Super-Scaffold_100006	30426131	30434420	8289	g_4234	g_4235
Super-Scaffold_100006	30443642	30464650	21008	g_4235	g_4236
Super-Scaffold_100006	30465161	30480357	15196	g_4236	g_43213
Super-Scaffold_100006	30487419	30497278	9859	g_43213	g_43214
Super-Scaffold_100006	30497775	30499777	2002	g_43214	g_4237
Super-Scaffold_100006	30500910	30501769	859	g_4237	g_4238
Super-Scaffold_100006	30503214	30555377	52163	g_4238	g_4240
Super-Scaffold_100006	30561658	30572873	11215	g_4240	g_43215
Super-Scaffold_100006	30581476	30599986	18510	g_43215	g_4241
Super-Scaffold_100006	30610514	30612772	2258	g_4241	g_4242
Super-Scaffold_100006	30615252	30630528	15276	g_4242	g_4244
Super-Scaffold_100006	30646059	30652482	6423	g_4244	g_43216
Super-Scaffold_100006	30675620	30716417	40797	g_43216	g_4245
Super-Scaffold_100006	30721148	30756949	35801	g_4245	g_4246
Super-Scaffold_100006	30757155	30760421	3266	g_4246	g_4247
Super-Scaffold_100006	30773829	30784953	11124	g_4247	g_4248
Super-Scaffold_100006	30785393	30785619	226	g_4248	g_4249
Super-Scaffold_100006	30787550	30819094	31544	g_4249	g_4251
Super-Scaffold_100006	30820658	30833077	12419	g_4251	g_4252
Super-Scaffold_100006	30833514	30850065	16551	g_4252	g_4254
Super-Scaffold_100006	30854805	30864783	9978	g_4254	g_42129
Super-Scaffold_100006	30865097	30865529	432	g_42129	g_4255
Super-Scaffold_100006	30866791	30873310	6519	g_4255	g_43217
Super-Scaffold_100006	30874448	30880773	6325	g_43217	g_4257
Super-Scaffold_100006	30883155	30893426	10271	g_4257	g_4258
Super-Scaffold_100006	30895801	30948662	52861	g_4258	g_4259
Super-Scaffold_100006	30963306	30982053	18747	g_4259	g_4260
Super-Scaffold_100006	30982280	31013563	31283	g_4260	g_4263
Super-Scaffold_100006	31017452	31022958	5506	g_4263	g_4264
Super-Scaffold_100006	31024430	31030738	6308	g_4264	g_4265
Super-Scaffold_100006	31041256	31140583	99327	g_4265	g_4267
Super-Scaffold_100006	31141317	31141354	37	g_4267	g_4268
Super-Scaffold_100006	31141742	31141965	223	g_4268	g_4269
Super-Scaffold_100006	31142946	31242334	99388	g_4269	g_4270
Super-Scaffold_100006	31253677	31293685	40008	g_4270	g_4273
Super-Scaffold_100006	31294722	31363406	68684	g_4273	g_4274
Super-Scaffold_100006	31363627	31442491	78864	g_4274	g_4275
Super-Scaffold_100006	31442817	31449012	6195	g_4275	g_4276
Super-Scaffold_100006	31449251	31455666	6415	g_4276	g_4277
Super-Scaffold_100006	31457801	31497460	39659	g_4277	g_4278
Super-Scaffold_100006	31497705	31526648	28943	g_4278	g_4279
Super-Scaffold_100006	31533146	31547583	14437	g_4279	g_4280
Super-Scaffold_100006	31552522	31557508	4986	g_4280	g_43218
Super-Scaffold_100006	31571833	31575533	3700	g_43218	g_4281
Super-Scaffold_100006	31600725	31672361	71636	g_4281	g_4283
Super-Scaffold_100006	31677507	31759641	82134	g_4283	g_4284
Super-Scaffold_100006	31761241	31761786	545	g_4284	g_4285
Super-Scaffold_100006	31761992	31771269	9277	g_4285	g_4286
Super-Scaffold_100006	31772200	31815958	43758	g_4286	g_42136
Super-Scaffold_100006	31816311	31828753	12442	g_42136	g_4288
Super-Scaffold_100006	31829247	31829289	42	g_4288	g_4289
Super-Scaffold_100006	31830041	31830281	240	g_4289	g_4290
Super-Scaffold_100006	31830879	31854843	23964	g_4290	g_4291
Super-Scaffold_100006	31855811	31857294	1483	g_4291	g_4292
Super-Scaffold_100006	31858484	31859311	827	g_4292	g_4293
Super-Scaffold_100006	31859768	31911805	52037	g_4293	g_4294
Super-Scaffold_100006	31912780	31912887	107	g_4294	g_4295
Super-Scaffold_100006	31915259	31915289	30	g_4295	g_4296
Super-Scaffold_100006	31915771	32040240	124469	g_4296	g_4299
Super-Scaffold_100006	32044074	32158344	114270	g_4299	g_4300
Super-Scaffold_100006	32159551	32207485	47934	g_4300	g_42140
Super-Scaffold_100006	32207790	32228103	20313	g_42140	g_4302
Super-Scaffold_100006	32229590	32231350	1760	g_4302	g_43219
Super-Scaffold_100006	32232582	32233596	1014	g_43219	g_4303
Super-Scaffold_100006	32234713	32303578	68865	g_42141	g_4304
Super-Scaffold_100006	32304282	32306150	1868	g_4304	g_4305
Super-Scaffold_100006	32307266	32379649	72383	g_4305	g_4310
Super-Scaffold_100006	32379987	32447019	67032	g_4310	g_4312
Super-Scaffold_100006	32447321	32526812	79491	g_4312	g_4316
Super-Scaffold_100006	32528080	32589968	61888	g_4316	g_4317
Super-Scaffold_100006	32590303	32710621	120318	g_4317	g_4319
Super-Scaffold_100006	32745388	32789629	44241	g_4319	g_4321
Super-Scaffold_100006	32811985	32820366	8381	g_4321	g_4322
Super-Scaffold_100006	32880979	32886936	5957	g_4322	g_4323
Super-Scaffold_100006	32906875	32983169	76294	g_42144	g_4325
Super-Scaffold_100006	32996961	33000504	3543	g_4325	g_4326
Super-Scaffold_100006	33002249	33002528	279	g_4326	g_4327
Super-Scaffold_100006	33003515	33007552	4037	g_4327	g_4328
Super-Scaffold_100006	33025566	33033590	8024	g_42147	g_4329
Super-Scaffold_100006	33040367	33074981	34614	g_4329	g_4331
Super-Scaffold_100006	33075235	33082646	7411	g_4331	g_4332
Super-Scaffold_100006	33089594	33098388	8794	g_4332	g_4333
Super-Scaffold_100006	33104117	33144571	40454	g_4333	g_4334
Super-Scaffold_100006	33154630	33159450	4820	g_4334	g_4335
Super-Scaffold_100006	33162391	33164093	1702	g_4335	g_4336
Super-Scaffold_100006	33196090	33248817	52727	g_4336	g_4337
Super-Scaffold_100006	33256898	33264218	7320	g_4337	g_4338
Super-Scaffold_100006	33267681	33270438	2757	g_4338	g_4339
Super-Scaffold_100006	33272761	33310454	37693	g_4339	g_4341
Super-Scaffold_100006	33311152	33311384	232	g_4341	g_4340
Super-Scaffold_100006	33311638	33324759	13121	g_4340	g_4342
Super-Scaffold_100006	33325199	33325352	153	g_4342	g_4343
Super-Scaffold_100006	33325717	33356432	30715	g_4343	g_4344
Super-Scaffold_100006	33366098	33425754	59656	g_4344	g_4345
Super-Scaffold_100006	33426413	33455744	29331	g_4345	g_4346
Super-Scaffold_100006	33455992	33456226	234	g_4346	g_4347
Super-Scaffold_100006	33457893	33503077	45184	g_4347	g_4348
Super-Scaffold_100006	33522133	33572469	50336	g_4348	g_4350
Super-Scaffold_100006	33594358	33606618	12260	g_4350	g_4351
Super-Scaffold_100006	33606878	33666263	59385	g_4351	g_4353
Super-Scaffold_100006	33684966	33694815	9849	g_4353	g_4354
Super-Scaffold_100006	33695663	33695745	82	g_4354	g_4355
Super-Scaffold_100006	33696347	33696421	74	g_4355	g_4356
Super-Scaffold_100006	33696756	33696763	7	g_4356	g_4357
Super-Scaffold_100006	33697656	33733631	35975	g_4357	g_4359
Super-Scaffold_100006	33734944	33755204	20260	g_4359	g_4362
Super-Scaffold_100006	33755644	33764399	8755	g_4362	g_4364
Super-Scaffold_100006	33765529	33804478	38949	g_4364	g_4365
Super-Scaffold_100006	33805347	33820423	15076	g_4365	g_4366
Super-Scaffold_100006	33820782	33828286	7504	g_4366	g_4367
Super-Scaffold_100006	33828624	33876521	47897	g_4367	g_42154
Super-Scaffold_100006	33876853	33885444	8591	g_42154	g_4368
Super-Scaffold_100006	33885707	33895199	9492	g_4368	g_4370
Super-Scaffold_100006	33895513	33953904	58391	g_4370	g_4372
Super-Scaffold_100006	33954482	33990943	36461	g_4372	g_4374
Super-Scaffold_100006	33996112	34042504	46392	g_4374	g_4375
Super-Scaffold_100006	34044231	34075518	31287	g_4375	g_4376
Super-Scaffold_100006	34076144	34096186	20042	g_4376	g_4377
Super-Scaffold_100006	34101350	34197113	95763	g_4377	g_4379
Super-Scaffold_100006	34198597	34199198	601	g_4379	g_4378
Super-Scaffold_100006	34199461	34208175	8714	g_4378	g_4380
Super-Scaffold_100006	34208723	34250394	41671	g_4380	g_4382
Super-Scaffold_100006	34251452	34311056	59604	g_4382	g_4384
Super-Scaffold_100006	34311541	34354471	42930	g_4384	g_4385
Super-Scaffold_100006	34356124	34367196	11072	g_4385	g_4386
Super-Scaffold_100006	34370810	34508355	137545	g_4386	g_4387
Super-Scaffold_100006	34510492	34515064	4572	g_4387	g_4388
Super-Scaffold_100006	34515330	34515458	128	g_4388	g_4389
Super-Scaffold_100006	34515895	34527910	12015	g_4389	g_4391
Super-Scaffold_100006	34534421	34599954	65533	g_4391	g_4392
Super-Scaffold_100006	34600697	34644862	44165	g_4392	g_4394
Super-Scaffold_100006	34656616	34683463	26847	g_4394	g_4395
Super-Scaffold_100006	34683858	34692154	8296	g_4395	g_43220
Super-Scaffold_100006	34715350	34816652	101302	g_43220	g_4396
Super-Scaffold_100006	34817191	34817792	601	g_4396	g_4397
Super-Scaffold_100006	34818178	34910649	92471	g_4397	g_4398
Super-Scaffold_100006	34912657	34962051	49394	g_4398	g_4399
Super-Scaffold_100006	34962525	35193339	230814	g_4400	g_4403
Super-Scaffold_100006	35194805	35194891	86	g_4403	g_4404
Super-Scaffold_100006	35195400	35195492	92	g_4404	g_4405
Super-Scaffold_100006	35196193	35212933	16740	g_4405	g_4406
Super-Scaffold_100006	35213589	35227186	13597	g_4406	g_4407
Super-Scaffold_100006	35227623	35227751	128	g_4407	g_4408
Super-Scaffold_100006	35228017	35293363	65346	g_4408	g_4412
Super-Scaffold_100006	35293905	35305748	11843	g_4412	g_4413
Super-Scaffold_100006	35307893	35318580	10687	g_4413	g_4414
Super-Scaffold_100006	35319908	35319977	69	g_4414	g_4415
Super-Scaffold_100006	35320570	35326880	6310	g_4415	g_4418
Super-Scaffold_100006	35327665	35353001	25336	g_4418	g_4419
Super-Scaffold_100006	35353531	35353624	93	g_4419	g_4420
Super-Scaffold_100006	35354310	35354366	56	g_4420	g_4421
Super-Scaffold_100006	35354581	35381842	27261	g_4421	g_4423
Super-Scaffold_100006	35393109	35404441	11332	g_4423	g_43221
Super-Scaffold_100006	35432569	35451793	19224	g_43221	g_4424
Super-Scaffold_100006	35485638	35574918	89280	g_4424	g_4425
Super-Scaffold_100006	35583087	35593490	10403	g_42168	g_4426
Super-Scaffold_100006	35594562	35648188	53626	g_4426	g_4428
Super-Scaffold_100006	35650296	35654272	3976	g_4428	g_42170
Super-Scaffold_100006	35673064	35713820	40756	g_4429	g_4430
Super-Scaffold_100006	35716020	35745736	29716	g_4430	g_43222
Super-Scaffold_100006	35747306	35749134	1828	g_43222	g_4431
Super-Scaffold_100006	35753780	35791798	38018	g_4431	g_4432
Super-Scaffold_100006	35793023	35813538	20515	g_4432	g_4433
Super-Scaffold_100006	35818602	35973945	155343	g_4433	g_4435
Super-Scaffold_100006	35974181	35981457	7276	g_4435	g_4436
Super-Scaffold_100006	35982368	36107018	124650	g_4436	g_4441
Super-Scaffold_100006	36109644	36153723	44079	g_4441	g_42177
Super-Scaffold_100006	36153950	36287589	133639	g_42177	g_4443
Super-Scaffold_100006	36299442	36300277	835	g_4443	g_4444
Super-Scaffold_100006	36306420	36308855	2435	g_4444	g_4445
Super-Scaffold_100006	36329950	36399108	69158	g_4445	g_42178
Super-Scaffold_100006	36399341	36513853	114512	g_42178	g_4448
Super-Scaffold_100006	36514380	36527295	12915	g_4448	g_4450
Super-Scaffold_100006	36528231	36658730	130499	g_4450	g_4454
Super-Scaffold_100006	36659062	36668899	9837	g_4454	g_4455
Super-Scaffold_100006	36677924	36741180	63256	g_4455	g_4456
Super-Scaffold_100006	36741566	36742821	1255	g_4456	g_4457
Super-Scaffold_100006	36743069	36802641	59572	g_4457	g_4459
Super-Scaffold_100006	36803468	36861547	58079	g_4459	g_4460
Super-Scaffold_100006	36874102	36875122	1020	g_4460	g_4461
Super-Scaffold_100006	36875433	36888353	12920	g_4461	g_4462
Super-Scaffold_100006	36890686	36895960	5274	g_4462	g_4463
Super-Scaffold_100006	36897716	36901491	3775	g_4463	g_4464
Super-Scaffold_100006	36924924	36941671	16747	g_4464	g_4466
Super-Scaffold_100006	36944856	36968186	23330	g_4465	g_4467
Super-Scaffold_100006	36984658	37008274	23616	g_4467	g_4468
Super-Scaffold_100006	37031657	37034975	3318	g_4468	g_4469
Super-Scaffold_100006	37052468	37054447	1979	g_4469	g_4470
Super-Scaffold_100006	37057647	37058460	813	g_4470	g_43223
Super-Scaffold_100006	37083150	37084153	1003	g_43223	g_4471
Super-Scaffold_100006	37122492	37343404	220912	g_4471	g_4480
Super-Scaffold_100006	37343613	37346644	3031	g_4480	g_4481
Super-Scaffold_100006	37359413	37417414	58001	g_4481	g_4482
Super-Scaffold_100006	37418457	37418513	56	g_4482	g_4483
Super-Scaffold_100006	37419241	37454325	35084	g_4483	g_4485
Super-Scaffold_100006	37455888	37483149	27261	g_4485	g_4489
Super-Scaffold_100006	37484195	37520138	35943	g_4489	g_4490
Super-Scaffold_100006	37521169	37591452	70283	g_4490	g_4491
Super-Scaffold_100006	37592891	37640891	48000	g_4491	g_4492
Super-Scaffold_100006	37644486	37645798	1312	g_4492	g_4493
Super-Scaffold_100006	37665386	37679046	13660	g_4493	g_4495
Super-Scaffold_100006	37680386	37691557	11171	g_4495	g_4496
Super-Scaffold_100006	37696145	37791724	95579	g_4496	g_4499
Super-Scaffold_100006	37792254	37812773	20519	g_4499	g_4500
Super-Scaffold_100006	37813042	37857815	44773	g_4500	g_4501
Super-Scaffold_100006	37858030	37861874	3844	g_4501	g_4502
Super-Scaffold_100006	37863374	37878056	14682	g_42186	g_4504
Super-Scaffold_100006	37878865	37879459	594	g_4504	g_4505
Super-Scaffold_100006	37880751	37974989	94238	g_4505	g_4509
Super-Scaffold_100007	70536	370265	299729	g_29012	g_29017
Super-Scaffold_100007	370561	370681	120	g_29017	g_29018
Super-Scaffold_100007	370980	371035	55	g_29018	g_29019
Super-Scaffold_100007	372857	592093	219236	g_29019	g_29024
Super-Scaffold_100007	593954	593986	32	g_29024	g_29025
Super-Scaffold_100007	594408	643449	49041	g_29025	g_29026
Super-Scaffold_100007	648185	650945	2760	g_29026	g_29027
Super-Scaffold_100007	652587	656225	3638	g_29027	g_29028
Super-Scaffold_100007	661898	698363	36465	g_29028	g_29029
Super-Scaffold_100007	698761	708348	9587	g_29029	g_29031
Super-Scaffold_100007	709874	709920	46	g_29031	g_29032
Super-Scaffold_100007	713302	713872	570	g_29033	g_29034
Super-Scaffold_100007	714171	714841	670	g_29034	g_29035
Super-Scaffold_100007	715125	738768	23643	g_29035	g_29036
Super-Scaffold_100007	766427	793131	26704	g_29036	g_45270
Super-Scaffold_100007	798719	839815	41096	g_45270	g_29037
Super-Scaffold_100007	846021	868796	22775	g_29037	g_29038
Super-Scaffold_100007	869095	908312	39217	g_29038	g_42194
Super-Scaffold_100007	908542	1006601	98059	g_42194	g_42196
Super-Scaffold_100007	1006801	1063196	56395	g_42196	g_29041
Super-Scaffold_100007	1063480	1078619	15139	g_29041	g_29043
Super-Scaffold_100007	1079008	1083705	4697	g_29043	g_29044
Super-Scaffold_100007	1084166	1122106	37940	g_29044	g_29045
Super-Scaffold_100007	1122438	1160826	38388	g_29045	g_29048
Super-Scaffold_100007	1161512	1185750	24238	g_29048	g_29049
Super-Scaffold_100007	1198266	1206891	8625	g_29049	g_42202
Super-Scaffold_100007	1207169	1214227	7058	g_42202	g_29051
Super-Scaffold_100007	1214622	1251527	36905	g_29051	g_29052
Super-Scaffold_100007	1259340	1261916	2576	g_29052	g_29053
Super-Scaffold_100007	1268585	1316958	48373	g_42203	g_45271
Super-Scaffold_100007	1338515	1436024	97509	g_45271	g_29057
Super-Scaffold_100007	1436820	1437411	591	g_29057	g_29058
Super-Scaffold_100007	1445017	1449906	4889	g_29058	g_29059
Super-Scaffold_100007	1452131	1453732	1601	g_29059	g_45272
Super-Scaffold_100007	1472495	1481974	9479	g_45272	g_29061
Super-Scaffold_100007	1503243	1528029	24786	g_29061	g_29062
Super-Scaffold_100007	1534902	1545416	10514	g_29062	g_29063
Super-Scaffold_100007	1548195	1602418	54223	g_29063	g_29064
Super-Scaffold_100007	1619613	1623772	4159	g_29064	g_29065
Super-Scaffold_100007	1632657	1648862	16205	g_29065	g_42206
Super-Scaffold_100007	1649089	1660478	11389	g_42206	g_29066
Super-Scaffold_100007	1669726	1690381	20655	g_29066	g_29067
Super-Scaffold_100007	1691141	1698827	7686	g_42207	g_29068
Super-Scaffold_100007	1699849	1700460	611	g_29068	g_45273
Super-Scaffold_100007	1709997	1714460	4463	g_45273	g_29069
Super-Scaffold_100007	1714675	1718630	3955	g_29069	g_29070
Super-Scaffold_100007	1721514	1721828	314	g_29070	g_29071
Super-Scaffold_100007	1738431	1762102	23671	g_29071	g_29075
Super-Scaffold_100007	1763099	1812661	49562	g_29075	g_29076
Super-Scaffold_100007	1812879	1895243	82364	g_29076	g_29081
Super-Scaffold_100007	1895614	1945813	50199	g_29081	g_29082
Super-Scaffold_100007	1949801	1950671	870	g_29082	g_42208
Super-Scaffold_100007	1950907	2014571	63664	g_42208	g_29084
Super-Scaffold_100007	2015917	2042014	26097	g_29084	g_29087
Super-Scaffold_100007	2042244	2107728	65484	g_29087	g_29088
Super-Scaffold_100007	2107937	2119318	11381	g_29088	g_29089
Super-Scaffold_100007	2125195	2127061	1866	g_29089	g_29090
Super-Scaffold_100007	2129265	2136074	6809	g_29090	g_29091
Super-Scaffold_100007	2151064	2153991	2927	g_29091	g_29092
Super-Scaffold_100007	2155010	2167087	12077	g_29092	g_29093
Super-Scaffold_100007	2190935	2194117	3182	g_29093	g_29094
Super-Scaffold_100007	2208980	2224042	15062	g_29094	g_29095
Super-Scaffold_100007	2231935	2259833	27898	g_29095	g_29096
Super-Scaffold_100007	2269469	2271882	2413	g_29096	g_29097
Super-Scaffold_100007	2272973	2384597	111624	g_29097	g_29100
Super-Scaffold_100007	2401702	2471111	69409	g_29100	g_29101
Super-Scaffold_100007	2471341	2475044	3703	g_29101	g_29102
Super-Scaffold_100007	2500000	2520441	20441	g_29102	g_29103
Super-Scaffold_100007	2541940	2555073	13133	g_29103	g_29105
Super-Scaffold_100007	2558331	2561327	2996	g_29105	g_29106
Super-Scaffold_100007	2579982	2580699	717	g_29106	g_29107
Super-Scaffold_100007	2584824	2657586	72762	g_29107	g_29110
Super-Scaffold_100007	2669722	2679504	9782	g_29110	g_29111
Super-Scaffold_100007	2684628	2685663	1035	g_29111	g_45274
Super-Scaffold_100007	2688874	2701578	12704	g_45274	g_29112
Super-Scaffold_100007	2703883	2704555	672	g_29112	g_29113
Super-Scaffold_100007	2711629	2713183	1554	g_29113	g_29114
Super-Scaffold_100007	2721446	2725496	4050	g_29114	g_29115
Super-Scaffold_100007	2742158	2746839	4681	g_29115	g_45275
Super-Scaffold_100007	2763141	2775325	12184	g_45275	g_29116
Super-Scaffold_100007	2802782	2814423	11641	g_29116	g_29117
Super-Scaffold_100007	2815364	2828309	12945	g_29117	g_29118
Super-Scaffold_100007	2828542	2844365	15823	g_29118	g_29119
Super-Scaffold_100007	2845003	2866256	21253	g_29119	g_29121
Super-Scaffold_100007	2867116	3032772	165656	g_29121	g_29124
Super-Scaffold_100007	3033161	3096881	63720	g_29124	g_29127
Super-Scaffold_100007	3097411	3097722	311	g_29127	g_29125
Super-Scaffold_100007	3098246	3099022	776	g_29125	g_29128
Super-Scaffold_100007	3100140	3100162	22	g_29128	g_29129
Super-Scaffold_100007	3100950	3101048	98	g_29129	g_29130
Super-Scaffold_100007	3101347	3107276	5929	g_29130	g_29132
Super-Scaffold_100007	3107860	3109577	1717	g_29132	g_29133
Super-Scaffold_100007	3110152	3127273	17121	g_29133	g_29134
Super-Scaffold_100007	3127983	3183800	55817	g_29134	g_29135
Super-Scaffold_100007	3188852	3194669	5817	g_29135	g_29136
Super-Scaffold_100007	3194941	3201703	6762	g_29136	g_29137
Super-Scaffold_100007	3227672	3311891	84219	g_29137	g_29139
Super-Scaffold_100007	3313237	3317306	4069	g_29139	g_29140
Super-Scaffold_100007	3317848	3516877	199029	g_29140	g_29143
Super-Scaffold_100007	3517338	3549775	32437	g_29143	g_29144
Super-Scaffold_100007	3554525	3584214	29689	g_29144	g_29146
Super-Scaffold_100007	3588182	3590816	2634	g_29146	g_29147
Super-Scaffold_100007	3591058	3595956	4898	g_29147	g_29148
Super-Scaffold_100007	3598511	3627554	29043	g_29148	g_29150
Super-Scaffold_100007	3627778	3657144	29366	g_29150	g_29151
Super-Scaffold_100007	3658391	3780493	122102	g_29151	g_29153
Super-Scaffold_100007	3780882	3781640	758	g_29153	g_29154
Super-Scaffold_100007	3782407	3853409	71002	g_29154	g_29155
Super-Scaffold_100007	3856371	3865796	9425	g_29155	g_29156
Super-Scaffold_100007	3866131	3883047	16916	g_29156	g_29157
Super-Scaffold_100007	3883277	3904759	21482	g_29157	g_42226
Super-Scaffold_100007	3904974	3913750	8776	g_42226	g_29160
Super-Scaffold_100007	3914055	3924777	10722	g_29160	g_29161
Super-Scaffold_100007	3924977	3943895	18918	g_29161	g_29162
Super-Scaffold_100007	3951960	4130164	178204	g_29162	g_29169
Super-Scaffold_100007	4142196	4145849	3653	g_29169	g_29170
Super-Scaffold_100007	4158687	4163027	4340	g_29170	g_29171
Super-Scaffold_100007	4163230	4169579	6349	g_29171	g_29172
Super-Scaffold_100007	4170414	4170598	184	g_29172	g_29173
Super-Scaffold_100007	4172945	4212684	39739	g_29173	g_29174
Super-Scaffold_100007	4214940	4215137	197	g_29174	g_29175
Super-Scaffold_100007	4221755	4233432	11677	g_29175	g_29176
Super-Scaffold_100007	4233641	4241259	7618	g_29176	g_29177
Super-Scaffold_100007	4243790	4248462	4672	g_29177	g_29178
Super-Scaffold_100007	4277692	4289281	11589	g_29178	g_29179
Super-Scaffold_100007	4293622	4297881	4259	g_29179	g_29180
Super-Scaffold_100007	4299881	4331607	31726	g_29180	g_29181
Super-Scaffold_100007	4332723	4346249	13526	g_29181	g_45276
Super-Scaffold_100007	4353615	4354418	803	g_45276	g_45277
Super-Scaffold_100007	4358649	4358678	29	g_45277	g_45278
Super-Scaffold_100007	4359131	4361603	2472	g_45278	g_29182
Super-Scaffold_100007	4362020	4364206	2186	g_29182	g_29183
Super-Scaffold_100007	4365906	4367152	1246	g_29183	g_29184
Super-Scaffold_100007	4373044	4415495	42451	g_29184	g_29185
Super-Scaffold_100007	4416334	4424038	7704	g_29185	g_29186
Super-Scaffold_100007	4425663	4429789	4126	g_29186	g_29187
Super-Scaffold_100007	4449855	4454028	4173	g_29187	g_29188
Super-Scaffold_100007	4455506	4471141	15635	g_29188	g_29189
Super-Scaffold_100007	4472715	4512620	39905	g_29189	g_29191
Super-Scaffold_100007	4512865	4602588	89723	g_29191	g_29195
Super-Scaffold_100007	4602860	4611550	8690	g_29195	g_29196
Super-Scaffold_100007	4626851	4637821	10970	g_29196	g_29197
Super-Scaffold_100007	4645032	4647126	2094	g_29197	g_29198
Super-Scaffold_100007	4655952	4664801	8849	g_29198	g_29199
Super-Scaffold_100007	4669530	4670624	1094	g_29199	g_29200
Super-Scaffold_100007	4676139	4678875	2736	g_29200	g_29201
Super-Scaffold_100007	4680455	4681361	906	g_29201	g_29202
Super-Scaffold_100007	4683475	4684540	1065	g_29202	g_29203
Super-Scaffold_100007	4688614	4767329	78715	g_29203	g_29205
Super-Scaffold_100007	4775090	4819401	44311	g_29205	g_29206
Super-Scaffold_100007	4831326	4878689	47363	g_29206	g_29207
Super-Scaffold_100007	4878943	4889335	10392	g_29207	g_29208
Super-Scaffold_100007	4897767	4953817	56050	g_29208	g_29210
Super-Scaffold_100007	4955100	4959259	4159	g_29210	g_29211
Super-Scaffold_100007	4978508	4986701	8193	g_29211	g_29212
Super-Scaffold_100007	4987876	5067918	80042	g_29212	g_29215
Super-Scaffold_100007	5120161	5161405	41244	g_29215	g_29216
Super-Scaffold_100007	5162452	5170674	8222	g_29216	g_42235
Super-Scaffold_100007	5170895	5265137	94242	g_42235	g_29218
Super-Scaffold_100007	5268359	5338275	69916	g_29218	g_29219
Super-Scaffold_100007	5339310	5477781	138471	g_29219	g_29220
Super-Scaffold_100007	5480205	5540742	60537	g_29220	g_29221
Super-Scaffold_100007	5541110	5588279	47169	g_29221	g_29222
Super-Scaffold_100007	5589729	5793251	203522	g_29222	g_29223
Super-Scaffold_100007	5793655	5894979	101324	g_29223	g_29226
Super-Scaffold_100007	5910071	5984303	74232	g_29226	g_29228
Super-Scaffold_100007	5984587	6300237	315650	g_29228	g_29229
Super-Scaffold_100007	6300647	6301056	409	g_29229	g_29230
Super-Scaffold_100007	6301769	6302165	396	g_29230	g_29231
Super-Scaffold_100007	6302743	6307479	4736	g_29231	g_29232
Super-Scaffold_100007	6316184	6346637	30453	g_29232	g_29233
Super-Scaffold_100007	6346864	6354255	7391	g_29233	g_29234
Super-Scaffold_100007	6354848	6440741	85893	g_29234	g_29235
Super-Scaffold_100007	6441004	6472048	31044	g_29235	g_29236
Super-Scaffold_100007	6473523	6781578	308055	g_29236	g_29240
Super-Scaffold_100007	6781790	6812527	30737	g_29240	g_45279
Super-Scaffold_100007	6828676	6862721	34045	g_45279	g_29241
Super-Scaffold_100007	6877381	6883849	6468	g_29241	g_29242
Super-Scaffold_100007	6893467	6899093	5626	g_29242	g_29243
Super-Scaffold_100007	6910440	7060218	149778	g_29243	g_29245
Super-Scaffold_100007	7067219	7105126	37907	g_29245	g_29246
Super-Scaffold_100007	7112435	7115172	2737	g_29246	g_29247
Super-Scaffold_100007	7115417	7135973	20556	g_29247	g_29248
Super-Scaffold_100007	7136797	7153424	16627	g_29248	g_29249
Super-Scaffold_100007	7161029	7162917	1888	g_29249	g_29250
Super-Scaffold_100007	7173041	7192231	19190	g_29250	g_29251
Super-Scaffold_100007	7203135	7285969	82834	g_29251	g_29254
Super-Scaffold_100007	7299935	7305215	5280	g_29254	g_29255
Super-Scaffold_100007	7316485	7361992	45507	g_29255	g_29257
Super-Scaffold_100007	7371657	7378291	6634	g_29257	g_29258
Super-Scaffold_100007	7381973	7396695	14722	g_29258	g_29259
Super-Scaffold_100007	7411856	7419665	7809	g_29259	g_29260
Super-Scaffold_100007	7425297	7427735	2438	g_29260	g_29261
Super-Scaffold_100007	7431030	7435634	4604	g_29261	g_29262
Super-Scaffold_100007	7441091	7459422	18331	g_29262	g_29263
Super-Scaffold_100007	7465635	7482883	17248	g_29263	g_29264
Super-Scaffold_100007	7489401	7490042	641	g_29264	g_29265
Super-Scaffold_100007	7504033	7513962	9929	g_29265	g_45280
Super-Scaffold_100007	7532071	7563904	31833	g_45280	g_29266
Super-Scaffold_100007	7565458	7566876	1418	g_29266	g_29267
Super-Scaffold_100007	7578369	7579385	1016	g_29267	g_29268
Super-Scaffold_100007	7579756	7584019	4263	g_29268	g_29269
Super-Scaffold_100007	7592351	7613424	21073	g_29269	g_29271
Super-Scaffold_100007	7615722	7620328	4606	g_29271	g_29272
Super-Scaffold_100007	7631082	7634300	3218	g_29272	g_45281
Super-Scaffold_100007	7640360	7641585	1225	g_45281	g_29273
Super-Scaffold_100007	7666705	7671933	5228	g_29273	g_29274
Super-Scaffold_100007	7678097	7679443	1346	g_29274	g_45282
Super-Scaffold_100007	7681468	7682243	775	g_45282	g_29275
Super-Scaffold_100007	7687094	7694500	7406	g_29275	g_29276
Super-Scaffold_100007	7697182	7700912	3730	g_29276	g_29277
Super-Scaffold_100007	7701112	7710958	9846	g_29277	g_29278
Super-Scaffold_100007	7735554	7776800	41246	g_29278	g_29279
Super-Scaffold_100007	7780654	7811845	31191	g_29279	g_29281
Super-Scaffold_100007	7817218	7841121	23903	g_29281	g_29283
Super-Scaffold_100007	7843019	7844999	1980	g_29283	g_29282
Super-Scaffold_100007	7861138	7881035	19897	g_29282	g_29284
Super-Scaffold_100007	7896038	7935226	39188	g_29284	g_29286
Super-Scaffold_100007	7944568	7975722	31154	g_29286	g_29287
Super-Scaffold_100007	7976279	8034802	58523	g_29287	g_29288
Super-Scaffold_100007	8035389	8035470	81	g_29288	g_29289
Super-Scaffold_100007	8035685	8036216	531	g_29289	g_29290
Super-Scaffold_100007	8036901	8036958	57	g_29290	g_29291
Super-Scaffold_100007	8037407	8037664	257	g_29291	g_29292
Super-Scaffold_100007	8039499	8100540	61041	g_29292	g_29293
Super-Scaffold_100007	8101960	8167686	65726	g_29293	g_29295
Super-Scaffold_100007	8168436	8170163	1727	g_29295	g_45283
Super-Scaffold_100007	8170390	8197748	27358	g_45283	g_29296
Super-Scaffold_100007	8198188	8217228	19040	g_29296	g_29298
Super-Scaffold_100007	8218196	8405286	187090	g_29298	g_29302
Super-Scaffold_100007	8405675	8461503	55828	g_29302	g_29304
Super-Scaffold_100007	8466310	8529410	63100	g_29304	g_29306
Super-Scaffold_100007	8529673	8549305	19632	g_29306	g_29307
Super-Scaffold_100007	8550201	8565098	14897	g_29307	g_29308
Super-Scaffold_100007	8572155	8588834	16679	g_29308	g_29309
Super-Scaffold_100007	8594681	8608016	13335	g_29309	g_29310
Super-Scaffold_100007	8625449	8628889	3440	g_29310	g_29311
Super-Scaffold_100007	8632173	8728965	96792	g_29311	g_29313
Super-Scaffold_100007	8732865	8775447	42582	g_29313	g_29314
Super-Scaffold_100007	8779339	8820676	41337	g_29314	g_42247
Super-Scaffold_100007	8820966	8896330	75364	g_42247	g_29316
Super-Scaffold_100007	8904116	8969741	65625	g_29316	g_29318
Super-Scaffold_100007	8985568	9020100	34532	g_29318	g_29320
Super-Scaffold_100007	9038395	9047273	8878	g_29320	g_29321
Super-Scaffold_100007	9074462	9078516	4054	g_29321	g_29322
Super-Scaffold_100007	9094395	9116631	22236	g_29322	g_29323
Super-Scaffold_100007	9142053	9156227	14174	g_29323	g_29324
Super-Scaffold_100007	9167699	9171608	3909	g_29324	g_29325
Super-Scaffold_100007	9172003	9190015	18012	g_29325	g_29326
Super-Scaffold_100007	9196055	9197230	1175	g_29326	g_29327
Super-Scaffold_100007	9205119	9209665	4546	g_29327	g_29328
Super-Scaffold_100007	9234930	9302227	67297	g_29328	g_29330
Super-Scaffold_100007	9308036	9310144	2108	g_29330	g_29331
Super-Scaffold_100007	9319800	9323745	3945	g_29331	g_29332
Super-Scaffold_100007	9342577	9343844	1267	g_29332	g_29333
Super-Scaffold_100007	9345445	9345789	344	g_29333	g_29334
Super-Scaffold_100007	9346691	9346946	255	g_29334	g_29335
Super-Scaffold_100007	9348846	9349349	503	g_29335	g_45284
Super-Scaffold_100007	9359891	9374828	14937	g_45284	g_29336
Super-Scaffold_100007	9376432	9454743	78311	g_29336	g_29338
Super-Scaffold_100007	9471918	9472878	960	g_29338	g_45285
Super-Scaffold_100007	9479812	9486498	6686	g_45285	g_29340
Super-Scaffold_100007	9487250	9493877	6627	g_29340	g_29342
Super-Scaffold_100007	9495211	9499206	3995	g_29342	g_29343
Super-Scaffold_100007	9500540	9515741	15201	g_29343	g_29344
Super-Scaffold_100007	9517075	9526965	9890	g_29344	g_29345
Super-Scaffold_100007	9528302	9532296	3994	g_29345	g_29346
Super-Scaffold_100007	9533633	9537625	3992	g_29346	g_29347
Super-Scaffold_100007	9538959	9548720	9761	g_29347	g_29348
Super-Scaffold_100007	9550054	9554050	3996	g_29348	g_45286
Super-Scaffold_100007	9555438	9610238	54800	g_45286	g_29349
Super-Scaffold_100007	9615568	9623136	7568	g_29349	g_29350
Super-Scaffold_100007	9632449	9670348	37899	g_29350	g_29352
Super-Scaffold_100007	9672047	9729144	57097	g_29352	g_29353
Super-Scaffold_100007	9730862	9787960	57098	g_29353	g_29354
Super-Scaffold_100007	9789204	9839705	50501	g_29354	g_29356
Super-Scaffold_100007	9841424	9872166	30742	g_29356	g_29357
Super-Scaffold_100007	9884113	9904332	20219	g_29357	g_29358
Super-Scaffold_100007	9918790	9925497	6707	g_29358	g_29360
Super-Scaffold_100007	9925775	9930101	4326	g_29360	g_29361
Super-Scaffold_100007	9952699	9956049	3350	g_29361	g_29362
Super-Scaffold_100007	9956339	9973268	16929	g_29362	g_29363
Super-Scaffold_100007	9975556	9977509	1953	g_29363	g_29364
Super-Scaffold_100007	9984250	10028569	44319	g_29364	g_29365
Super-Scaffold_100007	10039886	10052578	12692	g_29365	g_29367
Super-Scaffold_100007	10066720	10133961	67241	g_29367	g_29369
Super-Scaffold_100007	10146139	10299026	152887	g_29369	g_29372
Super-Scaffold_100007	10299463	10439129	139666	g_29372	g_29376
Super-Scaffold_100007	10439344	10460229	20885	g_29376	g_29377
Super-Scaffold_100007	10466863	10475300	8437	g_29377	g_29378
Super-Scaffold_100007	10480145	10555364	75219	g_29378	g_29380
Super-Scaffold_100007	10570918	10615053	44135	g_29380	g_29381
Super-Scaffold_100007	10615316	10731397	116081	g_29381	g_29385
Super-Scaffold_100007	10731762	10834631	102869	g_29385	g_42258
Super-Scaffold_100007	10834852	10955242	120390	g_42258	g_29389
Super-Scaffold_100007	10974272	10980248	5976	g_29389	g_29391
Super-Scaffold_100007	10982121	10984391	2270	g_29391	g_29392
Super-Scaffold_100007	10991643	10994453	2810	g_29392	g_29393
Super-Scaffold_100007	11020498	11060997	40499	g_29393	g_29394
Super-Scaffold_100007	11065578	11084933	19355	g_29394	g_29396
Super-Scaffold_100007	11093580	11098819	5239	g_29396	g_45287
Super-Scaffold_100007	11107125	11109709	2584	g_45287	g_29397
Super-Scaffold_100007	11114578	11115261	683	g_29397	g_29398
Super-Scaffold_100007	11117644	11119402	1758	g_29398	g_29399
Super-Scaffold_100007	11124086	11131462	7376	g_29399	g_29400
Super-Scaffold_100007	11131740	11133707	1967	g_29400	g_29401
Super-Scaffold_100007	11133973	11134054	81	g_29401	g_45288
Super-Scaffold_100007	11142795	11162291	19496	g_45288	g_29402
Super-Scaffold_100007	11172714	11183959	11245	g_29402	g_29403
Super-Scaffold_100007	11197808	11222318	24510	g_29403	g_42261
Super-Scaffold_100007	11222581	11276718	54137	g_42261	g_29406
Super-Scaffold_100007	11277059	11282830	5771	g_29406	g_42264
Super-Scaffold_100007	11283269	11361608	78339	g_29407	g_29409
Super-Scaffold_100007	11363011	11387884	24873	g_29409	g_29410
Super-Scaffold_100007	11390851	11396118	5267	g_29410	g_29411
Super-Scaffold_100007	11396993	11531718	134725	g_29411	g_29413
Super-Scaffold_100007	11537122	11540158	3036	g_29413	g_29414
Super-Scaffold_100007	11548277	11551016	2739	g_29414	g_29415
Super-Scaffold_100007	11557647	11558710	1063	g_29415	g_29416
Super-Scaffold_100007	11560844	11562527	1683	g_29416	g_29417
Super-Scaffold_100007	11582240	11582757	517	g_29417	g_29418
Super-Scaffold_100007	11583098	11591660	8562	g_29418	g_29419
Super-Scaffold_100007	11616005	11621509	5504	g_29419	g_29420
Super-Scaffold_100007	11627058	11629061	2003	g_29420	g_29421
Super-Scaffold_100007	11645814	11661063	15249	g_29421	g_29423
Super-Scaffold_100007	11662336	11664753	2417	g_29423	g_29424
Super-Scaffold_100007	11666648	11676715	10067	g_29424	g_29425
Super-Scaffold_100007	11681319	11689999	8680	g_29425	g_29426
Super-Scaffold_100007	11696002	11765808	69806	g_29426	g_29427
Super-Scaffold_100007	11767238	11826443	59205	g_29427	g_29429
Super-Scaffold_100007	11864500	11870750	6250	g_29429	g_29430
Super-Scaffold_100007	11889503	11892269	2766	g_29430	g_29431
Super-Scaffold_100007	11895332	11897480	2148	g_29431	g_29432
Super-Scaffold_100007	11899265	11903957	4692	g_29432	g_29433
Super-Scaffold_100007	11927288	11932197	4909	g_29433	g_29434
Super-Scaffold_100007	11932406	11939168	6762	g_29434	g_29436
Super-Scaffold_100007	11939374	11940309	935	g_29436	g_29437
Super-Scaffold_100007	11968079	11973936	5857	g_29437	g_29438
Super-Scaffold_100007	11981087	11985374	4287	g_29438	g_29439
Super-Scaffold_100007	11992143	11992620	477	g_29439	g_29440
Super-Scaffold_100007	11996054	11997751	1697	g_29440	g_29441
Super-Scaffold_100007	12000439	12070117	69678	g_29441	g_29443
Super-Scaffold_100007	12082805	12089121	6316	g_29443	g_29444
Super-Scaffold_100007	12101515	12134573	33058	g_29444	g_42276
Super-Scaffold_100007	12134788	12152693	17905	g_42276	g_29445
Super-Scaffold_100007	12164411	12165889	1478	g_29445	g_29446
Super-Scaffold_100007	12172907	12243509	70602	g_29446	g_29449
Super-Scaffold_100007	12244435	12303814	59379	g_29449	g_29452
Super-Scaffold_100007	12304050	12384326	80276	g_29452	g_29458
Super-Scaffold_100007	12413081	12424315	11234	g_29458	g_29459
Super-Scaffold_100007	12428319	12431601	3282	g_29459	g_29460
Super-Scaffold_100007	12457397	12478045	20648	g_29460	g_29461
Super-Scaffold_100007	12480327	12503884	23557	g_29461	g_29462
Super-Scaffold_100007	12522810	12677765	154955	g_29462	g_29464
Super-Scaffold_100007	12686840	12689903	3063	g_29464	g_29465
Super-Scaffold_100007	12694862	12734295	39433	g_29465	g_29466
Super-Scaffold_100007	12738994	12753136	14142	g_29466	g_29467
Super-Scaffold_100007	12760981	12778911	17930	g_29467	g_29468
Super-Scaffold_100007	12780065	12888363	108298	g_29468	g_29470
Super-Scaffold_100007	12896029	12906749	10720	g_29470	g_29474
Super-Scaffold_100007	12909276	12928839	19563	g_29474	g_29476
Super-Scaffold_100007	12929255	12990872	61617	g_29476	g_29478
Super-Scaffold_100007	12994847	13101853	107006	g_29478	g_29480
Super-Scaffold_100007	13109058	13123403	14345	g_29480	g_29481
Super-Scaffold_100007	13123660	13124269	609	g_29481	g_29482
Super-Scaffold_100007	13124727	13274772	150045	g_29482	g_29484
Super-Scaffold_100007	13276305	13276658	353	g_29484	g_29485
Super-Scaffold_100007	13276885	13349428	72543	g_29485	g_29486
Super-Scaffold_100007	13349925	13350001	76	g_29486	g_29487
Super-Scaffold_100007	13350555	13499035	148480	g_29487	g_29488
Super-Scaffold_100007	13523659	13540020	16361	g_29488	g_29489
Super-Scaffold_100007	13540244	13659106	118862	g_29489	g_29490
Super-Scaffold_100007	13660758	13665632	4874	g_29490	g_29491
Super-Scaffold_100007	13665856	13678481	12625	g_29491	g_29492
Super-Scaffold_100007	13678693	13697953	19260	g_29492	g_29493
Super-Scaffold_100007	13698159	13777215	79056	g_29493	g_29494
Super-Scaffold_100007	13778312	13778719	407	g_29494	g_29495
Super-Scaffold_100007	13779237	13816794	37557	g_29495	g_29496
Super-Scaffold_100007	13818524	13823162	4638	g_29496	g_29497
Super-Scaffold_100007	13824573	13833138	8565	g_29497	g_29498
Super-Scaffold_100007	13835012	13841902	6890	g_29498	g_29499
Super-Scaffold_100007	13847926	13849040	1114	g_29499	g_29500
Super-Scaffold_100007	13851914	13872248	20334	g_29500	g_29501
Super-Scaffold_100007	13872952	13924731	51779	g_29501	g_29502
Super-Scaffold_100007	13926053	13956629	30576	g_29502	g_29504
Super-Scaffold_100007	13956907	14157576	200669	g_29504	g_29505
Super-Scaffold_100007	14159165	14159701	536	g_29505	g_29506
Super-Scaffold_100007	14161587	14196415	34828	g_29506	g_29507
Super-Scaffold_100007	14199033	14226152	27119	g_29507	g_29508
Super-Scaffold_100007	14227100	14277957	50857	g_29508	g_29510
Super-Scaffold_100007	14291100	14291130	30	g_29510	g_45289
Super-Scaffold_100007	14294650	14318648	23998	g_45289	g_42282
Super-Scaffold_100007	14319790	14322702	2912	g_42282	g_29512
Super-Scaffold_100007	14350712	14353521	2809	g_29512	g_29513
Super-Scaffold_100007	14363095	14365706	2611	g_29513	g_29514
Super-Scaffold_100007	14373173	14376073	2900	g_29514	g_45290
Super-Scaffold_100007	14384605	14414303	29698	g_45290	g_29515
Super-Scaffold_100007	14429774	14437338	7564	g_29515	g_29516
Super-Scaffold_100007	14445800	14468224	22424	g_29516	g_29518
Super-Scaffold_100007	14468887	14512134	43247	g_29518	g_29519
Super-Scaffold_100007	14524925	14526786	1861	g_29519	g_29520
Super-Scaffold_100007	14534857	14571129	36272	g_29520	g_29522
Super-Scaffold_100007	14576609	14587495	10886	g_29522	g_29523
Super-Scaffold_100007	14598704	14619131	20427	g_29523	g_29525
Super-Scaffold_100007	14630178	14632345	2167	g_29525	g_29526
Super-Scaffold_100007	14639735	14717590	77855	g_29526	g_29528
Super-Scaffold_100007	14717952	14721039	3087	g_29528	g_29529
Super-Scaffold_100007	14721488	14750773	29285	g_29529	g_29530
Super-Scaffold_100007	14751732	14798041	46309	g_29530	g_29531
Super-Scaffold_100007	14802866	14818075	15209	g_29531	g_29532
Super-Scaffold_100007	14818335	14890780	72445	g_29532	g_29533
Super-Scaffold_100007	14891073	14897373	6300	g_29533	g_42287
Super-Scaffold_100007	14897840	14909995	12155	g_42287	g_29534
Super-Scaffold_100007	14910282	14977602	67320	g_29534	g_29537
Super-Scaffold_100007	15020276	15026045	5769	g_29537	g_29538
Super-Scaffold_100007	15036064	15037051	987	g_29538	g_29539
Super-Scaffold_100007	15042472	15044580	2108	g_29539	g_29540
Super-Scaffold_100007	15049122	15054251	5129	g_29540	g_29541
Super-Scaffold_100007	15069472	15099092	29620	g_29541	g_29542
Super-Scaffold_100007	15107782	15120449	12667	g_29542	g_29543
Super-Scaffold_100007	15126151	15127586	1435	g_29543	g_29544
Super-Scaffold_100007	15129261	15130321	1060	g_29544	g_29545
Super-Scaffold_100007	15141569	15144194	2625	g_29545	g_29546
Super-Scaffold_100007	15153847	15154052	205	g_29546	g_29547
Super-Scaffold_100007	15154594	15170580	15986	g_29547	g_29548
Super-Scaffold_100007	15179138	15193410	14272	g_29548	g_45291
Super-Scaffold_100007	15238745	15240996	2251	g_45291	g_29549
Super-Scaffold_100007	15246534	15259556	13022	g_29549	g_29550
Super-Scaffold_100007	15263479	15270993	7514	g_29550	g_29551
Super-Scaffold_100007	15278460	15281973	3513	g_29551	g_29552
Super-Scaffold_100007	15292048	15293806	1758	g_29552	g_29553
Super-Scaffold_100007	15294726	15298113	3387	g_29553	g_45292
Super-Scaffold_100007	15300717	15311709	10992	g_45292	g_29554
Super-Scaffold_100007	15320309	15324605	4296	g_29554	g_29555
Super-Scaffold_100007	15330030	15332683	2653	g_29555	g_45293
Super-Scaffold_100007	15341442	15469189	127747	g_45293	g_29558
Super-Scaffold_100007	15470963	15489865	18902	g_29558	g_29559
Super-Scaffold_100007	15490221	15528046	37825	g_29559	g_29560
Super-Scaffold_100007	15530269	15532393	2124	g_29560	g_29561
Super-Scaffold_100007	15532809	15533380	571	g_29561	g_29562
Super-Scaffold_100007	15533685	15536934	3249	g_29562	g_29563
Super-Scaffold_100007	15544731	15582544	37813	g_29563	g_29565
Super-Scaffold_100007	15599834	15611443	11609	g_29565	g_45294
Super-Scaffold_100007	15611754	15611930	176	g_45294	g_29566
Super-Scaffold_100007	15612316	15649849	37533	g_29566	g_29568
Super-Scaffold_100007	15655687	15774251	118564	g_29568	g_29571
Super-Scaffold_100007	15780239	15783450	3211	g_29571	g_29572
Super-Scaffold_100007	15809988	15873804	63816	g_29572	g_29574
Super-Scaffold_100007	15889602	15938072	48470	g_29574	g_29576
Super-Scaffold_100007	15952115	16044034	91919	g_29576	g_29577
Super-Scaffold_100007	16049523	16056268	6745	g_29577	g_29578
Super-Scaffold_100007	16066813	16068051	1238	g_29578	g_29579
Super-Scaffold_100007	16073310	16076759	3449	g_29579	g_29580
Super-Scaffold_100007	16094658	16120085	25427	g_29580	g_29581
Super-Scaffold_100007	16136734	16144238	7504	g_29581	g_29582
Super-Scaffold_100007	16146337	16154822	8485	g_29582	g_29583
Super-Scaffold_100007	16157904	16165985	8081	g_29583	g_42296
Super-Scaffold_100007	16166185	16217501	51316	g_42296	g_29586
Super-Scaffold_100007	16255203	16258929	3726	g_29586	g_45295
Super-Scaffold_100007	16266840	16277976	11136	g_45295	g_45296
Super-Scaffold_100007	16291873	16300396	8523	g_45296	g_29587
Super-Scaffold_100007	16302268	16302365	97	g_29587	g_42297
Super-Scaffold_100007	16302577	16309118	6541	g_42297	g_29588
Super-Scaffold_100007	16309435	16317052	7617	g_29588	g_42299
Super-Scaffold_100007	16317303	16362431	45128	g_42299	g_29589
Super-Scaffold_100007	16377754	16381331	3577	g_29589	g_29590
Super-Scaffold_100007	16393978	16396163	2185	g_29590	g_29591
Super-Scaffold_100007	16412610	16434577	21967	g_29591	g_29593
Super-Scaffold_100007	16435823	16476391	40568	g_29593	g_29595
Super-Scaffold_100007	16477089	16502641	25552	g_29595	g_29598
Super-Scaffold_100007	16505336	16513302	7966	g_29598	g_29599
Super-Scaffold_100007	16516109	16516855	746	g_29599	g_29600
Super-Scaffold_100007	16517876	16559454	41578	g_29600	g_29601
Super-Scaffold_100007	16562967	16638879	75912	g_29601	g_29602
Super-Scaffold_100007	16640067	16644264	4197	g_29602	g_42300
Super-Scaffold_100007	16644482	16701797	57315	g_42300	g_42303
Super-Scaffold_100007	16702036	16819078	117042	g_42303	g_29604
Super-Scaffold_100007	16834609	16892977	58368	g_29604	g_29606
Super-Scaffold_100007	16899635	16930359	30724	g_29606	g_29608
Super-Scaffold_100007	16933661	16935748	2087	g_29608	g_29609
Super-Scaffold_100007	16944628	16946881	2253	g_29609	g_29610
Super-Scaffold_100007	16955247	17049601	94354	g_29610	g_29614
Super-Scaffold_100007	17049912	17079586	29674	g_29614	g_29616
Super-Scaffold_100007	17080752	17086647	5895	g_29616	g_29617
Super-Scaffold_100007	17104242	17110904	6662	g_29617	g_29618
Super-Scaffold_100007	17111110	17118429	7319	g_29618	g_29619
Super-Scaffold_100007	17128284	17131377	3093	g_29619	g_29620
Super-Scaffold_100007	17139791	17254229	114438	g_29620	g_29623
Super-Scaffold_100007	17254483	17259214	4731	g_29623	g_29624
Super-Scaffold_100007	17269108	17305858	36750	g_29624	g_29626
Super-Scaffold_100007	17306073	17313548	7475	g_29626	g_29627
Super-Scaffold_100007	17313778	17374687	60909	g_29627	g_29629
Super-Scaffold_100007	17374926	17428974	54048	g_29629	g_29630
Super-Scaffold_100007	17454416	17458766	4350	g_29630	g_29632
Super-Scaffold_100007	17459080	17480123	21043	g_29632	g_29633
Super-Scaffold_100007	17507296	17519753	12457	g_29633	g_29634
Super-Scaffold_100007	17525536	17537211	11675	g_29634	g_29636
Super-Scaffold_100007	17555789	17606605	50816	g_29636	g_29637
Super-Scaffold_100007	17614603	17634840	20237	g_29637	g_29638
Super-Scaffold_100007	17644522	17648966	4444	g_29638	g_29639
Super-Scaffold_100007	17657099	17660647	3548	g_29639	g_29640
Super-Scaffold_100007	17661697	17699857	38160	g_29640	g_29642
Super-Scaffold_100007	17700702	17703910	3208	g_29642	g_29643
Super-Scaffold_100007	17708752	17728577	19825	g_29643	g_29644
Super-Scaffold_100007	17734241	17735043	802	g_29644	g_45297
Super-Scaffold_100007	17737149	17748178	11029	g_45297	g_29645
Super-Scaffold_100007	17749573	17754329	4756	g_29645	g_29646
Super-Scaffold_100007	17769583	17776319	6736	g_29646	g_45298
Super-Scaffold_100007	17779460	17837535	58075	g_45298	g_29647
Super-Scaffold_100007	17852831	17881494	28663	g_29647	g_29648
Super-Scaffold_100007	17887996	17939230	51234	g_29648	g_29649
Super-Scaffold_100007	17939457	18002378	62921	g_29649	g_29651
Super-Scaffold_100007	18008218	18013862	5644	g_29651	g_29652
Super-Scaffold_100007	18015355	18018533	3178	g_29652	g_29653
Super-Scaffold_100007	18039481	18064229	24748	g_29653	g_29654
Super-Scaffold_100007	18064915	18072383	7468	g_29654	g_29655
Super-Scaffold_100007	18093038	18097805	4767	g_29655	g_29656
Super-Scaffold_100007	18104234	18135221	30987	g_29656	g_29657
Super-Scaffold_100007	18212451	18215741	3290	g_29657	g_29658
Super-Scaffold_100007	18218143	18228775	10632	g_29658	g_29659
Super-Scaffold_100007	18244517	18249077	4560	g_29659	g_29660
Super-Scaffold_100007	18253225	18274578	21353	g_29660	g_29661
Super-Scaffold_100007	18276322	18282221	5899	g_29661	g_29662
Super-Scaffold_100007	18305018	18305279	261	g_29662	g_29663
Super-Scaffold_100007	18312155	18319526	7371	g_29663	g_42318
Super-Scaffold_100007	18330102	18341890	11788	g_42318	g_29664
Super-Scaffold_100007	18353420	18354499	1079	g_29664	g_45299
Super-Scaffold_100007	18367369	18369780	2411	g_45299	g_29665
Super-Scaffold_100007	18382810	18403651	20841	g_29665	g_29666
Super-Scaffold_100007	18418830	18426610	7780	g_29666	g_29667
Super-Scaffold_100007	18435944	18439157	3213	g_29667	g_29668
Super-Scaffold_100007	18439618	18443228	3610	g_29668	g_29669
Super-Scaffold_100007	18446442	18458777	12335	g_29669	g_29670
Super-Scaffold_100007	18476914	18479925	3011	g_29670	g_29671
Super-Scaffold_100007	18500997	18510435	9438	g_29671	g_45300
Super-Scaffold_100007	18523916	18536152	12236	g_45300	g_29673
Super-Scaffold_100007	18542792	18546119	3327	g_29673	g_29674
Super-Scaffold_100007	18550160	18556982	6822	g_29674	g_29675
Super-Scaffold_100007	18565772	18576446	10674	g_29675	g_29676
Super-Scaffold_100007	18586800	18595467	8667	g_29676	g_45301
Super-Scaffold_100007	18597915	18636830	38915	g_45301	g_29678
Super-Scaffold_100007	18643141	18650695	7554	g_29678	g_29679
Super-Scaffold_100007	18662047	18666663	4616	g_29679	g_29680
Super-Scaffold_100007	18672268	18683973	11705	g_29680	g_29682
Super-Scaffold_100007	18691053	18693067	2014	g_29682	g_29683
Super-Scaffold_100007	18695888	18698723	2835	g_29683	g_29684
Super-Scaffold_100007	18703607	18707677	4070	g_29684	g_29685
Super-Scaffold_100007	18717500	18738656	21156	g_29685	g_29686
Super-Scaffold_100007	18753936	18758843	4907	g_29686	g_29687
Super-Scaffold_100007	18760315	18770347	10032	g_29687	g_29688
Super-Scaffold_100007	18772738	18775468	2730	g_29688	g_29689
Super-Scaffold_100007	18791123	18815508	24385	g_29689	g_29690
Super-Scaffold_100007	18819245	18860541	41296	g_29690	g_42321
Super-Scaffold_100007	18860867	18872165	11298	g_42321	g_29692
Super-Scaffold_100007	18872458	18900031	27573	g_29692	g_29694
Super-Scaffold_100007	18907005	18911853	4848	g_29694	g_29695
Super-Scaffold_100007	18912296	18916375	4079	g_29695	g_29696
Super-Scaffold_100007	18920177	18945750	25573	g_29696	g_29698
Super-Scaffold_100007	18946061	18957941	11880	g_29698	g_29700
Super-Scaffold_100007	18958279	18963843	5564	g_29700	g_29701
Super-Scaffold_100007	18964112	18964293	181	g_29701	g_29702
Super-Scaffold_100007	19014047	19030486	16439	g_29702	g_29703
Super-Scaffold_100007	19031547	19034428	2881	g_29703	g_45302
Super-Scaffold_100007	19052721	19053523	802	g_45302	g_29704
Super-Scaffold_100007	19063697	19064509	812	g_29704	g_29705
Super-Scaffold_100007	19067854	19087310	19456	g_29705	g_29706
Super-Scaffold_100007	19097427	19124529	27102	g_29706	g_29707
Super-Scaffold_100007	19125608	19134107	8499	g_29707	g_29708
Super-Scaffold_100007	19158611	19170926	12315	g_29708	g_29709
Super-Scaffold_100007	19172044	19216928	44884	g_29709	g_29710
Super-Scaffold_100007	19229236	19231223	1987	g_29710	g_29711
Super-Scaffold_100007	19231483	19233808	2325	g_29711	g_29712
Super-Scaffold_100007	19237171	19239249	2078	g_29712	g_29713
Super-Scaffold_100007	19243960	19250431	6471	g_29713	g_29714
Super-Scaffold_100007	19255644	19272516	16872	g_29714	g_29715
Super-Scaffold_100007	19279750	19337702	57952	g_29715	g_29716
Super-Scaffold_100007	19341585	19347042	5457	g_29716	g_29717
Super-Scaffold_100007	19347305	19350199	2894	g_29717	g_45303
Super-Scaffold_100007	19353892	19355674	1782	g_45303	g_29718
Super-Scaffold_100007	19356988	19360899	3911	g_29718	g_29719
Super-Scaffold_100007	19372678	19408583	35905	g_29719	g_29720
Super-Scaffold_100007	19415116	19418165	3049	g_29720	g_29721
Super-Scaffold_100007	19430576	19433807	3231	g_29721	g_29722
Super-Scaffold_100007	19439802	19440893	1091	g_29722	g_29723
Super-Scaffold_100007	19443203	19446668	3465	g_29723	g_29724
Super-Scaffold_100007	19494715	19504022	9307	g_29724	g_29725
Super-Scaffold_100007	19504831	19510156	5325	g_29725	g_29726
Super-Scaffold_100007	19514503	19527370	12867	g_29726	g_29727
Super-Scaffold_100007	19530306	19532476	2170	g_29727	g_29728
Super-Scaffold_100007	19537763	19558372	20609	g_29728	g_29730
Super-Scaffold_100007	19558578	19587743	29165	g_29730	g_29731
Super-Scaffold_100007	19587982	19619019	31037	g_29731	g_29733
Super-Scaffold_100007	19635071	19639367	4296	g_29733	g_29734
Super-Scaffold_100007	19643915	19651961	8046	g_29734	g_29735
Super-Scaffold_100007	19658800	19661843	3043	g_29735	g_29736
Super-Scaffold_100007	19662160	19666495	4335	g_29736	g_29737
Super-Scaffold_100007	19668742	19674960	6218	g_29737	g_29738
Super-Scaffold_100007	19676885	19681707	4822	g_29738	g_29739
Super-Scaffold_100007	19693287	19740797	47510	g_29739	g_29740
Super-Scaffold_100007	19743563	19746551	2988	g_29740	g_29741
Super-Scaffold_100007	19756155	19758976	2821	g_29741	g_45304
Super-Scaffold_100007	19777365	19785048	7683	g_45304	g_29742
Super-Scaffold_100007	19788620	19790982	2362	g_29742	g_29743
Super-Scaffold_100007	19794907	19798208	3301	g_29743	g_29744
Super-Scaffold_100007	19802520	19807251	4731	g_29744	g_29745
Super-Scaffold_100007	19816512	19824023	7511	g_29745	g_29746
Super-Scaffold_100007	19853321	19871882	18561	g_29746	g_29747
Super-Scaffold_100007	19873693	19877169	3476	g_29747	g_29748
Super-Scaffold_100007	19878858	19880352	1494	g_29748	g_29749
Super-Scaffold_100007	19904087	19906753	2666	g_29749	g_45305
Super-Scaffold_100007	19913107	19915197	2090	g_45305	g_29750
Super-Scaffold_100007	19919105	19920564	1459	g_29750	g_29751
Super-Scaffold_100007	19929148	19930031	883	g_29751	g_45306
Super-Scaffold_100007	19940875	19950850	9975	g_45306	g_29752
Super-Scaffold_100007	19952779	19969389	16610	g_29752	g_29753
Super-Scaffold_100007	19972705	19974379	1674	g_29753	g_42328
Super-Scaffold_100007	19975816	19977238	1422	g_42328	g_29754
Super-Scaffold_100007	19984510	19988991	4481	g_29754	g_29755
Super-Scaffold_100007	19999593	20006257	6664	g_29755	g_29756
Super-Scaffold_100007	20018734	20021663	2929	g_29756	g_29757
Super-Scaffold_100007	20023963	20028166	4203	g_29757	g_29759
Super-Scaffold_100007	20035072	20036867	1795	g_29759	g_29760
Super-Scaffold_100007	20043876	20074280	30404	g_29760	g_29761
Super-Scaffold_100007	20077906	20083600	5694	g_29761	g_29762
Super-Scaffold_100007	20083863	20090264	6401	g_29762	g_29763
Super-Scaffold_100007	20116348	20120097	3749	g_29763	g_29764
Super-Scaffold_100007	20122987	20124452	1465	g_29764	g_29765
Super-Scaffold_100007	20138594	20172069	33475	g_29765	g_29766
Super-Scaffold_100007	20173220	20184247	11027	g_29766	g_29767
Super-Scaffold_100007	20184684	20186909	2225	g_29767	g_29768
Super-Scaffold_100007	20195564	20206365	10801	g_29768	g_29769
Super-Scaffold_100007	20217728	20219924	2196	g_29769	g_29770
Super-Scaffold_100007	20220382	20221464	1082	g_29770	g_29771
Super-Scaffold_100007	20225724	20227381	1657	g_29771	g_29772
Super-Scaffold_100007	20230703	20234922	4219	g_29772	g_29773
Super-Scaffold_100007	20241918	20246161	4243	g_29773	g_29774
Super-Scaffold_100007	20253350	20282591	29241	g_29774	g_29776
Super-Scaffold_100007	20283856	20606256	322400	g_29776	g_29778
Super-Scaffold_100007	20609149	20609499	350	g_29778	g_29779
Super-Scaffold_100007	20609810	20706648	96838	g_29779	g_29780
Super-Scaffold_100007	20706953	20807761	100808	g_29780	g_29782
Super-Scaffold_100007	20807991	20808047	56	g_29782	g_29783
Super-Scaffold_100007	20809363	20823662	14299	g_29783	g_29781
Super-Scaffold_100007	20912246	20940891	28645	g_29781	g_29787
Super-Scaffold_100007	20945709	20949457	3748	g_29787	g_29788
Super-Scaffold_100007	20957792	20968075	10283	g_29788	g_29789
Super-Scaffold_100007	20977276	20980531	3255	g_29789	g_29790
Super-Scaffold_100007	20981966	20985183	3217	g_29790	g_45307
Super-Scaffold_100007	20994734	21028665	33931	g_45307	g_29792
Super-Scaffold_100007	21028949	21040461	11512	g_29792	g_29793
Super-Scaffold_100007	21046209	21047137	928	g_29793	g_29794
Super-Scaffold_100007	21066417	21069375	2958	g_29794	g_45308
Super-Scaffold_100007	21086828	21106946	20118	g_45308	g_29795
Super-Scaffold_100007	21117112	21345105	227993	g_29795	g_29800
Super-Scaffold_100007	21345311	21365797	20486	g_29800	g_29801
Super-Scaffold_100007	21372715	21374107	1392	g_29801	g_29802
Super-Scaffold_100007	21384819	21388826	4007	g_29802	g_29803
Super-Scaffold_100007	21399446	21415083	15637	g_29803	g_29804
Super-Scaffold_100007	21424202	21461496	37294	g_29804	g_29805
Super-Scaffold_100007	21461840	21510885	49045	g_29805	g_29807
Super-Scaffold_100007	21512251	21532374	20123	g_29807	g_29808
Super-Scaffold_100007	21539951	21546213	6262	g_29808	g_29809
Super-Scaffold_100007	21547466	21559271	11805	g_29809	g_29810
Super-Scaffold_100007	21582122	21584012	1890	g_29810	g_29811
Super-Scaffold_100007	21585942	21589399	3457	g_29811	g_29812
Super-Scaffold_100007	21599012	21601889	2877	g_29812	g_29813
Super-Scaffold_100007	21602110	21633049	30939	g_29813	g_29814
Super-Scaffold_100007	21633285	21853486	220201	g_29814	g_29816
Super-Scaffold_100007	21879229	21964471	85242	g_29816	g_29817
Super-Scaffold_100007	21965355	22094926	129571	g_29817	g_29818
Super-Scaffold_100007	22095300	22132763	37463	g_29818	g_29820
Super-Scaffold_100007	22132981	22153121	20140	g_29820	g_29821
Super-Scaffold_100007	22158433	22185222	26789	g_29821	g_29822
Super-Scaffold_100007	22187071	22200644	13573	g_29822	g_45309
Super-Scaffold_100007	22201562	22202446	884	g_45309	g_45310
Super-Scaffold_100007	22203912	22206489	2577	g_45310	g_45311
Super-Scaffold_100007	22215218	22217289	2071	g_45311	g_29823
Super-Scaffold_100007	22222374	22226114	3740	g_29823	g_29824
Super-Scaffold_100007	22232378	22236831	4453	g_29824	g_29825
Super-Scaffold_100007	22255299	22265709	10410	g_29825	g_29826
Super-Scaffold_100007	22266077	22266328	251	g_29826	g_29827
Super-Scaffold_100007	22269388	22298536	29148	g_29827	g_29828
Super-Scaffold_100007	22300080	22322466	22386	g_29828	g_29829
Super-Scaffold_100007	22328728	22332799	4071	g_29829	g_29830
Super-Scaffold_100007	22334480	22363326	28846	g_29830	g_29831
Super-Scaffold_100007	22375598	22380595	4997	g_29831	g_29832
Super-Scaffold_100007	22386011	22390253	4242	g_29832	g_29833
Super-Scaffold_100007	22393271	22471446	78175	g_29833	g_29837
Super-Scaffold_100007	22487818	22488779	961	g_29837	g_29838
Super-Scaffold_100007	22493765	22505084	11319	g_29838	g_29839
Super-Scaffold_100007	22507301	22532900	25599	g_29839	g_42340
Super-Scaffold_100007	22533133	22538747	5614	g_42340	g_29843
Super-Scaffold_100007	22539068	22555651	16583	g_29843	g_29845
Super-Scaffold_100007	22556007	22558605	2598	g_29845	g_29846
Super-Scaffold_100007	22559862	22586530	26668	g_29846	g_29848
Super-Scaffold_100007	22586928	22623059	36131	g_29848	g_42345
Super-Scaffold_100007	22623325	22663519	40194	g_42345	g_29853
Super-Scaffold_100007	22681691	22688611	6920	g_29853	g_29854
Super-Scaffold_100007	22703335	22725591	22256	g_29854	g_29855
Super-Scaffold_100007	22735325	22742868	7543	g_29855	g_45312
Super-Scaffold_100007	22744481	22766482	22001	g_45312	g_29856
Super-Scaffold_100007	22769331	22781018	11687	g_29856	g_29857
Super-Scaffold_100007	22788356	22789710	1354	g_29857	g_29858
Super-Scaffold_100007	22790750	22891360	100610	g_29858	g_29860
Super-Scaffold_100007	22913828	22915517	1689	g_29860	g_29861
Super-Scaffold_100007	22922495	22925645	3150	g_29861	g_29862
Super-Scaffold_100007	22948759	22953704	4945	g_29862	g_29863
Super-Scaffold_100007	22963992	23018797	54805	g_29863	g_29864
Super-Scaffold_100007	23020745	23022815	2070	g_29864	g_45313
Super-Scaffold_100007	23026224	23131882	105658	g_45313	g_29865
Super-Scaffold_100007	23132163	23293829	161666	g_29865	g_29868
Super-Scaffold_100007	23311092	23313964	2872	g_29868	g_29869
Super-Scaffold_100007	23329416	23467437	138021	g_29869	g_29874
Super-Scaffold_100007	23467796	23523301	55505	g_29874	g_29875
Super-Scaffold_100007	23530828	23668963	138135	g_29875	g_42352
Super-Scaffold_100007	23669256	23693487	24231	g_42352	g_29878
Super-Scaffold_100007	23693792	23704679	10887	g_29878	g_29881
Super-Scaffold_100007	23719476	23722201	2725	g_29881	g_29883
Super-Scaffold_100007	23734095	23740079	5984	g_29883	g_45314
Super-Scaffold_100007	23762727	23775420	12693	g_45314	g_29884
Super-Scaffold_100007	23781811	23790288	8477	g_29884	g_29885
Super-Scaffold_100007	23794349	23796985	2636	g_29885	g_29886
Super-Scaffold_100007	23801783	23808170	6387	g_29886	g_29887
Super-Scaffold_100007	23814145	23815912	1767	g_29887	g_29888
Super-Scaffold_100007	23816252	23817417	1165	g_29888	g_29889
Super-Scaffold_100007	23823231	23824155	924	g_29889	g_29890
Super-Scaffold_100007	23829917	23832289	2372	g_29890	g_29891
Super-Scaffold_100007	23841206	23860401	19195	g_29891	g_29892
Super-Scaffold_100007	23869310	23872407	3097	g_29892	g_29893
Super-Scaffold_100007	23873749	23874035	286	g_29893	g_45315
Super-Scaffold_100007	23876555	23879832	3277	g_45315	g_45316
Super-Scaffold_100007	23895837	23901558	5721	g_45316	g_29894
Super-Scaffold_100007	23906593	23909987	3394	g_29894	g_29895
Super-Scaffold_100007	23924491	23926409	1918	g_29895	g_45317
Super-Scaffold_100007	23931777	23933597	1820	g_45317	g_45318
Super-Scaffold_100007	23940427	23941390	963	g_45318	g_45319
Super-Scaffold_100007	23943559	23946988	3429	g_45319	g_29896
Super-Scaffold_100007	23962132	23968543	6411	g_29896	g_29897
Super-Scaffold_100007	23975069	23987900	12831	g_29897	g_42353
Super-Scaffold_100007	23991153	23991251	98	g_29899	g_29900
Super-Scaffold_100007	24001559	24002912	1353	g_29900	g_29901
Super-Scaffold_100007	24006109	24006321	212	g_29901	g_29902
Super-Scaffold_100007	24009579	24012102	2523	g_29902	g_29903
Super-Scaffold_100007	24040972	24150638	109666	g_29903	g_29905
Super-Scaffold_100007	24150850	24158605	7755	g_29905	g_29907
Super-Scaffold_100007	24160684	24166532	5848	g_29907	g_42354
Super-Scaffold_100007	24167773	24170231	2458	g_42354	g_29909
Super-Scaffold_100007	24172084	24178017	5933	g_29909	g_29910
Super-Scaffold_100007	24179729	24184583	4854	g_29910	g_29911
Super-Scaffold_100007	24186298	24192935	6637	g_29911	g_29912
Super-Scaffold_100007	24195344	24197262	1918	g_29912	g_29913
Super-Scaffold_100007	24198329	24204014	5685	g_29913	g_29914
Super-Scaffold_100007	24223004	24234341	11337	g_29914	g_29915
Super-Scaffold_100007	24236107	24239859	3752	g_29915	g_29916
Super-Scaffold_100007	24244376	24277552	33176	g_29916	g_29917
Super-Scaffold_100007	24295362	24297092	1730	g_29917	g_29918
Super-Scaffold_100007	24299872	24303250	3378	g_29918	g_29919
Super-Scaffold_100007	24307655	24311789	4134	g_29919	g_29920
Super-Scaffold_100007	24316227	24318974	2747	g_29920	g_29921
Super-Scaffold_100007	24324083	24326291	2208	g_29921	g_29922
Super-Scaffold_100007	24331460	24339593	8133	g_29922	g_29923
Super-Scaffold_100007	24347657	24349846	2189	g_29923	g_29925
Super-Scaffold_100007	24351213	24352051	838	g_29925	g_29926
Super-Scaffold_100007	24359082	24365710	6628	g_29926	g_29927
Super-Scaffold_100007	24370552	24372115	1563	g_29927	g_29928
Super-Scaffold_100007	24379131	24380741	1610	g_29928	g_29929
Super-Scaffold_100007	24383145	24388802	5657	g_29929	g_29930
Super-Scaffold_100007	24392830	24395357	2527	g_29930	g_29931
Super-Scaffold_100007	24396250	24408389	12139	g_29931	g_45320
Super-Scaffold_100007	24410866	24412324	1458	g_45320	g_29932
Super-Scaffold_100007	24416979	24429415	12436	g_29932	g_29933
Super-Scaffold_100007	24434863	24450925	16062	g_29933	g_29934
Super-Scaffold_100007	24452458	24454983	2525	g_29934	g_29935
Super-Scaffold_100007	24467501	24534852	67351	g_29935	g_29937
Super-Scaffold_100007	24535520	24536271	751	g_29937	g_45321
Super-Scaffold_100007	24537801	24561141	23340	g_45321	g_29939
Super-Scaffold_100007	24573097	24589938	16841	g_29939	g_29941
Super-Scaffold_100007	24590635	24613996	23361	g_29941	g_42358
Super-Scaffold_100007	24614214	24634927	20713	g_42358	g_29943
Super-Scaffold_100007	24635151	24661202	26051	g_29943	g_29944
Super-Scaffold_100007	24662131	24670073	7942	g_29944	g_29945
Super-Scaffold_100007	24684028	24698864	14836	g_29945	g_29946
Super-Scaffold_100007	24716045	24735083	19038	g_29946	g_29947
Super-Scaffold_100007	24752356	24756398	4042	g_29947	g_29948
Super-Scaffold_100007	24758121	24759293	1172	g_29948	g_45322
Super-Scaffold_100007	24763887	24769878	5991	g_45322	g_29949
Super-Scaffold_100007	24777876	24812466	34590	g_29949	g_29950
Super-Scaffold_100007	24822106	24823853	1747	g_29950	g_29951
Super-Scaffold_100007	24833275	24834249	974	g_29951	g_29952
Super-Scaffold_100007	24836570	24845054	8484	g_29952	g_29953
Super-Scaffold_100007	24858371	24859864	1493	g_29953	g_29954
Super-Scaffold_100007	24869035	24869755	720	g_29954	g_29955
Super-Scaffold_100007	24873854	24879208	5354	g_29955	g_29956
Super-Scaffold_100007	24883446	24883548	102	g_29956	g_29957
Super-Scaffold_100007	24894050	24901438	7388	g_29957	g_29958
Super-Scaffold_100007	24907472	24908398	926	g_29958	g_29959
Super-Scaffold_100007	24908682	24910260	1578	g_29959	g_29960
Super-Scaffold_100007	24913072	24928545	15473	g_29960	g_45323
Super-Scaffold_100007	24955000	24958249	3249	g_45323	g_29961
Super-Scaffold_100007	24963626	24967801	4175	g_29961	g_45324
Super-Scaffold_100007	24973491	24975445	1954	g_45324	g_29962
Super-Scaffold_100007	24982673	24989585	6912	g_29962	g_29963
Super-Scaffold_100007	25002140	25025849	23709	g_29963	g_29964
Super-Scaffold_100007	25029382	25031949	2567	g_29964	g_29965
Super-Scaffold_100007	25048311	25050966	2655	g_29965	g_29966
Super-Scaffold_100007	25070414	25072862	2448	g_29966	g_29967
Super-Scaffold_100007	25083861	25084950	1089	g_29967	g_45325
Super-Scaffold_100007	25088815	25088934	119	g_45325	g_29968
Super-Scaffold_100007	25095587	25097111	1524	g_29968	g_45326
Super-Scaffold_100007	25102114	25104239	2125	g_45326	g_29969
Super-Scaffold_100007	25106623	25108308	1685	g_29969	g_29970
Super-Scaffold_100007	25110581	25112774	2193	g_29970	g_29971
Super-Scaffold_100007	25113914	25119777	5863	g_29971	g_29972
Super-Scaffold_100007	25124383	25127568	3185	g_29972	g_29973
Super-Scaffold_100007	25129109	25141514	12405	g_29973	g_29974
Super-Scaffold_100007	25147043	25150915	3872	g_29974	g_29975
Super-Scaffold_100007	25152011	25155434	3423	g_29975	g_29976
Super-Scaffold_100007	25162316	25168579	6263	g_29976	g_29977
Super-Scaffold_100007	25170229	25174315	4086	g_29977	g_29978
Super-Scaffold_100007	25176580	25180963	4383	g_29978	g_29979
Super-Scaffold_100007	25189480	25194183	4703	g_29979	g_29980
Super-Scaffold_100007	25225272	25226590	1318	g_29980	g_29981
Super-Scaffold_100007	25228291	25280498	52207	g_29981	g_29983
Super-Scaffold_100007	25280842	25302864	22022	g_29983	g_42365
Super-Scaffold_100007	25303115	25306128	3013	g_42365	g_29984
Super-Scaffold_100007	25319993	25339095	19102	g_29984	g_29985
Super-Scaffold_100007	25348974	25353543	4569	g_29985	g_29986
Super-Scaffold_100007	25363050	25418287	55237	g_29986	g_29990
Super-Scaffold_100007	25418517	25459449	40932	g_29990	g_29991
Super-Scaffold_100007	25459667	25524618	64951	g_29991	g_29993
Super-Scaffold_100007	25524911	25571990	47079	g_29993	g_29994
Super-Scaffold_100007	25580078	25583255	3177	g_29994	g_45327
Super-Scaffold_100007	25589265	25593047	3782	g_45327	g_29995
Super-Scaffold_100007	25614589	25631883	17294	g_29995	g_29996
Super-Scaffold_100007	25634451	25638795	4344	g_29996	g_45328
Super-Scaffold_100007	25641800	25645018	3218	g_45328	g_29997
Super-Scaffold_100007	25663917	25664795	878	g_29997	g_29998
Super-Scaffold_100007	25668393	25668652	259	g_29998	g_29999
Super-Scaffold_100007	25670356	25673762	3406	g_29999	g_30000
Super-Scaffold_100007	25674334	25677357	3023	g_30000	g_30001
Super-Scaffold_100007	25683216	25687610	4394	g_30001	g_30002
Super-Scaffold_100007	25695008	25697940	2932	g_30002	g_30003
Super-Scaffold_100007	25713721	25720688	6967	g_30003	g_30004
Super-Scaffold_100007	25725055	25727960	2905	g_30004	g_30005
Super-Scaffold_100007	25731334	25733886	2552	g_30005	g_30006
Super-Scaffold_100007	25739943	25742069	2126	g_30006	g_30007
Super-Scaffold_100007	25747139	25747851	712	g_30007	g_30008
Super-Scaffold_100007	25748808	25749499	691	g_30008	g_30009
Super-Scaffold_100007	25752277	25754111	1834	g_30009	g_30010
Super-Scaffold_100007	25757705	25760370	2665	g_30010	g_30011
Super-Scaffold_100007	25763431	25765445	2014	g_30011	g_30012
Super-Scaffold_100007	25772202	25776261	4059	g_30012	g_30013
Super-Scaffold_100007	25782024	25786268	4244	g_30013	g_30014
Super-Scaffold_100007	25792436	25862365	69929	g_30014	g_30016
Super-Scaffold_100007	25863312	25869172	5860	g_30016	g_30017
Super-Scaffold_100007	25871189	25873196	2007	g_30017	g_30018
Super-Scaffold_100007	25874860	25912056	37196	g_30018	g_30020
Super-Scaffold_100007	25914248	25917904	3656	g_30020	g_30021
Super-Scaffold_100007	25927326	25934158	6832	g_30021	g_45329
Super-Scaffold_100007	25940212	25951388	11176	g_45329	g_30023
Super-Scaffold_100007	25956159	25957990	1831	g_30023	g_30024
Super-Scaffold_100007	25977033	26004521	27488	g_30024	g_30027
Super-Scaffold_100007	26005843	26006635	792	g_30027	g_30028
Super-Scaffold_100007	26012474	26015161	2687	g_30028	g_30029
Super-Scaffold_100007	26025731	26033449	7718	g_30029	g_30031
Super-Scaffold_100007	26045517	26069951	24434	g_30031	g_30032
Super-Scaffold_100007	26071811	26073236	1425	g_30032	g_30033
Super-Scaffold_100007	26080537	26084993	4456	g_30033	g_30034
Super-Scaffold_100007	26091540	26093559	2019	g_30034	g_30035
Super-Scaffold_100007	26118964	26125680	6716	g_30035	g_30036
Super-Scaffold_100007	26142287	26142998	711	g_30036	g_30037
Super-Scaffold_100007	26147059	26149459	2400	g_30037	g_30038
Super-Scaffold_100007	26160933	26163026	2093	g_30038	g_30039
Super-Scaffold_100007	26167078	26167958	880	g_30039	g_45330
Super-Scaffold_100007	26170558	26173463	2905	g_45330	g_45331
Super-Scaffold_100007	26179120	26180852	1732	g_45331	g_45332
Super-Scaffold_100007	26184755	26186487	1732	g_45332	g_45333
Super-Scaffold_100007	26189360	26197501	8141	g_45333	g_30040
Super-Scaffold_100007	26209935	26216109	6174	g_30040	g_45334
Super-Scaffold_100007	26229048	26231994	2946	g_45334	g_30041
Super-Scaffold_100007	26236654	26239686	3032	g_30041	g_30042
Super-Scaffold_100007	26240096	26240842	746	g_30042	g_30043
Super-Scaffold_100007	26244197	26246389	2192	g_30043	g_30044
Super-Scaffold_100007	26263691	26283408	19717	g_30044	g_30045
Super-Scaffold_100007	26295497	26300866	5369	g_30045	g_30046
Super-Scaffold_100007	26306660	26310534	3874	g_30046	g_30047
Super-Scaffold_100007	26326108	26329472	3364	g_30047	g_30048
Super-Scaffold_100007	26333264	26338195	4931	g_30048	g_30049
Super-Scaffold_100007	26346763	26359692	12929	g_30049	g_30050
Super-Scaffold_100007	26367006	26370250	3244	g_30050	g_30051
Super-Scaffold_100007	26380398	26383370	2972	g_30051	g_30052
Super-Scaffold_100007	26395416	26399406	3990	g_30052	g_30053
Super-Scaffold_100007	26399698	26406726	7028	g_30053	g_30054
Super-Scaffold_100007	26407938	26413189	5251	g_30054	g_30055
Super-Scaffold_100007	26416783	26421912	5129	g_30055	g_30056
Super-Scaffold_100007	26423653	26430024	6371	g_30056	g_45335
Super-Scaffold_100007	26432353	26436819	4466	g_45335	g_30057
Super-Scaffold_100007	26438466	26492324	53858	g_30057	g_30060
Super-Scaffold_100007	26493774	26496699	2925	g_30060	g_30061
Super-Scaffold_100007	26499276	26500595	1319	g_30061	g_30062
Super-Scaffold_100007	26516134	26518146	2012	g_30062	g_45336
Super-Scaffold_100007	26536426	26545003	8577	g_45336	g_30063
Super-Scaffold_100007	26578271	26584442	6171	g_30063	g_45337
Super-Scaffold_100007	26597163	26612830	15667	g_45337	g_30064
Super-Scaffold_100007	26624288	26630931	6643	g_30064	g_30065
Super-Scaffold_100007	26639194	26664230	25036	g_30065	g_30066
Super-Scaffold_100007	26669293	26704980	35687	g_30066	g_30067
Super-Scaffold_100007	26705386	26721385	15999	g_30067	g_30068
Super-Scaffold_100007	26739579	26826888	87309	g_30068	g_30069
Super-Scaffold_100007	26828402	26828863	461	g_30069	g_30070
Super-Scaffold_100007	26830767	26831418	651	g_30070	g_30071
Super-Scaffold_100007	26834684	26842471	7787	g_30071	g_30072
Super-Scaffold_100007	26847887	26856276	8389	g_30072	g_30074
Super-Scaffold_100007	26861037	26870976	9939	g_30074	g_42380
Super-Scaffold_100007	26871185	26914601	43416	g_42380	g_30078
Super-Scaffold_100007	26915113	26917744	2631	g_30078	g_30079
Super-Scaffold_100007	26922516	26924116	1600	g_30079	g_30080
Super-Scaffold_100007	26931696	26949778	18082	g_30080	g_30081
Super-Scaffold_100007	26956415	26989213	32798	g_30081	g_30083
Super-Scaffold_100007	27006242	27024330	18088	g_30083	g_30084
Super-Scaffold_100007	27032298	27037749	5451	g_30084	g_30085
Super-Scaffold_100007	27039185	27058410	19225	g_30085	g_30086
Super-Scaffold_100007	27059780	27086418	26638	g_30086	g_30087
Super-Scaffold_100007	27086651	27088665	2014	g_30087	g_30088
Super-Scaffold_100007	27088868	27138306	49438	g_30088	g_42382
Super-Scaffold_100007	27138551	27154255	15704	g_42382	g_30092
Super-Scaffold_100007	27180217	27199760	19543	g_30092	g_30093
Super-Scaffold_100007	27204623	27207716	3093	g_30093	g_30095
Super-Scaffold_100007	27219319	27247333	28014	g_30095	g_30096
Super-Scaffold_100007	27250407	27260671	10264	g_30096	g_30097
Super-Scaffold_100007	27265055	27268010	2955	g_30097	g_30098
Super-Scaffold_100007	27279292	27281823	2531	g_30098	g_45338
Super-Scaffold_100007	27304060	27307130	3070	g_45338	g_45339
Super-Scaffold_100007	27321744	27332007	10263	g_45339	g_30099
Super-Scaffold_100007	27379571	27380975	1404	g_30099	g_30100
Super-Scaffold_100007	27381199	27408395	27196	g_30100	g_30102
Super-Scaffold_100007	27410174	27415458	5284	g_30102	g_30103
Super-Scaffold_100007	27415775	27420049	4274	g_30103	g_30104
Super-Scaffold_100007	27421303	27427363	6060	g_30104	g_45340
Super-Scaffold_100007	27428617	27431014	2397	g_45340	g_45341
Super-Scaffold_100007	27432267	27434665	2398	g_45341	g_45342
Super-Scaffold_100007	27435918	27443461	7543	g_45342	g_30105
Super-Scaffold_100007	27444422	27459089	14667	g_30105	g_30106
Super-Scaffold_100007	27460050	27471942	11892	g_30106	g_30107
Super-Scaffold_100007	27473215	27481141	7926	g_30107	g_30108
Super-Scaffold_100007	27481491	27483516	2025	g_30108	g_30109
Super-Scaffold_100007	27484864	27495630	10766	g_30109	g_30110
Super-Scaffold_100007	27498899	27511801	12902	g_30110	g_30111
Super-Scaffold_100007	27512084	27513858	1774	g_30111	g_30112
Super-Scaffold_100007	27516980	27544377	27397	g_30112	g_30113
Super-Scaffold_100007	27544660	27546396	1736	g_30113	g_30114
Super-Scaffold_100007	27547736	27552146	4410	g_30114	g_30115
Super-Scaffold_100007	27553351	27558499	5148	g_30115	g_30116
Super-Scaffold_100007	27560215	27563451	3236	g_30116	g_45343
Super-Scaffold_100007	27565360	27569211	3851	g_45343	g_30117
Super-Scaffold_100007	27571243	27572285	1042	g_30117	g_30118
Super-Scaffold_100007	27576831	27611274	34443	g_30118	g_30120
Super-Scaffold_100007	27618784	27705570	86786	g_30120	g_30125
Super-Scaffold_100007	27705902	27731070	25168	g_30125	g_30127
Super-Scaffold_100007	27731303	27824772	93469	g_30127	g_30132
Super-Scaffold_100007	27831571	27840917	9346	g_30132	g_30133
Super-Scaffold_100007	27842149	27873509	31360	g_30133	g_30134
Super-Scaffold_100007	27880239	27884519	4280	g_30134	g_30135
Super-Scaffold_100007	27887252	27936672	49420	g_30135	g_30136
Super-Scaffold_100007	27954813	27957262	2449	g_30136	g_45344
Super-Scaffold_100007	27962034	27972506	10472	g_45344	g_30137
Super-Scaffold_100007	27980141	27985211	5070	g_30137	g_45345
Super-Scaffold_100007	27996510	28015312	18802	g_45345	g_30139
Super-Scaffold_100007	28023687	28026332	2645	g_30139	g_30140
Super-Scaffold_100007	28026700	28034472	7772	g_30140	g_30141
Super-Scaffold_100007	28041664	28047013	5349	g_30141	g_30142
Super-Scaffold_100007	28061070	28068238	7168	g_30142	g_30143
Super-Scaffold_100007	28069781	28073010	3229	g_30143	g_45346
Super-Scaffold_100007	28073276	28092901	19625	g_45346	g_30144
Super-Scaffold_100007	28093935	28104912	10977	g_30144	g_30145
Super-Scaffold_100007	28105160	28116662	11502	g_30145	g_30147
Super-Scaffold_100007	28133890	28142679	8789	g_30147	g_30148
Super-Scaffold_100007	28143650	28150415	6765	g_30148	g_30149
Super-Scaffold_100007	28151122	28163808	12686	g_30149	g_30150
Super-Scaffold_100007	28165640	28195307	29667	g_30150	g_30151
Super-Scaffold_100007	28195597	28222992	27395	g_30151	g_30152
Super-Scaffold_100007	28225135	28226151	1016	g_30152	g_30153
Super-Scaffold_100007	28227095	28230076	2981	g_30153	g_30154
Super-Scaffold_100007	28232815	28235057	2242	g_30154	g_30155
Super-Scaffold_100007	28240333	28245563	5230	g_30155	g_45347
Super-Scaffold_100007	28249496	28256411	6915	g_45347	g_30156
Super-Scaffold_100007	28276495	28288548	12053	g_30156	g_30157
Super-Scaffold_100007	28302064	28323233	21169	g_30157	g_30159
Super-Scaffold_100007	28328666	28333570	4904	g_30159	g_30160
Super-Scaffold_100007	28344828	28394860	50032	g_30160	g_30164
Super-Scaffold_100007	28417988	28466336	48348	g_30164	g_30165
Super-Scaffold_100007	28478901	28480632	1731	g_30165	g_30166
Super-Scaffold_100007	28491445	28492245	800	g_30166	g_30167
Super-Scaffold_100007	28496613	28498470	1857	g_30167	g_30169
Super-Scaffold_100007	28501344	28507308	5964	g_30169	g_30170
Super-Scaffold_100007	28513454	28525330	11876	g_30170	g_30171
Super-Scaffold_100007	28560041	28585540	25499	g_30171	g_30173
Super-Scaffold_100007	28586664	28587777	1113	g_30173	g_30174
Super-Scaffold_100007	28588019	28596534	8515	g_30174	g_30175
Super-Scaffold_100007	28601119	28604729	3610	g_30175	g_45348
Super-Scaffold_100007	28610412	28612748	2336	g_45348	g_30176
Super-Scaffold_100007	28628341	28645400	17059	g_30176	g_30178
Super-Scaffold_100007	28660513	28660830	317	g_30178	g_30179
Super-Scaffold_100007	28661132	28670847	9715	g_30179	g_30180
Super-Scaffold_100007	28671086	28685084	13998	g_30180	g_45349
Super-Scaffold_100007	28696003	28723541	27538	g_45349	g_30182
Super-Scaffold_100007	28737185	28745750	8565	g_30182	g_30183
Super-Scaffold_100007	28753909	28766802	12893	g_30183	g_30184
Super-Scaffold_100007	28770825	28773439	2614	g_30184	g_30185
Super-Scaffold_100007	28780351	28835045	54694	g_30185	g_42400
Super-Scaffold_100007	28835458	28925919	90461	g_42400	g_30188
Super-Scaffold_100007	28926836	28955514	28678	g_30188	g_30191
Super-Scaffold_100007	28966702	28970881	4179	g_30191	g_30192
Super-Scaffold_100007	28982781	28995297	12516	g_30192	g_30193
Super-Scaffold_100007	29001150	29004705	3555	g_30193	g_45350
Super-Scaffold_100007	29009924	29012014	2090	g_45350	g_30194
Super-Scaffold_100007	29015546	29016069	523	g_30194	g_45351
Super-Scaffold_100007	29025763	29027308	1545	g_45351	g_45352
Super-Scaffold_100007	29030712	29033915	3203	g_45352	g_30195
Super-Scaffold_100007	29041001	29042253	1252	g_30195	g_30196
Super-Scaffold_100007	29044503	29113578	69075	g_30196	g_30198
Super-Scaffold_100007	29113886	29118205	4319	g_30198	g_30199
Super-Scaffold_100007	29121507	29126790	5283	g_30199	g_30200
Super-Scaffold_100007	29128900	29136744	7844	g_30200	g_30201
Super-Scaffold_100007	29137100	29138997	1897	g_30201	g_30202
Super-Scaffold_100007	29140223	29143212	2989	g_30202	g_30203
Super-Scaffold_100007	29151786	29155493	3707	g_30203	g_30204
Super-Scaffold_100007	29158270	29158949	679	g_30204	g_30205
Super-Scaffold_100007	29176403	29178574	2171	g_30205	g_30206
Super-Scaffold_100007	29193048	29200575	7527	g_30206	g_30207
Super-Scaffold_100007	29206673	29211023	4350	g_30207	g_30208
Super-Scaffold_100007	29235976	29252776	16800	g_30208	g_30209
Super-Scaffold_100007	29265420	29269601	4181	g_30209	g_42404
Super-Scaffold_100007	29269915	29274890	4975	g_42404	g_30210
Super-Scaffold_100007	29277628	29279871	2243	g_30210	g_30211
Super-Scaffold_100007	29283468	29284141	673	g_30211	g_30212
Super-Scaffold_100007	29294723	29297100	2377	g_30212	g_30213
Super-Scaffold_100007	29300276	29321302	21026	g_30213	g_30215
Super-Scaffold_100007	29324064	29326096	2032	g_30215	g_45353
Super-Scaffold_100007	29334392	29340341	5949	g_45353	g_30216
Super-Scaffold_100007	29348338	29362961	14623	g_30216	g_30218
Super-Scaffold_100007	29363512	29364578	1066	g_30218	g_30219
Super-Scaffold_100007	29364937	29366308	1371	g_30219	g_30220
Super-Scaffold_100007	29366895	29408014	41119	g_30220	g_30223
Super-Scaffold_100007	29411169	29419391	8222	g_30223	g_30224
Super-Scaffold_100007	29430380	29432523	2143	g_30224	g_45354
Super-Scaffold_100007	29438660	29440944	2284	g_45354	g_30225
Super-Scaffold_100007	29445162	29446160	998	g_30225	g_45355
Super-Scaffold_100007	29451945	29452858	913	g_45355	g_45356
Super-Scaffold_100007	29456617	29457561	944	g_45356	g_45357
Super-Scaffold_100007	29463488	29464762	1274	g_45357	g_30226
Super-Scaffold_100007	29485523	29485937	414	g_30226	g_45358
Super-Scaffold_100007	29486173	29488780	2607	g_45358	g_30227
Super-Scaffold_100007	29511873	29514881	3008	g_30227	g_30228
Super-Scaffold_100007	29531024	29534716	3692	g_30228	g_30229
Super-Scaffold_100007	29535726	29545272	9546	g_30229	g_30230
Super-Scaffold_100007	29548460	29549732	1272	g_30230	g_30231
Super-Scaffold_100007	29554472	29555557	1085	g_30231	g_45359
Super-Scaffold_100007	29562160	29564542	2382	g_45359	g_30232
Super-Scaffold_100007	29607533	29634317	26784	g_30232	g_30235
Super-Scaffold_100007	29645324	29657839	12515	g_30235	g_30236
Super-Scaffold_100007	29662660	29666812	4152	g_30236	g_30237
Super-Scaffold_100007	29680402	29683632	3230	g_30237	g_30238
Super-Scaffold_100007	29686802	29690001	3199	g_30238	g_30239
Super-Scaffold_100007	29690793	29697396	6603	g_30239	g_30240
Super-Scaffold_100007	29713368	29714102	734	g_30240	g_30241
Super-Scaffold_100007	29722827	29725485	2658	g_30241	g_30242
Super-Scaffold_100007	29733742	29911697	177955	g_30242	g_30248
Super-Scaffold_100007	29912020	29925932	13912	g_30248	g_30250
Super-Scaffold_100007	29927026	29933515	6489	g_30250	g_30251
Super-Scaffold_100007	29934762	29943147	8385	g_30251	g_30252
Super-Scaffold_100007	29955466	29956480	1014	g_30252	g_45360
Super-Scaffold_100007	29959897	29960699	802	g_45360	g_30253
Super-Scaffold_100007	30022095	30022646	551	g_30253	g_30254
Super-Scaffold_100007	30024611	30036921	12310	g_30254	g_30255
Super-Scaffold_100007	30051886	30055042	3156	g_30255	g_30256
Super-Scaffold_100007	30070657	30085076	14419	g_30256	g_30258
Super-Scaffold_100007	30085423	30091106	5683	g_30258	g_30257
Super-Scaffold_100007	30096775	30107651	10876	g_30257	g_30259
Super-Scaffold_100007	30108838	30139745	30907	g_30259	g_30260
Super-Scaffold_100007	30151431	30169317	17886	g_30260	g_30262
Super-Scaffold_100007	30181318	30186825	5507	g_30262	g_30263
Super-Scaffold_100007	30187055	30201626	14571	g_30263	g_42413
Super-Scaffold_100007	30202093	30223764	21671	g_42413	g_30265
Super-Scaffold_100007	30246207	30302800	56593	g_30265	g_30268
Super-Scaffold_100007	30303129	30380590	77461	g_30268	g_30273
Super-Scaffold_100007	30396727	30412940	16213	g_30273	g_30275
Super-Scaffold_100007	30413158	30427245	14087	g_30275	g_30276
Super-Scaffold_100007	30463280	30475149	11869	g_30276	g_30277
Super-Scaffold_100007	30486681	30516803	30122	g_30277	g_30278
Super-Scaffold_100007	30517270	30526234	8964	g_30278	g_45361
Super-Scaffold_100007	30528611	30567279	38668	g_45361	g_30279
Super-Scaffold_100007	30568520	30647584	79064	g_30279	g_30282
Super-Scaffold_100007	30656578	30657874	1296	g_30282	g_30283
Super-Scaffold_100007	30659373	30660190	817	g_30283	g_30284
Super-Scaffold_100007	30663101	30667048	3947	g_30284	g_30285
Super-Scaffold_100007	30672522	30686348	13826	g_30285	g_30286
Super-Scaffold_100007	30686737	30898090	211353	g_30286	g_30287
Super-Scaffold_100007	30898428	30898542	114	g_30287	g_30288
Super-Scaffold_100007	30900356	30908096	7740	g_30288	g_42417
Super-Scaffold_100007	30908485	30923201	14716	g_42417	g_30289
Super-Scaffold_100007	30925378	30949968	24590	g_30289	g_30290
Super-Scaffold_100007	30952118	30959727	7609	g_30290	g_30291
Super-Scaffold_100007	30960116	30974855	14739	g_30291	g_30292
Super-Scaffold_100007	30977002	30984370	7368	g_30292	g_42418
Super-Scaffold_100007	30984759	31000347	15588	g_42418	g_30293
Super-Scaffold_100007	31002464	31009532	7068	g_30293	g_30294
Super-Scaffold_100007	31009921	31021567	11646	g_30294	g_30295
Super-Scaffold_100007	31023744	31046608	22864	g_30295	g_30296
Super-Scaffold_100007	31047345	31047652	307	g_30296	g_30297
Super-Scaffold_100007	31048785	31058302	9517	g_30297	g_42419
Super-Scaffold_100007	31058691	31073761	15070	g_42419	g_30298
Super-Scaffold_100007	31075011	31082652	7641	g_30298	g_30299
Super-Scaffold_100007	31083041	31094674	11633	g_30299	g_30300
Super-Scaffold_100007	31096881	31165701	68820	g_30300	g_30304
Super-Scaffold_100007	31166054	31169356	3302	g_30304	g_30306
Super-Scaffold_100007	31170518	31197883	27365	g_30306	g_30309
Super-Scaffold_100007	31198257	31211907	13650	g_30309	g_30310
Super-Scaffold_100007	31212927	31225329	12402	g_30310	g_30311
Super-Scaffold_100007	31225922	31235117	9195	g_30311	g_30312
Super-Scaffold_100007	31272983	31297138	24155	g_30312	g_30313
Super-Scaffold_100007	31316724	31321797	5073	g_30313	g_30315
Super-Scaffold_100007	31346325	31393029	46704	g_30315	g_30317
Super-Scaffold_100007	31411841	31434252	22411	g_30317	g_30318
Super-Scaffold_100007	31479130	31493640	14510	g_30318	g_30319
Super-Scaffold_100007	31572485	31577015	4530	g_30319	g_30320
Super-Scaffold_100007	31579601	31582361	2760	g_30320	g_30321
Super-Scaffold_100007	31588762	31589562	800	g_30321	g_30322
Super-Scaffold_100007	31596178	31599914	3736	g_30322	g_30323
Super-Scaffold_100007	31600558	31603813	3255	g_30323	g_30324
Super-Scaffold_100007	31627525	31638768	11243	g_30324	g_30325
Super-Scaffold_100007	31657950	31659133	1183	g_30325	g_30326
Super-Scaffold_100007	31662495	31711061	48566	g_30326	g_30329
Super-Scaffold_100007	31718957	31728210	9253	g_30329	g_45362
Super-Scaffold_100007	31736849	31744427	7578	g_45362	g_45363
Super-Scaffold_100007	31749394	31751084	1690	g_45363	g_30331
Super-Scaffold_100007	31755814	31757006	1192	g_30331	g_30332
Super-Scaffold_100007	31763682	31764762	1080	g_30332	g_30333
Super-Scaffold_100007	31768077	31772449	4372	g_30333	g_30334
Super-Scaffold_100007	31776986	31779282	2296	g_30334	g_45364
Super-Scaffold_100007	31787095	31797828	10733	g_45364	g_30335
Super-Scaffold_100007	31806301	31815660	9359	g_30335	g_30336
Super-Scaffold_100007	31829308	31836925	7617	g_30336	g_45365
Super-Scaffold_100007	31841658	31850001	8343	g_45365	g_30337
Super-Scaffold_100007	31858111	31859267	1156	g_30337	g_30338
Super-Scaffold_100007	31860953	31862598	1645	g_30338	g_30339
Super-Scaffold_100007	31870563	31912709	42146	g_30339	g_30341
Super-Scaffold_100007	31958892	31964326	5434	g_30341	g_30342
Super-Scaffold_100007	31972247	31981219	8972	g_30342	g_30343
Super-Scaffold_100007	31991042	32006382	15340	g_30343	g_30345
Super-Scaffold_100007	32019366	32021411	2045	g_30345	g_30346
Super-Scaffold_100007	32033222	32035158	1936	g_30346	g_30347
Super-Scaffold_100007	32038929	32041042	2113	g_30347	g_30348
Super-Scaffold_100007	32048788	32049574	786	g_30348	g_45366
Super-Scaffold_100007	32059215	32127062	67847	g_45366	g_30350
Super-Scaffold_100007	32127442	32186483	59041	g_30350	g_30351
Super-Scaffold_100007	32191354	32220929	29575	g_30351	g_42425
Super-Scaffold_100007	32221258	32224639	3381	g_42425	g_42426
Super-Scaffold_100007	32225022	32229248	4226	g_42426	g_30353
Super-Scaffold_100007	32229496	32272834	43338	g_30353	g_30354
Super-Scaffold_100007	32286346	32331725	45379	g_30354	g_30355
Super-Scaffold_100007	32332564	32337037	4473	g_30355	g_30356
Super-Scaffold_100007	32340444	32346098	5654	g_30356	g_30357
Super-Scaffold_100007	32349273	32354930	5657	g_30357	g_30359
Super-Scaffold_100007	32355229	32357055	1826	g_30359	g_30360
Super-Scaffold_100007	32371978	32374057	2079	g_30360	g_30361
Super-Scaffold_100007	32376233	32384453	8220	g_30361	g_30362
Super-Scaffold_100007	32386592	32439974	53382	g_30362	g_30364
Super-Scaffold_100007	32456229	32457455	1226	g_30364	g_45367
Super-Scaffold_100007	32485562	32498516	12954	g_45367	g_30365
Super-Scaffold_100007	32526464	32527186	722	g_30365	g_30366
Super-Scaffold_100007	32527404	32622661	95257	g_30366	g_30370
Super-Scaffold_100007	32629318	32632888	3570	g_30370	g_30371
Super-Scaffold_100007	32686323	32699554	13231	g_30371	g_30372
Super-Scaffold_100007	32703071	32752526	49455	g_30372	g_30373
Super-Scaffold_100007	32753755	32809256	55501	g_30373	g_30376
Super-Scaffold_100007	32831053	32837019	5966	g_30376	g_30377
Super-Scaffold_100007	32843284	32888869	45585	g_30377	g_30379
Super-Scaffold_100007	32903780	32931441	27661	g_30379	g_30380
Super-Scaffold_100007	32933734	32952413	18679	g_30380	g_30381
Super-Scaffold_100007	32960965	32969352	8387	g_30381	g_30382
Super-Scaffold_100007	32984696	32992385	7689	g_30382	g_45368
Super-Scaffold_100007	32997954	33002998	5044	g_45368	g_45369
Super-Scaffold_100007	33007393	33012744	5351	g_45369	g_45370
Super-Scaffold_100007	33025135	33028974	3839	g_45370	g_30383
Super-Scaffold_100007	33038615	33079526	40911	g_30383	g_30386
Super-Scaffold_100007	33080134	33105955	25821	g_30386	g_30387
Super-Scaffold_100007	33119727	33126177	6450	g_30387	g_45371
Super-Scaffold_100007	33135547	33136914	1367	g_45371	g_30388
Super-Scaffold_100007	33207558	33226992	19434	g_30388	g_30390
Super-Scaffold_100007	33233444	33334274	100830	g_42438	g_30393
Super-Scaffold_100007	33334534	33364717	30183	g_30393	g_30394
Super-Scaffold_100007	33365576	33377854	12278	g_30394	g_30396
Super-Scaffold_100007	33378156	33381526	3370	g_30396	g_30397
Super-Scaffold_100007	33392405	33399166	6761	g_30397	g_30398
Super-Scaffold_100007	33401435	33411322	9887	g_30398	g_30400
Super-Scaffold_100007	33433541	33437581	4040	g_30400	g_30401
Super-Scaffold_100007	33440139	33446464	6325	g_30401	g_30402
Super-Scaffold_100007	33448580	33452270	3690	g_30402	g_30403
Super-Scaffold_100007	33474041	33477791	3750	g_30403	g_30404
Super-Scaffold_100007	33491338	33495259	3921	g_30404	g_30405
Super-Scaffold_100007	33500599	33596902	96303	g_30405	g_30407
Super-Scaffold_100007	33603724	33605973	2249	g_30407	g_30408
Super-Scaffold_100007	33616385	33623664	7279	g_30408	g_30409
Super-Scaffold_100007	33632323	33633414	1091	g_30409	g_45372
Super-Scaffold_100007	33634280	33637068	2788	g_45372	g_30410
Super-Scaffold_100007	33657720	33677289	19569	g_30410	g_30411
Super-Scaffold_100007	33687348	33717943	30595	g_30411	g_30412
Super-Scaffold_100007	33724750	33751475	26725	g_30412	g_30413
Super-Scaffold_100007	33753655	33755552	1897	g_30413	g_30414
Super-Scaffold_100007	33774049	33779066	5017	g_30414	g_30415
Super-Scaffold_100007	33782897	33787391	4494	g_30415	g_30416
Super-Scaffold_100007	33811834	33898270	86436	g_30416	g_30417
Super-Scaffold_100007	33919693	33922631	2938	g_30417	g_45373
Super-Scaffold_100007	33940812	34002754	61942	g_45373	g_30419
Super-Scaffold_100007	34025460	34033777	8317	g_30419	g_30420
Super-Scaffold_100007	34036025	34155222	119197	g_30420	g_30424
Super-Scaffold_100007	34157063	34177177	20114	g_30424	g_30425
Super-Scaffold_100007	34177845	34220727	42882	g_30425	g_30427
Super-Scaffold_100007	34223105	34246966	23861	g_30427	g_30428
Super-Scaffold_100007	34250904	34305504	54600	g_30428	g_30430
Super-Scaffold_100007	34305803	34367136	61333	g_30430	g_30435
Super-Scaffold_100007	34368752	34562355	193603	g_30435	g_30439
Super-Scaffold_100007	34563158	34563678	520	g_30439	g_30440
Super-Scaffold_100007	34564526	34684087	119561	g_30440	g_30442
Super-Scaffold_100007	34701289	34730709	29420	g_30442	g_30443
Super-Scaffold_100007	34730927	34756073	25146	g_30443	g_42453
Super-Scaffold_100007	34756876	34815871	58995	g_42453	g_30448
Super-Scaffold_100007	34837480	34840655	3175	g_30448	g_30449
Super-Scaffold_100007	34841968	34845334	3366	g_30449	g_45374
Super-Scaffold_100007	34861405	34863952	2547	g_45374	g_30450
Super-Scaffold_100007	34875180	34878696	3516	g_30450	g_30451
Super-Scaffold_100007	34883476	34896813	13337	g_30451	g_30452
Super-Scaffold_100007	34903701	34924529	20828	g_30452	g_30454
Super-Scaffold_100007	34927533	34934072	6539	g_30454	g_30455
Super-Scaffold_100007	34943092	34961141	18049	g_30455	g_30456
Super-Scaffold_100007	34966393	34969172	2779	g_30456	g_30457
Super-Scaffold_100007	35006973	35010956	3983	g_30457	g_30458
Super-Scaffold_100007	35027619	35029697	2078	g_30458	g_30459
Super-Scaffold_100007	35054495	35057252	2757	g_30459	g_45375
Super-Scaffold_100007	35076062	35083181	7119	g_45375	g_30460
Super-Scaffold_100007	35090334	35090586	252	g_30460	g_30461
Super-Scaffold_100007	35090936	35206492	115556	g_30461	g_30466
Super-Scaffold_100007	35228054	35271609	43555	g_30466	g_30468
Super-Scaffold_100007	35285217	35362199	76982	g_30468	g_30471
Super-Scaffold_100007	35445959	35456740	10781	g_30471	g_30472
Super-Scaffold_100007	35457780	35460364	2584	g_30472	g_30473
Super-Scaffold_100007	35465648	35480177	14529	g_30473	g_42459
Super-Scaffold_100007	35480557	35489969	9412	g_42459	g_30475
Super-Scaffold_100007	35490457	35531268	40811	g_30475	g_30477
Super-Scaffold_100007	35531558	35538570	7012	g_30477	g_30478
Super-Scaffold_100007	35539557	35607550	67993	g_30478	g_45376
Super-Scaffold_100007	35629186	35638194	9008	g_45376	g_30479
Super-Scaffold_100007	35692712	35769975	77263	g_30479	g_30482
Super-Scaffold_100007	35781016	35816509	35493	g_30482	g_30484
Super-Scaffold_100007	35845305	35868865	23560	g_30484	g_30485
Super-Scaffold_100007	35869173	35869654	481	g_30485	g_30486
Super-Scaffold_100007	35870028	35870110	82	g_30486	g_30487
Super-Scaffold_100007	35870496	35880861	10365	g_30487	g_30488
Super-Scaffold_100007	35897783	35929895	32112	g_30488	g_30490
Super-Scaffold_100007	35930245	35934919	4674	g_30490	g_30491
Super-Scaffold_100007	35953982	35981435	27453	g_30491	g_30492
Super-Scaffold_100007	35982043	35987678	5635	g_30492	g_30493
Super-Scaffold_100007	36008360	36009418	1058	g_30493	g_30494
Super-Scaffold_100007	36009996	36022438	12442	g_30494	g_30495
Super-Scaffold_100007	36030538	36033148	2610	g_30495	g_45377
Super-Scaffold_100007	36034874	36043385	8511	g_45377	g_45378
Super-Scaffold_100007	36051963	36061709	9746	g_45378	g_30496
Super-Scaffold_100007	36069016	36078607	9591	g_30496	g_30497
Super-Scaffold_100007	36103557	36109245	5688	g_30497	g_30498
Super-Scaffold_100007	36131217	36137377	6160	g_30498	g_30499
Super-Scaffold_100007	36139795	36142538	2743	g_30499	g_30501
Super-Scaffold_100007	36164744	36164957	213	g_30501	g_30502
Super-Scaffold_100007	36165664	36171670	6006	g_30502	g_30503
Super-Scaffold_100007	36178854	36198053	19199	g_30503	g_45379
Super-Scaffold_100007	36200912	36219670	18758	g_42465	g_30504
Super-Scaffold_100007	36227509	36231428	3919	g_30504	g_30505
Super-Scaffold_100007	36235105	36235530	425	g_30505	g_42466
Super-Scaffold_100007	36237658	36240216	2558	g_30506	g_30507
Super-Scaffold_100007	36250159	36256150	5991	g_30507	g_30508
Super-Scaffold_100007	36256548	36285477	28929	g_30508	g_30509
Super-Scaffold_100007	36311389	36320460	9071	g_30509	g_30511
Super-Scaffold_100007	36346297	36349887	3590	g_30511	g_45380
Super-Scaffold_100007	36385287	36388636	3349	g_45380	g_30512
Super-Scaffold_100007	36390039	36394717	4678	g_42468	g_30513
Super-Scaffold_100007	36398285	36412164	13879	g_30513	g_30514
Super-Scaffold_100007	36420596	36424511	3915	g_30514	g_30515
Super-Scaffold_100007	36425143	36435984	10841	g_30515	g_30516
Super-Scaffold_100007	36438884	36457544	18660	g_30516	g_30517
Super-Scaffold_100007	36466281	36468257	1976	g_30517	g_30518
Super-Scaffold_100007	36471632	36480546	8914	g_30518	g_30519
Super-Scaffold_100007	36495753	36497103	1350	g_30519	g_30520
Super-Scaffold_100007	36503549	36507969	4420	g_30520	g_30521
Super-Scaffold_100007	36508301	36510150	1849	g_30521	g_30522
Super-Scaffold_100007	36534759	36544002	9243	g_30522	g_45381
Super-Scaffold_100007	36563591	36578976	15385	g_45381	g_30523
Super-Scaffold_100007	36582002	36583490	1488	g_30523	g_30524
Super-Scaffold_100007	36585619	36587778	2159	g_30524	g_30526
Super-Scaffold_100007	36600009	36601318	1309	g_30526	g_30527
Super-Scaffold_100007	36610289	36611653	1364	g_30527	g_30528
Super-Scaffold_100007	36612024	36634446	22422	g_30528	g_30529
Super-Scaffold_100007	36635561	36642595	7034	g_30529	g_30531
Super-Scaffold_100007	36645186	36645776	590	g_30531	g_30532
Super-Scaffold_100007	36646138	36647081	943	g_30532	g_30533
Super-Scaffold_100007	36647479	36648888	1409	g_30533	g_30534
Super-Scaffold_100007	36654867	36662521	7654	g_30534	g_30535
Super-Scaffold_100007	36663039	36667236	4197	g_30535	g_30536
Super-Scaffold_100007	36675553	36685414	9861	g_30536	g_30538
Super-Scaffold_100007	36691207	36725374	34167	g_42471	g_30540
Super-Scaffold_100007	36725604	36754852	29248	g_30540	g_30543
Super-Scaffold_100007	36755784	36757926	2142	g_30543	g_30544
Super-Scaffold_100007	36799652	36801840	2188	g_30544	g_45382
Super-Scaffold_100007	36822049	36826788	4739	g_45382	g_30545
Super-Scaffold_100007	36837972	36841518	3546	g_30545	g_30546
Super-Scaffold_100007	36845630	36848369	2739	g_30546	g_30547
Super-Scaffold_100007	36852524	36863072	10548	g_30547	g_30549
Super-Scaffold_100007	36875039	36879539	4500	g_30549	g_30550
Super-Scaffold_100007	36880150	36890361	10211	g_30550	g_30552
Super-Scaffold_100007	36900055	36903829	3774	g_30552	g_30554
Super-Scaffold_100007	36916111	36929908	13797	g_30554	g_30556
Super-Scaffold_100007	36931758	36936113	4355	g_30556	g_30557
Super-Scaffold_100007	36939052	36942454	3402	g_30557	g_30558
Super-Scaffold_100007	36946815	36976205	29390	g_30558	g_30559
Super-Scaffold_100007	36976447	37049705	73258	g_30559	g_30564
Super-Scaffold_100007	37066805	37079567	12762	g_30564	g_30566
Super-Scaffold_100007	37092233	37099096	6863	g_30566	g_30567
Super-Scaffold_100007	37100073	37101405	1332	g_30567	g_30568
Super-Scaffold_100007	37125167	37162585	37418	g_30568	g_30571
Super-Scaffold_100007	37163016	37170970	7954	g_30571	g_30572
Super-Scaffold_100007	37171335	37184059	12724	g_30572	g_30573
Super-Scaffold_100007	37200830	37208676	7846	g_30573	g_30574
Super-Scaffold_100007	37208957	37208968	11	g_30574	g_30575
Super-Scaffold_100007	37209207	37222777	13570	g_30575	g_30578
Super-Scaffold_100007	37232168	37237633	5465	g_30578	g_30579
Super-Scaffold_100007	37249217	37259416	10199	g_42479	g_30580
Super-Scaffold_100007	37279200	37311833	32633	g_30580	g_30581
Super-Scaffold_100007	37312063	37312894	831	g_30581	g_30582
Super-Scaffold_100007	37313808	37314044	236	g_30582	g_30583
Super-Scaffold_100007	37314817	37315718	901	g_30583	g_30584
Super-Scaffold_100007	37316131	37333819	17688	g_30584	g_30586
Super-Scaffold_100007	37334103	37335695	1592	g_30586	g_42481
Super-Scaffold_100007	37336165	37381872	45707	g_42481	g_30590
Super-Scaffold_100007	37382384	37401010	18626	g_30590	g_30591
Super-Scaffold_100007	37401417	37401702	285	g_30591	g_30592
Super-Scaffold_100007	37402184	37424118	21934	g_30592	g_45383
Super-Scaffold_100007	37424474	37425352	878	g_45383	g_30593
Super-Scaffold_100007	37429854	37443115	13261	g_30593	g_30595
Super-Scaffold_100007	37466714	37467634	920	g_30595	g_42483
Super-Scaffold_100007	37467981	37476933	8952	g_42483	g_30598
Super-Scaffold_100007	37520332	37533951	13619	g_30598	g_30599
Super-Scaffold_100007	37534256	37541090	6834	g_30599	g_30601
Super-Scaffold_100007	37541521	37541551	30	g_30601	g_30602
Super-Scaffold_100007	37542291	37543606	1315	g_30602	g_30603
Super-Scaffold_100007	37544037	37579612	35575	g_30603	g_30604
Super-Scaffold_100007	37580658	37588051	7393	g_30604	g_30605
Super-Scaffold_100007	37594962	37597506	2544	g_30605	g_30606
Super-Scaffold_100007	37597745	37605765	8020	g_30606	g_30607
Super-Scaffold_100007	37606175	37627333	21158	g_30607	g_30608
Super-Scaffold_100007	37628619	37631954	3335	g_30608	g_45384
Super-Scaffold_100007	37638368	37679497	41129	g_45384	g_30610
Super-Scaffold_100007	37693764	37753617	59853	g_30610	g_30614
Super-Scaffold_100007	37755329	37755400	71	g_30614	g_30615
Super-Scaffold_100007	37756065	37757337	1272	g_30615	g_30616
Super-Scaffold_100007	37758257	37758284	27	g_30616	g_30617
Super-Scaffold_100007	37759060	37763346	4286	g_30617	g_30618
Super-Scaffold_100007	37763678	37827643	63965	g_30618	g_30623
Super-Scaffold_100007	37827978	37843442	15464	g_30623	g_30624
Super-Scaffold_100007	37843921	37932994	89073	g_30624	g_30628
Super-Scaffold_100007	37933284	37944902	11618	g_30628	g_30629
Super-Scaffold_100007	37950762	38001141	50379	g_30629	g_30631
Super-Scaffold_100009	116872	136194	19322	g_9436	g_9437
Super-Scaffold_100009	136604	200516	63912	g_9437	g_9439
Super-Scaffold_100009	200803	215917	15114	g_9439	g_9440
Super-Scaffold_100009	216333	221727	5394	g_9440	g_9442
Super-Scaffold_100009	222554	222745	191	g_9442	g_9443
Super-Scaffold_100009	224670	242974	18304	g_9443	g_9444
Super-Scaffold_100009	244976	245053	77	g_9444	g_9445
Super-Scaffold_100009	245562	300056	54494	g_9445	g_9446
Super-Scaffold_100009	300307	300455	148	g_9446	g_9447
Super-Scaffold_100009	301486	345005	43519	g_9447	g_36861
Super-Scaffold_100009	345208	408944	63736	g_36861	g_9450
Super-Scaffold_100009	409150	445172	36022	g_9450	g_9452
Super-Scaffold_100009	445720	445749	29	g_9452	g_9453
Super-Scaffold_100009	446681	446710	29	g_9453	g_9454
Super-Scaffold_100009	447627	481561	33934	g_9454	g_9456
Super-Scaffold_100009	481878	501067	19189	g_9456	g_9457
Super-Scaffold_100009	501912	591825	89913	g_9457	g_9459
Super-Scaffold_100009	592031	601717	9686	g_9459	g_9460
Super-Scaffold_100009	602285	653996	51711	g_9460	g_9463
Super-Scaffold_100009	656435	678478	22043	g_9463	g_9465
Super-Scaffold_100009	680253	714714	34461	g_9465	g_9466
Super-Scaffold_100009	718105	737352	19247	g_9466	g_9467
Super-Scaffold_100009	740624	749741	9117	g_9467	g_9468
Super-Scaffold_100009	749941	775970	26029	g_9468	g_43760
Super-Scaffold_100009	776707	793056	16349	g_43760	g_9470
Super-Scaffold_100009	794880	828024	33144	g_9470	g_9471
Super-Scaffold_100009	833534	844646	11112	g_9471	g_9472
Super-Scaffold_100009	853274	856008	2734	g_9472	g_9473
Super-Scaffold_100009	869720	871628	1908	g_9473	g_9474
Super-Scaffold_100009	873378	886618	13240	g_9474	g_9475
Super-Scaffold_100009	892229	898096	5867	g_9475	g_36864
Super-Scaffold_100009	920794	928611	7817	g_9476	g_43761
Super-Scaffold_100009	936203	984575	48372	g_43761	g_9479
Super-Scaffold_100009	985414	1020353	34939	g_9479	g_9480
Super-Scaffold_100009	1026878	1065903	39025	g_9480	g_9482
Super-Scaffold_100009	1085081	1107009	21928	g_9482	g_9483
Super-Scaffold_100009	1110768	1112981	2213	g_9483	g_9484
Super-Scaffold_100009	1113421	1116941	3520	g_9484	g_9485
Super-Scaffold_100009	1148234	1157298	9064	g_9485	g_43762
Super-Scaffold_100009	1178072	1204392	26320	g_43762	g_9487
Super-Scaffold_100009	1205921	1214319	8398	g_9487	g_36868
Super-Scaffold_100009	1215089	1218447	3358	g_36868	g_9490
Super-Scaffold_100009	1219938	1256971	37033	g_36869	g_9491
Super-Scaffold_100009	1258440	1302671	44231	g_9491	g_9493
Super-Scaffold_100009	1311401	1312720	1319	g_9493	g_9494
Super-Scaffold_100009	1321826	1328607	6781	g_9494	g_9495
Super-Scaffold_100009	1354327	1356120	1793	g_9495	g_9496
Super-Scaffold_100009	1362854	1374570	11716	g_9496	g_9497
Super-Scaffold_100009	1390745	1396436	5691	g_9497	g_9498
Super-Scaffold_100009	1399850	1404271	4421	g_9498	g_9499
Super-Scaffold_100009	1414860	1424188	9328	g_9499	g_9500
Super-Scaffold_100009	1424715	1443418	18703	g_9500	g_9501
Super-Scaffold_100009	1450214	1455776	5562	g_9501	g_9502
Super-Scaffold_100009	1470373	1473374	3001	g_9502	g_9503
Super-Scaffold_100009	1496432	1496990	558	g_9503	g_9504
Super-Scaffold_100009	1509750	1514093	4343	g_9504	g_43763
Super-Scaffold_100009	1525777	1539922	14145	g_43763	g_9505
Super-Scaffold_100009	1543179	1562662	19483	g_9505	g_9507
Super-Scaffold_100009	1563159	1563530	371	g_9507	g_9508
Super-Scaffold_100009	1565027	1577202	12175	g_9508	g_9509
Super-Scaffold_100009	1578122	1605692	27570	g_9509	g_9510
Super-Scaffold_100009	1605943	1615476	9533	g_9510	g_9511
Super-Scaffold_100009	1662668	1712566	49898	g_9511	g_36870
Super-Scaffold_100009	1713012	1792615	79603	g_36870	g_36871
Super-Scaffold_100009	1792821	1848606	55785	g_36871	g_9513
Super-Scaffold_100009	1852597	1899776	47179	g_9513	g_36873
Super-Scaffold_100009	1900027	1908366	8339	g_36873	g_9515
Super-Scaffold_100009	1908914	1931595	22681	g_9515	g_9516
Super-Scaffold_100009	1987097	1992214	5117	g_9516	g_9517
Super-Scaffold_100009	2001245	2019477	18232	g_9517	g_9518
Super-Scaffold_100009	2061342	2062956	1614	g_9518	g_9519
Super-Scaffold_100009	2063399	2069995	6596	g_9519	g_9520
Super-Scaffold_100009	2074097	2095838	21741	g_9520	g_9521
Super-Scaffold_100009	2098193	2098784	591	g_9521	g_9522
Super-Scaffold_100009	2100298	2117604	17306	g_9522	g_9523
Super-Scaffold_100009	2121857	2131723	9866	g_9523	g_9524
Super-Scaffold_100009	2139843	2143239	3396	g_9524	g_9525
Super-Scaffold_100009	2145107	2154986	9879	g_9525	g_9528
Super-Scaffold_100009	2166244	2218256	52012	g_9528	g_9530
Super-Scaffold_100009	2218537	2232434	13897	g_9530	g_9531
Super-Scaffold_100009	2250041	2283824	33783	g_9531	g_9532
Super-Scaffold_100009	2284084	2307294	23210	g_9532	g_9535
Super-Scaffold_100009	2315148	2326721	11573	g_9535	g_9537
Super-Scaffold_100009	2328205	2356641	28436	g_9537	g_9538
Super-Scaffold_100009	2359018	2361028	2010	g_9538	g_9539
Super-Scaffold_100009	2369290	2370070	780	g_9539	g_9540
Super-Scaffold_100009	2377024	2408002	30978	g_9540	g_9543
Super-Scaffold_100009	2408898	2412464	3566	g_9543	g_43764
Super-Scaffold_100009	2422067	2425339	3272	g_43764	g_9544
Super-Scaffold_100009	2434970	2456934	21964	g_9544	g_9545
Super-Scaffold_100009	2460351	2463454	3103	g_9545	g_9546
Super-Scaffold_100009	2485260	2502042	16782	g_9546	g_9547
Super-Scaffold_100009	2502383	2525485	23102	g_9547	g_9548
Super-Scaffold_100009	2526066	2527192	1126	g_9548	g_9549
Super-Scaffold_100009	2530856	2532289	1433	g_9549	g_9550
Super-Scaffold_100009	2544261	2551454	7193	g_9550	g_43765
Super-Scaffold_100009	2556266	2561891	5625	g_43765	g_9551
Super-Scaffold_100009	2575714	2575864	150	g_9551	g_9552
Super-Scaffold_100009	2576181	2580329	4148	g_9552	g_9553
Super-Scaffold_100009	2595751	2620600	24849	g_9553	g_9554
Super-Scaffold_100009	2620941	2622790	1849	g_9554	g_9555
Super-Scaffold_100009	2623680	2634580	10900	g_9555	g_9556
Super-Scaffold_100009	2669354	2687678	18324	g_9556	g_9558
Super-Scaffold_100009	2694662	2704697	10035	g_9558	g_9559
Super-Scaffold_100009	2705719	2709632	3913	g_9559	g_9560
Super-Scaffold_100009	2732402	2756415	24013	g_9560	g_9561
Super-Scaffold_100009	2773704	2785024	11320	g_9561	g_9563
Super-Scaffold_100009	2810846	2815007	4161	g_9563	g_9564
Super-Scaffold_100009	2815252	2856442	41190	g_9564	g_9566
Super-Scaffold_100009	2872478	2888368	15890	g_9566	g_43766
Super-Scaffold_100009	2889027	2981242	92215	g_43766	g_9567
Super-Scaffold_100009	2983904	2991731	7827	g_9567	g_9568
Super-Scaffold_100009	2993254	2993766	512	g_9568	g_9569
Super-Scaffold_100009	2996586	3144444	147858	g_9569	g_9577
Super-Scaffold_100009	3144917	3230466	85549	g_9577	g_9580
Super-Scaffold_100009	3239411	3355367	115956	g_9580	g_9581
Super-Scaffold_100009	3374074	3376640	2566	g_9581	g_9582
Super-Scaffold_100009	3377512	3384151	6639	g_9582	g_9583
Super-Scaffold_100009	3401139	3404956	3817	g_9583	g_9584
Super-Scaffold_100009	3411532	3412960	1428	g_9584	g_9585
Super-Scaffold_100009	3413256	3466268	53012	g_9585	g_9586
Super-Scaffold_100009	3467641	3472418	4777	g_9586	g_9588
Super-Scaffold_100009	3485810	3500561	14751	g_9588	g_43767
Super-Scaffold_100009	3519236	3589072	69836	g_43767	g_9591
Super-Scaffold_100009	3589311	3755628	166317	g_9591	g_9596
Super-Scaffold_100009	3772810	3788770	15960	g_9596	g_9597
Super-Scaffold_100009	3860944	3885620	24676	g_9597	g_9598
Super-Scaffold_100009	3887732	3889153	1421	g_9598	g_9599
Super-Scaffold_100009	3889824	3892300	2476	g_9599	g_9600
Super-Scaffold_100009	3892935	3895212	2277	g_9600	g_9601
Super-Scaffold_100009	3895874	3900418	4544	g_9601	g_9602
Super-Scaffold_100009	3901050	3902681	1631	g_9602	g_9603
Super-Scaffold_100009	3903424	3907016	3592	g_9603	g_9604
Super-Scaffold_100009	3907651	3909388	1737	g_9604	g_9605
Super-Scaffold_100009	3910011	3919746	9735	g_9605	g_9606
Super-Scaffold_100009	3920405	3926004	5599	g_9606	g_9607
Super-Scaffold_100009	3926660	3928760	2100	g_9607	g_9608
Super-Scaffold_100009	3929407	3987184	57777	g_9608	g_9609
Super-Scaffold_100009	3995379	3998312	2933	g_9609	g_9610
Super-Scaffold_100009	4004231	4052644	48413	g_9610	g_9611
Super-Scaffold_100009	4064154	4078910	14756	g_9611	g_9612
Super-Scaffold_100009	4081025	4084297	3272	g_9612	g_9613
Super-Scaffold_100009	4096221	4098290	2069	g_9613	g_9614
Super-Scaffold_100009	4111711	4130449	18738	g_9614	g_9616
Super-Scaffold_100009	4130667	4151379	20712	g_9616	g_9617
Super-Scaffold_100009	4223275	4253585	30310	g_9617	g_9618
Super-Scaffold_100009	4260607	4264500	3893	g_9618	g_9619
Super-Scaffold_100009	4300646	4306376	5730	g_9619	g_9620
Super-Scaffold_100009	4316967	4325311	8344	g_9620	g_9622
Super-Scaffold_100009	4326046	4375233	49187	g_9622	g_9623
Super-Scaffold_100009	4376245	4383919	7674	g_9623	g_9624
Super-Scaffold_100009	4388792	4391088	2296	g_9624	g_9625
Super-Scaffold_100009	4391423	4408120	16697	g_9625	g_9626
Super-Scaffold_100009	4421367	4430064	8697	g_9626	g_9628
Super-Scaffold_100009	4444542	4466479	21937	g_9628	g_9629
Super-Scaffold_100009	4475031	4483956	8925	g_9629	g_9630
Super-Scaffold_100009	4491502	4519053	27551	g_9630	g_9632
Super-Scaffold_100009	4531048	4535081	4033	g_9632	g_9633
Super-Scaffold_100009	4548126	4552209	4083	g_9633	g_9634
Super-Scaffold_100009	4558706	4565179	6473	g_9634	g_9635
Super-Scaffold_100009	4580709	4581059	350	g_9635	g_9636
Super-Scaffold_100009	4581658	4586950	5292	g_9636	g_9637
Super-Scaffold_100009	4587561	4590722	3161	g_9637	g_43768
Super-Scaffold_100009	4592869	4614137	21268	g_43768	g_9638
Super-Scaffold_100009	4659452	4675956	16504	g_9638	g_9640
Super-Scaffold_100009	4693033	4736868	43835	g_9640	g_9641
Super-Scaffold_100009	4750068	4762814	12746	g_9641	g_9642
Super-Scaffold_100009	4764156	4773749	9593	g_9642	g_9643
Super-Scaffold_100009	4788950	4800028	11078	g_9643	g_9644
Super-Scaffold_100009	4805993	4873790	67797	g_9644	g_9645
Super-Scaffold_100009	4876397	4906886	30489	g_9645	g_9647
Super-Scaffold_100009	4907323	4956359	49036	g_9647	g_9648
Super-Scaffold_100009	4957282	5028361	71079	g_9648	g_9650
Super-Scaffold_100009	5032305	5035239	2934	g_9650	g_9651
Super-Scaffold_100009	5035662	5071871	36209	g_9651	g_9653
Super-Scaffold_100009	5072482	5226377	153895	g_9653	g_9655
Super-Scaffold_100009	5226727	5293745	67018	g_9655	g_9656
Super-Scaffold_100009	5297071	5414308	117237	g_9656	g_9658
Super-Scaffold_100009	5415258	5431767	16509	g_9658	g_9659
Super-Scaffold_100009	5432243	5442136	9893	g_9659	g_9660
Super-Scaffold_100009	5442387	5442504	117	g_9660	g_9661
Super-Scaffold_100009	5442722	5473265	30543	g_9661	g_9663
Super-Scaffold_100009	5482045	5485873	3828	g_9663	g_9664
Super-Scaffold_100009	5486973	5515286	28313	g_9664	g_36899
Super-Scaffold_100009	5515504	5694141	178637	g_36899	g_9667
Super-Scaffold_100009	5696748	5699103	2355	g_9667	g_9668
Super-Scaffold_100009	5717592	5755413	37821	g_9668	g_36900
Super-Scaffold_100009	5755613	5872103	116490	g_36900	g_9669
Super-Scaffold_100009	5884246	6016692	132446	g_9669	g_9670
Super-Scaffold_100009	6017848	6147713	129865	g_9670	g_9672
Super-Scaffold_100009	6147979	6151844	3865	g_9672	g_9673
Super-Scaffold_100009	6152269	6219498	67229	g_9673	g_9675
Super-Scaffold_100009	6220775	6237501	16726	g_9675	g_43769
Super-Scaffold_100009	6252656	6292471	39815	g_43769	g_9678
Super-Scaffold_100009	6377669	6380399	2730	g_9678	g_43770
Super-Scaffold_100009	6380662	6403974	23312	g_43770	g_9679
Super-Scaffold_100009	6405062	6411674	6612	g_9679	g_9680
Super-Scaffold_100009	6426996	6431486	4490	g_9680	g_9681
Super-Scaffold_100009	6450560	6459011	8451	g_9681	g_43771
Super-Scaffold_100009	6462984	6490164	27180	g_43771	g_9683
Super-Scaffold_100009	6490505	6520777	30272	g_9683	g_9684
Super-Scaffold_100009	6536278	6544506	8228	g_9684	g_43772
Super-Scaffold_100009	6552773	6591475	38702	g_43772	g_9685
Super-Scaffold_100009	6606283	6628254	21971	g_9685	g_9686
Super-Scaffold_100009	6632203	6636685	4482	g_9686	g_43773
Super-Scaffold_100009	6641387	6702799	61412	g_43773	g_9688
Super-Scaffold_100009	6703014	6725179	22165	g_9688	g_9690
Super-Scaffold_100009	6725529	6759409	33880	g_9690	g_9691
Super-Scaffold_100009	6759627	6762778	3151	g_9691	g_9692
Super-Scaffold_100009	6763050	6855141	92091	g_9692	g_9694
Super-Scaffold_100009	6855554	6873496	17942	g_9694	g_9695
Super-Scaffold_100009	6873831	6924927	51096	g_9695	g_9698
Super-Scaffold_100009	6925229	6980497	55268	g_9698	g_9700
Super-Scaffold_100009	6981062	7016395	35333	g_9700	g_9703
Super-Scaffold_100009	7023095	7246103	223008	g_9703	g_9705
Super-Scaffold_100009	7246345	7259307	12962	g_9705	g_9706
Super-Scaffold_100009	7275598	7313563	37965	g_9706	g_9708
Super-Scaffold_100009	7313889	7566667	252778	g_9708	g_9713
Super-Scaffold_100009	7567131	7589730	22599	g_9713	g_9715
Super-Scaffold_100009	7589951	7593712	3761	g_9715	g_9716
Super-Scaffold_100009	7601220	7607584	6364	g_9716	g_9717
Super-Scaffold_100009	7608123	7625954	17831	g_9717	g_9718
Super-Scaffold_100009	7640582	7673439	32857	g_9718	g_9719
Super-Scaffold_100009	7689161	7700670	11509	g_9719	g_9720
Super-Scaffold_100009	7727157	7729924	2767	g_9720	g_9721
Super-Scaffold_100009	7740665	7773340	32675	g_9721	g_9722
Super-Scaffold_100009	7786589	7792041	5452	g_9722	g_9723
Super-Scaffold_100009	7795438	7866993	71555	g_9723	g_9725
Super-Scaffold_100009	7875239	7876070	831	g_9725	g_43774
Super-Scaffold_100009	7877310	7931156	53846	g_43774	g_9727
Super-Scaffold_100009	7946958	7949466	2508	g_9727	g_43775
Super-Scaffold_100009	7957537	7965362	7825	g_43775	g_9728
Super-Scaffold_100009	7966951	8001748	34797	g_9728	g_9729
Super-Scaffold_100009	8002846	8012502	9656	g_9729	g_9730
Super-Scaffold_100009	8025804	8044512	18708	g_9730	g_9732
Super-Scaffold_100009	8055225	8061580	6355	g_9732	g_43776
Super-Scaffold_100009	8083930	8104181	20251	g_43776	g_9733
Super-Scaffold_100009	8105647	8105940	293	g_9733	g_9734
Super-Scaffold_100009	8106455	8139799	33344	g_9734	g_9735
Super-Scaffold_100009	8147483	8165042	17559	g_9735	g_9736
Super-Scaffold_100009	8166501	8174380	7879	g_9736	g_9737
Super-Scaffold_100009	8176468	8180811	4343	g_9737	g_9738
Super-Scaffold_100009	8183482	8253006	69524	g_9738	g_9739
Super-Scaffold_100009	8253812	8255954	2142	g_9739	g_9740
Super-Scaffold_100009	8257433	8315413	57980	g_9740	g_9741
Super-Scaffold_100009	8315739	8351017	35278	g_9741	g_9744
Super-Scaffold_100009	8351220	8380618	29398	g_9744	g_9745
Super-Scaffold_100009	8380818	8473167	92349	g_9745	g_9747
Super-Scaffold_100009	8552887	8557520	4633	g_9747	g_43777
Super-Scaffold_100009	8557984	8568384	10400	g_43777	g_9748
Super-Scaffold_100009	8568713	8584125	15412	g_9748	g_9749
Super-Scaffold_100009	8586066	8587582	1516	g_9749	g_9750
Super-Scaffold_100009	8591623	8663353	71730	g_9750	g_9751
Super-Scaffold_100009	8670913	8672494	1581	g_9751	g_9752
Super-Scaffold_100009	8673852	8675939	2087	g_9752	g_9753
Super-Scaffold_100009	8680266	8683457	3191	g_9753	g_9754
Super-Scaffold_100009	8700470	8719177	18707	g_9754	g_36921
Super-Scaffold_100009	8719440	8801463	82023	g_36921	g_9756
Super-Scaffold_100009	8818912	8821097	2185	g_9756	g_9757
Super-Scaffold_100009	8835560	8840874	5314	g_9757	g_9758
Super-Scaffold_100009	8853836	8941895	88059	g_9758	g_9759
Super-Scaffold_100009	8953305	8957319	4014	g_9759	g_9760
Super-Scaffold_100009	8963836	8990677	26841	g_9760	g_9761
Super-Scaffold_100009	9009228	9039638	30410	g_9761	g_9762
Super-Scaffold_100009	9053390	9063677	10287	g_9762	g_9763
Super-Scaffold_100009	9065982	9128364	62382	g_9763	g_9764
Super-Scaffold_100009	9133398	9263421	130023	g_9764	g_9768
Super-Scaffold_100009	9272346	9315444	43098	g_9768	g_9769
Super-Scaffold_100009	9326351	9334348	7997	g_9769	g_9770
Super-Scaffold_100009	9342541	9345338	2797	g_9770	g_36924
Super-Scaffold_100009	9348078	9354998	6920	g_9771	g_9772
Super-Scaffold_100009	9400476	9414646	14170	g_9772	g_9775
Super-Scaffold_100009	9414930	9415875	945	g_9775	g_9776
Super-Scaffold_100009	9416261	9416625	364	g_9776	g_9773
Super-Scaffold_100009	9421838	9423184	1346	g_9773	g_43778
Super-Scaffold_100009	9431376	9466449	35073	g_43778	g_9777
Super-Scaffold_100009	9486619	9508543	21924	g_9777	g_9778
Super-Scaffold_100009	9541475	9551742	10267	g_9778	g_9779
Super-Scaffold_100009	9559345	9582759	23414	g_9779	g_9780
Super-Scaffold_100009	9583667	9592375	8708	g_9780	g_9781
Super-Scaffold_100009	9619004	9621856	2852	g_9781	g_43779
Super-Scaffold_100009	9625266	9629671	4405	g_43779	g_9782
Super-Scaffold_100009	9631770	9632678	908	g_9782	g_9783
Super-Scaffold_100009	9639972	9640556	584	g_9783	g_9784
Super-Scaffold_100009	9648824	9667060	18236	g_9784	g_43780
Super-Scaffold_100009	9672774	9709232	36458	g_43780	g_9785
Super-Scaffold_100009	9709897	9725258	15361	g_9785	g_43781
Super-Scaffold_100009	9733237	9738899	5662	g_43781	g_9786
Super-Scaffold_100009	9741172	9745338	4166	g_9786	g_9787
Super-Scaffold_100009	9750131	9751342	1211	g_9787	g_9788
Super-Scaffold_100009	9762489	9812305	49816	g_9788	g_9791
Super-Scaffold_100009	9817830	9853370	35540	g_9791	g_9792
Super-Scaffold_100009	9877772	9886118	8346	g_9792	g_9794
Super-Scaffold_100009	9886744	9955143	68399	g_9794	g_9795
Super-Scaffold_100009	9962537	9972594	10057	g_9795	g_9796
Super-Scaffold_100009	9979400	9980001	601	g_9796	g_9797
Super-Scaffold_100009	9997507	10005898	8391	g_9797	g_9799
Super-Scaffold_100009	10009052	10015492	6440	g_9799	g_9800
Super-Scaffold_100009	10016052	10016566	514	g_9800	g_9801
Super-Scaffold_100009	10017246	10047801	30555	g_9801	g_9803
Super-Scaffold_100009	10049558	10057275	7717	g_9803	g_9804
Super-Scaffold_100009	10059032	10133612	74580	g_9804	g_9807
Super-Scaffold_100009	10133839	10149795	15956	g_9807	g_9810
Super-Scaffold_100009	10150397	10172208	21811	g_9810	g_9813
Super-Scaffold_100009	10176248	10177068	820	g_9813	g_9814
Super-Scaffold_100009	10178324	10181788	3464	g_9814	g_9815
Super-Scaffold_100009	10187614	10191512	3898	g_9815	g_9816
Super-Scaffold_100009	10200762	10204009	3247	g_9816	g_9817
Super-Scaffold_100009	10209211	10212594	3383	g_9817	g_9818
Super-Scaffold_100009	10214750	10214859	109	g_9818	g_9819
Super-Scaffold_100009	10218057	10218799	742	g_9819	g_9820
Super-Scaffold_100009	10220706	10226194	5488	g_9820	g_9821
Super-Scaffold_100009	10229287	10233098	3811	g_9821	g_9822
Super-Scaffold_100009	10244466	10246122	1656	g_9822	g_9823
Super-Scaffold_100009	10258451	10262080	3629	g_9823	g_9824
Super-Scaffold_100009	10314146	10333969	19823	g_9825	g_9827
Super-Scaffold_100009	10347820	10357468	9648	g_9827	g_9828
Super-Scaffold_100009	10361080	10406236	45156	g_9828	g_36933
Super-Scaffold_100009	10406649	10420495	13846	g_36933	g_9835
Super-Scaffold_100009	10420866	10421208	342	g_9835	g_9836
Super-Scaffold_100009	10421576	10435818	14242	g_9836	g_9837
Super-Scaffold_100009	10441556	10443112	1556	g_9837	g_43782
Super-Scaffold_100009	10455885	10458789	2904	g_43782	g_43783
Super-Scaffold_100009	10459136	10507142	48006	g_43783	g_9839
Super-Scaffold_100009	10516205	10517062	857	g_9839	g_9840
Super-Scaffold_100009	10519644	10524081	4437	g_9840	g_9841
Super-Scaffold_100009	10530193	10534339	4146	g_9841	g_9842
Super-Scaffold_100009	10543310	10551700	8390	g_9842	g_9843
Super-Scaffold_100009	10552029	10854198	302169	g_9843	g_9847
Super-Scaffold_100009	10856399	10936373	79974	g_9847	g_9850
Super-Scaffold_100009	10936651	10943923	7272	g_9850	g_9851
Super-Scaffold_100009	10956935	11086046	129111	g_9851	g_9852
Super-Scaffold_100009	11089948	11262494	172546	g_9852	g_9854
Super-Scaffold_100009	11268343	11363412	95069	g_9854	g_9855
Super-Scaffold_100009	11383152	11385523	2371	g_9855	g_9856
Super-Scaffold_100009	11392612	11395056	2444	g_9856	g_43784
Super-Scaffold_100009	11402212	11406549	4337	g_43784	g_9857
Super-Scaffold_100009	11415379	11421383	6004	g_9857	g_9858
Super-Scaffold_100009	11443272	11447862	4590	g_9858	g_9859
Super-Scaffold_100009	11455730	11458535	2805	g_9859	g_9860
Super-Scaffold_100009	11458759	11485426	26667	g_9860	g_9862
Super-Scaffold_100009	11485863	11492291	6428	g_9862	g_9863
Super-Scaffold_100009	11499399	11505073	5674	g_9863	g_9864
Super-Scaffold_100009	11505456	11518274	12818	g_9864	g_9866
Super-Scaffold_100009	11522596	11536872	14276	g_9866	g_9867
Super-Scaffold_100009	11542031	11558216	16185	g_9867	g_9868
Super-Scaffold_100009	11623900	11629639	5739	g_9868	g_43785
Super-Scaffold_100009	11643548	11664319	20771	g_43785	g_9869
Super-Scaffold_100009	11665934	11700636	34702	g_9869	g_36944
Super-Scaffold_100009	11700875	11733609	32734	g_36944	g_9870
Super-Scaffold_100009	11734250	11805614	71364	g_9870	g_9871
Super-Scaffold_100009	11806576	11810864	4288	g_9871	g_9872
Super-Scaffold_100009	11823807	11832017	8210	g_9872	g_43786
Super-Scaffold_100009	11833789	11836129	2340	g_43786	g_36947
Super-Scaffold_100009	11837649	11838127	478	g_36947	g_9873
Super-Scaffold_100009	11838543	11840389	1846	g_9873	g_9874
Super-Scaffold_100009	11842178	11849116	6938	g_9874	g_9875
Super-Scaffold_100009	11851725	11853881	2156	g_9875	g_9876
Super-Scaffold_100009	11856954	11884072	27118	g_9876	g_9877
Super-Scaffold_100009	11886967	11954436	67469	g_9877	g_9881
Super-Scaffold_100009	11961135	11971142	10007	g_9881	g_9882
Super-Scaffold_100009	11972242	11974902	2660	g_9882	g_9883
Super-Scaffold_100009	11975255	11987354	12099	g_9883	g_9884
Super-Scaffold_100009	11994585	12044303	49718	g_9884	g_9885
Super-Scaffold_100009	12046889	12049202	2313	g_9885	g_9886
Super-Scaffold_100009	12072320	12129108	56788	g_9886	g_9890
Super-Scaffold_100009	12133357	12139725	6368	g_9890	g_9891
Super-Scaffold_100009	12141333	12143668	2335	g_9891	g_9892
Super-Scaffold_100009	12147325	12151141	3816	g_9892	g_43787
Super-Scaffold_100009	12166008	12172889	6881	g_43787	g_9893
Super-Scaffold_100009	12178479	12444810	266331	g_9893	g_9897
Super-Scaffold_100009	12464567	12477783	13216	g_9897	g_9898
Super-Scaffold_100009	12479745	12480441	696	g_9898	g_9899
Super-Scaffold_100009	12484835	12486564	1729	g_9899	g_9900
Super-Scaffold_100009	12489985	12497484	7499	g_9900	g_9901
Super-Scaffold_100009	12519551	12523667	4116	g_9901	g_9902
Super-Scaffold_100009	12524752	12526600	1848	g_9902	g_9903
Super-Scaffold_100009	12527370	12528652	1282	g_9903	g_9904
Super-Scaffold_100009	12529539	12555207	25668	g_9904	g_9908
Super-Scaffold_100009	12567276	12591245	23969	g_9908	g_9909
Super-Scaffold_100009	12617527	12618318	791	g_9909	g_9910
Super-Scaffold_100009	12620908	12621462	554	g_9910	g_9911
Super-Scaffold_100009	12623717	12625306	1589	g_9911	g_9912
Super-Scaffold_100009	12632499	12668543	36044	g_9913	g_9914
Super-Scaffold_100009	12671074	12724396	53322	g_9914	g_9915
Super-Scaffold_100009	12744599	12796694	52095	g_9915	g_9916
Super-Scaffold_100009	12801889	12810684	8795	g_9916	g_9917
Super-Scaffold_100009	12815603	12826823	11220	g_9917	g_9918
Super-Scaffold_100009	12837725	12841989	4264	g_9918	g_9919
Super-Scaffold_100009	12853065	12887044	33979	g_9919	g_43788
Super-Scaffold_100009	12893239	12909852	16613	g_43788	g_9920
Super-Scaffold_100009	12917613	12922198	4585	g_9920	g_9921
Super-Scaffold_100009	12934041	12963793	29752	g_9921	g_9922
Super-Scaffold_100009	12971258	12976052	4794	g_9922	g_9923
Super-Scaffold_100009	12990761	12994475	3714	g_9923	g_9924
Super-Scaffold_100009	13031379	13047561	16182	g_9924	g_9925
Super-Scaffold_100009	13048640	13050024	1384	g_9925	g_9926
Super-Scaffold_100009	13056446	13155171	98725	g_9926	g_9929
Super-Scaffold_100009	13156184	13156381	197	g_9929	g_9930
Super-Scaffold_100009	13158186	13158568	382	g_9930	g_9931
Super-Scaffold_100009	13159961	13160017	56	g_9931	g_9932
Super-Scaffold_100009	13160283	13198136	37853	g_9932	g_9934
Super-Scaffold_100009	13209971	13218669	8698	g_9934	g_9936
Super-Scaffold_100009	13218965	13242531	23566	g_9936	g_9939
Super-Scaffold_100009	13258532	13268352	9820	g_9939	g_9940
Super-Scaffold_100009	13270850	13272543	1693	g_9940	g_9941
Super-Scaffold_100009	13274891	13284570	9679	g_9941	g_9942
Super-Scaffold_100009	13287866	13289365	1499	g_9942	g_9943
Super-Scaffold_100009	13295037	13313471	18434	g_9943	g_9944
Super-Scaffold_100009	13344650	13357809	13159	g_36960	g_9945
Super-Scaffold_100009	13358036	13377274	19238	g_9945	g_9946
Super-Scaffold_100009	13380271	13448649	68378	g_9946	g_9947
Super-Scaffold_100009	13462971	13464026	1055	g_9947	g_9948
Super-Scaffold_100009	13465923	13468368	2445	g_9948	g_9949
Super-Scaffold_100009	13469299	13473761	4462	g_9949	g_9950
Super-Scaffold_100009	13485870	13598404	112534	g_9950	g_9951
Super-Scaffold_100009	13602335	13609331	6996	g_9951	g_9952
Super-Scaffold_100009	13631037	13633579	2542	g_9952	g_9953
Super-Scaffold_100009	13643441	13751616	108175	g_9953	g_9955
Super-Scaffold_100009	13752056	13826033	73977	g_9955	g_9957
Super-Scaffold_100009	13826431	13863394	36963	g_9957	g_9959
Super-Scaffold_100009	13863645	13867773	4128	g_9959	g_9960
Super-Scaffold_100009	13868090	13890570	22480	g_9960	g_9961
Super-Scaffold_100009	13954433	14110663	156230	g_9961	g_9966
Super-Scaffold_100009	14110938	14136053	25115	g_9966	g_9967
Super-Scaffold_100009	14136346	14155773	19427	g_9967	g_9969
Super-Scaffold_100009	14156231	14214670	58439	g_9969	g_9971
Super-Scaffold_100009	14214906	14354015	139109	g_9971	g_9973
Super-Scaffold_100009	14361042	14364018	2976	g_9973	g_9974
Super-Scaffold_100009	14373708	14377230	3522	g_9974	g_9975
Super-Scaffold_100009	14381593	14382793	1200	g_9975	g_9976
Super-Scaffold_100009	14392723	14452334	59611	g_9976	g_9977
Super-Scaffold_100009	14461033	14483681	22648	g_9977	g_9978
Super-Scaffold_100009	14486701	14508624	21923	g_9978	g_9979
Super-Scaffold_100009	14510418	14518550	8132	g_9979	g_9980
Super-Scaffold_100009	14519479	14535134	15655	g_9980	g_9981
Super-Scaffold_100009	14536048	14540173	4125	g_9981	g_9982
Super-Scaffold_100009	14541729	14550534	8805	g_9982	g_9983
Super-Scaffold_100009	14551448	14560230	8782	g_9983	g_9985
Super-Scaffold_100009	14562923	14581735	18812	g_9985	g_9987
Super-Scaffold_100009	14582649	14594219	11570	g_9987	g_9988
Super-Scaffold_100009	14595133	14623336	28203	g_9988	g_9991
Super-Scaffold_100009	14624894	14648975	24081	g_9991	g_9992
Super-Scaffold_100009	14649458	14660080	10622	g_9992	g_9993
Super-Scaffold_100009	14660994	14687902	26908	g_9993	g_9996
Super-Scaffold_100009	14688816	14693045	4229	g_9996	g_9997
Super-Scaffold_100009	14699895	14709577	9682	g_9997	g_9998
Super-Scaffold_100009	14710491	14747887	37396	g_9998	g_9999
Super-Scaffold_100009	14761814	14764720	2906	g_9999	g_43789
Super-Scaffold_100009	14785343	14791752	6409	g_43789	g_10000
Super-Scaffold_100009	14796838	14799780	2942	g_10000	g_10001
Super-Scaffold_100009	14801036	14804178	3142	g_10001	g_10002
Super-Scaffold_100009	14809843	14824340	14497	g_10002	g_10003
Super-Scaffold_100009	14827455	14830997	3542	g_10003	g_10004
Super-Scaffold_100009	14832508	14838766	6258	g_10004	g_10005
Super-Scaffold_100009	14841276	14843013	1737	g_10005	g_10006
Super-Scaffold_100009	14846499	14852061	5562	g_10006	g_10007
Super-Scaffold_100009	14855444	14859271	3827	g_10007	g_10008
Super-Scaffold_100009	14867578	14868365	787	g_10008	g_43790
Super-Scaffold_100009	14871343	14874150	2807	g_43790	g_10009
Super-Scaffold_100009	14878731	14885278	6547	g_10009	g_10010
Super-Scaffold_100009	14894538	14903495	8957	g_10010	g_36977
Super-Scaffold_100009	14903782	14950674	46892	g_36977	g_10013
Super-Scaffold_100009	14950916	14962409	11493	g_10013	g_10014
Super-Scaffold_100009	14971272	14976894	5622	g_10014	g_36980
Super-Scaffold_100009	14977127	14984400	7273	g_36980	g_10016
Super-Scaffold_100009	14985026	15035947	50921	g_10016	g_10017
Super-Scaffold_100009	15049660	15072443	22783	g_10017	g_10018
Super-Scaffold_100009	15073192	15076103	2911	g_10018	g_10019
Super-Scaffold_100009	15078617	15084033	5416	g_10019	g_10020
Super-Scaffold_100009	15086112	15088534	2422	g_10020	g_10021
Super-Scaffold_100009	15093129	15094452	1323	g_10021	g_10022
Super-Scaffold_100009	15111038	15112994	1956	g_10022	g_43791
Super-Scaffold_100009	15115164	15115693	529	g_43791	g_10023
Super-Scaffold_100009	15117661	15119361	1700	g_10023	g_10024
Super-Scaffold_100009	15166429	15168085	1656	g_10024	g_36981
Super-Scaffold_100009	15170241	15170940	699	g_36981	g_10025
Super-Scaffold_100009	15180674	15263107	82433	g_10025	g_10026
Super-Scaffold_100009	15276289	15298788	22499	g_10026	g_10027
Super-Scaffold_100009	15302871	15308339	5468	g_10027	g_43792
Super-Scaffold_100009	15312485	15313000	515	g_43792	g_10028
Super-Scaffold_100009	15322313	15327834	5521	g_10028	g_10029
Super-Scaffold_100009	15334486	15339588	5102	g_10029	g_10030
Super-Scaffold_100009	15349117	15352045	2928	g_10030	g_10031
Super-Scaffold_100009	15354441	15480364	125923	g_10031	g_36982
Super-Scaffold_100009	15480609	15611863	131254	g_36982	g_10033
Super-Scaffold_100009	15633846	15665679	31833	g_10033	g_10035
Super-Scaffold_100009	15665945	15731049	65104	g_10035	g_10040
Super-Scaffold_100009	15731438	15732528	1090	g_10040	g_10041
Super-Scaffold_100009	15740879	15750129	9250	g_10042	g_10044
Super-Scaffold_100009	15758411	15763980	5569	g_10044	g_10045
Super-Scaffold_100009	15771727	15779671	7944	g_10045	g_10046
Super-Scaffold_100009	15784597	15790848	6251	g_10046	g_10047
Super-Scaffold_100009	15798178	15802249	4071	g_10047	g_10048
Super-Scaffold_100009	15803892	15867107	63215	g_10048	g_10049
Super-Scaffold_100009	15867604	15871080	3476	g_10049	g_10050
Super-Scaffold_100009	15871400	15987301	115901	g_10050	g_10051
Super-Scaffold_100009	15991699	16000074	8375	g_10051	g_10052
Super-Scaffold_100009	16003155	16014369	11214	g_10052	g_10053
Super-Scaffold_100009	16023099	16024595	1496	g_10053	g_10054
Super-Scaffold_100009	16033224	16045490	12266	g_10054	g_10055
Super-Scaffold_100009	16048025	16068829	20804	g_10055	g_10057
Super-Scaffold_100009	16106534	16320297	213763	g_10057	g_10060
Super-Scaffold_100009	16339043	16354309	15266	g_10060	g_10061
Super-Scaffold_100009	16376396	16412192	35796	g_10061	g_10064
Super-Scaffold_100009	16412512	16426879	14367	g_10064	g_10065
Super-Scaffold_100009	16431518	16434004	2486	g_10065	g_10066
Super-Scaffold_100009	16437720	16439018	1298	g_10066	g_10067
Super-Scaffold_100009	16440226	16441925	1699	g_10067	g_10068
Super-Scaffold_100009	16445306	16447513	2207	g_10068	g_10069
Super-Scaffold_100009	16458079	16498867	40788	g_10070	g_10071
Super-Scaffold_100009	16508280	16556979	48699	g_10071	g_10072
Super-Scaffold_100009	16559790	16566739	6949	g_10072	g_10073
Super-Scaffold_100009	16569370	16571389	2019	g_10073	g_10074
Super-Scaffold_100009	16584784	16590520	5736	g_10074	g_10075
Super-Scaffold_100009	16604022	16622521	18499	g_10075	g_10077
Super-Scaffold_100009	16627300	16630045	2745	g_10077	g_43793
Super-Scaffold_100009	16633767	16685401	51634	g_43793	g_10079
Super-Scaffold_100009	16695363	16707133	11770	g_10079	g_10080
Super-Scaffold_100009	16711278	16715739	4461	g_10080	g_43794
Super-Scaffold_100009	16718816	16720378	1562	g_43794	g_10081
Super-Scaffold_100009	16724809	16729017	4208	g_10081	g_10082
Super-Scaffold_100009	16733256	16734557	1301	g_10082	g_10083
Super-Scaffold_100009	16736432	16747570	11138	g_10083	g_10084
Super-Scaffold_100009	16767426	16768906	1480	g_10084	g_10085
Super-Scaffold_100009	16771304	16799721	28417	g_10085	g_10086
Super-Scaffold_100009	16823529	16825199	1670	g_10086	g_10087
Super-Scaffold_100009	16825495	16825764	269	g_10087	g_10088
Super-Scaffold_100009	16826000	16826028	28	g_10088	g_10089
Super-Scaffold_100009	16826576	16827614	1038	g_10089	g_10091
Super-Scaffold_100009	16828288	16828566	278	g_10091	g_10092
Super-Scaffold_100009	16830629	16835149	4520	g_10092	g_43795
Super-Scaffold_100009	16841831	16844577	2746	g_43795	g_10093
Super-Scaffold_100009	16848350	16855276	6926	g_10093	g_43796
Super-Scaffold_100009	16859506	16860983	1477	g_43796	g_10094
Super-Scaffold_100009	16876071	16883674	7603	g_10094	g_10095
Super-Scaffold_100009	16887717	16894129	6412	g_10095	g_43797
Super-Scaffold_100009	16898231	16898908	677	g_43797	g_10096
Super-Scaffold_100009	16899585	16899748	163	g_10096	g_10097
Super-Scaffold_100009	16900326	16901998	1672	g_10097	g_10098
Super-Scaffold_100009	16902759	16903218	459	g_10098	g_10099
Super-Scaffold_100009	16903811	16951216	47405	g_10099	g_10100
Super-Scaffold_100009	16951434	16989691	38257	g_10100	g_10101
Super-Scaffold_100009	16990959	17032561	41602	g_10101	g_10102
Super-Scaffold_100009	17038418	17063596	25178	g_10102	g_10103
Super-Scaffold_100009	17072033	17098707	26674	g_10103	g_10105
Super-Scaffold_100009	17101465	17110755	9290	g_10105	g_43798
Super-Scaffold_100009	17115233	17116100	867	g_43798	g_10106
Super-Scaffold_100009	17116802	17163123	46321	g_36990	g_10107
Super-Scaffold_100009	17166433	17177539	11106	g_10107	g_10109
Super-Scaffold_100009	17177820	17202317	24497	g_10109	g_10110
Super-Scaffold_100009	17203172	17211878	8706	g_10110	g_10111
Super-Scaffold_100009	17215400	17226079	10679	g_10111	g_10112
Super-Scaffold_100009	17229572	17280133	50561	g_10112	g_10114
Super-Scaffold_100009	17283331	17295757	12426	g_10114	g_10115
Super-Scaffold_100009	17299703	17325452	25749	g_10115	g_10116
Super-Scaffold_100009	17338020	17344697	6677	g_10116	g_10117
Super-Scaffold_100009	17354183	17359850	5667	g_10117	g_10118
Super-Scaffold_100009	17360368	17374525	14157	g_10118	g_10119
Super-Scaffold_100009	17382015	17388125	6110	g_10119	g_10120
Super-Scaffold_100009	17410941	17413307	2366	g_10120	g_10121
Super-Scaffold_100009	17437821	17474927	37106	g_10121	g_10122
Super-Scaffold_100009	17475478	17504390	28912	g_10122	g_10123
Super-Scaffold_100009	17505451	17531267	25816	g_10123	g_10124
Super-Scaffold_100009	17551624	17579616	27992	g_10124	g_10125
Super-Scaffold_100009	17579828	17626709	46881	g_10125	g_10126
Super-Scaffold_100009	17627059	17634500	7441	g_10126	g_10127
Super-Scaffold_100009	17635129	17640157	5028	g_10127	g_10128
Super-Scaffold_100009	17646643	17668213	21570	g_10128	g_10129
Super-Scaffold_100009	17677603	17687093	9490	g_10129	g_10130
Super-Scaffold_100009	17688905	17694166	5261	g_10130	g_10131
Super-Scaffold_100009	17695122	17701638	6516	g_10131	g_10132
Super-Scaffold_100009	17703991	17708660	4669	g_10132	g_43799
Super-Scaffold_100009	17721922	17722648	726	g_43799	g_10133
Super-Scaffold_100009	17723640	17724156	516	g_10133	g_10134
Super-Scaffold_100009	17742275	17904987	162712	g_10134	g_10139
Super-Scaffold_100009	17919630	17922757	3127	g_10139	g_10140
Super-Scaffold_100009	17924409	17925788	1379	g_10140	g_10141
Super-Scaffold_100009	17938310	17948610	10300	g_10141	g_10142
Super-Scaffold_100009	17949272	17953285	4013	g_10142	g_10143
Super-Scaffold_100009	17965723	17989156	23433	g_10143	g_10144
Super-Scaffold_100009	18005740	18008845	3105	g_10144	g_10145
Super-Scaffold_100009	18010699	18014770	4071	g_10145	g_10146
Super-Scaffold_100009	18024370	18026828	2458	g_10146	g_10147
Super-Scaffold_100009	18028181	18031093	2912	g_10147	g_10148
Super-Scaffold_100009	18082685	18086053	3368	g_10148	g_10149
Super-Scaffold_100009	18094982	18099594	4612	g_10149	g_10150
Super-Scaffold_100009	18099836	18105794	5958	g_10150	g_10151
Super-Scaffold_100009	18106030	18106929	899	g_10151	g_37000
Super-Scaffold_100009	18107165	18107772	607	g_37000	g_10152
Super-Scaffold_100009	18109719	18111032	1313	g_10152	g_10153
Super-Scaffold_100009	18113508	18116243	2735	g_10153	g_10154
Super-Scaffold_100009	18120395	18126392	5997	g_10154	g_10155
Super-Scaffold_100009	18128750	18130223	1473	g_10155	g_10156
Super-Scaffold_100009	18131208	18134216	3008	g_10156	g_10157
Super-Scaffold_100009	18139986	18169995	30009	g_10157	g_10158
Super-Scaffold_100009	18170246	18180579	10333	g_10158	g_43800
Super-Scaffold_100009	18184781	18185478	697	g_43800	g_10159
Super-Scaffold_100009	18186617	18190661	4044	g_10159	g_10160
Super-Scaffold_100009	18198493	18221005	22512	g_10160	g_10161
Super-Scaffold_100009	18229229	18285674	56445	g_10161	g_10162
Super-Scaffold_100009	18286828	18292782	5954	g_10162	g_10163
Super-Scaffold_100009	18299400	18313205	13805	g_10163	g_10166
Super-Scaffold_100009	18315604	18317325	1721	g_10166	g_10167
Super-Scaffold_100009	18318723	18321170	2447	g_10167	g_10168
Super-Scaffold_100009	18323628	18326128	2500	g_10168	g_10169
Super-Scaffold_100009	18328303	18328816	513	g_10169	g_10170
Super-Scaffold_100009	18331547	18331772	225	g_10170	g_10171
Super-Scaffold_100009	18337849	18341272	3423	g_10171	g_10172
Super-Scaffold_100009	18354262	18356548	2286	g_10172	g_10173
Super-Scaffold_100009	18359976	18362274	2298	g_10173	g_10174
Super-Scaffold_100009	18364173	18370961	6788	g_10174	g_10175
Super-Scaffold_100009	18371434	18390255	18821	g_10175	g_10177
Super-Scaffold_100009	18409054	18417087	8033	g_10177	g_10178
Super-Scaffold_100009	18428456	18430121	1665	g_10178	g_10179
Super-Scaffold_100009	18438097	18448037	9940	g_10179	g_10181
Super-Scaffold_100009	18458363	18461088	2725	g_10181	g_10182
Super-Scaffold_100009	18461360	18476763	15403	g_10182	g_10183
Super-Scaffold_100009	18480441	18485727	5286	g_10183	g_10184
Super-Scaffold_100009	18490757	18494654	3897	g_10184	g_10185
Super-Scaffold_100009	18495232	18521934	26702	g_10185	g_10187
Super-Scaffold_100009	18538236	18549467	11231	g_10187	g_10188
Super-Scaffold_100009	18550483	18595952	45469	g_10188	g_10189
Super-Scaffold_100009	18620974	18625036	4062	g_10189	g_10190
Super-Scaffold_100009	18629024	18630294	1270	g_10190	g_10191
Super-Scaffold_100009	18635072	18636378	1306	g_10191	g_10192
Super-Scaffold_100009	18638385	18640865	2480	g_10192	g_10193
Super-Scaffold_100009	18646449	18653365	6916	g_10193	g_10194
Super-Scaffold_100009	18655384	18658133	2749	g_10194	g_10195
Super-Scaffold_100009	18670062	18672995	2933	g_10195	g_10196
Super-Scaffold_100009	18683114	18688253	5139	g_10196	g_10197
Super-Scaffold_100009	18690860	18693465	2605	g_10197	g_10198
Super-Scaffold_100009	18697176	18712501	15325	g_10198	g_10201
Super-Scaffold_100009	18740039	18742513	2474	g_10201	g_10202
Super-Scaffold_100009	18742806	18754821	12015	g_10202	g_10203
Super-Scaffold_100009	18755232	18757424	2192	g_10203	g_10204
Super-Scaffold_100009	18757837	18772882	15045	g_10204	g_10205
Super-Scaffold_100009	18773295	18805354	32059	g_10205	g_10207
Super-Scaffold_100009	18807510	18833818	26308	g_10207	g_10208
Super-Scaffold_100009	18834207	18837671	3464	g_10208	g_10209
Super-Scaffold_100009	18838045	18883996	45951	g_10209	g_10210
Super-Scaffold_100009	18888280	18961150	72870	g_10210	g_10213
Super-Scaffold_100009	18964799	18967999	3200	g_10213	g_43801
Super-Scaffold_100009	18972566	18974576	2010	g_43801	g_10214
Super-Scaffold_100009	18985430	18988503	3073	g_10214	g_10215
Super-Scaffold_100009	18992870	19026133	33263	g_10215	g_10216
Super-Scaffold_100009	19034107	19038606	4499	g_10216	g_10217
Super-Scaffold_100009	19043076	19083256	40180	g_10217	g_10218
Super-Scaffold_100009	19102590	19108354	5764	g_10218	g_10219
Super-Scaffold_100009	19108575	19110609	2034	g_10219	g_37010
Super-Scaffold_100009	19110830	19128175	17345	g_37010	g_10223
Super-Scaffold_100009	19128444	19140445	12001	g_10223	g_10224
Super-Scaffold_100009	19165663	19169592	3929	g_10224	g_10225
Super-Scaffold_100009	19169888	19173607	3719	g_10225	g_37015
Super-Scaffold_100009	19173903	19178290	4387	g_37015	g_10226
Super-Scaffold_100009	19181719	19189304	7585	g_10226	g_10227
Super-Scaffold_100009	19203044	19229664	26620	g_10227	g_10229
Super-Scaffold_100009	19236770	19240462	3692	g_10229	g_10230
Super-Scaffold_100009	19242060	19243842	1782	g_10230	g_10231
Super-Scaffold_100009	19256713	19283550	26837	g_10231	g_10232
Super-Scaffold_100009	19297690	19307930	10240	g_10232	g_10233
Super-Scaffold_100009	19308952	19326275	17323	g_10233	g_10234
Super-Scaffold_100009	19328162	19356013	27851	g_10234	g_10235
Super-Scaffold_100009	19358155	19365076	6921	g_37016	g_10236
Super-Scaffold_100009	19367697	19417641	49944	g_10236	g_10237
Super-Scaffold_100009	19417886	19438517	20631	g_10237	g_10238
Super-Scaffold_100009	19462991	19475661	12670	g_10238	g_43802
Super-Scaffold_100009	19479245	19483912	4667	g_43802	g_10240
Super-Scaffold_100009	19494314	19494391	77	g_10240	g_10241
Super-Scaffold_100009	19494675	19497688	3013	g_10241	g_10242
Super-Scaffold_100009	19500966	19525059	24093	g_10242	g_43803
Super-Scaffold_100009	19528805	19531427	2622	g_43803	g_10243
Super-Scaffold_100009	19536976	19538041	1065	g_10243	g_10244
Super-Scaffold_100009	19542540	19546946	4406	g_10244	g_10245
Super-Scaffold_100009	19548316	19700274	151958	g_10245	g_10249
Super-Scaffold_100009	19706584	19737454	30870	g_10249	g_10251
Super-Scaffold_100009	19737936	19825051	87115	g_10251	g_10253
Super-Scaffold_100009	19834094	19835574	1480	g_10253	g_10254
Super-Scaffold_100009	19843870	19846190	2320	g_10254	g_10255
Super-Scaffold_100009	19848242	19850048	1806	g_10255	g_10256
Super-Scaffold_100009	19861334	19914646	53312	g_10256	g_10257
Super-Scaffold_100009	19918944	19924063	5119	g_10257	g_10258
Super-Scaffold_100009	19926818	19927719	901	g_10258	g_10259
Super-Scaffold_100009	19928952	19935545	6593	g_10259	g_10260
Super-Scaffold_100009	19936741	19937476	735	g_10260	g_43804
Super-Scaffold_100009	19938587	19960074	21487	g_43804	g_10261
Super-Scaffold_100009	19977527	19990477	12950	g_10261	g_10262
Super-Scaffold_100009	19994020	20005001	10981	g_10262	g_10263
Super-Scaffold_100009	20011248	20027117	15869	g_10263	g_10264
Super-Scaffold_100009	20039520	20093292	53772	g_10264	g_10265
Super-Scaffold_100009	20098517	20151517	53000	g_10265	g_10267
Super-Scaffold_100009	20154248	20154890	642	g_10267	g_10268
Super-Scaffold_100009	20163261	20167477	4216	g_10268	g_10269
Super-Scaffold_100009	20174098	20177868	3770	g_10269	g_10270
Super-Scaffold_100009	20187917	20200086	12169	g_10270	g_43805
Super-Scaffold_100009	20212022	20216637	4615	g_43805	g_10271
Super-Scaffold_100009	20217783	20226999	9216	g_10271	g_10272
Super-Scaffold_100009	20261151	20354436	93285	g_10272	g_37029
Super-Scaffold_100009	20354648	20427464	72816	g_37029	g_37030
Super-Scaffold_100009	20427685	20463053	35368	g_37030	g_10274
Super-Scaffold_100009	20463298	20469008	5710	g_10274	g_10275
Super-Scaffold_100009	20469337	20511850	42513	g_10275	g_10277
Super-Scaffold_100009	20517840	20535631	17791	g_10277	g_10278
Super-Scaffold_100009	20560423	20572893	12470	g_10278	g_43806
Super-Scaffold_100009	20605549	20610914	5365	g_43806	g_10279
Super-Scaffold_100009	20618667	20656259	37592	g_10279	g_10280
Super-Scaffold_100009	20657605	20667505	9900	g_10280	g_10281
Super-Scaffold_100009	20669006	20681493	12487	g_10281	g_10282
Super-Scaffold_100009	20706787	20715207	8420	g_10282	g_10283
Super-Scaffold_100009	20715545	20719314	3769	g_10283	g_10284
Super-Scaffold_100009	20734604	20739070	4466	g_10284	g_10285
Super-Scaffold_100009	20753992	20756876	2884	g_10285	g_10286
Super-Scaffold_100009	20759387	20760128	741	g_10286	g_43807
Super-Scaffold_100009	20763979	20765704	1725	g_43807	g_43808
Super-Scaffold_100009	20771211	20785232	14021	g_43808	g_10288
Super-Scaffold_100009	20789225	20790661	1436	g_10288	g_10289
Super-Scaffold_100009	20797887	20856295	58408	g_10289	g_10291
Super-Scaffold_100009	20881915	20884363	2448	g_10291	g_10292
Super-Scaffold_100009	20884707	20923482	38775	g_10292	g_10294
Super-Scaffold_100009	20938314	20974108	35794	g_10294	g_10297
Super-Scaffold_100009	20982252	20988323	6071	g_10297	g_10298
Super-Scaffold_100009	20993235	21003561	10326	g_10299	g_10300
Super-Scaffold_100009	21025598	21030503	4905	g_10300	g_43809
Super-Scaffold_100009	21041107	21064503	23396	g_43809	g_10302
Super-Scaffold_100009	21082214	21087172	4958	g_10302	g_10303
Super-Scaffold_100009	21097330	21119117	21787	g_10303	g_10304
Super-Scaffold_100009	21122693	21126655	3962	g_10304	g_10305
Super-Scaffold_100009	21133368	21134667	1299	g_10305	g_10306
Super-Scaffold_100009	21138297	21140071	1774	g_10306	g_10307
Super-Scaffold_100009	21155928	21157200	1272	g_10307	g_10308
Super-Scaffold_100009	21164647	21166411	1764	g_10308	g_10309
Super-Scaffold_100009	21174213	21175341	1128	g_10309	g_10310
Super-Scaffold_100009	21179723	21181876	2153	g_10310	g_10311
Super-Scaffold_100009	21185710	21187799	2089	g_10311	g_10312
Super-Scaffold_100009	21192134	21194797	2663	g_10312	g_10313
Super-Scaffold_100009	21201595	21207501	5906	g_10313	g_10314
Super-Scaffold_100009	21218645	21220657	2012	g_10314	g_10315
Super-Scaffold_100009	21231290	21247042	15752	g_10315	g_10316
Super-Scaffold_100009	21248557	21252799	4242	g_10316	g_10317
Super-Scaffold_100009	21254821	21256819	1998	g_10317	g_10318
Super-Scaffold_100009	21271208	21275933	4725	g_10319	g_10320
Super-Scaffold_100009	21295652	21326380	30728	g_10320	g_10322
Super-Scaffold_100009	21330865	21379899	49034	g_10322	g_10324
Super-Scaffold_100009	21388569	21455394	66825	g_10324	g_10325
Super-Scaffold_100009	21468682	21512901	44219	g_10325	g_10326
Super-Scaffold_100009	21513653	21513929	276	g_10326	g_10327
Super-Scaffold_100009	21514390	21514454	64	g_10327	g_10328
Super-Scaffold_100009	21514954	21515097	143	g_10328	g_10329
Super-Scaffold_100009	21515699	21516307	608	g_10329	g_10330
Super-Scaffold_100009	21517470	21517531	61	g_10330	g_10331
Super-Scaffold_100009	21523856	21528098	4242	g_10331	g_10332
Super-Scaffold_100009	21531002	21532200	1198	g_10332	g_43810
Super-Scaffold_100009	21534487	21536970	2483	g_43810	g_10333
Super-Scaffold_100009	21538221	21539664	1443	g_10333	g_10334
Super-Scaffold_100009	21561588	21779010	217422	g_10334	g_10336
Super-Scaffold_100009	21779267	21828448	49181	g_10336	g_10337
Super-Scaffold_100009	21830841	21868039	37198	g_10337	g_10338
Super-Scaffold_100009	21868722	22072588	203866	g_10338	g_10341
Super-Scaffold_100009	22074456	22100198	25742	g_10341	g_10342
Super-Scaffold_100009	22103146	22112584	9438	g_10342	g_10343
Super-Scaffold_100009	22113985	22115169	1184	g_10343	g_10344
Super-Scaffold_100009	22116783	22152513	35730	g_10344	g_10346
Super-Scaffold_100009	22168203	22181098	12895	g_10346	g_10347
Super-Scaffold_100009	22181349	22205604	24255	g_10347	g_10348
Super-Scaffold_100009	22209613	22212526	2913	g_10348	g_10349
Super-Scaffold_100009	22222960	22227636	4676	g_10349	g_43811
Super-Scaffold_100009	22238343	22247989	9646	g_43811	g_10350
Super-Scaffold_100009	22259504	22260504	1000	g_10350	g_43812
Super-Scaffold_100009	22269582	22339111	69529	g_43812	g_10352
Super-Scaffold_100009	22341484	22345752	4268	g_10352	g_10353
Super-Scaffold_100009	22354445	22373868	19423	g_10353	g_43813
Super-Scaffold_100009	22392356	22418179	25823	g_43813	g_10354
Super-Scaffold_100009	22423428	22427192	3764	g_10354	g_10355
Super-Scaffold_100009	22444822	22456242	11420	g_10355	g_10356
Super-Scaffold_100009	22464413	22474735	10322	g_10356	g_10357
Super-Scaffold_100009	22475058	22476952	1894	g_10357	g_10358
Super-Scaffold_100009	22481095	22488314	7219	g_10358	g_10360
Super-Scaffold_100009	22498337	22500000	1663	g_10360	g_10361
Super-Scaffold_100009	22520675	22588803	68128	g_10361	g_10363
Super-Scaffold_100009	22596915	22598786	1871	g_10363	g_10364
Super-Scaffold_100009	22602329	22637175	34846	g_10364	g_10365
Super-Scaffold_100009	22641405	22654370	12965	g_10365	g_43814
Super-Scaffold_100009	22672122	22768435	96313	g_43814	g_10368
Super-Scaffold_100009	22768764	22858603	89839	g_10368	g_10370
Super-Scaffold_100009	22977092	23051380	74288	g_10370	g_10373
Super-Scaffold_100009	23057534	23094095	36561	g_10373	g_10374
Super-Scaffold_100009	23100383	23101602	1219	g_10374	g_43815
Super-Scaffold_100009	23109751	23123606	13855	g_43815	g_10375
Super-Scaffold_100009	23141322	23164848	23526	g_10375	g_10376
Super-Scaffold_100009	23174623	23188722	14099	g_10376	g_10377
Super-Scaffold_100009	23192017	23194784	2767	g_10377	g_10378
Super-Scaffold_100009	23214490	23217088	2598	g_10378	g_10379
Super-Scaffold_100009	23229107	23233224	4117	g_10379	g_10380
Super-Scaffold_100009	23241020	23244449	3429	g_10380	g_10381
Super-Scaffold_100009	23259089	23266029	6940	g_10381	g_10382
Super-Scaffold_100009	23266685	23276382	9697	g_10382	g_10383
Super-Scaffold_100009	23277332	23284498	7166	g_10383	g_10384
Super-Scaffold_100009	23299093	23301106	2013	g_10384	g_10385
Super-Scaffold_100009	23303150	23305048	1898	g_10385	g_10386
Super-Scaffold_100009	23308970	23312353	3383	g_10386	g_10387
Super-Scaffold_100009	23314446	23317527	3081	g_10387	g_43816
Super-Scaffold_100009	23319080	23320594	1514	g_43816	g_10388
Super-Scaffold_100009	23322121	23325551	3430	g_10388	g_10389
Super-Scaffold_100009	23327538	23332922	5384	g_10389	g_10390
Super-Scaffold_100009	23357806	23361882	4076	g_10390	g_10391
Super-Scaffold_100009	23364713	23375417	10704	g_10391	g_10392
Super-Scaffold_100009	23382591	23386115	3524	g_10392	g_43817
Super-Scaffold_100009	23405837	23408871	3034	g_43817	g_10393
Super-Scaffold_100009	23421356	23436184	14828	g_10393	g_10394
Super-Scaffold_100009	23437257	23446907	9650	g_10394	g_43818
Super-Scaffold_100009	23477142	23621217	144075	g_43818	g_10395
Super-Scaffold_100009	23634729	23637384	2655	g_10395	g_43819
Super-Scaffold_100009	23655240	23660453	5213	g_43819	g_10396
Super-Scaffold_100009	23674374	23677231	2857	g_10396	g_10397
Super-Scaffold_100009	23682412	23684443	2031	g_10397	g_10398
Super-Scaffold_100009	23702051	23702826	775	g_10398	g_10399
Super-Scaffold_100009	23714158	23727452	13294	g_10399	g_10400
Super-Scaffold_100009	23746270	23751541	5271	g_10400	g_43820
Super-Scaffold_100009	23754530	23756042	1512	g_43820	g_10401
Super-Scaffold_100009	23761159	23772572	11413	g_10401	g_43821
Super-Scaffold_100009	23778014	23840980	62966	g_43821	g_10405
Super-Scaffold_100009	23842760	23844440	1680	g_10405	g_10406
Super-Scaffold_100009	23867254	23887748	20494	g_10406	g_10407
Super-Scaffold_100009	23889493	23914787	25294	g_10407	g_10408
Super-Scaffold_100009	23915002	23928425	13423	g_10408	g_10409
Super-Scaffold_100009	23932973	23935685	2712	g_10409	g_10410
Super-Scaffold_100009	23936968	23942564	5596	g_10410	g_10411
Super-Scaffold_100009	23951160	24010903	59743	g_10411	g_10413
Super-Scaffold_100009	24012676	24013655	979	g_10413	g_10414
Super-Scaffold_100009	24019882	24022524	2642	g_10414	g_10415
Super-Scaffold_100009	24029025	24030657	1632	g_10415	g_10416
Super-Scaffold_100009	24037978	24038494	516	g_10416	g_10417
Super-Scaffold_100009	24047533	24048648	1115	g_10417	g_10418
Super-Scaffold_100009	24055776	24057136	1360	g_10418	g_10419
Super-Scaffold_100009	24059025	24063380	4355	g_10419	g_10420
Super-Scaffold_100009	24067742	24070880	3138	g_10420	g_10421
Super-Scaffold_100009	24071965	24080323	8358	g_10421	g_10422
Super-Scaffold_100009	24082596	24089928	7332	g_10422	g_10423
Super-Scaffold_100009	24091509	24094232	2723	g_10423	g_10424
Super-Scaffold_100009	24106921	24111682	4761	g_10424	g_10425
Super-Scaffold_100009	24118886	24120145	1259	g_10425	g_10426
Super-Scaffold_100009	24121014	24126339	5325	g_10426	g_10427
Super-Scaffold_100009	24127208	24130663	3455	g_10427	g_10428
Super-Scaffold_100009	24140251	24148636	8385	g_10428	g_10429
Super-Scaffold_100009	24153443	24157899	4456	g_10429	g_10430
Super-Scaffold_100009	24178361	24180376	2015	g_10430	g_10431
Super-Scaffold_100009	24192995	24231561	38566	g_10431	g_10433
Super-Scaffold_100009	24232202	24234835	2633	g_10433	g_10432
Super-Scaffold_100009	24239117	24241772	2655	g_10432	g_10434
Super-Scaffold_100009	24242972	24249468	6496	g_10434	g_10435
Super-Scaffold_100009	24251526	24266000	14474	g_10435	g_10436
Super-Scaffold_100009	24269790	24276336	6546	g_10436	g_43822
Super-Scaffold_100009	24288267	24294315	6048	g_43822	g_10437
Super-Scaffold_100009	24305481	24383852	78371	g_10437	g_10438
Super-Scaffold_100009	24385927	24389956	4029	g_10438	g_10439
Super-Scaffold_100009	24391809	24467792	75983	g_10439	g_10440
Super-Scaffold_100009	24468019	24490176	22157	g_10440	g_10441
Super-Scaffold_100009	24490433	24540910	50477	g_10441	g_10443
Super-Scaffold_100009	24541113	25016656	475543	g_10443	g_10447
Super-Scaffold_100009	25028869	25114359	85490	g_10447	g_10449
Super-Scaffold_100009	25116133	25125032	8899	g_10449	g_43823
Super-Scaffold_100009	25125997	25127384	1387	g_43823	g_43824
Super-Scaffold_100009	25147640	25154859	7219	g_43824	g_10450
Super-Scaffold_100009	25159832	25164851	5019	g_10450	g_10451
Super-Scaffold_100009	25185943	25199164	13221	g_10451	g_10452
Super-Scaffold_100009	25224600	25228723	4123	g_10452	g_10453
Super-Scaffold_100009	25246147	25268888	22741	g_10453	g_10455
Super-Scaffold_100009	25280297	25293091	12794	g_10455	g_10456
Super-Scaffold_100009	25319316	25330451	11135	g_10456	g_10458
Super-Scaffold_100009	25332456	25334993	2537	g_10458	g_10459
Super-Scaffold_100009	25350863	25440730	89867	g_10459	g_10461
Super-Scaffold_100009	25452068	25464246	12178	g_10461	g_10462
Super-Scaffold_100009	25473220	25474405	1185	g_10462	g_10463
Super-Scaffold_100009	25480386	25482216	1830	g_10463	g_10464
Super-Scaffold_100009	25485103	25488683	3580	g_10464	g_10465
Super-Scaffold_100009	25494766	25499588	4822	g_10465	g_10466
Super-Scaffold_100009	25508160	25512291	4131	g_10466	g_10467
Super-Scaffold_100009	25518319	25522067	3748	g_10467	g_43825
Super-Scaffold_100009	25526053	25527897	1844	g_43825	g_10468
Super-Scaffold_100009	25535022	25543948	8926	g_10468	g_10469
Super-Scaffold_100009	25544828	25550024	5196	g_10469	g_10470
Super-Scaffold_100009	25558114	25560797	2683	g_10470	g_43826
Super-Scaffold_100009	25566944	25568855	1911	g_43826	g_10471
Super-Scaffold_100009	25572097	25575862	3765	g_10471	g_10472
Super-Scaffold_100009	25598615	25640041	41426	g_10472	g_10473
Super-Scaffold_100009	25641767	25644911	3144	g_10473	g_10474
Super-Scaffold_100009	25655843	25669634	13791	g_10474	g_10475
Super-Scaffold_100009	25671264	25683063	11799	g_10475	g_10476
Super-Scaffold_100009	25687036	25695269	8233	g_10476	g_10477
Super-Scaffold_100009	25700052	25700649	597	g_10477	g_43827
Super-Scaffold_100009	25704802	25707035	2233	g_43827	g_43828
Super-Scaffold_100009	25710422	25714636	4214	g_43828	g_43829
Super-Scaffold_100009	25721990	25723955	1965	g_43829	g_10478
Super-Scaffold_100009	25728564	25736093	7529	g_10478	g_43830
Super-Scaffold_100009	25739869	25761447	21578	g_43830	g_43831
Super-Scaffold_100009	25765718	25866435	100717	g_43831	g_10479
Super-Scaffold_100009	25866641	25945864	79223	g_10479	g_10481
Super-Scaffold_100009	25957220	25964507	7287	g_10481	g_10482
Super-Scaffold_100009	25985275	25987406	2131	g_10482	g_10483
Super-Scaffold_100009	25992752	25993750	998	g_10483	g_43832
Super-Scaffold_100009	25999153	26003729	4576	g_43832	g_10484
Super-Scaffold_100009	26011905	26013804	1899	g_10484	g_10485
Super-Scaffold_100009	26020690	26025228	4538	g_10485	g_10486
Super-Scaffold_100009	26027548	26058122	30574	g_10486	g_10487
Super-Scaffold_100009	26065972	26066957	985	g_10487	g_10488
Super-Scaffold_100009	26067235	26109615	42380	g_10488	g_37060
Super-Scaffold_100009	26119812	26144759	24947	g_10489	g_10490
Super-Scaffold_100009	26145880	26151011	5131	g_10490	g_10491
Super-Scaffold_100009	26172820	26209400	36580	g_10491	g_10493
Super-Scaffold_100009	26209669	26215233	5564	g_10493	g_10494
Super-Scaffold_100009	26228766	26288886	60120	g_10494	g_10495
Super-Scaffold_100009	26293435	26396352	102917	g_10495	g_10496
Super-Scaffold_100009	26396679	26572000	175321	g_10496	g_10497
Super-Scaffold_100009	26591989	26601268	9279	g_10497	g_10498
Super-Scaffold_100009	26601468	26637687	36219	g_10498	g_10500
Super-Scaffold_100009	26638292	26639669	1377	g_10500	g_10501
Super-Scaffold_100009	26639908	26665863	25955	g_10501	g_10502
Super-Scaffold_100009	26676263	26680358	4095	g_10502	g_10503
Super-Scaffold_100009	26686785	26770993	84208	g_10503	g_10505
Super-Scaffold_100009	26771367	26792995	21628	g_10505	g_10506
Super-Scaffold_100009	26811964	26831570	19606	g_10506	g_10508
Super-Scaffold_100009	26836989	26837466	477	g_10508	g_10509
Super-Scaffold_100009	26842456	26843166	710	g_10509	g_10510
Super-Scaffold_100009	26845633	26849615	3982	g_10510	g_10511
Super-Scaffold_100009	26875269	26879241	3972	g_10511	g_43833
Super-Scaffold_100009	26909954	26912202	2248	g_43833	g_10512
Super-Scaffold_100009	26934804	26943867	9063	g_10512	g_10513
Super-Scaffold_100009	26966141	26970534	4393	g_10513	g_10514
Super-Scaffold_100009	26980468	26989766	9298	g_10514	g_10515
Super-Scaffold_100009	26992268	26992577	309	g_10515	g_10516
Super-Scaffold_100009	26995907	26996493	586	g_10516	g_10517
Super-Scaffold_100009	27004957	27009041	4084	g_10517	g_10519
Super-Scaffold_100009	27014414	27015807	1393	g_10519	g_10520
Super-Scaffold_100009	27024478	27024934	456	g_10520	g_10521
Super-Scaffold_100009	27025167	27067043	41876	g_10521	g_10523
Super-Scaffold_100009	27079669	27086031	6362	g_10523	g_10524
Super-Scaffold_100009	27086294	27117877	31583	g_10524	g_10526
Super-Scaffold_100009	27119040	27122555	3515	g_10526	g_10527
Super-Scaffold_100009	27124417	27128393	3976	g_10527	g_43834
Super-Scaffold_100009	27132560	27147017	14457	g_43834	g_10528
Super-Scaffold_100009	27154747	27184888	30141	g_10528	g_10529
Super-Scaffold_100009	27185264	27192074	6810	g_10529	g_10530
Super-Scaffold_100009	27200675	27209900	9225	g_10530	g_10531
Super-Scaffold_100009	27226331	27263577	37246	g_10531	g_10532
Super-Scaffold_100009	27265266	27265328	62	g_10532	g_43835
Super-Scaffold_100009	27269624	27367865	98241	g_43835	g_10534
Super-Scaffold_100009	27383983	27399016	15033	g_10534	g_10535
Super-Scaffold_100009	27399240	27468173	68933	g_10535	g_37075
Super-Scaffold_100009	27468397	27476472	8075	g_37075	g_10538
Super-Scaffold_100009	27492820	27498062	5242	g_10538	g_10539
Super-Scaffold_100009	27539248	27540160	912	g_10539	g_10540
Super-Scaffold_100009	27551911	27592203	40292	g_10540	g_10542
Super-Scaffold_100009	27595721	27596756	1035	g_10542	g_10543
Super-Scaffold_100009	27598822	27606397	7575	g_10543	g_10545
Super-Scaffold_100009	27610625	27623329	12704	g_10545	g_10546
Super-Scaffold_100009	27637834	27641019	3185	g_10546	g_10547
Super-Scaffold_100009	27646623	27654053	7430	g_10547	g_10548
Super-Scaffold_100009	27671433	27674711	3278	g_10548	g_43836
Super-Scaffold_100009	27683996	27701502	17506	g_43836	g_10550
Super-Scaffold_100009	27701783	27787416	85633	g_10550	g_10552
Super-Scaffold_100009	27807946	27812721	4775	g_10552	g_10553
Super-Scaffold_100009	27815121	27843991	28870	g_10553	g_10554
Super-Scaffold_100009	27861735	27894866	33131	g_10554	g_10556
Super-Scaffold_100009	27896721	27915829	19108	g_10556	g_43837
Super-Scaffold_100009	27916335	27964781	48446	g_43837	g_43838
Super-Scaffold_100009	27977840	27986796	8956	g_43838	g_10558
Super-Scaffold_100009	27998293	28059478	61185	g_10558	g_10560
Super-Scaffold_100009	28065256	28089681	24425	g_10560	g_10562
Super-Scaffold_100009	28097796	28149199	51403	g_10562	g_10564
Super-Scaffold_100009	28158242	28174404	16162	g_10564	g_10565
Super-Scaffold_100009	28182698	28193966	11268	g_10565	g_10566
Super-Scaffold_100009	28225039	28346520	121481	g_10566	g_10568
Super-Scaffold_100009	28349893	28616984	267091	g_10568	g_10569
Super-Scaffold_100009	28696565	28728525	31960	g_10569	g_10571
Super-Scaffold_100009	28731239	28788934	57695	g_10571	g_10573
Super-Scaffold_100009	28797621	28854958	57337	g_10573	g_37084
Super-Scaffold_100009	28855188	29051539	196351	g_37084	g_10574
Super-Scaffold_100009	29062304	29073035	10731	g_10574	g_10575
Super-Scaffold_100009	29073520	29078739	5219	g_10575	g_10576
Super-Scaffold_100009	29084233	29141946	57713	g_10576	g_37088
Super-Scaffold_100009	29142254	29156762	14508	g_37088	g_10582
Super-Scaffold_100009	29157055	29164371	7316	g_10582	g_10583
Super-Scaffold_100009	29164649	29164704	55	g_10583	g_10584
Super-Scaffold_100009	29165072	29165376	304	g_10584	g_10585
Super-Scaffold_100009	29165579	29174926	9347	g_10585	g_10586
Super-Scaffold_100009	29175132	29196398	21266	g_10586	g_10587
Super-Scaffold_100009	29196685	29201790	5105	g_10587	g_43839
Super-Scaffold_100009	29202002	29236699	34697	g_43839	g_10590
Super-Scaffold_100009	29254838	29259102	4264	g_10590	g_10592
Super-Scaffold_100009	29259458	29263663	4205	g_10592	g_10593
Super-Scaffold_100009	29264052	29266599	2547	g_10593	g_10594
Super-Scaffold_100009	29289187	29290613	1426	g_10594	g_10595
Super-Scaffold_100009	29293578	29294803	1225	g_10595	g_10596
Super-Scaffold_100009	29316499	29345261	28762	g_10596	g_10597
Super-Scaffold_100009	29352787	29353782	995	g_10597	g_10598
Super-Scaffold_100009	29357320	29358026	706	g_10598	g_10599
Super-Scaffold_100009	29360660	29362206	1546	g_10599	g_43840
Super-Scaffold_100009	29394460	29396045	1585	g_43840	g_10600
Super-Scaffold_100009	29401724	29402636	912	g_10600	g_10601
Super-Scaffold_100009	29408492	29409389	897	g_10601	g_10602
Super-Scaffold_100009	29421682	29424703	3021	g_10602	g_10603
Super-Scaffold_100009	29440214	29454578	14364	g_10603	g_10604
Super-Scaffold_100009	29460100	29600477	140377	g_10604	g_10607
Super-Scaffold_100009	29603825	29624425	20600	g_10607	g_10608
Super-Scaffold_100009	29624709	29634483	9774	g_10608	g_10609
Super-Scaffold_100009	29634746	29639531	4785	g_10609	g_10610
Super-Scaffold_100009	29675588	29707012	31424	g_10610	g_10611
Super-Scaffold_100009	29707338	29707498	160	g_10611	g_10612
Super-Scaffold_100009	29707866	29715092	7226	g_10612	g_10613
Super-Scaffold_100009	29751440	29755671	4231	g_10613	g_10614
Super-Scaffold_100009	29758322	29765878	7556	g_10614	g_43841
Super-Scaffold_100009	29769504	29826389	56885	g_43841	g_10615
Super-Scaffold_100009	29847820	29860488	12668	g_10615	g_10616
Super-Scaffold_100009	29882595	29892083	9488	g_10616	g_10617
Super-Scaffold_100009	29892397	29901809	9412	g_10617	g_10618
Super-Scaffold_100009	29902081	29911122	9041	g_10618	g_10619
Super-Scaffold_100009	29911436	29940001	28565	g_10619	g_10621
Super-Scaffold_100009	29958340	29965215	6875	g_10621	g_43842
Super-Scaffold_100009	29966422	29966683	261	g_43842	g_37097
Super-Scaffold_100009	29967093	29973312	6219	g_37097	g_10622
Super-Scaffold_100009	29975942	29979116	3174	g_10622	g_37098
Super-Scaffold_100009	29979322	29983446	4124	g_37098	g_10624
Super-Scaffold_100009	29984864	29992277	7413	g_10624	g_10625
Super-Scaffold_100009	29993695	29995039	1344	g_10625	g_10626
Super-Scaffold_100009	29996458	30023089	26631	g_10626	g_10627
Super-Scaffold_100009	30028887	30031082	2195	g_10627	g_10628
Super-Scaffold_100009	30042719	30044782	2063	g_10628	g_10629
Super-Scaffold_100009	30051266	30053413	2147	g_10629	g_10630
Super-Scaffold_100009	30065677	30066491	814	g_10630	g_10631
Super-Scaffold_100009	30074651	30087053	12402	g_10631	g_10632
Super-Scaffold_100009	30087685	30087740	55	g_10632	g_10633
Super-Scaffold_100009	30088738	30100729	11991	g_10633	g_10634
Super-Scaffold_100009	30103585	30123193	19608	g_10634	g_10635
Super-Scaffold_100009	30124141	30128490	4349	g_10635	g_10636
Super-Scaffold_100009	30129812	30132739	2927	g_10636	g_10637
Super-Scaffold_100009	30142383	30179210	36827	g_10637	g_10641
Super-Scaffold_100009	30180091	30225830	45739	g_10641	g_10642
Super-Scaffold_100009	30232197	30235632	3435	g_10642	g_10643
Super-Scaffold_100009	30247670	30254059	6389	g_10643	g_10644
Super-Scaffold_100009	30268936	30281961	13025	g_10644	g_10645
Super-Scaffold_100009	30296838	30297350	512	g_10645	g_10646
Super-Scaffold_100009	30297823	30309333	11510	g_10646	g_10648
Super-Scaffold_100009	30310057	30319913	9856	g_10648	g_10649
Super-Scaffold_100009	30322542	30338602	16060	g_10649	g_10650
Super-Scaffold_100009	30341231	30352607	11376	g_10650	g_43843
Super-Scaffold_100009	30354750	30360105	5355	g_43843	g_43844
Super-Scaffold_100009	30364902	30385037	20135	g_43844	g_10652
Super-Scaffold_100009	30387408	30397635	10227	g_10652	g_10653
Super-Scaffold_100009	30399196	30403936	4740	g_10653	g_10654
Super-Scaffold_100009	30404376	30418940	14564	g_10654	g_10655
Super-Scaffold_100009	30429582	30434965	5383	g_10655	g_10656
Super-Scaffold_100009	30444719	30447662	2943	g_10656	g_10657
Super-Scaffold_100009	30456680	30464554	7874	g_10657	g_10658
Super-Scaffold_100009	30469889	30477748	7859	g_10658	g_10659
Super-Scaffold_100009	30477960	30480103	2143	g_10659	g_10660
Super-Scaffold_100009	30483458	30510482	27024	g_10660	g_10661
Super-Scaffold_100009	30515325	30532868	17543	g_10661	g_10662
Super-Scaffold_100009	30578410	30640036	61626	g_10662	g_10663
Super-Scaffold_100009	30640956	30660187	19231	g_10663	g_10664
Super-Scaffold_100009	30660789	30660816	27	g_10664	g_37106
Super-Scaffold_100009	30661019	30677355	16336	g_37106	g_10665
Super-Scaffold_100009	30677597	30733520	55923	g_10665	g_10666
Super-Scaffold_100009	30742981	30745584	2603	g_10666	g_10667
Super-Scaffold_100009	30765145	30768632	3487	g_10667	g_43845
Super-Scaffold_100009	30772586	30781083	8497	g_43845	g_10668
Super-Scaffold_100009	30788778	30801120	12342	g_10668	g_10669
Super-Scaffold_100009	30801539	30836577	35038	g_10669	g_10670
Super-Scaffold_100009	30837431	30849336	11905	g_10670	g_10671
Super-Scaffold_100009	30849608	30896306	46698	g_10671	g_37111
Super-Scaffold_100009	30896659	30949600	52941	g_37111	g_10672
Super-Scaffold_100009	30949917	31187539	237622	g_10672	g_10679
Super-Scaffold_100009	31208464	31269869	61405	g_10679	g_10681
Super-Scaffold_100009	31290159	31315523	25364	g_10681	g_10682
Super-Scaffold_100009	31335294	31342657	7363	g_10682	g_37112
Super-Scaffold_100009	31342950	31366717	23767	g_37112	g_37114
Super-Scaffold_100009	31366935	31450436	83501	g_37114	g_10685
Super-Scaffold_100009	31450675	31482193	31518	g_10685	g_10686
Super-Scaffold_100009	31482459	31604084	121625	g_10686	g_10689
Super-Scaffold_100009	31614097	31614317	220	g_10689	g_10690
Super-Scaffold_100009	31614649	31617546	2897	g_10690	g_43846
Super-Scaffold_100009	31641336	31648869	7533	g_43846	g_37121
Super-Scaffold_100009	31650266	31650296	30	g_37121	g_37122
Super-Scaffold_100009	31650613	31794065	143452	g_37122	g_10695
Super-Scaffold_100009	31800217	31809104	8887	g_10695	g_10696
Super-Scaffold_100009	31809877	31827315	17438	g_10696	g_10698
Super-Scaffold_100009	31836546	31850767	14221	g_10698	g_10701
Super-Scaffold_100009	31866292	31896702	30410	g_10701	g_10704
Super-Scaffold_100009	31902422	31955029	52607	g_10704	g_10705
Super-Scaffold_100009	31955577	32011571	55994	g_10705	g_10707
Super-Scaffold_100009	32013334	32014029	695	g_10707	g_10708
Super-Scaffold_100009	32020669	32024734	4065	g_10708	g_10709
Super-Scaffold_100009	32032743	32038112	5369	g_10709	g_10710
Super-Scaffold_100009	32059427	32062673	3246	g_10710	g_10711
Super-Scaffold_100009	32078267	32085163	6896	g_10711	g_10712
Super-Scaffold_100009	32108809	32135546	26737	g_10712	g_37126
Super-Scaffold_100009	32140141	32143335	3194	g_37127	g_10715
Super-Scaffold_100009	32162092	32175561	13469	g_10715	g_10716
Super-Scaffold_100009	32188825	32193797	4972	g_10716	g_10717
Super-Scaffold_100009	32234941	32238273	3332	g_10717	g_10718
Super-Scaffold_100009	32241417	32243685	2268	g_10718	g_10719
Super-Scaffold_100009	32243900	32250262	6362	g_10719	g_43847
Super-Scaffold_100009	32273027	32280931	7904	g_43847	g_37128
Super-Scaffold_100009	32281251	32320680	39429	g_37128	g_10723
Super-Scaffold_100009	32321777	32327243	5466	g_10723	g_10724
Super-Scaffold_100009	32347247	32403936	56689	g_10724	g_10726
Super-Scaffold_100009	32410417	32415762	5345	g_10726	g_10728
Super-Scaffold_100009	32415983	32416128	145	g_10728	g_10729
Super-Scaffold_100009	32427827	32622705	194878	g_10729	g_10732
Super-Scaffold_100009	32636455	32653171	16716	g_10732	g_10733
Super-Scaffold_100009	32653413	32664537	11124	g_10733	g_10734
Super-Scaffold_100009	32669760	32731101	61341	g_10734	g_10735
Super-Scaffold_100009	32746652	32765767	19115	g_10735	g_10737
Super-Scaffold_100009	32768136	32912617	144481	g_10737	g_10739
Super-Scaffold_100009	32920805	32984656	63851	g_10739	g_43848
Super-Scaffold_100009	32991592	33005621	14029	g_43848	g_10740
Super-Scaffold_100009	33014844	33019056	4212	g_10740	g_10741
Super-Scaffold_100009	33042742	33054110	11368	g_10741	g_10743
Super-Scaffold_100009	33071557	33090315	18758	g_10743	g_10744
Super-Scaffold_100009	33092886	33093215	329	g_10744	g_10745
Super-Scaffold_100009	33093663	33096965	3302	g_10745	g_10746
Super-Scaffold_100009	33098167	33112962	14795	g_10746	g_10747
Super-Scaffold_100009	33115452	33135041	19589	g_10747	g_10748
Super-Scaffold_100009	33135966	33153309	17343	g_10748	g_10749
Super-Scaffold_100009	33155794	33168074	12280	g_10749	g_10750
Super-Scaffold_100009	33186986	33195714	8728	g_10750	g_10751
Super-Scaffold_100009	33198345	33234316	35971	g_10751	g_10753
Super-Scaffold_100009	33234543	33244828	10285	g_10753	g_10754
Super-Scaffold_100009	33284759	33352527	67768	g_10754	g_10755
Super-Scaffold_100009	33374872	33384085	9213	g_10755	g_10756
Super-Scaffold_100009	33394862	33429005	34143	g_10756	g_10757
Super-Scaffold_100009	33431574	33437533	5959	g_10757	g_10758
Super-Scaffold_100009	33455100	33471382	16282	g_10758	g_10759
Super-Scaffold_100009	33476114	33493185	17071	g_10759	g_10761
Super-Scaffold_100009	33493856	33495631	1775	g_10761	g_10762
Super-Scaffold_100009	33496137	33550477	54340	g_10762	g_10764
Super-Scaffold_100009	33567980	33658397	90417	g_10764	g_37135
Super-Scaffold_100009	33666019	33686468	20449	g_10766	g_10768
Super-Scaffold_100009	33705467	33705534	67	g_10768	g_10769
Super-Scaffold_100009	33707261	33712332	5071	g_10769	g_10770
Super-Scaffold_100009	33760284	33760422	138	g_10770	g_10771
Super-Scaffold_100009	33761012	33766445	5433	g_10771	g_10772
Super-Scaffold_100009	33770674	33771877	1203	g_10772	g_10773
Super-Scaffold_100009	33772101	33787460	15359	g_10773	g_10774
Super-Scaffold_100009	33798452	33799352	900	g_10774	g_43849
Super-Scaffold_100009	33799633	33827821	28188	g_43849	g_37137
Super-Scaffold_100009	33830500	33845716	15216	g_37138	g_43850
Super-Scaffold_100009	33878112	33909603	31491	g_43850	g_10777
Super-Scaffold_100009	33919838	33990053	70215	g_10777	g_10778
Super-Scaffold_100009	34000375	34005794	5419	g_10778	g_10779
Super-Scaffold_100009	34010852	34013371	2519	g_10779	g_10780
Super-Scaffold_100009	34014616	34031378	16762	g_10780	g_10781
Super-Scaffold_100009	34050972	34053298	2326	g_10781	g_10782
Super-Scaffold_100009	34064384	34124727	60343	g_10782	g_10784
Super-Scaffold_100009	34129613	34155441	25828	g_10784	g_10785
Super-Scaffold_100009	34158548	34174539	15991	g_10786	g_10787
Super-Scaffold_100009	34182040	34190956	8916	g_10787	g_10788
Super-Scaffold_100009	34191495	34192753	1258	g_10788	g_10789
Super-Scaffold_100009	34193208	34201606	8398	g_10789	g_10790
Super-Scaffold_100009	34205892	34219198	13306	g_10790	g_10791
Super-Scaffold_100009	34224665	34227597	2932	g_10791	g_10792
Super-Scaffold_100009	34228652	34234526	5874	g_10792	g_10793
Super-Scaffold_100009	34235581	34238917	3336	g_10793	g_10794
Super-Scaffold_100009	34249017	34257563	8546	g_10794	g_10795
Super-Scaffold_100009	34270319	34275567	5248	g_10795	g_10796
Super-Scaffold_100009	34279389	34295914	16525	g_10796	g_10797
Super-Scaffold_100009	34296702	34361490	64788	g_10797	g_10801
Super-Scaffold_100009	34361729	34361836	107	g_10801	g_37144
Super-Scaffold_100009	34362282	34374810	12528	g_37144	g_10802
Super-Scaffold_100009	34375892	34436167	60275	g_10802	g_10804
Super-Scaffold_100009	34491744	34508808	17064	g_10804	g_10806
Super-Scaffold_100009	34515527	34517993	2466	g_10806	g_10808
Super-Scaffold_100009	34529678	34554318	24640	g_10808	g_10809
Super-Scaffold_100009	34554539	34584287	29748	g_10809	g_10810
Super-Scaffold_100009	34589068	34613532	24464	g_10810	g_10812
Super-Scaffold_100009	34630572	34636609	6037	g_10812	g_10814
Super-Scaffold_100009	34638363	34658901	20538	g_10814	g_10815
Super-Scaffold_100009	34659839	34660311	472	g_10815	g_10816
Super-Scaffold_100009	34660703	34668910	8207	g_10816	g_10817
Super-Scaffold_100009	34677891	34685788	7897	g_37147	g_10818
Super-Scaffold_100009	34691020	34741205	50185	g_10818	g_10820
Super-Scaffold_100009	34743812	34798675	54863	g_37149	g_10821
Super-Scaffold_100009	34807996	34809663	1667	g_10821	g_43851
Super-Scaffold_100009	34811195	34817162	5967	g_43851	g_10823
Super-Scaffold_100009	34848279	35043789	195510	g_10823	g_10832
Super-Scaffold_100009	35044232	35100834	56602	g_10832	g_37153
Super-Scaffold_100009	35101304	35149686	48382	g_37153	g_10835
Super-Scaffold_100009	35150027	35167224	17197	g_10835	g_10836
Super-Scaffold_100009	35168222	35170637	2415	g_10836	g_10837
Super-Scaffold_100009	35188582	35201399	12817	g_10837	g_10839
Super-Scaffold_100009	35218138	35219902	1764	g_10839	g_43852
Super-Scaffold_100009	35224880	35226869	1989	g_43852	g_43853
Super-Scaffold_100009	35254514	35278010	23496	g_43853	g_10841
Super-Scaffold_100009	35285837	35310334	24497	g_10841	g_10843
Super-Scaffold_100009	35318118	35318374	256	g_10843	g_43854
Super-Scaffold_100009	35318781	35324120	5339	g_43854	g_10845
Super-Scaffold_100009	35324427	35383477	59050	g_10845	g_10848
Super-Scaffold_100009	35391007	35399044	8037	g_10848	g_10849
Super-Scaffold_100009	35409614	35438291	28677	g_10849	g_10850
Super-Scaffold_100009	35445078	35448009	2931	g_10850	g_10851
Super-Scaffold_100009	35448911	35451017	2106	g_10851	g_10852
Super-Scaffold_100009	35474400	35492966	18566	g_10852	g_37157
Super-Scaffold_100009	35493175	35503319	10144	g_37157	g_37158
Super-Scaffold_100009	35503531	35504031	500	g_37158	g_10854
Super-Scaffold_100009	35504720	35550254	45534	g_10854	g_10856
Super-Scaffold_100009	35550973	35551191	218	g_10856	g_10857
Super-Scaffold_100009	35554444	35573371	18927	g_10857	g_10858
Super-Scaffold_100009	35576235	35586076	9841	g_10858	g_43855
Super-Scaffold_100009	35603412	35603462	50	g_43855	g_10859
Super-Scaffold_100009	35605594	35666897	61303	g_10859	g_10862
Super-Scaffold_100009	35707030	35715539	8509	g_10862	g_10863
Super-Scaffold_100009	35741983	35752866	10883	g_10863	g_43856
Super-Scaffold_100009	35765855	35773827	7972	g_43856	g_43857
Super-Scaffold_100009	35777498	35785060	7562	g_43857	g_10864
Super-Scaffold_100009	35785701	35819472	33771	g_10864	g_10865
Super-Scaffold_100009	35839343	35845135	5792	g_10865	g_10868
Super-Scaffold_100010	387128	438410	51282	g_27562	g_27563
Super-Scaffold_100010	446338	449447	3109	g_27563	g_27564
Super-Scaffold_100010	455130	471595	16465	g_27564	g_45166
Super-Scaffold_100010	472728	474889	2161	g_45166	g_27566
Super-Scaffold_100010	475332	475422	90	g_27566	g_27567
Super-Scaffold_100010	476335	525801	49466	g_27567	g_27569
Super-Scaffold_100010	538080	556767	18687	g_27569	g_27571
Super-Scaffold_100010	591185	597972	6787	g_27571	g_27572
Super-Scaffold_100010	603416	608981	5565	g_27572	g_27573
Super-Scaffold_100010	629223	631170	1947	g_27573	g_27574
Super-Scaffold_100010	640938	662277	21339	g_27574	g_27576
Super-Scaffold_100010	665354	684027	18673	g_27576	g_27577
Super-Scaffold_100010	684323	794068	109745	g_27577	g_27579
Super-Scaffold_100010	794784	804750	9966	g_27579	g_45167
Super-Scaffold_100010	805653	805923	270	g_45167	g_27580
Super-Scaffold_100010	806375	876631	70256	g_27580	g_27585
Super-Scaffold_100010	880760	889632	8872	g_27585	g_27586
Super-Scaffold_100010	892217	893603	1386	g_27586	g_27587
Super-Scaffold_100010	914875	921513	6638	g_27587	g_27588
Super-Scaffold_100010	923483	932264	8781	g_27588	g_27589
Super-Scaffold_100010	942936	949003	6067	g_27590	g_27591
Super-Scaffold_100010	955772	957988	2216	g_27591	g_27592
Super-Scaffold_100010	963078	964826	1748	g_27592	g_27593
Super-Scaffold_100010	973397	975563	2166	g_27593	g_27594
Super-Scaffold_100010	995927	998803	2876	g_27594	g_27595
Super-Scaffold_100010	1009679	1030756	21077	g_27595	g_41569
Super-Scaffold_100010	1031631	1033699	2068	g_41569	g_27597
Super-Scaffold_100010	1034820	1127453	92633	g_27597	g_27599
Super-Scaffold_100010	1136637	1161537	24900	g_27599	g_27600
Super-Scaffold_100010	1161839	1161917	78	g_27600	g_27601
Super-Scaffold_100010	1162177	1162349	172	g_27601	g_45168
Super-Scaffold_100010	1162621	1165826	3205	g_45168	g_27602
Super-Scaffold_100010	1202224	1227011	24787	g_27602	g_27603
Super-Scaffold_100010	1227637	1228037	400	g_27603	g_27604
Super-Scaffold_100010	1228333	1247501	19168	g_27604	g_27605
Super-Scaffold_100010	1248087	1259783	11696	g_41573	g_41574
Super-Scaffold_100010	1260055	1262311	2256	g_41574	g_27606
Super-Scaffold_100010	1271753	1278199	6446	g_27606	g_27607
Super-Scaffold_100010	1291486	1296378	4892	g_27607	g_27608
Super-Scaffold_100010	1317911	1330947	13036	g_27608	g_27609
Super-Scaffold_100010	1356534	1362384	5850	g_27609	g_27610
Super-Scaffold_100010	1368754	1405265	36511	g_27610	g_27611
Super-Scaffold_100010	1409318	1409529	211	g_27611	g_27612
Super-Scaffold_100010	1412954	1423072	10118	g_27612	g_27614
Super-Scaffold_100010	1425146	1428365	3219	g_27614	g_27613
Super-Scaffold_100010	1441936	1445589	3653	g_27613	g_27615
Super-Scaffold_100010	1457484	1461671	4187	g_27615	g_27616
Super-Scaffold_100010	1462732	1526993	64261	g_27616	g_27618
Super-Scaffold_100010	1529968	1543476	13508	g_27618	g_27619
Super-Scaffold_100010	1548670	1578624	29954	g_27619	g_27620
Super-Scaffold_100010	1579188	1611475	32287	g_41575	g_27621
Super-Scaffold_100010	1617433	1623708	6275	g_27621	g_45169
Super-Scaffold_100010	1648787	1681943	33156	g_45169	g_27622
Super-Scaffold_100010	1682410	1695779	13369	g_27622	g_27623
Super-Scaffold_100010	1716769	1718432	1663	g_27623	g_27624
Super-Scaffold_100010	1722328	1725996	3668	g_27624	g_27625
Super-Scaffold_100010	1736280	1811842	75562	g_27625	g_27629
Super-Scaffold_100010	1829326	1830676	1350	g_27629	g_27630
Super-Scaffold_100010	1838508	1878943	40435	g_27630	g_27631
Super-Scaffold_100010	1881796	1882665	869	g_27631	g_27632
Super-Scaffold_100010	1890691	1890766	75	g_27632	g_41576
Super-Scaffold_100010	1891779	1932726	40947	g_41576	g_27633
Super-Scaffold_100010	1940603	1994124	53521	g_27633	g_27635
Super-Scaffold_100010	1994405	1994864	459	g_27635	g_27636
Super-Scaffold_100010	1996024	2031419	35395	g_27636	g_27639
Super-Scaffold_100010	2031649	2103520	71871	g_27639	g_27640
Super-Scaffold_100010	2114941	2143471	28530	g_27640	g_45170
Super-Scaffold_100010	2167806	2200539	32733	g_45170	g_27642
Super-Scaffold_100010	2201998	2205061	3063	g_27642	g_27643
Super-Scaffold_100010	2206125	2207480	1355	g_27643	g_27644
Super-Scaffold_100010	2210207	2270366	60159	g_27644	g_27647
Super-Scaffold_100010	2274237	2282959	8722	g_27647	g_27648
Super-Scaffold_100010	2285278	2299778	14500	g_27648	g_27649
Super-Scaffold_100010	2301370	2307251	5881	g_27649	g_27650
Super-Scaffold_100010	2311152	2319797	8645	g_27650	g_27651
Super-Scaffold_100010	2326146	2352307	26161	g_27651	g_27653
Super-Scaffold_100010	2352861	2353260	399	g_27653	g_27654
Super-Scaffold_100010	2354267	2383924	29657	g_27654	g_27655
Super-Scaffold_100010	2384172	2384466	294	g_27655	g_27656
Super-Scaffold_100010	2385176	2385545	369	g_27656	g_41578
Super-Scaffold_100010	2385877	2558936	173059	g_41578	g_41579
Super-Scaffold_100010	2559145	2629732	70587	g_41579	g_27662
Super-Scaffold_100010	2629986	2633087	3101	g_27662	g_27663
Super-Scaffold_100010	2676575	2963924	287349	g_27663	g_27668
Super-Scaffold_100010	2964841	2964859	18	g_27668	g_27669
Super-Scaffold_100010	2965976	3306725	340749	g_27669	g_41583
Super-Scaffold_100010	3307057	3307065	8	g_41583	g_27670
Super-Scaffold_100010	3307400	3413701	106301	g_27670	g_27671
Super-Scaffold_100010	3415713	3496189	80476	g_27671	g_27672
Super-Scaffold_100010	3497902	3498600	698	g_27672	g_27673
Super-Scaffold_100010	3503321	3560349	57028	g_27673	g_27674
Super-Scaffold_100010	3584740	3590603	5863	g_27674	g_27675
Super-Scaffold_100010	3603091	3606246	3155	g_27675	g_27676
Super-Scaffold_100010	3630788	3641007	10219	g_27676	g_27677
Super-Scaffold_100010	3651751	3652508	757	g_27677	g_27678
Super-Scaffold_100010	3657531	3719286	61755	g_27678	g_27681
Super-Scaffold_100010	3747339	3753428	6089	g_27681	g_27682
Super-Scaffold_100010	3769997	3779072	9075	g_27682	g_27683
Super-Scaffold_100010	3784009	3822641	38632	g_27683	g_27685
Super-Scaffold_100010	3856606	3880562	23956	g_27685	g_27686
Super-Scaffold_100010	3880780	3949265	68485	g_27686	g_27690
Super-Scaffold_100010	3949525	3972001	22476	g_27690	g_41589
Super-Scaffold_100010	3972231	4016112	43881	g_41589	g_27693
Super-Scaffold_100010	4016498	4065938	49440	g_27693	g_27694
Super-Scaffold_100010	4073342	4080219	6877	g_27694	g_27695
Super-Scaffold_100010	4090110	4100535	10425	g_27695	g_27696
Super-Scaffold_100010	4104051	4111102	7051	g_27696	g_27697
Super-Scaffold_100010	4126084	4145217	19133	g_27697	g_27698
Super-Scaffold_100010	4145564	4167747	22183	g_27698	g_27699
Super-Scaffold_100010	4167983	4168814	831	g_27699	g_27700
Super-Scaffold_100010	4169239	4304666	135427	g_27700	g_27703
Super-Scaffold_100010	4307004	4418142	111138	g_27703	g_27705
Super-Scaffold_100010	4418393	4499335	80942	g_27705	g_41596
Super-Scaffold_100010	4499574	4712392	212818	g_41596	g_27709
Super-Scaffold_100010	4712805	4785820	73015	g_27709	g_27710
Super-Scaffold_100010	4786053	4832427	46374	g_27710	g_27711
Super-Scaffold_100010	4832696	5029337	196641	g_27711	g_41603
Super-Scaffold_100010	5029570	5081461	51891	g_41603	g_27714
Super-Scaffold_100010	5081910	5127488	45578	g_27714	g_27716
Super-Scaffold_100010	5128111	5128253	142	g_27716	g_27717
Super-Scaffold_100010	5128774	5216780	88006	g_27717	g_27720
Super-Scaffold_100010	5216983	5435853	218870	g_27720	g_27723
Super-Scaffold_100010	5436122	5544809	108687	g_27723	g_41609
Super-Scaffold_100010	5545279	5567916	22637	g_41609	g_27726
Super-Scaffold_100010	5574348	5701692	127344	g_27726	g_27728
Super-Scaffold_100010	5702030	5721649	19619	g_27728	g_27729
Super-Scaffold_100010	5721963	5751729	29766	g_27729	g_27730
Super-Scaffold_100010	5755980	5756028	48	g_27730	g_27731
Super-Scaffold_100010	5756745	5784835	28090	g_27731	g_27733
Super-Scaffold_100010	5785584	5797882	12298	g_27733	g_27734
Super-Scaffold_100010	5810382	5813168	2786	g_27734	g_27735
Super-Scaffold_100010	5827671	5829665	1994	g_27735	g_27736
Super-Scaffold_100010	5843960	5845341	1381	g_27736	g_45171
Super-Scaffold_100010	5862463	5867895	5432	g_45171	g_27737
Super-Scaffold_100010	5891286	5907789	16503	g_27737	g_27738
Super-Scaffold_100010	5924257	5926240	1983	g_27738	g_27739
Super-Scaffold_100010	5927109	5976873	49764	g_27739	g_27741
Super-Scaffold_100010	5977169	5978762	1593	g_27741	g_27742
Super-Scaffold_100010	5983324	6037983	54659	g_27742	g_27743
Super-Scaffold_100010	6040818	6115390	74572	g_27743	g_27744
Super-Scaffold_100010	6120140	6121940	1800	g_27744	g_27745
Super-Scaffold_100010	6122644	6124091	1447	g_27745	g_27746
Super-Scaffold_100010	6125113	6126698	1585	g_27746	g_27747
Super-Scaffold_100010	6130481	6133393	2912	g_27747	g_27748
Super-Scaffold_100010	6153780	6166142	12362	g_27748	g_27749
Super-Scaffold_100010	6168471	6183021	14550	g_27749	g_27750
Super-Scaffold_100010	6183281	6237140	53859	g_27750	g_27753
Super-Scaffold_100010	6237637	6261662	24025	g_27753	g_27756
Super-Scaffold_100010	6285456	6288622	3166	g_27756	g_45172
Super-Scaffold_100010	6311104	6311912	808	g_45172	g_27757
Super-Scaffold_100010	6314685	6316302	1617	g_27757	g_27758
Super-Scaffold_100010	6326704	6328230	1526	g_27758	g_27759
Super-Scaffold_100010	6338527	6344851	6324	g_27759	g_27760
Super-Scaffold_100010	6356789	6358339	1550	g_27760	g_27761
Super-Scaffold_100010	6367162	6367969	807	g_27761	g_27762
Super-Scaffold_100010	6373202	6374845	1643	g_27762	g_27763
Super-Scaffold_100010	6382366	6448810	66444	g_27763	g_27765
Super-Scaffold_100010	6450216	6467839	17623	g_27765	g_27766
Super-Scaffold_100010	6468060	6545411	77351	g_27766	g_27768
Super-Scaffold_100010	6545956	6569633	23677	g_27768	g_27769
Super-Scaffold_100010	6598113	6654575	56462	g_27769	g_41619
Super-Scaffold_100010	6654787	6668242	13455	g_41619	g_27771
Super-Scaffold_100010	6668598	6679918	11320	g_27771	g_45173
Super-Scaffold_100010	6680475	6680836	361	g_45173	g_27772
Super-Scaffold_100010	6681953	6695086	13133	g_27772	g_27773
Super-Scaffold_100010	6695397	6780151	84754	g_27773	g_41620
Super-Scaffold_100010	6780381	7035720	255339	g_41620	g_27776
Super-Scaffold_100010	7039487	7097738	58251	g_27776	g_27779
Super-Scaffold_100010	7108041	7120325	12284	g_27779	g_41622
Super-Scaffold_100010	7120567	7217004	96437	g_41622	g_27781
Super-Scaffold_100010	7223126	7328892	105766	g_27781	g_27783
Super-Scaffold_100010	7354172	7361449	7277	g_27783	g_27784
Super-Scaffold_100010	7373791	7572221	198430	g_27784	g_41623
Super-Scaffold_100010	7572514	7679068	106554	g_41623	g_27786
Super-Scaffold_100010	7706689	7722112	15423	g_27786	g_27787
Super-Scaffold_100010	7723095	7723113	18	g_27787	g_27788
Super-Scaffold_100010	7724177	7731243	7066	g_27788	g_27789
Super-Scaffold_100010	7731497	7853804	122307	g_27789	g_27791
Super-Scaffold_100010	7866992	7882255	15263	g_27791	g_27793
Super-Scaffold_100010	7882545	7912141	29596	g_27793	g_27795
Super-Scaffold_100010	7912464	7933119	20655	g_27795	g_27796
Super-Scaffold_100010	7933919	7957345	23426	g_27796	g_27797
Super-Scaffold_100010	7975771	8075061	99290	g_27797	g_27798
Super-Scaffold_100010	8109267	8119480	10213	g_27798	g_27799
Super-Scaffold_100010	8120130	8223044	102914	g_27799	g_27802
Super-Scaffold_100010	8237251	8256840	19589	g_27802	g_27803
Super-Scaffold_100010	8297144	8308519	11375	g_27803	g_27804
Super-Scaffold_100010	8311857	8318166	6309	g_27804	g_27805
Super-Scaffold_100010	8334889	8475729	140840	g_27805	g_27807
Super-Scaffold_100010	8476121	8684273	208152	g_27807	g_27808
Super-Scaffold_100010	8685308	8718861	33553	g_27808	g_27809
Super-Scaffold_100010	8719412	9146271	426859	g_27809	g_27811
Super-Scaffold_100010	9147684	9298531	150847	g_27811	g_27813
Super-Scaffold_100010	9298917	9456888	157971	g_27813	g_27815
Super-Scaffold_100010	9457259	9457790	531	g_27815	g_27816
Super-Scaffold_100010	9458854	9502513	43659	g_27816	g_27817
Super-Scaffold_100010	9519840	9524013	4173	g_27817	g_27818
Super-Scaffold_100010	9571518	9642528	71010	g_27819	g_45174
Super-Scaffold_100010	9656558	9658962	2404	g_45174	g_27821
Super-Scaffold_100010	9672419	9674877	2458	g_27821	g_27822
Super-Scaffold_100010	9679911	9683071	3160	g_27822	g_27823
Super-Scaffold_100010	9684967	9688356	3389	g_27823	g_27824
Super-Scaffold_100010	9690289	9730091	39802	g_27824	g_27825
Super-Scaffold_100010	9731369	9735573	4204	g_27825	g_27826
Super-Scaffold_100010	9740294	9753025	12731	g_41635	g_27827
Super-Scaffold_100010	9756104	9762628	6524	g_27827	g_27829
Super-Scaffold_100010	9762945	9953260	190315	g_27829	g_27832
Super-Scaffold_100010	9953754	9971389	17635	g_27832	g_27833
Super-Scaffold_100010	9973003	10014419	41416	g_27833	g_27834
Super-Scaffold_100010	10020636	10025275	4639	g_27834	g_27835
Super-Scaffold_100010	10045926	10052075	6149	g_27835	g_27837
Super-Scaffold_100010	10053091	10062381	9290	g_27837	g_27838
Super-Scaffold_100010	10065729	10089655	23926	g_27838	g_27839
Super-Scaffold_100010	10113396	10363148	249752	g_27839	g_27841
Super-Scaffold_100010	10365873	10367720	1847	g_27841	g_27842
Super-Scaffold_100010	10375845	10380651	4806	g_27842	g_27843
Super-Scaffold_100010	10428696	10454622	25926	g_27843	g_41640
Super-Scaffold_100010	10454831	10487783	32952	g_41640	g_27845
Super-Scaffold_100010	10488487	10534139	45652	g_27845	g_27846
Super-Scaffold_100010	10536937	10604037	67100	g_27846	g_27847
Super-Scaffold_100010	10610677	10612878	2201	g_27847	g_27848
Super-Scaffold_100010	10620597	10623143	2546	g_27848	g_45175
Super-Scaffold_100010	10628436	10722651	94215	g_45175	g_27850
Super-Scaffold_100010	10744253	10749570	5317	g_27850	g_27851
Super-Scaffold_100010	10761863	10778447	16584	g_27851	g_27852
Super-Scaffold_100010	10833646	10867478	33832	g_27852	g_27855
Super-Scaffold_100010	10869385	10871744	2359	g_27855	g_27857
Super-Scaffold_100010	10873027	11052972	179945	g_27857	g_27859
Super-Scaffold_100010	11060294	11087883	27589	g_27859	g_27860
Super-Scaffold_100010	11089688	11186490	96802	g_27860	g_27863
Super-Scaffold_100010	11226174	11245163	18989	g_27863	g_27864
Super-Scaffold_100010	11246431	11282156	35725	g_27864	g_27866
Super-Scaffold_100010	11285074	11290703	5629	g_27866	g_27867
Super-Scaffold_100010	11308776	11447797	139021	g_27867	g_27870
Super-Scaffold_100010	11448559	11579529	130970	g_27870	g_27872
Super-Scaffold_100010	11592476	11785397	192921	g_27872	g_27873
Super-Scaffold_100010	11791825	11792655	830	g_27873	g_27874
Super-Scaffold_100010	11796952	11831658	34706	g_27874	g_27875
Super-Scaffold_100010	11877338	11879156	1818	g_27875	g_27876
Super-Scaffold_100010	11886394	11898711	12317	g_27876	g_27877
Super-Scaffold_100010	11900562	11911706	11144	g_27877	g_27878
Super-Scaffold_100010	11914252	11928884	14632	g_27878	g_27879
Super-Scaffold_100010	11929762	11968296	38534	g_27879	g_27880
Super-Scaffold_100010	11991940	12016829	24889	g_27880	g_27881
Super-Scaffold_100010	12027511	12041321	13810	g_27881	g_27882
Super-Scaffold_100010	12041848	12076344	34496	g_27882	g_41648
Super-Scaffold_100010	12076638	12113273	36635	g_27883	g_27885
Super-Scaffold_100010	12140064	12145839	5775	g_27885	g_45176
Super-Scaffold_100010	12148488	12226502	78014	g_45176	g_27886
Super-Scaffold_100010	12229441	12242042	12601	g_27886	g_27888
Super-Scaffold_100010	12249474	12264233	14759	g_27888	g_27889
Super-Scaffold_100010	12264667	12271324	6657	g_27889	g_27891
Super-Scaffold_100010	12271659	12446712	175053	g_27891	g_27892
Super-Scaffold_100010	12454213	12527638	73425	g_27892	g_27893
Super-Scaffold_100010	12527982	12557860	29878	g_27893	g_27894
Super-Scaffold_100010	12558075	12602181	44106	g_27894	g_27895
Super-Scaffold_100010	12607642	12617800	10158	g_27895	g_45177
Super-Scaffold_100010	12782818	12883433	100615	g_45177	g_27896
Super-Scaffold_100010	12887280	12899229	11949	g_27896	g_41651
Super-Scaffold_100010	12900048	13014382	114334	g_27897	g_27898
Super-Scaffold_100010	13015263	13029809	14546	g_27898	g_27899
Super-Scaffold_100010	13034726	13048710	13984	g_27899	g_27900
Super-Scaffold_100010	13052329	13053320	991	g_27900	g_27901
Super-Scaffold_100010	13062642	13066795	4153	g_27901	g_27902
Super-Scaffold_100010	13076954	13252321	175367	g_27902	g_27907
Super-Scaffold_100010	13264008	13265100	1092	g_27907	g_27908
Super-Scaffold_100010	13267955	13278906	10951	g_27908	g_27909
Super-Scaffold_100010	13289819	13303243	13424	g_27909	g_27910
Super-Scaffold_100010	13307134	13328972	21838	g_27910	g_27912
Super-Scaffold_100010	13332869	13337862	4993	g_27912	g_27913
Super-Scaffold_100010	13344685	13376084	31399	g_27913	g_27914
Super-Scaffold_100010	13376338	13398512	22174	g_27914	g_27915
Super-Scaffold_100010	13401336	13420750	19414	g_27915	g_27916
Super-Scaffold_100010	13425878	13446112	20234	g_27916	g_27917
Super-Scaffold_100010	13467736	13501991	34255	g_27917	g_45178
Super-Scaffold_100010	13542855	13623366	80511	g_45178	g_27919
Super-Scaffold_100010	13624601	13624644	43	g_27919	g_27920
Super-Scaffold_100010	13625432	13647078	21646	g_27920	g_27921
Super-Scaffold_100010	13647446	13702218	54772	g_27921	g_27923
Super-Scaffold_100010	13703911	13722501	18590	g_27923	g_27924
Super-Scaffold_100010	13742383	13743183	800	g_27924	g_27925
Super-Scaffold_100010	13746292	13748160	1868	g_27925	g_27926
Super-Scaffold_100010	13757481	13761714	4233	g_27926	g_27927
Super-Scaffold_100010	13770064	13868150	98086	g_27927	g_41657
Super-Scaffold_100010	13868419	13909726	41307	g_41657	g_27930
Super-Scaffold_100010	13910055	13953805	43750	g_27930	g_27931
Super-Scaffold_100010	13964931	13973035	8104	g_27931	g_27932
Super-Scaffold_100010	13980111	13983215	3104	g_27932	g_27933
Super-Scaffold_100010	13988586	14003124	14538	g_27933	g_45179
Super-Scaffold_100010	14010729	14015019	4290	g_45179	g_27934
Super-Scaffold_100010	14022681	14093666	70985	g_27934	g_27935
Super-Scaffold_100010	14095366	14112509	17143	g_27935	g_27936
Super-Scaffold_100010	14133577	14178553	44976	g_27936	g_27938
Super-Scaffold_100010	14180527	14187823	7296	g_27938	g_27939
Super-Scaffold_100010	14188059	14204941	16882	g_27939	g_27940
Super-Scaffold_100010	14207547	14218122	10575	g_27940	g_27941
Super-Scaffold_100010	14219135	14240633	21498	g_27941	g_27942
Super-Scaffold_100010	14241409	14255973	14564	g_27942	g_27943
Super-Scaffold_100010	14263425	14265082	1657	g_27943	g_27944
Super-Scaffold_100010	14267632	14269791	2159	g_27944	g_27945
Super-Scaffold_100010	14301509	14303778	2269	g_27945	g_27946
Super-Scaffold_100010	14316389	14335298	18909	g_27946	g_27947
Super-Scaffold_100010	14335699	14336063	364	g_27947	g_27948
Super-Scaffold_100010	14336851	14388528	51677	g_27948	g_27949
Super-Scaffold_100010	14396126	14400968	4842	g_27949	g_27950
Super-Scaffold_100010	14402622	14406892	4270	g_27950	g_27952
Super-Scaffold_100010	14413126	14414035	909	g_27952	g_27953
Super-Scaffold_100010	14416588	14419669	3081	g_27953	g_27954
Super-Scaffold_100010	14421299	14648052	226753	g_27954	g_27956
Super-Scaffold_100010	14648450	14779165	130715	g_27956	g_27958
Super-Scaffold_100010	14782423	15057997	275574	g_27958	g_27962
Super-Scaffold_100010	15058239	15058488	249	g_27962	g_27963
Super-Scaffold_100010	15058757	15062996	4239	g_27963	g_27964
Super-Scaffold_100010	15065403	15067937	2534	g_27964	g_27965
Super-Scaffold_100010	15074059	15079174	5115	g_27965	g_27966
Super-Scaffold_100010	15087617	15090497	2880	g_27966	g_27967
Super-Scaffold_100010	15091705	15146218	54513	g_27967	g_27970
Super-Scaffold_100010	15148095	15171973	23878	g_27970	g_27971
Super-Scaffold_100010	15181410	15185761	4351	g_27971	g_27972
Super-Scaffold_100010	15195863	15216100	20237	g_27972	g_27973
Super-Scaffold_100010	15218128	15235939	17811	g_27973	g_27974
Super-Scaffold_100010	15258094	15268865	10771	g_27974	g_27975
Super-Scaffold_100010	15290595	15333242	42647	g_27975	g_27977
Super-Scaffold_100010	15333679	15417049	83370	g_27977	g_27979
Super-Scaffold_100010	15425186	15426407	1221	g_27979	g_27980
Super-Scaffold_100010	15430560	15435332	4772	g_27980	g_27981
Super-Scaffold_100010	15445877	15447831	1954	g_27981	g_27982
Super-Scaffold_100010	15460536	15556285	95749	g_27982	g_27985
Super-Scaffold_100010	15560443	15597465	37022	g_27985	g_27987
Super-Scaffold_100010	15598760	15598861	101	g_27987	g_27988
Super-Scaffold_100010	15607106	15613933	6827	g_27988	g_27990
Super-Scaffold_100010	15614418	15616868	2450	g_27990	g_27991
Super-Scaffold_100010	15617785	15621205	3420	g_27991	g_27992
Super-Scaffold_100010	15639030	15690053	51023	g_27992	g_27993
Super-Scaffold_100010	15713238	15719251	6013	g_27993	g_45180
Super-Scaffold_100010	15722541	15724997	2456	g_45180	g_27994
Super-Scaffold_100010	15730272	15840035	109763	g_27994	g_27997
Super-Scaffold_100010	15842231	15842370	139	g_27997	g_27998
Super-Scaffold_100010	15843959	15851034	7075	g_27998	g_27999
Super-Scaffold_100010	15852623	15852946	323	g_27999	g_28000
Super-Scaffold_100010	15855048	15856808	1760	g_28000	g_28001
Super-Scaffold_100010	15857431	15871571	14140	g_28001	g_28002
Super-Scaffold_100010	15878278	15880453	2175	g_28002	g_45181
Super-Scaffold_100010	15884785	15960019	75234	g_45181	g_28003
Super-Scaffold_100010	15984679	16233555	248876	g_28003	g_28007
Super-Scaffold_100010	16247862	16319923	72061	g_28007	g_28008
Super-Scaffold_100010	16320357	16498101	177744	g_28008	g_28010
Super-Scaffold_100010	16502893	16522034	19141	g_28010	g_28011
Super-Scaffold_100010	16547131	16549257	2126	g_28011	g_45182
Super-Scaffold_100010	16619596	16623144	3548	g_45182	g_45183
Super-Scaffold_100010	16630920	16631516	596	g_45183	g_28012
Super-Scaffold_100010	16634951	16653973	19022	g_28012	g_28015
Super-Scaffold_100010	16656931	16658650	1719	g_28015	g_41671
Super-Scaffold_100010	16658949	16660665	1716	g_41671	g_28016
Super-Scaffold_100010	16666731	16671284	4553	g_28016	g_28017
Super-Scaffold_100010	16690514	16698750	8236	g_28017	g_28018
Super-Scaffold_100010	16705832	16710701	4869	g_28018	g_28019
Super-Scaffold_100010	16722042	16748994	26952	g_28019	g_28020
Super-Scaffold_100010	16761665	16766416	4751	g_28020	g_28021
Super-Scaffold_100010	16771183	16800489	29306	g_28021	g_28022
Super-Scaffold_100010	16811046	16814072	3026	g_28022	g_28023
Super-Scaffold_100010	16814374	16814411	37	g_28023	g_45184
Super-Scaffold_100010	16830846	16835214	4368	g_45184	g_28024
Super-Scaffold_100010	16842260	16866904	24644	g_28024	g_28025
Super-Scaffold_100010	16883208	16918364	35156	g_28025	g_28026
Super-Scaffold_100010	16931320	16957999	26679	g_28026	g_28027
Super-Scaffold_100010	16963340	16965872	2532	g_28027	g_28028
Super-Scaffold_100010	16969249	16970383	1134	g_28028	g_45185
Super-Scaffold_100010	16975048	16975773	725	g_45185	g_28029
Super-Scaffold_100010	16976759	16980871	4112	g_28029	g_28030
Super-Scaffold_100010	16987663	16996180	8517	g_28030	g_28032
Super-Scaffold_100010	16998096	17006852	8756	g_28031	g_28033
Super-Scaffold_100010	17041028	17086849	45821	g_28033	g_28036
Super-Scaffold_100010	17090539	17108210	17671	g_28036	g_28037
Super-Scaffold_100010	17112808	17116340	3532	g_28037	g_28038
Super-Scaffold_100010	17131136	17136829	5693	g_28038	g_28039
Super-Scaffold_100010	17137656	17143207	5551	g_28039	g_28040
Super-Scaffold_100010	17161282	17181116	19834	g_28040	g_28043
Super-Scaffold_100010	17191293	17196280	4987	g_28043	g_28044
Super-Scaffold_100010	17212668	17220379	7711	g_28044	g_28045
Super-Scaffold_100010	17222807	17223607	800	g_28045	g_28046
Super-Scaffold_100010	17223897	17284874	60977	g_28046	g_28049
Super-Scaffold_100010	17288694	17294538	5844	g_28049	g_28050
Super-Scaffold_100010	17303309	17306416	3107	g_28050	g_45186
Super-Scaffold_100010	17308545	17309290	745	g_45186	g_28051
Super-Scaffold_100010	17313912	17321935	8023	g_28051	g_28052
Super-Scaffold_100010	17336792	17338737	1945	g_28052	g_28053
Super-Scaffold_100010	17358243	17361186	2943	g_28053	g_28055
Super-Scaffold_100010	17362172	17420869	58697	g_28055	g_28056
Super-Scaffold_100010	17434511	17466380	31869	g_28056	g_28057
Super-Scaffold_100010	17475050	17478483	3433	g_28057	g_28058
Super-Scaffold_100010	17483979	17486531	2552	g_28058	g_28059
Super-Scaffold_100010	17499793	17505685	5892	g_28059	g_28060
Super-Scaffold_100010	17522747	17528570	5823	g_28060	g_28061
Super-Scaffold_100010	17532158	17544521	12363	g_28061	g_28062
Super-Scaffold_100010	17552879	17584291	31412	g_28062	g_28063
Super-Scaffold_100010	17593201	17665649	72448	g_28063	g_28064
Super-Scaffold_100010	17667859	17693645	25786	g_28064	g_28066
Super-Scaffold_100010	17693863	17717312	23449	g_28066	g_28067
Super-Scaffold_100010	17718058	17751564	33506	g_28067	g_28068
Super-Scaffold_100010	17762796	17764050	1254	g_28068	g_45187
Super-Scaffold_100010	17771568	17772884	1316	g_45187	g_45188
Super-Scaffold_100010	17774331	17777938	3607	g_45188	g_28069
Super-Scaffold_100010	17798724	17801815	3091	g_28069	g_45189
Super-Scaffold_100010	17805443	17815547	10104	g_45189	g_28070
Super-Scaffold_100010	17815798	17819864	4066	g_28070	g_28071
Super-Scaffold_100010	17823640	17835487	11847	g_28071	g_28072
Super-Scaffold_100010	17848782	17852855	4073	g_28072	g_45190
Super-Scaffold_100010	17855617	17883963	28346	g_45190	g_28073
Super-Scaffold_100010	17905606	17921574	15968	g_28073	g_28075
Super-Scaffold_100010	17985155	17987326	2171	g_28075	g_28076
Super-Scaffold_100010	17991169	18030915	39746	g_28078	g_28081
Super-Scaffold_100010	18032611	18035726	3115	g_28081	g_28082
Super-Scaffold_100010	18057781	18109720	51939	g_28082	g_28083
Super-Scaffold_100010	18135408	18136216	808	g_28083	g_28084
Super-Scaffold_100010	18137830	18138129	299	g_28084	g_45191
Super-Scaffold_100010	18142407	18153499	11092	g_45191	g_28085
Super-Scaffold_100010	18153777	18158425	4648	g_28085	g_28086
Super-Scaffold_100010	18169165	18172553	3388	g_28086	g_28087
Super-Scaffold_100010	18188218	18193755	5537	g_28087	g_28088
Super-Scaffold_100010	18196100	18198211	2111	g_28088	g_28089
Super-Scaffold_100010	18199232	18200430	1198	g_28089	g_28090
Super-Scaffold_100010	18206320	18231593	25273	g_28090	g_28091
Super-Scaffold_100010	18231931	18249594	17663	g_28091	g_28092
Super-Scaffold_100010	18249866	18264923	15057	g_28092	g_28093
Super-Scaffold_100010	18265261	18267525	2264	g_28093	g_28094
Super-Scaffold_100010	18269482	18283720	14238	g_28094	g_28095
Super-Scaffold_100010	18286841	18303475	16634	g_28095	g_28096
Super-Scaffold_100010	18303768	18322425	18657	g_28096	g_28097
Super-Scaffold_100010	18322670	18337643	14973	g_28097	g_41679
Super-Scaffold_100010	18337888	18396469	58581	g_41679	g_28099
Super-Scaffold_100010	18397059	18412765	15706	g_28099	g_28100
Super-Scaffold_100010	18414698	18435927	21229	g_28100	g_28101
Super-Scaffold_100010	18456430	18464975	8545	g_28101	g_28102
Super-Scaffold_100010	18465283	18498464	33181	g_28102	g_28103
Super-Scaffold_100010	18514586	18518304	3718	g_28103	g_28104
Super-Scaffold_100010	18541527	18543514	1987	g_28104	g_45192
Super-Scaffold_100010	18547696	18566589	18893	g_45192	g_28105
Super-Scaffold_100010	18568883	18570137	1254	g_28105	g_45193
Super-Scaffold_100010	18573029	18636797	63768	g_45193	g_28106
Super-Scaffold_100010	18641638	18642324	686	g_28106	g_28107
Super-Scaffold_100010	18647610	18648582	972	g_28107	g_28108
Super-Scaffold_100010	18650255	18651502	1247	g_28108	g_28109
Super-Scaffold_100010	18653314	18657698	4384	g_28109	g_45194
Super-Scaffold_100010	18662824	18666557	3733	g_45194	g_28111
Super-Scaffold_100010	18667930	18695436	27506	g_28111	g_28112
Super-Scaffold_100010	18708918	18714566	5648	g_28112	g_28113
Super-Scaffold_100010	18717750	18718450	700	g_28113	g_28114
Super-Scaffold_100010	18726507	18728083	1576	g_28114	g_28115
Super-Scaffold_100010	18737801	18777973	40172	g_28115	g_28117
Super-Scaffold_100010	18786462	18787000	538	g_28117	g_28118
Super-Scaffold_100010	18796946	18799622	2676	g_28118	g_28119
Super-Scaffold_100010	18808879	18818278	9399	g_28119	g_28120
Super-Scaffold_100010	18826640	18827572	932	g_28120	g_28121
Super-Scaffold_100010	18833451	18836689	3238	g_28121	g_28122
Super-Scaffold_100010	18838105	18839740	1635	g_28122	g_28123
Super-Scaffold_100010	18843004	18844126	1122	g_28123	g_28124
Super-Scaffold_100010	18853371	18854553	1182	g_28124	g_28125
Super-Scaffold_100010	18865980	18873970	7990	g_28125	g_28127
Super-Scaffold_100010	18882377	18885525	3148	g_28127	g_28128
Super-Scaffold_100010	18898921	18920551	21630	g_28128	g_28129
Super-Scaffold_100010	18929134	18935669	6535	g_28129	g_28131
Super-Scaffold_100010	18936295	18936384	89	g_28131	g_28132
Super-Scaffold_100010	18937595	18944171	6576	g_28132	g_41686
Super-Scaffold_100010	18944614	18948546	3932	g_41686	g_28134
Super-Scaffold_100010	18951341	18955543	4202	g_28134	g_28135
Super-Scaffold_100010	18958378	18959737	1359	g_28135	g_28136
Super-Scaffold_100010	18965866	18998976	33110	g_28136	g_28137
Super-Scaffold_100010	19009389	19011913	2524	g_28137	g_28138
Super-Scaffold_100010	19015082	19020360	5278	g_28138	g_28139
Super-Scaffold_100010	19023965	19031971	8006	g_28139	g_45195
Super-Scaffold_100010	19033935	19054673	20738	g_45195	g_28141
Super-Scaffold_100010	19058735	19111010	52275	g_28141	g_28142
Super-Scaffold_100010	19117377	19131014	13637	g_28142	g_28143
Super-Scaffold_100010	19132603	19148346	15743	g_28143	g_28146
Super-Scaffold_100010	19150608	19164168	13560	g_28146	g_45196
Super-Scaffold_100010	19167678	19169695	2017	g_45196	g_28147
Super-Scaffold_100010	19171880	19174118	2238	g_28147	g_28148
Super-Scaffold_100010	19179891	19184381	4490	g_28148	g_28149
Super-Scaffold_100010	19187752	19189562	1810	g_28149	g_28150
Super-Scaffold_100010	19206281	19258635	52354	g_28150	g_28151
Super-Scaffold_100010	19276618	19299391	22773	g_28151	g_28152
Super-Scaffold_100010	19309592	19347118	37526	g_28152	g_28153
Super-Scaffold_100010	19412715	19459446	46731	g_28153	g_28154
Super-Scaffold_100010	19461677	19464921	3244	g_28154	g_28155
Super-Scaffold_100010	19465976	19487243	21267	g_28155	g_28156
Super-Scaffold_100010	19489381	19569846	80465	g_28156	g_28157
Super-Scaffold_100010	19571686	19594038	22352	g_28157	g_28159
Super-Scaffold_100010	19595222	19595339	117	g_28159	g_28160
Super-Scaffold_100010	19595644	19610829	15185	g_28160	g_41691
Super-Scaffold_100010	19613789	19613972	183	g_41691	g_41692
Super-Scaffold_100010	19614874	19614931	57	g_41692	g_41693
Super-Scaffold_100010	19615575	19641130	25555	g_41693	g_28162
Super-Scaffold_100010	19643232	19675450	32218	g_28162	g_28163
Super-Scaffold_100010	19680364	19681264	900	g_28163	g_28164
Super-Scaffold_100010	19686316	19688360	2044	g_28164	g_28165
Super-Scaffold_100010	19697098	19700495	3397	g_28165	g_28166
Super-Scaffold_100010	19702643	19706522	3879	g_28166	g_28167
Super-Scaffold_100010	19707794	19719156	11362	g_28167	g_28168
Super-Scaffold_100010	19725003	19738018	13015	g_28168	g_45197
Super-Scaffold_100010	19742104	19745530	3426	g_45197	g_45198
Super-Scaffold_100010	19745973	19776417	30444	g_45198	g_28171
Super-Scaffold_100010	19784203	19793189	8986	g_28171	g_28172
Super-Scaffold_100010	19797660	19800270	2610	g_28172	g_28173
Super-Scaffold_100010	19818738	19847837	29099	g_28173	g_28174
Super-Scaffold_100010	19859223	19866680	7457	g_28174	g_28175
Super-Scaffold_100010	19868170	19876733	8563	g_28175	g_28176
Super-Scaffold_100010	19877980	19902311	24331	g_28176	g_28177
Super-Scaffold_100010	19903444	19907624	4180	g_28177	g_28178
Super-Scaffold_100010	19911381	19914310	2929	g_28178	g_28179
Super-Scaffold_100010	19922430	19923553	1123	g_28179	g_41697
Super-Scaffold_100010	19923822	19953370	29548	g_41697	g_28181
Super-Scaffold_100010	19959504	19959993	489	g_28181	g_28182
Super-Scaffold_100010	19960268	19962134	1866	g_28182	g_28183
Super-Scaffold_100010	19968740	19970740	2000	g_28183	g_28184
Super-Scaffold_100010	19976768	19994332	17564	g_28184	g_45199
Super-Scaffold_100010	19998387	19999927	1540	g_45199	g_28185
Super-Scaffold_100010	20002992	20003417	425	g_28185	g_28186
Super-Scaffold_100010	20004850	20013579	8729	g_28186	g_28187
Super-Scaffold_100010	20038104	20051942	13838	g_28187	g_28188
Super-Scaffold_100010	20054068	20072526	18458	g_28188	g_28189
Super-Scaffold_100010	20073502	20075414	1912	g_28189	g_28190
Super-Scaffold_100010	20080204	20082411	2207	g_28190	g_28191
Super-Scaffold_100010	20095510	20103427	7917	g_28191	g_28192
Super-Scaffold_100010	20103801	20117003	13202	g_28192	g_28193
Super-Scaffold_100010	20118448	20125706	7258	g_28193	g_28194
Super-Scaffold_100010	20126970	20128039	1069	g_28194	g_28195
Super-Scaffold_100010	20129840	20130943	1103	g_28195	g_28196
Super-Scaffold_100010	20132216	20137827	5611	g_28196	g_28197
Super-Scaffold_100010	20139298	20140362	1064	g_28197	g_28198
Super-Scaffold_100010	20141636	20157805	16169	g_28198	g_28199
Super-Scaffold_100010	20158941	20183115	24174	g_28199	g_28201
Super-Scaffold_100010	20185369	20212065	26696	g_28201	g_28202
Super-Scaffold_100010	20227931	20281107	53176	g_28202	g_28204
Super-Scaffold_100010	20287931	20289669	1738	g_28204	g_28205
Super-Scaffold_100010	20294616	20302187	7571	g_28205	g_28206
Super-Scaffold_100010	20312783	20340646	27863	g_28206	g_28207
Super-Scaffold_100010	20360396	20375667	15271	g_28207	g_28208
Super-Scaffold_100010	20375888	20406786	30898	g_28208	g_28209
Super-Scaffold_100010	20412663	20415245	2582	g_28209	g_28210
Super-Scaffold_100010	20422293	20425638	3345	g_28210	g_28211
Super-Scaffold_100010	20428587	20432949	4362	g_28211	g_28212
Super-Scaffold_100010	20448568	20449139	571	g_28212	g_28213
Super-Scaffold_100010	20455943	20462698	6755	g_28213	g_28214
Super-Scaffold_100010	20467586	20496909	29323	g_28214	g_28215
Super-Scaffold_100010	20497346	20502486	5140	g_28215	g_28216
Super-Scaffold_100010	20513309	20515533	2224	g_28216	g_28217
Super-Scaffold_100010	20523308	20524121	813	g_28217	g_28218
Super-Scaffold_100010	20524631	20527305	2674	g_28218	g_28219
Super-Scaffold_100010	20527913	20530443	2530	g_28219	g_28220
Super-Scaffold_100010	20537448	20561282	23834	g_28220	g_28221
Super-Scaffold_100010	20561821	20616722	54901	g_28221	g_28223
Super-Scaffold_100010	20625953	20648546	22593	g_28223	g_28224
Super-Scaffold_100010	20658513	20661544	3031	g_28224	g_28225
Super-Scaffold_100010	20673552	20674623	1071	g_28225	g_28226
Super-Scaffold_100010	20678750	20680899	2149	g_28226	g_45200
Super-Scaffold_100010	20686946	20687807	861	g_45200	g_28227
Super-Scaffold_100010	20690709	20697597	6888	g_28227	g_28228
Super-Scaffold_100010	20700484	20701946	1462	g_28228	g_45201
Super-Scaffold_100010	20705331	20728759	23428	g_45201	g_28229
Super-Scaffold_100010	20732187	20746739	14552	g_28229	g_28230
Super-Scaffold_100010	20758665	20780476	21811	g_41703	g_28231
Super-Scaffold_100010	20783082	20800505	17423	g_28231	g_28232
Super-Scaffold_100010	20802940	20888720	85780	g_28232	g_28234
Super-Scaffold_100010	20890682	20916579	25897	g_28234	g_28235
Super-Scaffold_100010	20920211	20938187	17976	g_28235	g_28236
Super-Scaffold_100010	20938912	20963523	24611	g_28236	g_28237
Super-Scaffold_100010	21000929	21002508	1579	g_28237	g_28238
Super-Scaffold_100010	21006746	21007682	936	g_28238	g_28239
Super-Scaffold_100010	21009353	21012101	2748	g_28239	g_28240
Super-Scaffold_100010	21013265	21015748	2483	g_28240	g_45202
Super-Scaffold_100010	21026822	21029244	2422	g_45202	g_28241
Super-Scaffold_100010	21062112	21066169	4057	g_28241	g_28242
Super-Scaffold_100010	21066720	21133485	66765	g_28242	g_28244
Super-Scaffold_100010	21141469	21145769	4300	g_28244	g_45203
Super-Scaffold_100010	21146116	21146205	89	g_45203	g_28245
Super-Scaffold_100010	21146432	21146579	147	g_28245	g_28246
Super-Scaffold_100010	21154414	21182526	28112	g_28246	g_28248
Super-Scaffold_100010	21182786	21193013	10227	g_28248	g_28249
Super-Scaffold_100010	21211715	21243897	32182	g_28249	g_28251
Super-Scaffold_100010	21286770	21298361	11591	g_28251	g_45204
Super-Scaffold_100010	21307607	21313637	6030	g_45204	g_28252
Super-Scaffold_100010	21320485	21321148	663	g_28252	g_28253
Super-Scaffold_100010	21327888	21331268	3380	g_28253	g_28254
Super-Scaffold_100010	21332347	21335952	3605	g_28254	g_28256
Super-Scaffold_100010	21353678	21361002	7324	g_41709	g_28257
Super-Scaffold_100010	21362403	21365187	2784	g_28257	g_28258
Super-Scaffold_100010	21370552	21373332	2780	g_28258	g_45205
Super-Scaffold_100010	21380236	21384525	4289	g_45205	g_28259
Super-Scaffold_100010	21384797	21384951	154	g_28259	g_28260
Super-Scaffold_100010	21410626	21420948	10322	g_28260	g_28261
Super-Scaffold_100010	21421354	21423356	2002	g_28261	g_28262
Super-Scaffold_100010	21455546	21493545	37999	g_28262	g_28264
Super-Scaffold_100010	21499564	21503540	3976	g_28264	g_28265
Super-Scaffold_100010	21506751	21602323	95572	g_28265	g_28269
Super-Scaffold_100010	21603942	21612884	8942	g_28269	g_28270
Super-Scaffold_100010	21614212	21626868	12656	g_28270	g_28271
Super-Scaffold_100010	21628175	21630359	2184	g_28271	g_28272
Super-Scaffold_100010	21632098	21636096	3998	g_28272	g_45206
Super-Scaffold_100010	21637491	21643079	5588	g_45206	g_45207
Super-Scaffold_100010	21644345	21654879	10534	g_45207	g_28273
Super-Scaffold_100010	21657022	21674103	17081	g_28273	g_28274
Super-Scaffold_100010	21681722	21738799	57077	g_28274	g_28278
Super-Scaffold_100010	21739107	21766946	27839	g_28278	g_28280
Super-Scaffold_100010	21767197	21768791	1594	g_28280	g_28281
Super-Scaffold_100010	21770503	21772573	2070	g_28281	g_45208
Super-Scaffold_100010	21780342	21810988	30646	g_41717	g_28282
Super-Scaffold_100010	21819884	21824330	4446	g_28282	g_28283
Super-Scaffold_100010	21831986	21833741	1755	g_28283	g_28284
Super-Scaffold_100010	21840908	21844607	3699	g_28284	g_28285
Super-Scaffold_100010	21847164	21848058	894	g_28285	g_28286
Super-Scaffold_100010	21852958	21855520	2562	g_28286	g_28287
Super-Scaffold_100010	21857377	21905415	48038	g_28287	g_28290
Super-Scaffold_100010	21911545	21944839	33294	g_28290	g_28291
Super-Scaffold_100010	21947718	21949214	1496	g_28291	g_45209
Super-Scaffold_100010	21953497	21955638	2141	g_45209	g_28292
Super-Scaffold_100010	21968504	21972508	4004	g_28292	g_45210
Super-Scaffold_100010	21988197	21995055	6858	g_45210	g_41718
Super-Scaffold_100010	21995279	22013085	17806	g_41718	g_28294
Super-Scaffold_100010	22036070	22038463	2393	g_28294	g_28295
Super-Scaffold_100010	22042073	22043473	1400	g_28295	g_28296
Super-Scaffold_100010	22045505	22046872	1367	g_28296	g_28297
Super-Scaffold_100010	22066983	22076534	9551	g_28297	g_28298
Super-Scaffold_100010	22077901	22084085	6184	g_28298	g_28299
Super-Scaffold_100010	22085537	22105859	20322	g_28299	g_28302
Super-Scaffold_100010	22106113	22110589	4476	g_28302	g_28303
Super-Scaffold_100010	22120871	22124579	3708	g_28303	g_28304
Super-Scaffold_100010	22144858	22145980	1122	g_28304	g_28305
Super-Scaffold_100010	22164131	22166275	2144	g_28305	g_28306
Super-Scaffold_100010	22168452	22169568	1116	g_28306	g_45211
Super-Scaffold_100010	22177398	22182572	5174	g_45211	g_28307
Super-Scaffold_100010	22193448	22195678	2230	g_28307	g_28308
Super-Scaffold_100010	22200277	22207911	7634	g_28308	g_28309
Super-Scaffold_100010	22218404	22229500	11096	g_28309	g_28310
Super-Scaffold_100010	22230997	22240884	9887	g_28310	g_28311
Super-Scaffold_100010	22241879	22250128	8249	g_28311	g_28313
Super-Scaffold_100010	22260160	22265826	5666	g_28313	g_28314
Super-Scaffold_100010	22288171	22333308	45137	g_28314	g_28316
Super-Scaffold_100010	22335699	22335794	95	g_28316	g_28317
Super-Scaffold_100010	22339004	22344088	5084	g_28317	g_45212
Super-Scaffold_100010	22346830	22348429	1599	g_45212	g_45213
Super-Scaffold_100010	22354343	22356139	1796	g_45213	g_28318
Super-Scaffold_100010	22359349	22362531	3182	g_28318	g_28319
Super-Scaffold_100010	22367140	22369769	2629	g_28319	g_28320
Super-Scaffold_100010	22374196	22374893	697	g_28320	g_28321
Super-Scaffold_100010	22377602	22378812	1210	g_28321	g_28322
Super-Scaffold_100010	22382160	22409882	27722	g_28322	g_28324
Super-Scaffold_100010	22410130	22410656	526	g_28324	g_28325
Super-Scaffold_100010	22411453	22425782	14329	g_28325	g_28327
Super-Scaffold_100010	22426546	22450935	24389	g_28327	g_28328
Super-Scaffold_100010	22451297	22465767	14470	g_28328	g_28329
Super-Scaffold_100010	22476500	22483073	6573	g_28329	g_28330
Super-Scaffold_100010	22485826	22495604	9778	g_28330	g_28331
Super-Scaffold_100010	22509214	22515084	5870	g_28331	g_28332
Super-Scaffold_100010	22519204	22520321	1117	g_28332	g_28333
Super-Scaffold_100010	22534273	22539691	5418	g_28333	g_28334
Super-Scaffold_100010	22552734	22553869	1135	g_28334	g_28335
Super-Scaffold_100010	22555696	22678565	122869	g_28335	g_28338
Super-Scaffold_100010	22688758	22696402	7644	g_28338	g_28340
Super-Scaffold_100010	22696677	22726604	29927	g_28340	g_28343
Super-Scaffold_100010	22726858	22729430	2572	g_28343	g_28342
Super-Scaffold_100010	22732630	22740298	7668	g_28342	g_28344
Super-Scaffold_100010	22744665	22751595	6930	g_28344	g_28346
Super-Scaffold_100010	22752371	22756183	3812	g_28346	g_28347
Super-Scaffold_100010	22757913	22769792	11879	g_28347	g_28348
Super-Scaffold_100010	22783582	22787017	3435	g_28348	g_41731
Super-Scaffold_100010	22787220	22791164	3944	g_41731	g_28349
Super-Scaffold_100010	22797602	22804700	7098	g_28349	g_28350
Super-Scaffold_100010	22806793	22808803	2010	g_28350	g_28351
Super-Scaffold_100010	22817461	22828418	10957	g_41732	g_45214
Super-Scaffold_100010	22835656	22842190	6534	g_45214	g_28352
Super-Scaffold_100010	22847338	22871180	23842	g_28352	g_28353
Super-Scaffold_100010	22872417	22891260	18843	g_28353	g_28354
Super-Scaffold_100010	22902614	22907806	5192	g_28354	g_28355
Super-Scaffold_100010	22939634	22945003	5369	g_28355	g_28356
Super-Scaffold_100010	22946836	22950048	3212	g_28356	g_28357
Super-Scaffold_100010	22967619	22970166	2547	g_28357	g_28358
Super-Scaffold_100010	22985942	23019654	33712	g_28358	g_28359
Super-Scaffold_100010	23021920	23023162	1242	g_28359	g_28360
Super-Scaffold_100010	23023479	23024085	606	g_28360	g_28361
Super-Scaffold_100010	23025730	23028801	3071	g_28361	g_28363
Super-Scaffold_100010	23058633	23065719	7086	g_28363	g_28364
Super-Scaffold_100010	23077216	23079644	2428	g_28364	g_28365
Super-Scaffold_100010	23082437	23084024	1587	g_28365	g_28366
Super-Scaffold_100010	23099898	23101993	2095	g_28366	g_28367
Super-Scaffold_100010	23122330	23168814	46484	g_28367	g_41735
Super-Scaffold_100010	23169167	23196646	27479	g_41735	g_28371
Super-Scaffold_100010	23204833	23304396	99563	g_28371	g_28373
Super-Scaffold_100010	23309858	23311538	1680	g_28373	g_45215
Super-Scaffold_100010	23315416	23319195	3779	g_45215	g_28374
Super-Scaffold_100010	23324491	23325315	824	g_28374	g_28375
Super-Scaffold_100010	23325837	23326967	1130	g_28375	g_28376
Super-Scaffold_100010	23335670	23394926	59256	g_28376	g_28377
Super-Scaffold_100010	23395363	23406363	11000	g_28377	g_28379
Super-Scaffold_100010	23439404	23484773	45369	g_28380	g_28382
Super-Scaffold_100010	23553471	23574077	20606	g_28382	g_28383
Super-Scaffold_100010	23583274	23695937	112663	g_28383	g_28387
Super-Scaffold_100010	23698585	23703829	5244	g_28387	g_28388
Super-Scaffold_100010	23706636	23721988	15352	g_28388	g_28389
Super-Scaffold_100010	23738282	23783106	44824	g_28389	g_41743
Super-Scaffold_100010	23783315	23800620	17305	g_41743	g_28391
Super-Scaffold_100010	23802265	23810292	8027	g_28391	g_28392
Super-Scaffold_100010	23811428	23817482	6054	g_28392	g_28393
Super-Scaffold_100010	23818495	23837962	19467	g_28393	g_28394
Super-Scaffold_100010	23859129	23911975	52846	g_28394	g_28396
Super-Scaffold_100010	23912274	23922937	10663	g_28396	g_45216
Super-Scaffold_100010	23923554	23938927	15373	g_45216	g_41744
Super-Scaffold_100010	23939175	23957742	18567	g_41744	g_28397
Super-Scaffold_100010	23960292	23967032	6740	g_28397	g_28398
Super-Scaffold_100010	23983799	24060297	76498	g_28398	g_28401
Super-Scaffold_100010	24063120	24066234	3114	g_28401	g_28402
Super-Scaffold_100010	24069657	24101280	31623	g_28402	g_28404
Super-Scaffold_100010	24117239	24143799	26560	g_28404	g_28405
Super-Scaffold_100010	24144668	24146230	1562	g_28405	g_28406
Super-Scaffold_100010	24149567	24149944	377	g_28406	g_28407
Super-Scaffold_100010	24152280	24152978	698	g_28407	g_28408
Super-Scaffold_100010	24155895	24160279	4384	g_28408	g_28409
Super-Scaffold_100010	24163181	24167212	4031	g_28409	g_28410
Super-Scaffold_100010	24230138	24234985	4847	g_28410	g_28411
Super-Scaffold_100010	24244263	24245763	1500	g_28411	g_28412
Super-Scaffold_100010	24256823	24258495	1672	g_28412	g_28413
Super-Scaffold_100010	24259501	24260622	1121	g_28413	g_28414
Super-Scaffold_100010	24262487	24265717	3230	g_28414	g_28415
Super-Scaffold_100010	24267289	24269927	2638	g_28415	g_28416
Super-Scaffold_100010	24275333	24279158	3825	g_28416	g_45217
Super-Scaffold_100010	24287503	24298707	11204	g_45217	g_28417
Super-Scaffold_100010	24299201	24307251	8050	g_28417	g_28418
Super-Scaffold_100010	24316074	24396587	80513	g_28418	g_28425
Super-Scaffold_100010	24402321	24420358	18037	g_28425	g_28426
Super-Scaffold_100010	24432211	24435556	3345	g_28426	g_28427
Super-Scaffold_100010	24453867	24487753	33886	g_28427	g_28428
Super-Scaffold_100010	24506387	24508927	2540	g_28428	g_28429
Super-Scaffold_100010	24520832	24524944	4112	g_28429	g_28430
Super-Scaffold_100010	24525581	24528900	3319	g_28430	g_28431
Super-Scaffold_100010	24531374	24560322	28948	g_28431	g_28432
Super-Scaffold_100010	24574716	24577414	2698	g_28432	g_28433
Super-Scaffold_100010	24579800	24580506	706	g_28433	g_45218
Super-Scaffold_100010	24583563	24596482	12919	g_45218	g_28434
Super-Scaffold_100010	24608883	24784609	175726	g_28434	g_28435
Super-Scaffold_100010	24784893	24884116	99223	g_28435	g_28438
Super-Scaffold_100010	24899141	24906498	7357	g_28438	g_28439
Super-Scaffold_100010	24907705	24928759	21054	g_28439	g_28440
Super-Scaffold_100010	24929715	24932448	2733	g_28440	g_28441
Super-Scaffold_100010	24934533	24936722	2189	g_28441	g_28442
Super-Scaffold_100010	24940365	24985534	45169	g_28442	g_28445
Super-Scaffold_100010	24987406	24988323	917	g_28445	g_28446
Super-Scaffold_100010	24992437	24995076	2639	g_28446	g_28447
Super-Scaffold_100010	25012357	25024307	11950	g_28447	g_28448
Super-Scaffold_100010	25030113	25034090	3977	g_28448	g_28449
Super-Scaffold_100010	25050364	25056001	5637	g_28449	g_28450
Super-Scaffold_100010	25068469	25071729	3260	g_28450	g_28451
Super-Scaffold_100010	25088761	25096126	7365	g_28451	g_28453
Super-Scaffold_100010	25108053	25110887	2834	g_28453	g_45219
Super-Scaffold_100010	25111105	25116705	5600	g_45219	g_45220
Super-Scaffold_100010	25117121	25121920	4799	g_45220	g_28454
Super-Scaffold_100010	25147370	25173859	26489	g_28454	g_28456
Super-Scaffold_100010	25174296	25192983	18687	g_28456	g_28457
Super-Scaffold_100010	25194008	25231411	37403	g_28457	g_41757
Super-Scaffold_100010	25231689	25260007	28318	g_41757	g_28461
Super-Scaffold_100010	25261071	25265156	4085	g_28461	g_28462
Super-Scaffold_100010	25286880	25292768	5888	g_28462	g_28463
Super-Scaffold_100010	25310421	25315101	4680	g_28463	g_28464
Super-Scaffold_100010	25327567	25331503	3936	g_28464	g_28465
Super-Scaffold_100010	25333291	25334635	1344	g_28465	g_28466
Super-Scaffold_100010	25336870	25337849	979	g_28466	g_28467
Super-Scaffold_100010	25340745	25345326	4581	g_28467	g_45221
Super-Scaffold_100010	25351371	25353406	2035	g_45221	g_28468
Super-Scaffold_100010	25357439	25380205	22766	g_28468	g_28469
Super-Scaffold_100010	25395857	25398786	2929	g_28469	g_28470
Super-Scaffold_100010	25399893	25401150	1257	g_28470	g_28471
Super-Scaffold_100010	25409275	25412462	3187	g_28471	g_28472
Super-Scaffold_100010	25414714	25435739	21025	g_41759	g_28474
Super-Scaffold_100010	25447048	25449264	2216	g_28474	g_28475
Super-Scaffold_100010	25456302	25458248	1946	g_28475	g_28476
Super-Scaffold_100010	25463180	25498053	34873	g_28476	g_28477
Super-Scaffold_100010	25499321	25508565	9244	g_28477	g_28478
Super-Scaffold_100010	25509725	25513804	4079	g_28478	g_28479
Super-Scaffold_100010	25515644	25515658	14	g_28479	g_41765
Super-Scaffold_100010	25515912	25518048	2136	g_41765	g_28480
Super-Scaffold_100010	25519932	25559751	39819	g_28480	g_28481
Super-Scaffold_100010	25560041	25562802	2761	g_28481	g_28482
Super-Scaffold_100010	25573433	25577802	4369	g_28482	g_28483
Super-Scaffold_100010	25578302	25590711	12409	g_28483	g_28484
Super-Scaffold_100010	25591116	25656025	64909	g_28484	g_28487
Super-Scaffold_100010	25681714	25685312	3598	g_28487	g_28488
Super-Scaffold_100010	25703865	25713856	9991	g_28488	g_45222
Super-Scaffold_100010	25714788	25788889	74101	g_45222	g_28491
Super-Scaffold_100010	25795475	25798385	2910	g_28491	g_28492
Super-Scaffold_100010	25803444	25809797	6353	g_28492	g_28493
Super-Scaffold_100010	25811701	25812858	1157	g_28493	g_28494
Super-Scaffold_100010	25817429	25820066	2637	g_28494	g_28495
Super-Scaffold_100010	25829704	25835119	5415	g_28495	g_28496
Super-Scaffold_100010	25837417	25840388	2971	g_28496	g_45223
Super-Scaffold_100010	25846287	25849029	2742	g_45223	g_28497
Super-Scaffold_100010	25853355	25854601	1246	g_28497	g_28498
Super-Scaffold_100010	25858086	25859956	1870	g_28498	g_28499
Super-Scaffold_100010	25867549	25874875	7326	g_28499	g_28500
Super-Scaffold_100010	25893960	25897068	3108	g_28500	g_28501
Super-Scaffold_100010	25903083	25905332	2249	g_28501	g_28502
Super-Scaffold_100010	25923482	25926908	3426	g_28502	g_28503
Super-Scaffold_100010	25933635	25935832	2197	g_28503	g_45224
Super-Scaffold_100010	25949590	25954176	4586	g_45224	g_28504
Super-Scaffold_100010	25958208	25974683	16475	g_28504	g_28505
Super-Scaffold_100010	25974898	25980007	5109	g_28505	g_28506
Super-Scaffold_100010	25981327	25981449	122	g_28506	g_45225
Super-Scaffold_100010	25984549	25985141	592	g_45225	g_28507
Super-Scaffold_100010	25988785	25991125	2340	g_28507	g_28508
Super-Scaffold_100010	25995679	26007883	12204	g_28508	g_28509
Super-Scaffold_100010	26034587	26038773	4186	g_28509	g_28510
Super-Scaffold_100010	26045200	26047987	2787	g_28510	g_28511
Super-Scaffold_100010	26053101	26057721	4620	g_28511	g_28512
Super-Scaffold_100010	26069295	26071533	2238	g_28512	g_45226
Super-Scaffold_100010	26076400	26078689	2289	g_45226	g_28513
Super-Scaffold_100010	26090564	26095796	5232	g_28513	g_45227
Super-Scaffold_100010	26102221	26118550	16329	g_28514	g_28515
Super-Scaffold_100010	26122357	26124172	1815	g_28515	g_41769
Super-Scaffold_100010	26124381	26129112	4731	g_41769	g_28516
Super-Scaffold_100010	26139954	26144753	4799	g_28516	g_28517
Super-Scaffold_100010	26155685	26159851	4166	g_28517	g_28518
Super-Scaffold_100010	26185392	26197501	12109	g_28518	g_28519
Super-Scaffold_100010	26213737	26229500	15763	g_28519	g_45228
Super-Scaffold_100010	26282422	26310218	27796	g_45228	g_28520
Super-Scaffold_100010	26310445	26310526	81	g_28520	g_41770
Super-Scaffold_100010	26310765	26324899	14134	g_41770	g_28521
Super-Scaffold_100010	26343335	26367650	24315	g_28521	g_28523
Super-Scaffold_100010	26377773	26395978	18205	g_28523	g_45229
Super-Scaffold_100010	26404553	26418458	13905	g_45229	g_28524
Super-Scaffold_100010	26425533	26461756	36223	g_28524	g_28525
Super-Scaffold_100010	26548977	26747779	198802	g_28525	g_28527
Super-Scaffold_100010	26748051	26795557	47506	g_28527	g_28528
Super-Scaffold_100010	26828947	26831113	2166	g_28528	g_28529
Super-Scaffold_100010	26837339	26843045	5706	g_28529	g_45230
Super-Scaffold_100010	26845208	26849041	3833	g_45230	g_45231
Super-Scaffold_100010	26852157	26861850	9693	g_45231	g_28531
Super-Scaffold_100010	26863939	26888721	24782	g_28531	g_28532
Super-Scaffold_100010	26890845	26896735	5890	g_28532	g_45232
Super-Scaffold_100010	26903137	26907585	4448	g_45232	g_45233
Super-Scaffold_100010	26909763	26916339	6576	g_45233	g_45234
Super-Scaffold_100010	26918463	26924329	5866	g_45234	g_45235
Super-Scaffold_100010	26926418	26930293	3875	g_45235	g_45236
Super-Scaffold_100010	26934047	26949006	14959	g_45236	g_28533
Super-Scaffold_100010	26951566	26953908	2342	g_28533	g_28534
Super-Scaffold_100010	26959132	26960426	1294	g_28534	g_45237
Super-Scaffold_100010	26978780	27067225	88445	g_45237	g_28537
Super-Scaffold_100010	27067578	27080138	12560	g_28537	g_28538
Super-Scaffold_100010	27109338	27138079	28741	g_28538	g_28540
Super-Scaffold_100010	27139230	27140139	909	g_28540	g_28541
Super-Scaffold_100010	27140582	27140719	137	g_28541	g_28542
Super-Scaffold_100010	27141033	27179974	38941	g_28542	g_28543
Super-Scaffold_100010	27201149	27210541	9392	g_28543	g_28544
Super-Scaffold_100010	27220580	27226471	5891	g_28544	g_28545
Super-Scaffold_100010	27226674	27253695	27021	g_28545	g_41778
Super-Scaffold_100010	27253955	27265343	11388	g_41778	g_28546
Super-Scaffold_100010	27266506	27364570	98064	g_28546	g_28550
Super-Scaffold_100010	27377823	27417834	40011	g_28550	g_28553
Super-Scaffold_100010	27418127	27446835	28708	g_28553	g_28555
Super-Scaffold_100010	27449417	27450955	1538	g_28555	g_28556
Super-Scaffold_100010	27463308	27470047	6739	g_28556	g_28557
Super-Scaffold_100010	27476013	27479114	3101	g_28557	g_28558
Super-Scaffold_100010	27479400	27484823	5423	g_28558	g_28559
Super-Scaffold_100010	27505235	27506534	1299	g_28559	g_28560
Super-Scaffold_100010	27514206	27515433	1227	g_28560	g_28561
Super-Scaffold_100010	27525679	27527216	1537	g_28561	g_45238
Super-Scaffold_100010	27529813	27546808	16995	g_45238	g_28564
Super-Scaffold_100010	27547101	27555743	8642	g_28564	g_28565
Super-Scaffold_100010	27563781	27569616	5835	g_28565	g_28566
Super-Scaffold_100010	27580156	27591355	11199	g_28566	g_28568
Super-Scaffold_100010	27620644	27637528	16884	g_28568	g_28569
Super-Scaffold_100010	27640547	27641517	970	g_28569	g_28570
Super-Scaffold_100010	27642695	27644521	1826	g_28570	g_28571
Super-Scaffold_100010	27666393	27666890	497	g_28571	g_28572
Super-Scaffold_100010	27674489	27699856	25367	g_28572	g_28573
Super-Scaffold_100010	27700656	27706678	6022	g_28573	g_28574
Super-Scaffold_100010	27708084	27718008	9924	g_28574	g_28575
Super-Scaffold_100010	27718292	27722319	4027	g_28575	g_28576
Super-Scaffold_100010	27749729	27754425	4696	g_28576	g_28577
Super-Scaffold_100010	27754811	27765740	10929	g_28577	g_28578
Super-Scaffold_100010	27790408	27793249	2841	g_28578	g_28579
Super-Scaffold_100010	27806839	27808548	1709	g_28579	g_28580
Super-Scaffold_100010	27822646	27824657	2011	g_28580	g_28581
Super-Scaffold_100010	27858072	27942469	84397	g_28581	g_28582
Super-Scaffold_100010	27975922	28027434	51512	g_28582	g_28583
Super-Scaffold_100010	28037179	28056443	19264	g_28583	g_28584
Super-Scaffold_100010	28057240	28318915	261675	g_28584	g_28585
Super-Scaffold_100010	28326046	28337429	11383	g_28585	g_28586
Super-Scaffold_100010	28341183	28345206	4023	g_28586	g_45239
Super-Scaffold_100010	28349418	28393455	44037	g_45239	g_28587
Super-Scaffold_100010	28396836	28408614	11778	g_28587	g_28588
Super-Scaffold_100010	28418883	28420885	2002	g_28588	g_28589
Super-Scaffold_100010	28421172	28421250	78	g_28589	g_28590
Super-Scaffold_100010	28423517	28428754	5237	g_28590	g_28591
Super-Scaffold_100010	28433448	28438550	5102	g_28591	g_45240
Super-Scaffold_100010	28465859	28470706	4847	g_45240	g_28592
Super-Scaffold_100010	28484851	28525501	40650	g_28592	g_28593
Super-Scaffold_100010	28535358	28586268	50910	g_28593	g_28595
Super-Scaffold_100010	28591661	28592080	419	g_28595	g_28596
Super-Scaffold_100010	28598142	28604691	6549	g_28596	g_28597
Super-Scaffold_100010	28610064	28610483	419	g_28597	g_28598
Super-Scaffold_100010	28616547	28632277	15730	g_28598	g_28599
Super-Scaffold_100010	28642770	28660396	17626	g_28599	g_28600
Super-Scaffold_100010	28665521	28780207	114686	g_28600	g_41784
Super-Scaffold_100010	28780443	28809334	28891	g_41784	g_28602
Super-Scaffold_100010	28809942	28823338	13396	g_28602	g_41785
Super-Scaffold_100010	28824119	28831937	7818	g_41785	g_28603
Super-Scaffold_100010	28832671	28886747	54076	g_28603	g_28604
Super-Scaffold_100010	28887494	28891769	4275	g_28604	g_28605
Super-Scaffold_100010	28892511	28897176	4665	g_28605	g_28606
Super-Scaffold_100010	28897926	28904977	7051	g_28606	g_28609
Super-Scaffold_100010	28906767	28913723	6956	g_28609	g_45241
Super-Scaffold_100010	28917041	28922629	5588	g_45241	g_28610
Super-Scaffold_100010	28930119	28935001	4882	g_28610	g_28611
Super-Scaffold_100010	28960100	28969902	9802	g_28611	g_45242
Super-Scaffold_100010	28978950	28982323	3373	g_45242	g_28612
Super-Scaffold_100010	28986357	29133866	147509	g_28612	g_28613
Super-Scaffold_100010	29150615	29153747	3132	g_28613	g_28614
Super-Scaffold_100010	29158444	29194113	35669	g_28614	g_28616
Super-Scaffold_100010	29194382	29197838	3456	g_28616	g_28617
Super-Scaffold_100010	29198167	29199265	1098	g_28617	g_45243
Super-Scaffold_100010	29204303	29238910	34607	g_45243	g_28620
Super-Scaffold_100010	29252299	29256849	4550	g_28620	g_28621
Super-Scaffold_100010	29264175	29405207	141032	g_28621	g_28622
Super-Scaffold_100010	29408270	29410250	1980	g_28622	g_41789
Super-Scaffold_100010	29410537	29415363	4826	g_41789	g_28624
Super-Scaffold_100010	29415593	29442341	26748	g_28624	g_28625
Super-Scaffold_100010	29457239	29463742	6503	g_28625	g_28626
Super-Scaffold_100010	29467642	29473684	6042	g_28626	g_28627
Super-Scaffold_100010	29474007	29490553	16546	g_28627	g_28628
Super-Scaffold_100010	29500995	29512404	11409	g_28628	g_45244
Super-Scaffold_100010	29532029	29536962	4933	g_45244	g_28630
Super-Scaffold_100010	29548506	29568268	19762	g_28630	g_28631
Super-Scaffold_100010	29580751	29602670	21919	g_28631	g_28632
Super-Scaffold_100010	29618012	29632500	14488	g_28632	g_28633
Super-Scaffold_100010	29642079	29749937	107858	g_28633	g_28637
Super-Scaffold_100010	29750143	29773957	23814	g_28637	g_28638
Super-Scaffold_100010	29790968	29815747	24779	g_28638	g_28639
Super-Scaffold_100010	29823132	29823775	643	g_28639	g_28640
Super-Scaffold_100010	29827068	29831954	4886	g_28640	g_28641
Super-Scaffold_100010	29860516	29862587	2071	g_28641	g_28642
Super-Scaffold_100010	29942544	29955258	12714	g_28642	g_28643
Super-Scaffold_100010	29967617	29970381	2764	g_28643	g_28644
Super-Scaffold_100010	29984251	30016876	32625	g_28644	g_28646
Super-Scaffold_100010	30017226	30023106	5880	g_28646	g_28647
Super-Scaffold_100010	30042877	30044804	1927	g_28647	g_28648
Super-Scaffold_100010	30059000	30069993	10993	g_28648	g_28649
Super-Scaffold_100010	30070247	30070788	541	g_28649	g_28650
Super-Scaffold_100010	30071747	30138191	66444	g_28650	g_28651
Super-Scaffold_100010	30139926	30185390	45464	g_28651	g_28654
Super-Scaffold_100010	30196379	30207467	11088	g_28654	g_28655
Super-Scaffold_100010	30279832	30297158	17326	g_28655	g_28656
Super-Scaffold_100010	30297532	30323218	25686	g_28656	g_28657
Super-Scaffold_100010	30323424	30472430	149006	g_28657	g_28662
Super-Scaffold_100010	30502681	30602189	99508	g_28662	g_28667
Super-Scaffold_100010	30607335	30609406	2071	g_28667	g_28668
Super-Scaffold_100010	30620223	30720482	100259	g_28668	g_28669
Super-Scaffold_100010	30778013	30784120	6107	g_28669	g_28670
Super-Scaffold_100010	30808822	30831745	22923	g_28670	g_28673
Super-Scaffold_100010	30859123	30898085	38962	g_28673	g_28675
Super-Scaffold_100010	30909207	30913883	4676	g_28675	g_28676
Super-Scaffold_100010	30927939	30931076	3137	g_28676	g_28677
Super-Scaffold_100010	30936940	30939820	2880	g_28677	g_28678
Super-Scaffold_100010	30947035	31091040	144005	g_28678	g_28681
Super-Scaffold_100010	31119977	31204549	84572	g_28681	g_28683
Super-Scaffold_100010	31207005	31276410	69405	g_28683	g_28685
Super-Scaffold_100010	31276619	31308173	31554	g_28685	g_28686
Super-Scaffold_100010	31317430	31322105	4675	g_28686	g_28687
Super-Scaffold_100010	31332216	31344911	12695	g_28687	g_28688
Super-Scaffold_100010	31347517	31351736	4219	g_28688	g_28689
Super-Scaffold_100010	31358985	31379927	20942	g_28689	g_28690
Super-Scaffold_100010	31384920	31390585	5665	g_28690	g_28691
Super-Scaffold_100010	31413695	31420269	6574	g_28691	g_28692
Super-Scaffold_100010	31431014	31565349	134335	g_28692	g_28695
Super-Scaffold_100010	31576020	31586223	10203	g_28695	g_28697
Super-Scaffold_100010	31587200	31587578	378	g_28697	g_28698
Super-Scaffold_100010	31587895	31602589	14694	g_28698	g_28699
Super-Scaffold_100010	31603119	31616700	13581	g_28699	g_28701
Super-Scaffold_100010	31633312	31716387	83075	g_28701	g_28703
Super-Scaffold_100010	31727375	31749408	22033	g_28703	g_28704
Super-Scaffold_100010	31772429	31790287	17858	g_28704	g_28707
Super-Scaffold_100010	31790763	31796731	5968	g_28707	g_28709
Super-Scaffold_100010	31871290	31874916	3626	g_28709	g_28710
Super-Scaffold_100010	31971787	31983240	11453	g_28710	g_28711
Super-Scaffold_100010	31988209	31997481	9272	g_28711	g_28712
Super-Scaffold_100010	32000507	32007031	6524	g_28712	g_28713
Super-Scaffold_100010	32010070	32013746	3676	g_28713	g_45245
Super-Scaffold_100010	32016790	32029148	12358	g_45245	g_28714
Super-Scaffold_100010	32049656	32087546	37890	g_28714	g_28715
Super-Scaffold_100010	32091668	32095724	4056	g_28715	g_28716
Super-Scaffold_100010	32135027	32138509	3482	g_28716	g_28717
Super-Scaffold_100010	32155101	32164524	9423	g_28717	g_28718
Super-Scaffold_100010	32185901	32190917	5016	g_28718	g_28719
Super-Scaffold_100010	32191500	32371081	179581	g_45246	g_28722
Super-Scaffold_100010	32371431	32397047	25616	g_28722	g_28724
Super-Scaffold_100010	32397994	32466178	68184	g_28724	g_28726
Super-Scaffold_100010	32475799	32479051	3252	g_28726	g_28727
Super-Scaffold_100010	32485264	32487043	1779	g_28727	g_45247
Super-Scaffold_100010	32512473	32585507	73034	g_45247	g_28728
Super-Scaffold_100010	32594097	32605025	10928	g_28728	g_28729
Super-Scaffold_100010	32655040	32667025	11985	g_28729	g_28730
Super-Scaffold_100010	32692156	32723145	30989	g_28730	g_28733
Super-Scaffold_100010	32723354	32758210	34856	g_28733	g_41802
Super-Scaffold_100010	32758443	32820704	62261	g_41802	g_28737
Super-Scaffold_100010	32824113	32829885	5772	g_28737	g_28738
Super-Scaffold_100010	32832731	32905047	72316	g_28738	g_28740
Super-Scaffold_100010	32913244	32936616	23372	g_28740	g_28741
Super-Scaffold_100010	32937812	32942653	4841	g_28741	g_28742
Super-Scaffold_100010	32943816	32945425	1609	g_28742	g_28743
Super-Scaffold_100010	32958297	32983837	25540	g_28743	g_28745
Super-Scaffold_100010	32998151	33009034	10883	g_28745	g_45248
Super-Scaffold_100010	33019068	33020548	1480	g_45248	g_28746
Super-Scaffold_100010	33020748	33024420	3672	g_28746	g_45249
Super-Scaffold_100010	33045524	33055451	9927	g_45249	g_28747
Super-Scaffold_100010	33083523	33085789	2266	g_28747	g_45250
Super-Scaffold_100010	33086052	33089013	2961	g_45250	g_28748
Super-Scaffold_100010	33096692	33106694	10002	g_28748	g_28750
Super-Scaffold_100010	33106981	33107393	412	g_28750	g_28751
Super-Scaffold_100010	33107824	33143460	35636	g_28751	g_28753
Super-Scaffold_100010	33156135	33323090	166955	g_28753	g_28756
Super-Scaffold_100010	33323698	33323740	42	g_28756	g_28757
Super-Scaffold_100010	33324453	33331952	7499	g_28757	g_28758
Super-Scaffold_100010	33336949	33354470	17521	g_28758	g_41804
Super-Scaffold_100010	33355447	33393093	37646	g_41804	g_28760
Super-Scaffold_100010	33393671	33473443	79772	g_28760	g_28761
Super-Scaffold_100010	33475677	33478363	2686	g_28761	g_28762
Super-Scaffold_100010	33490811	33509052	18241	g_28762	g_28763
Super-Scaffold_100010	33509324	33535506	26182	g_28763	g_28764
Super-Scaffold_100010	33551489	33552236	747	g_28764	g_45251
Super-Scaffold_100010	33559852	33568954	9102	g_45251	g_45252
Super-Scaffold_100010	33574410	33631467	57057	g_45252	g_28766
Super-Scaffold_100010	33639927	33647334	7407	g_28766	g_28767
Super-Scaffold_100010	33647801	33648535	734	g_28767	g_28768
Super-Scaffold_100010	33660767	33683349	22582	g_28768	g_28769
Super-Scaffold_100010	33683582	33688695	5113	g_28769	g_28770
Super-Scaffold_100010	33689036	33689211	175	g_28770	g_28771
Super-Scaffold_100010	33690005	33743098	53093	g_28771	g_28772
Super-Scaffold_100010	33743553	33774356	30803	g_28772	g_28774
Super-Scaffold_100010	33775495	33793577	18082	g_28774	g_28775
Super-Scaffold_100010	33793834	33795141	1307	g_28775	g_28776
Super-Scaffold_100010	33824487	33868195	43708	g_28776	g_28779
Super-Scaffold_100010	33874751	33949461	74710	g_28779	g_28782
Super-Scaffold_100010	33954585	33977245	22660	g_28782	g_28785
Super-Scaffold_100010	34003011	34008115	5104	g_28785	g_28786
Super-Scaffold_100010	34041208	34047274	6066	g_28786	g_28787
Super-Scaffold_100010	34070945	34081994	11049	g_41809	g_28788
Super-Scaffold_100010	34091210	34095755	4545	g_28788	g_28789
Super-Scaffold_100010	34118614	34119706	1092	g_28790	g_28791
Super-Scaffold_100010	34139020	34147981	8961	g_28791	g_28792
Super-Scaffold_100010	34148925	34161838	12913	g_28792	g_28793
Super-Scaffold_100010	34162158	34189744	27586	g_28793	g_28795
Super-Scaffold_100010	34190028	34244386	54358	g_28795	g_28797
Super-Scaffold_100010	34245065	34245679	614	g_28797	g_28798
Super-Scaffold_100010	34246047	34280248	34201	g_28798	g_28799
Super-Scaffold_100010	34280505	34335963	55458	g_28799	g_28800
Super-Scaffold_100010	34336331	34336942	611	g_28800	g_28801
Super-Scaffold_100010	34337621	34378119	40498	g_28801	g_28803
Super-Scaffold_100010	34379288	34381350	2062	g_28803	g_28804
Super-Scaffold_100010	34383061	34385695	2634	g_28805	g_28806
Super-Scaffold_100010	34386270	34574858	188588	g_28806	g_28807
Super-Scaffold_100010	34575142	34575242	100	g_28807	g_28808
Super-Scaffold_100010	34576279	34602598	26319	g_28808	g_28810
Super-Scaffold_100010	34607099	34622756	15657	g_28811	g_28812
Super-Scaffold_100010	34634031	34640611	6580	g_28812	g_45253
Super-Scaffold_100010	34645447	34651490	6043	g_45253	g_45254
Super-Scaffold_100010	34652125	34673043	20918	g_45254	g_28814
Super-Scaffold_100010	34677321	34685906	8585	g_28814	g_28815
Super-Scaffold_100010	34726181	34733103	6922	g_28815	g_28816
Super-Scaffold_100010	34738495	34747583	9088	g_28816	g_28817
Super-Scaffold_100010	34747888	34787763	39875	g_28817	g_28821
Super-Scaffold_100010	34807389	34819669	12280	g_28821	g_45255
Super-Scaffold_100010	34832362	34848170	15808	g_45255	g_28823
Super-Scaffold_100010	34848445	34853066	4621	g_28823	g_28824
Super-Scaffold_100010	34853380	34853971	591	g_28824	g_28825
Super-Scaffold_100010	34934826	34971904	37078	g_28825	g_28826
Super-Scaffold_100010	34972377	34972429	52	g_28826	g_45256
Super-Scaffold_100010	34987523	35101786	114263	g_45256	g_41814
Super-Scaffold_100010	35102025	35114108	12083	g_41814	g_41815
Super-Scaffold_100010	35114329	35146478	32149	g_41815	g_28829
Super-Scaffold_100010	35146984	35169041	22057	g_28829	g_28830
Super-Scaffold_100010	35193492	35196154	2662	g_28830	g_45257
Super-Scaffold_100010	35198531	35217240	18709	g_41816	g_28832
Super-Scaffold_100010	35217590	35217845	255	g_28832	g_28833
Super-Scaffold_100010	35219440	35220492	1052	g_28833	g_28834
Super-Scaffold_100010	35221399	35222280	881	g_28834	g_45258
Super-Scaffold_100010	35222492	35224883	2391	g_45258	g_28835
Super-Scaffold_100010	35258938	35263390	4452	g_28835	g_41817
Super-Scaffold_100010	35264145	35280758	16613	g_41817	g_28836
Super-Scaffold_100010	35293135	35331387	38252	g_41818	g_28840
Super-Scaffold_100010	35332337	35338564	6227	g_28840	g_28841
Super-Scaffold_100010	35339514	35345036	5522	g_28841	g_28842
Super-Scaffold_100010	35345986	35372461	26475	g_28842	g_28843
Super-Scaffold_100010	35373411	35378986	5575	g_28843	g_28844
Super-Scaffold_100010	35379936	35384229	4293	g_28844	g_28845
Super-Scaffold_100010	35385179	35403379	18200	g_28845	g_28846
Super-Scaffold_100010	35404326	35409980	5654	g_28846	g_28847
Super-Scaffold_100010	35410930	35438927	27997	g_28847	g_28848
Super-Scaffold_100010	35439877	35478814	38937	g_28848	g_28851
Super-Scaffold_100010	35482752	35561783	79031	g_28851	g_45259
Super-Scaffold_100010	35562259	35569575	7316	g_45259	g_28853
Super-Scaffold_100010	35582417	35592931	10514	g_28853	g_28857
Super-Scaffold_100010	35599196	35666626	67430	g_28856	g_28859
Super-Scaffold_100010	35668035	35672778	4743	g_28859	g_28861
Super-Scaffold_100010	35697999	35706518	8519	g_28861	g_28862
Super-Scaffold_100010	35779221	35823965	44744	g_28862	g_28864
Super-Scaffold_100010	35832334	35834945	2611	g_28864	g_45260
Super-Scaffold_100010	35917330	36009027	91697	g_41823	g_28869
Super-Scaffold_100010	36031100	36052511	21411	g_28869	g_41825
Super-Scaffold_100010	36071433	36088313	16880	g_28871	g_28872
Super-Scaffold_100010	36088666	36159494	70828	g_28872	g_28875
Super-Scaffold_100010	36161140	36211041	49901	g_28875	g_28876
Super-Scaffold_100012	46543	218589	172046	g_7679	g_7681
Super-Scaffold_100012	218888	342582	123694	g_7681	g_7685
Super-Scaffold_100012	343190	379367	36177	g_7685	g_7687
Super-Scaffold_100012	379897	390281	10384	g_7687	g_7688
Super-Scaffold_100012	390550	418368	27818	g_7688	g_7690
Super-Scaffold_100012	420790	547947	127157	g_7690	g_7691
Super-Scaffold_100012	548225	594240	46015	g_7691	g_7692
Super-Scaffold_100012	596149	615896	19747	g_7692	g_7693
Super-Scaffold_100012	616561	644850	28289	g_7693	g_7694
Super-Scaffold_100012	645071	845237	200166	g_7694	g_7697
Super-Scaffold_100012	845599	898312	52713	g_7697	g_7699
Super-Scaffold_100012	898674	898786	112	g_7699	g_7700
Super-Scaffold_100012	899787	992811	93024	g_7700	g_7703
Super-Scaffold_100012	993152	1198821	205669	g_7703	g_7705
Super-Scaffold_100012	1199192	1201134	1942	g_7705	g_7706
Super-Scaffold_100012	1203214	1234399	31185	g_7706	g_7707
Super-Scaffold_100012	1243458	1250375	6917	g_7707	g_7709
Super-Scaffold_100012	1250623	1459657	209034	g_7709	g_7711
Super-Scaffold_100012	1459884	1482335	22451	g_7711	g_7712
Super-Scaffold_100012	1487068	1660071	173003	g_7712	g_7715
Super-Scaffold_100012	1678797	1699443	20646	g_7715	g_7717
Super-Scaffold_100012	1699736	1708247	8511	g_7717	g_7716
Super-Scaffold_100012	1725437	1763414	37977	g_7716	g_7719
Super-Scaffold_100012	1764493	1764521	28	g_7719	g_7720
Super-Scaffold_100012	1764886	1765210	324	g_7720	g_7721
Super-Scaffold_100012	1767180	1832101	64921	g_7721	g_7725
Super-Scaffold_100012	1851002	1856736	5734	g_7725	g_7726
Super-Scaffold_100012	1857092	1858679	1587	g_7726	g_7727
Super-Scaffold_100012	1859257	1861413	2156	g_7727	g_7728
Super-Scaffold_100012	1862924	1864887	1963	g_7728	g_7729
Super-Scaffold_100012	1865498	1943541	78043	g_7729	g_41255
Super-Scaffold_100012	1944233	1983715	39482	g_41255	g_7732
Super-Scaffold_100012	1984662	1997996	13334	g_7732	g_7733
Super-Scaffold_100012	1998676	2017456	18780	g_7733	g_7735
Super-Scaffold_100012	2017776	2043181	25405	g_7735	g_7736
Super-Scaffold_100012	2064863	2073151	8288	g_7736	g_7737
Super-Scaffold_100012	2093009	2099426	6417	g_7737	g_7738
Super-Scaffold_100012	2108907	2112327	3420	g_7738	g_7739
Super-Scaffold_100012	2114709	2116184	1475	g_7739	g_7740
Super-Scaffold_100012	2135944	2137379	1435	g_7740	g_7741
Super-Scaffold_100012	2143825	2211631	67806	g_41257	g_7743
Super-Scaffold_100012	2222603	2243767	21164	g_7743	g_7744
Super-Scaffold_100012	2263127	2273371	10244	g_41258	g_43437
Super-Scaffold_100012	2289283	2294140	4857	g_43437	g_7745
Super-Scaffold_100012	2299201	2367503	68302	g_7745	g_7749
Super-Scaffold_100012	2372149	2377333	5184	g_7749	g_7750
Super-Scaffold_100012	2377728	2386789	9061	g_7750	g_7751
Super-Scaffold_100012	2412646	2429063	16417	g_7751	g_7752
Super-Scaffold_100012	2437288	2438144	856	g_7752	g_7753
Super-Scaffold_100012	2445242	2507563	62321	g_7753	g_7757
Super-Scaffold_100012	2523275	2527774	4499	g_7757	g_7758
Super-Scaffold_100012	2532895	2621910	89015	g_41261	g_7760
Super-Scaffold_100012	2624105	2629112	5007	g_7760	g_43438
Super-Scaffold_100012	2630115	2658967	28852	g_43438	g_7761
Super-Scaffold_100012	2659933	2670098	10165	g_7761	g_7762
Super-Scaffold_100012	2676632	2678821	2189	g_7762	g_7763
Super-Scaffold_100012	2688891	2694807	5916	g_7763	g_7764
Super-Scaffold_100012	2702766	2703191	425	g_7764	g_7765
Super-Scaffold_100012	2721397	2734082	12685	g_7765	g_43439
Super-Scaffold_100012	2737619	2741651	4032	g_43439	g_7766
Super-Scaffold_100012	2748667	2787806	39139	g_7766	g_41263
Super-Scaffold_100012	2789284	2812105	22821	g_41263	g_7768
Super-Scaffold_100012	2814143	2825801	11658	g_7768	g_7770
Super-Scaffold_100012	2826153	2845097	18944	g_7770	g_7771
Super-Scaffold_100012	2851064	2884371	33307	g_7771	g_7772
Super-Scaffold_100012	2884871	2927925	43054	g_7772	g_7773
Super-Scaffold_100012	2928728	2939251	10523	g_7773	g_7774
Super-Scaffold_100012	2940678	2941103	425	g_7774	g_7775
Super-Scaffold_100012	2942965	2943006	41	g_7775	g_7776
Super-Scaffold_100012	2943854	2969800	25946	g_7776	g_7779
Super-Scaffold_100012	2970994	2992026	21032	g_7779	g_7781
Super-Scaffold_100012	2992478	3034637	42159	g_7781	g_7782
Super-Scaffold_100012	3035059	3056290	21231	g_7782	g_7783
Super-Scaffold_100012	3091939	3093190	1251	g_7783	g_7784
Super-Scaffold_100012	3093966	3097770	3804	g_7784	g_7785
Super-Scaffold_100012	3123875	3132618	8743	g_7785	g_7786
Super-Scaffold_100012	3140584	3141764	1180	g_7786	g_7787
Super-Scaffold_100012	3142210	3195692	53482	g_7787	g_7789
Super-Scaffold_100012	3205221	3206229	1008	g_7789	g_7790
Super-Scaffold_100012	3217464	3258636	41172	g_7790	g_7791
Super-Scaffold_100012	3266693	3284928	18235	g_7791	g_7793
Super-Scaffold_100012	3286713	3340937	54224	g_7794	g_7795
Super-Scaffold_100012	3343518	3426669	83151	g_7795	g_7796
Super-Scaffold_100012	3427106	3430767	3661	g_7796	g_7797
Super-Scaffold_100012	3447934	3490603	42669	g_7797	g_41266
Super-Scaffold_100012	3491103	3520325	29222	g_41266	g_7800
Super-Scaffold_100012	3535303	3549422	14119	g_7800	g_7801
Super-Scaffold_100012	3549655	3577389	27734	g_7801	g_7803
Super-Scaffold_100012	3633224	3636692	3468	g_7803	g_7804
Super-Scaffold_100012	3646013	3680550	34537	g_7804	g_7806
Super-Scaffold_100012	3687359	3701413	14054	g_7806	g_7807
Super-Scaffold_100012	3709626	3711276	1650	g_7807	g_7808
Super-Scaffold_100012	3711524	3785918	74394	g_7808	g_7810
Super-Scaffold_100012	3789306	3797183	7877	g_7810	g_7811
Super-Scaffold_100012	3797551	3830334	32783	g_7811	g_7813
Super-Scaffold_100012	3830597	3838275	7678	g_7813	g_7814
Super-Scaffold_100012	3839204	3892956	53752	g_7814	g_7816
Super-Scaffold_100012	3894772	3901005	6233	g_7816	g_7818
Super-Scaffold_100012	3907716	3965400	57684	g_7818	g_7821
Super-Scaffold_100012	4008969	4043892	34923	g_7821	g_7823
Super-Scaffold_100012	4061670	4125518	63848	g_7823	g_7824
Super-Scaffold_100012	4132588	4141781	9193	g_7824	g_7825
Super-Scaffold_100012	4148492	4158151	9659	g_7825	g_7826
Super-Scaffold_100012	4162981	4167429	4448	g_7826	g_43440
Super-Scaffold_100012	4176537	4196333	19796	g_43440	g_7827
Super-Scaffold_100012	4204561	4351996	147435	g_7827	g_7833
Super-Scaffold_100012	4363158	4411845	48687	g_7833	g_7834
Super-Scaffold_100012	4414127	4418927	4800	g_7834	g_7835
Super-Scaffold_100012	4419226	4467308	48082	g_7835	g_7837
Super-Scaffold_100012	4482695	4498409	15714	g_7837	g_7838
Super-Scaffold_100012	4505076	4517463	12387	g_7838	g_7839
Super-Scaffold_100012	4523488	4530705	7217	g_7839	g_7841
Super-Scaffold_100012	4531188	4595764	64576	g_7841	g_7842
Super-Scaffold_100012	4596390	4596483	93	g_7842	g_7843
Super-Scaffold_100012	4597749	4604000	6251	g_7843	g_7844
Super-Scaffold_100012	4604314	4627801	23487	g_7844	g_7845
Super-Scaffold_100012	4633163	4682306	49143	g_7845	g_7846
Super-Scaffold_100012	4683448	4705111	21663	g_7846	g_7848
Super-Scaffold_100012	4707031	4726052	19021	g_7848	g_7850
Super-Scaffold_100012	4726537	4728054	1517	g_7850	g_7852
Super-Scaffold_100012	4729484	4755717	26233	g_7852	g_7853
Super-Scaffold_100012	4755929	4781817	25888	g_7853	g_7855
Super-Scaffold_100012	4782476	4807362	24886	g_7855	g_7856
Super-Scaffold_100012	4813198	4831956	18758	g_7856	g_41279
Super-Scaffold_100012	4832189	4843480	11291	g_41279	g_7858
Super-Scaffold_100012	4846369	4851866	5497	g_7858	g_7859
Super-Scaffold_100012	4854145	4873303	19158	g_7859	g_7860
Super-Scaffold_100012	4875574	4886646	11072	g_7860	g_7862
Super-Scaffold_100012	4886879	4888081	1202	g_7862	g_7863
Super-Scaffold_100012	4888428	4912288	23860	g_7863	g_7865
Super-Scaffold_100012	4919134	4928226	9092	g_7865	g_7866
Super-Scaffold_100012	4930858	4960404	29546	g_7866	g_7867
Super-Scaffold_100012	4963193	4974955	11762	g_7867	g_7868
Super-Scaffold_100012	4975608	4977224	1616	g_7868	g_7869
Super-Scaffold_100012	4977622	5167314	189692	g_7869	g_7873
Super-Scaffold_100012	5167643	5173642	5999	g_7873	g_7874
Super-Scaffold_100012	5176610	5184142	7532	g_7874	g_7875
Super-Scaffold_100012	5199817	5206287	6470	g_7875	g_7876
Super-Scaffold_100012	5212725	5224955	12230	g_7876	g_7878
Super-Scaffold_100012	5234532	5247923	13391	g_7878	g_7879
Super-Scaffold_100012	5248357	5312686	64329	g_7879	g_7880
Super-Scaffold_100012	5313036	5403499	90463	g_7880	g_7883
Super-Scaffold_100012	5416676	5420259	3583	g_7883	g_7884
Super-Scaffold_100012	5442931	5469693	26762	g_7884	g_7885
Super-Scaffold_100012	5475190	5492991	17801	g_7885	g_7886
Super-Scaffold_100012	5506824	5511668	4844	g_7886	g_7887
Super-Scaffold_100012	5522041	5528260	6219	g_7887	g_7888
Super-Scaffold_100012	5537228	5537283	55	g_7889	g_7890
Super-Scaffold_100012	5538797	5580268	41471	g_7890	g_7893
Super-Scaffold_100012	5580513	5587912	7399	g_7893	g_7894
Super-Scaffold_100012	5591911	5596501	4590	g_7894	g_7895
Super-Scaffold_100012	5608043	5626919	18876	g_7895	g_7896
Super-Scaffold_100012	5629446	5634995	5549	g_7896	g_7897
Super-Scaffold_100012	5651809	5655164	3355	g_7897	g_7898
Super-Scaffold_100012	5661944	5690181	28237	g_7898	g_7899
Super-Scaffold_100012	5701612	5710610	8998	g_7899	g_7900
Super-Scaffold_100012	5715615	5804645	89030	g_7900	g_7902
Super-Scaffold_100012	5807165	5807597	432	g_7902	g_7903
Super-Scaffold_100012	5807953	5811780	3827	g_7903	g_7905
Super-Scaffold_100012	5814702	5815525	823	g_7905	g_7906
Super-Scaffold_100012	5817855	5843938	26083	g_7906	g_7908
Super-Scaffold_100012	5853072	5871771	18699	g_7908	g_7909
Super-Scaffold_100012	5880895	5908391	27496	g_7909	g_7910
Super-Scaffold_100012	5935414	5965589	30175	g_7910	g_7911
Super-Scaffold_100012	5966062	6063153	97091	g_7911	g_7913
Super-Scaffold_100012	6072360	6149013	76653	g_7913	g_7914
Super-Scaffold_100012	6152800	6156549	3749	g_7914	g_7915
Super-Scaffold_100012	6170592	6178081	7489	g_7915	g_7916
Super-Scaffold_100012	6187891	6193807	5916	g_7916	g_7917
Super-Scaffold_100012	6195987	6200293	4306	g_7917	g_7918
Super-Scaffold_100012	6202531	6218656	16125	g_7918	g_43441
Super-Scaffold_100012	6233858	6238049	4191	g_43441	g_43442
Super-Scaffold_100012	6238927	6267166	28239	g_43442	g_7919
Super-Scaffold_100012	6295644	6298553	2909	g_7919	g_7920
Super-Scaffold_100012	6310934	6317323	6389	g_7920	g_7921
Super-Scaffold_100012	6330285	6345847	15562	g_7921	g_7922
Super-Scaffold_100012	6347526	6349717	2191	g_7922	g_43443
Super-Scaffold_100012	6365285	6430005	64720	g_43443	g_7925
Super-Scaffold_100012	6430403	6449433	19030	g_7925	g_43444
Super-Scaffold_100012	6457226	6465729	8503	g_43444	g_7926
Super-Scaffold_100012	6466013	6467842	1829	g_7926	g_7927
Super-Scaffold_100012	6478781	6485868	7087	g_7927	g_7928
Super-Scaffold_100012	6486149	6496261	10112	g_7928	g_7929
Super-Scaffold_100012	6502319	6551229	48910	g_7929	g_7930
Super-Scaffold_100012	6558875	6561509	2634	g_7930	g_7931
Super-Scaffold_100012	6562741	6619644	56903	g_7931	g_7932
Super-Scaffold_100012	6623257	6664716	41459	g_7932	g_7933
Super-Scaffold_100012	6671288	6681726	10438	g_7934	g_7935
Super-Scaffold_100012	6682490	6699522	17032	g_7935	g_7936
Super-Scaffold_100012	6704315	6707508	3193	g_7936	g_7937
Super-Scaffold_100012	6710463	6714483	4020	g_7937	g_7938
Super-Scaffold_100012	6716841	6745528	28687	g_7938	g_7939
Super-Scaffold_100012	6745734	6778081	32347	g_7939	g_7940
Super-Scaffold_100012	6784307	6807812	23505	g_7940	g_7941
Super-Scaffold_100012	6808516	6810384	1868	g_7941	g_7942
Super-Scaffold_100012	6811728	6821201	9473	g_7942	g_7943
Super-Scaffold_100012	6839417	6848232	8815	g_7943	g_7944
Super-Scaffold_100012	6851605	6865792	14187	g_7944	g_7945
Super-Scaffold_100012	6882603	6898053	15450	g_7945	g_43445
Super-Scaffold_100012	6899362	6914811	15449	g_43445	g_7946
Super-Scaffold_100012	6923513	6954502	30989	g_7946	g_7948
Super-Scaffold_100012	6969255	6978768	9513	g_7948	g_7949
Super-Scaffold_100012	7023780	7050194	26414	g_7949	g_7950
Super-Scaffold_100012	7051330	7063673	12343	g_7950	g_7952
Super-Scaffold_100012	7070236	7106112	35876	g_7952	g_7954
Super-Scaffold_100012	7120995	7131232	10237	g_7954	g_7955
Super-Scaffold_100012	7132060	7147245	15185	g_7955	g_7956
Super-Scaffold_100012	7148237	7189307	41070	g_7956	g_7958
Super-Scaffold_100012	7193200	7199092	5892	g_7958	g_7959
Super-Scaffold_100012	7209441	7259734	50293	g_7959	g_7960
Super-Scaffold_100012	7265761	7295768	30007	g_7960	g_7961
Super-Scaffold_100012	7296622	7329090	32468	g_7961	g_7962
Super-Scaffold_100012	7329386	7330759	1373	g_7962	g_7963
Super-Scaffold_100012	7331084	7336849	5765	g_7963	g_7964
Super-Scaffold_100012	7341539	7374603	33064	g_7964	g_7965
Super-Scaffold_100012	7390914	7407932	17018	g_7965	g_7967
Super-Scaffold_100012	7414507	7424444	9937	g_7967	g_7969
Super-Scaffold_100012	7448794	7454402	5608	g_7969	g_7970
Super-Scaffold_100012	7454653	7454736	83	g_7970	g_7971
Super-Scaffold_100012	7465118	7468430	3312	g_7971	g_7972
Super-Scaffold_100012	7477152	7488098	10946	g_7972	g_7973
Super-Scaffold_100012	7498206	7507714	9508	g_7973	g_7974
Super-Scaffold_100012	7517998	7522597	4599	g_7974	g_43446
Super-Scaffold_100012	7531494	7536815	5321	g_43446	g_7975
Super-Scaffold_100012	7556459	7564245	7786	g_7975	g_7976
Super-Scaffold_100012	7566164	7583862	17698	g_7976	g_7977
Super-Scaffold_100012	7591089	7595610	4521	g_7977	g_7978
Super-Scaffold_100012	7602911	7617889	14978	g_7978	g_43447
Super-Scaffold_100012	7632403	7644113	11710	g_43447	g_7979
Super-Scaffold_100012	7651435	7669949	18514	g_7979	g_7980
Super-Scaffold_100012	7672734	7680616	7882	g_7980	g_7981
Super-Scaffold_100012	7691932	7697661	5729	g_7981	g_7982
Super-Scaffold_100012	7718816	7724109	5293	g_7982	g_7983
Super-Scaffold_100012	7733220	7739171	5951	g_7983	g_43448
Super-Scaffold_100012	7740691	7745646	4955	g_43448	g_7984
Super-Scaffold_100012	7747022	7751695	4673	g_7984	g_7985
Super-Scaffold_100012	7753764	7756781	3017	g_7985	g_7986
Super-Scaffold_100012	7772819	7781665	8846	g_7986	g_7987
Super-Scaffold_100012	7804482	7806490	2008	g_7987	g_7988
Super-Scaffold_100012	7809790	7812150	2360	g_7988	g_7989
Super-Scaffold_100012	7820136	7823451	3315	g_7989	g_7990
Super-Scaffold_100012	7835695	7840827	5132	g_7990	g_7991
Super-Scaffold_100012	7850042	7853269	3227	g_7991	g_7992
Super-Scaffold_100012	7867299	7922729	55430	g_7992	g_7995
Super-Scaffold_100012	7925205	7932012	6807	g_7995	g_7996
Super-Scaffold_100012	7944334	7948073	3739	g_7996	g_7997
Super-Scaffold_100012	7959971	7967934	7963	g_7997	g_7998
Super-Scaffold_100012	7972319	7984256	11937	g_7998	g_7999
Super-Scaffold_100012	7995211	7996048	837	g_7999	g_8000
Super-Scaffold_100012	8001035	8002580	1545	g_8000	g_8001
Super-Scaffold_100012	8004235	8004281	46	g_8001	g_8002
Super-Scaffold_100012	8013691	8019568	5877	g_8002	g_8003
Super-Scaffold_100012	8019948	8020859	911	g_8003	g_8004
Super-Scaffold_100012	8029372	8062540	33168	g_8004	g_8005
Super-Scaffold_100012	8062806	8091748	28942	g_8005	g_8006
Super-Scaffold_100012	8092047	8098800	6753	g_8006	g_8007
Super-Scaffold_100012	8099555	8145409	45854	g_8007	g_8008
Super-Scaffold_100012	8146461	8262405	115944	g_8008	g_41299
Super-Scaffold_100012	8262626	8271214	8588	g_41299	g_8011
Super-Scaffold_100012	8271522	8313431	41909	g_8011	g_8012
Super-Scaffold_100012	8313940	8321429	7489	g_8012	g_8013
Super-Scaffold_100012	8331019	8337082	6063	g_8013	g_43449
Super-Scaffold_100012	8350011	8471912	121901	g_43449	g_8021
Super-Scaffold_100012	8472154	8535088	62934	g_8021	g_8023
Super-Scaffold_100012	8535309	8572710	37401	g_8023	g_8025
Super-Scaffold_100012	8572919	8586240	13321	g_8025	g_41308
Super-Scaffold_100012	8586455	8604512	18057	g_41308	g_8027
Super-Scaffold_100012	8604736	8616029	11293	g_8027	g_8028
Super-Scaffold_100012	8616340	8720143	103803	g_8028	g_8030
Super-Scaffold_100012	8720361	8798737	78376	g_8030	g_8033
Super-Scaffold_100012	8803279	8805632	2353	g_8033	g_43450
Super-Scaffold_100012	8809972	8832457	22485	g_43450	g_8034
Super-Scaffold_100012	8833125	8838971	5846	g_8034	g_8035
Super-Scaffold_100012	8839267	8846145	6878	g_8035	g_8037
Super-Scaffold_100012	8846495	8873817	27322	g_8037	g_8038
Super-Scaffold_100012	8880149	8884313	4164	g_8038	g_8039
Super-Scaffold_100012	8884714	8895602	10888	g_8039	g_8040
Super-Scaffold_100012	8895823	8913539	17716	g_8040	g_8042
Super-Scaffold_100012	8913841	8927133	13292	g_8042	g_8043
Super-Scaffold_100012	8931553	8953570	22017	g_8043	g_8044
Super-Scaffold_100012	8964333	9033677	69344	g_8044	g_41313
Super-Scaffold_100012	9033892	9036713	2821	g_41313	g_8046
Super-Scaffold_100012	9056653	9063968	7315	g_8046	g_8048
Super-Scaffold_100012	9064468	9066947	2479	g_8048	g_8049
Super-Scaffold_100012	9067357	9114332	46975	g_8049	g_8050
Super-Scaffold_100012	9124538	9178986	54448	g_8050	g_8051
Super-Scaffold_100012	9190601	9393656	203055	g_8051	g_8052
Super-Scaffold_100012	9414317	9431261	16944	g_8052	g_8053
Super-Scaffold_100012	9443358	9444817	1459	g_8053	g_8054
Super-Scaffold_100012	9465362	9466936	1574	g_8054	g_8055
Super-Scaffold_100012	9468832	9469688	856	g_8055	g_43451
Super-Scaffold_100012	9473507	9480983	7476	g_43451	g_8056
Super-Scaffold_100012	9499809	9505391	5582	g_8056	g_8057
Super-Scaffold_100012	9528710	9531683	2973	g_8057	g_8058
Super-Scaffold_100012	9537559	9539716	2157	g_8058	g_43452
Super-Scaffold_100012	9553285	9599157	45872	g_43452	g_8062
Super-Scaffold_100012	9620657	9625909	5252	g_8062	g_8063
Super-Scaffold_100012	9627145	9636179	9034	g_8063	g_8064
Super-Scaffold_100012	9641504	9643650	2146	g_8064	g_8065
Super-Scaffold_100012	9646762	9648867	2105	g_8065	g_43453
Super-Scaffold_100012	9653560	9656040	2480	g_43453	g_8066
Super-Scaffold_100012	9667575	9671446	3871	g_8066	g_8067
Super-Scaffold_100012	9701923	9704518	2595	g_8067	g_8068
Super-Scaffold_100012	9709017	9719135	10118	g_8068	g_8069
Super-Scaffold_100012	9724453	9735258	10805	g_8069	g_8070
Super-Scaffold_100012	9735470	9761011	25541	g_8070	g_8073
Super-Scaffold_100012	9762457	9768034	5577	g_8072	g_43454
Super-Scaffold_100012	9782280	9785863	3583	g_43454	g_8074
Super-Scaffold_100012	9814195	9818874	4679	g_8074	g_8075
Super-Scaffold_100012	9819338	9835353	16015	g_8075	g_8076
Super-Scaffold_100012	9835736	9858839	23103	g_8076	g_8077
Super-Scaffold_100012	9881205	9912224	31019	g_8077	g_8078
Super-Scaffold_100012	9914170	9946341	32171	g_8078	g_8079
Super-Scaffold_100012	9951832	9956481	4649	g_8079	g_8080
Super-Scaffold_100012	9977428	9980001	2573	g_8080	g_8081
Super-Scaffold_100012	9997867	9998346	479	g_8081	g_8082
Super-Scaffold_100012	10005404	10005675	271	g_8082	g_8083
Super-Scaffold_100012	10011436	10014408	2972	g_8083	g_8084
Super-Scaffold_100012	10029989	10034709	4720	g_8084	g_8085
Super-Scaffold_100012	10052649	10083967	31318	g_8085	g_8088
Super-Scaffold_100012	10084377	10084384	7	g_8088	g_8089
Super-Scaffold_100012	10084662	10085244	582	g_8089	g_8090
Super-Scaffold_100012	10085831	10090483	4652	g_8090	g_8091
Super-Scaffold_100012	10090965	10117945	26980	g_8091	g_8092
Super-Scaffold_100012	10118151	10118960	809	g_8092	g_43455
Super-Scaffold_100012	10120209	10153487	33278	g_43455	g_8094
Super-Scaffold_100012	10153687	10155229	1542	g_8094	g_8095
Super-Scaffold_100012	10155732	10170097	14365	g_8095	g_8096
Super-Scaffold_100012	10171544	10216277	44733	g_41320	g_8098
Super-Scaffold_100012	10222735	10225057	2322	g_8098	g_8099
Super-Scaffold_100012	10229878	10245199	15321	g_8099	g_8100
Super-Scaffold_100012	10255327	10259464	4137	g_8100	g_8101
Super-Scaffold_100012	10272503	10277816	5313	g_8101	g_8102
Super-Scaffold_100012	10286597	10351917	65320	g_8102	g_8103
Super-Scaffold_100012	10352357	10352464	107	g_8103	g_43456
Super-Scaffold_100012	10353324	10363350	10026	g_43456	g_8104
Super-Scaffold_100012	10369526	10377261	7735	g_8104	g_8105
Super-Scaffold_100012	10380491	10383905	3414	g_8105	g_8106
Super-Scaffold_100012	10386293	10392951	6658	g_8106	g_43457
Super-Scaffold_100012	10394935	10397278	2343	g_43457	g_8107
Super-Scaffold_100012	10414329	10445887	31558	g_8107	g_8109
Super-Scaffold_100012	10467568	10494918	27350	g_8109	g_8110
Super-Scaffold_100012	10496651	10498597	1946	g_8110	g_43458
Super-Scaffold_100012	10512306	10517658	5352	g_43458	g_8111
Super-Scaffold_100012	10528221	10532600	4379	g_8111	g_8112
Super-Scaffold_100012	10533691	10555272	21581	g_8112	g_8115
Super-Scaffold_100012	10556273	10617140	60867	g_8115	g_8117
Super-Scaffold_100012	10642422	10642640	218	g_8117	g_8118
Super-Scaffold_100012	10642930	10662953	20023	g_8118	g_8119
Super-Scaffold_100012	10674620	10734449	59829	g_8119	g_8120
Super-Scaffold_100012	10735060	10752638	17578	g_8120	g_8121
Super-Scaffold_100012	10753150	10860575	107425	g_8121	g_8123
Super-Scaffold_100012	10861174	11113153	251979	g_8123	g_8128
Super-Scaffold_100012	11119113	11122947	3834	g_8128	g_8129
Super-Scaffold_100012	11132995	11136263	3268	g_8129	g_8130
Super-Scaffold_100012	11140518	11141434	916	g_8130	g_8131
Super-Scaffold_100012	11142690	11144652	1962	g_8131	g_8132
Super-Scaffold_100012	11158482	11164258	5776	g_8132	g_8133
Super-Scaffold_100012	11168038	11195050	27012	g_8133	g_8134
Super-Scaffold_100012	11215004	11231098	16094	g_8134	g_8135
Super-Scaffold_100012	11237237	11258414	21177	g_8135	g_8136
Super-Scaffold_100012	11261196	11261576	380	g_8136	g_43459
Super-Scaffold_100012	11263611	11271403	7792	g_43459	g_43460
Super-Scaffold_100012	11274142	11285492	11350	g_43460	g_8137
Super-Scaffold_100012	11288281	11372879	84598	g_8137	g_8139
Super-Scaffold_100012	11382954	11385984	3030	g_8139	g_8140
Super-Scaffold_100012	11387798	11395704	7906	g_8140	g_8141
Super-Scaffold_100012	11418499	11432708	14209	g_8141	g_8142
Super-Scaffold_100012	11433199	11438915	5716	g_8142	g_8143
Super-Scaffold_100012	11457801	11459529	1728	g_8143	g_43461
Super-Scaffold_100012	11461023	11513327	52304	g_43461	g_41331
Super-Scaffold_100012	11513707	11570159	56452	g_41331	g_8145
Super-Scaffold_100012	11570461	11593088	22627	g_8145	g_8146
Super-Scaffold_100012	11595457	11675326	79869	g_8146	g_8147
Super-Scaffold_100012	11676666	11677520	854	g_8147	g_8148
Super-Scaffold_100012	11681184	11682688	1504	g_8148	g_8149
Super-Scaffold_100012	11691286	11693329	2043	g_8149	g_8150
Super-Scaffold_100012	11719045	11730593	11548	g_8150	g_8152
Super-Scaffold_100012	11736578	11775103	38525	g_8152	g_8156
Super-Scaffold_100012	11777247	11778003	756	g_8156	g_8157
Super-Scaffold_100012	11782570	11785549	2979	g_8157	g_8158
Super-Scaffold_100012	11796297	11824264	27967	g_8158	g_8159
Super-Scaffold_100012	11830428	11832894	2466	g_8159	g_8160
Super-Scaffold_100012	11836524	11849250	12726	g_8160	g_8161
Super-Scaffold_100012	11853863	11859775	5912	g_8161	g_8162
Super-Scaffold_100012	11860641	11894166	33525	g_8162	g_41336
Super-Scaffold_100012	11894366	11985619	91253	g_41336	g_8166
Super-Scaffold_100012	11986131	11991078	4947	g_8166	g_8168
Super-Scaffold_100012	12003713	12005043	1330	g_8168	g_8169
Super-Scaffold_100012	12009958	12012316	2358	g_8169	g_8170
Super-Scaffold_100012	12017952	12019889	1937	g_8170	g_43462
Super-Scaffold_100012	12026325	12028026	1701	g_43462	g_8171
Super-Scaffold_100012	12035988	12065599	29611	g_8171	g_8173
Super-Scaffold_100012	12065916	12081398	15482	g_8173	g_8174
Super-Scaffold_100012	12096325	12100870	4545	g_8174	g_8175
Super-Scaffold_100012	12111585	12117315	5730	g_8175	g_8176
Super-Scaffold_100012	12120789	12132710	11921	g_8176	g_8177
Super-Scaffold_100012	12133374	12135020	1646	g_8177	g_43463
Super-Scaffold_100012	12136485	12181971	45486	g_43463	g_8179
Super-Scaffold_100012	12194522	12279079	84557	g_8179	g_8182
Super-Scaffold_100012	12281627	12283188	1561	g_8182	g_8183
Super-Scaffold_100012	12287149	12305489	18340	g_8183	g_8184
Super-Scaffold_100012	12307126	12317979	10853	g_8184	g_8185
Super-Scaffold_100012	12330364	12334062	3698	g_8185	g_8186
Super-Scaffold_100012	12336791	12344515	7724	g_8186	g_8187
Super-Scaffold_100012	12346920	12378773	31853	g_8187	g_8189
Super-Scaffold_100012	12388378	12399872	11494	g_8189	g_8190
Super-Scaffold_100012	12414372	12418248	3876	g_8190	g_8191
Super-Scaffold_100012	12434177	12439900	5723	g_8191	g_8192
Super-Scaffold_100012	12455173	12504967	49794	g_8192	g_8193
Super-Scaffold_100012	12527607	12598555	70948	g_8193	g_8196
Super-Scaffold_100012	12599917	12602425	2508	g_8196	g_43464
Super-Scaffold_100012	12623433	12631286	7853	g_43464	g_43465
Super-Scaffold_100012	12635795	12638416	2621	g_43465	g_43466
Super-Scaffold_100012	12646650	12650116	3466	g_43466	g_8197
Super-Scaffold_100012	12654740	12776191	121451	g_8197	g_8201
Super-Scaffold_100012	12799709	12807324	7615	g_8201	g_8202
Super-Scaffold_100012	12808802	12809339	537	g_8202	g_8203
Super-Scaffold_100012	12815563	12817101	1538	g_8203	g_8204
Super-Scaffold_100012	12820675	12823445	2770	g_8204	g_8205
Super-Scaffold_100012	12826191	12831503	5312	g_8205	g_8206
Super-Scaffold_100012	12848435	12850821	2386	g_8206	g_43467
Super-Scaffold_100012	12853464	12859013	5549	g_43467	g_8207
Super-Scaffold_100012	12861468	12862982	1514	g_8207	g_8208
Super-Scaffold_100012	12868712	12871080	2368	g_8208	g_8209
Super-Scaffold_100012	12875781	12878584	2803	g_8209	g_8210
Super-Scaffold_100012	12898290	12898414	124	g_41343	g_8211
Super-Scaffold_100012	12898638	12901894	3256	g_8211	g_8212
Super-Scaffold_100012	12904448	12922716	18268	g_8212	g_8213
Super-Scaffold_100012	12944897	12951294	6397	g_8213	g_8214
Super-Scaffold_100012	12965918	12969105	3187	g_8214	g_8215
Super-Scaffold_100012	12985705	13011839	26134	g_8215	g_8218
Super-Scaffold_100012	13012933	13025574	12641	g_8218	g_8219
Super-Scaffold_100012	13042385	13047663	5278	g_8219	g_43468
Super-Scaffold_100012	13054641	13057243	2602	g_43468	g_8220
Super-Scaffold_100012	13059538	13063116	3578	g_8220	g_8221
Super-Scaffold_100012	13063885	13083822	19937	g_8221	g_8223
Super-Scaffold_100012	13084157	13090719	6562	g_8223	g_8225
Super-Scaffold_100012	13100591	13102979	2388	g_8225	g_8226
Super-Scaffold_100012	13106513	13108966	2453	g_8226	g_43469
Super-Scaffold_100012	13117492	13249544	132052	g_43469	g_8230
Super-Scaffold_100012	13249903	13254747	4844	g_8230	g_8231
Super-Scaffold_100012	13258967	13262247	3280	g_8231	g_8232
Super-Scaffold_100012	13266289	13273098	6809	g_8232	g_43470
Super-Scaffold_100012	13281026	13285479	4453	g_43470	g_8233
Super-Scaffold_100012	13287499	13292435	4936	g_8233	g_8234
Super-Scaffold_100012	13306366	13308270	1904	g_8234	g_8235
Super-Scaffold_100012	13308662	13353814	45152	g_8235	g_8236
Super-Scaffold_100012	13355265	13360325	5060	g_8236	g_8237
Super-Scaffold_100012	13376643	13396435	19792	g_8237	g_8238
Super-Scaffold_100012	13396893	13450505	53612	g_8238	g_8239
Super-Scaffold_100012	13457451	13493386	35935	g_8239	g_8240
Super-Scaffold_100012	13499138	13504847	5709	g_8240	g_8241
Super-Scaffold_100012	13507450	13543216	35766	g_8241	g_8242
Super-Scaffold_100012	13543845	13547892	4047	g_8242	g_8243
Super-Scaffold_100012	13551253	13566700	15447	g_8243	g_8244
Super-Scaffold_100012	13569279	13636516	67237	g_8244	g_8249
Super-Scaffold_100012	13642590	13667500	24910	g_8249	g_41347
Super-Scaffold_100012	13667790	13672218	4428	g_41347	g_8251
Super-Scaffold_100012	13672676	13708388	35712	g_8251	g_8254
Super-Scaffold_100012	13709479	13713485	4006	g_8254	g_8255
Super-Scaffold_100012	13727500	13736319	8819	g_8255	g_8256
Super-Scaffold_100012	13742281	13744749	2468	g_8256	g_43471
Super-Scaffold_100012	13750751	13752016	1265	g_43471	g_8257
Super-Scaffold_100012	13756685	13761693	5008	g_8257	g_8258
Super-Scaffold_100012	13783521	13785835	2314	g_8258	g_8259
Super-Scaffold_100012	13789206	13819427	30221	g_8259	g_41349
Super-Scaffold_100012	13819645	13871469	51824	g_41349	g_8260
Super-Scaffold_100012	13884750	13891141	6391	g_8260	g_8261
Super-Scaffold_100012	13897141	13914924	17783	g_8261	g_8262
Super-Scaffold_100012	13922295	13962664	40369	g_8262	g_8265
Super-Scaffold_100012	13962915	13970145	7230	g_8265	g_8266
Super-Scaffold_100012	13988734	14076474	87740	g_8266	g_8270
Super-Scaffold_100012	14076731	14190377	113646	g_8270	g_8272
Super-Scaffold_100012	14190787	14284014	93227	g_8272	g_8273
Super-Scaffold_100012	14284658	14292442	7784	g_8273	g_8274
Super-Scaffold_100012	14302660	14304074	1414	g_8274	g_8275
Super-Scaffold_100012	14307446	14311567	4121	g_8275	g_43472
Super-Scaffold_100012	14313036	14315933	2897	g_43472	g_8276
Super-Scaffold_100012	14320738	14325490	4752	g_8276	g_8277
Super-Scaffold_100012	14332125	14332663	538	g_8277	g_8278
Super-Scaffold_100012	14332869	14336603	3734	g_8278	g_8280
Super-Scaffold_100012	14344898	14359497	14599	g_8280	g_8281
Super-Scaffold_100012	14365152	14379202	14050	g_8281	g_8282
Super-Scaffold_100012	14379420	14382269	2849	g_8282	g_8283
Super-Scaffold_100012	14406299	14475650	69351	g_8283	g_8285
Super-Scaffold_100012	14476066	14565695	89629	g_8285	g_8288
Super-Scaffold_100012	14570920	14573837	2917	g_8288	g_41363
Super-Scaffold_100012	14574136	14684348	110212	g_41363	g_8290
Super-Scaffold_100012	14684692	14687236	2544	g_8290	g_8291
Super-Scaffold_100012	14687517	14697731	10214	g_8291	g_8292
Super-Scaffold_100012	14699351	14701824	2473	g_8292	g_8293
Super-Scaffold_100012	14708170	14720897	12727	g_8293	g_8294
Super-Scaffold_100012	14725864	14733867	8003	g_8294	g_8296
Super-Scaffold_100012	14736887	14737791	904	g_8296	g_8297
Super-Scaffold_100012	14744241	14745414	1173	g_8297	g_8298
Super-Scaffold_100012	14753118	14755047	1929	g_8298	g_8299
Super-Scaffold_100012	14765004	14772078	7074	g_8299	g_8300
Super-Scaffold_100012	14783836	14791072	7236	g_8300	g_8301
Super-Scaffold_100012	14795519	14803366	7847	g_8301	g_43473
Super-Scaffold_100012	14826741	14830025	3284	g_43473	g_8302
Super-Scaffold_100012	14832786	14836646	3860	g_8302	g_8303
Super-Scaffold_100012	14841262	14867757	26495	g_8303	g_8304
Super-Scaffold_100012	14874531	14877967	3436	g_8304	g_8306
Super-Scaffold_100012	14886870	14890766	3896	g_8306	g_8307
Super-Scaffold_100012	14894103	14899703	5600	g_8307	g_8308
Super-Scaffold_100012	14901068	14903772	2704	g_8308	g_8309
Super-Scaffold_100012	14906772	14908968	2196	g_8309	g_43474
Super-Scaffold_100012	14916550	14918218	1668	g_43474	g_8310
Super-Scaffold_100012	14924845	14928787	3942	g_8310	g_8311
Super-Scaffold_100012	14932030	14932742	712	g_8311	g_43475
Super-Scaffold_100012	14935982	14937744	1762	g_43475	g_8312
Super-Scaffold_100012	14940496	14942709	2213	g_8312	g_8313
Super-Scaffold_100012	14944795	14946317	1522	g_8313	g_41367
Super-Scaffold_100012	14947823	14948721	898	g_8314	g_8315
Super-Scaffold_100012	14954996	14957311	2315	g_8315	g_8316
Super-Scaffold_100012	14958445	14970001	11556	g_8316	g_8317
Super-Scaffold_100012	14980228	14981185	957	g_8317	g_8318
Super-Scaffold_100012	14983452	14986140	2688	g_8318	g_43476
Super-Scaffold_100012	14988345	14993633	5288	g_43476	g_8319
Super-Scaffold_100012	14997998	15004766	6768	g_8319	g_8320
Super-Scaffold_100012	15010925	15012004	1079	g_8320	g_8321
Super-Scaffold_100012	15013181	15016790	3609	g_8321	g_8322
Super-Scaffold_100012	15023295	15029894	6599	g_8322	g_8323
Super-Scaffold_100012	15040236	15073176	32940	g_8323	g_8325
Super-Scaffold_100012	15087725	15092309	4584	g_8325	g_8326
Super-Scaffold_100012	15092713	15123233	30520	g_8326	g_8328
Super-Scaffold_100012	15131987	15154750	22763	g_8328	g_8329
Super-Scaffold_100012	15176012	15186355	10343	g_8329	g_8331
Super-Scaffold_100012	15200637	15207362	6725	g_8331	g_41369
Super-Scaffold_100012	15207565	15215044	7479	g_41369	g_8332
Super-Scaffold_100012	15215262	15228458	13196	g_8332	g_43477
Super-Scaffold_100012	15233436	15262245	28809	g_43477	g_8333
Super-Scaffold_100012	15285996	15308222	22226	g_8333	g_8335
Super-Scaffold_100012	15312996	15319331	6335	g_8335	g_8336
Super-Scaffold_100012	15325946	15327926	1980	g_8336	g_8337
Super-Scaffold_100012	15332681	15336009	3328	g_8337	g_8338
Super-Scaffold_100012	15342797	15347413	4616	g_8338	g_8339
Super-Scaffold_100012	15350253	15352194	1941	g_8339	g_8340
Super-Scaffold_100012	15355759	15361588	5829	g_8340	g_8341
Super-Scaffold_100012	15386205	15390099	3894	g_8341	g_8342
Super-Scaffold_100012	15391460	15428301	36841	g_8342	g_8345
Super-Scaffold_100012	15433110	15435452	2342	g_8345	g_8346
Super-Scaffold_100012	15439857	15443333	3476	g_8346	g_8347
Super-Scaffold_100012	15452574	15455646	3072	g_8347	g_8348
Super-Scaffold_100012	15460070	15465765	5695	g_8348	g_8349
Super-Scaffold_100012	15468960	15471911	2951	g_8349	g_8350
Super-Scaffold_100012	15476185	15477536	1351	g_8350	g_8351
Super-Scaffold_100012	15485849	15490942	5093	g_8351	g_8352
Super-Scaffold_100012	15499904	15502537	2633	g_8352	g_8353
Super-Scaffold_100012	15506768	15510352	3584	g_8353	g_8354
Super-Scaffold_100012	15510570	15521861	11291	g_8354	g_8356
Super-Scaffold_100012	15522163	15601565	79402	g_8356	g_8361
Super-Scaffold_100012	15604863	15611234	6371	g_8361	g_8363
Super-Scaffold_100012	15615582	15620147	4565	g_8363	g_8364
Super-Scaffold_100012	15627245	15642484	15239	g_8364	g_8365
Super-Scaffold_100012	15649885	15663122	13237	g_8365	g_8366
Super-Scaffold_100012	15666451	15666567	116	g_8366	g_8367
Super-Scaffold_100012	15667229	15668425	1196	g_8367	g_43478
Super-Scaffold_100012	15672433	15673748	1315	g_43478	g_8368
Super-Scaffold_100012	15682425	15689257	6832	g_8368	g_8369
Super-Scaffold_100012	15690282	15691437	1155	g_8369	g_8370
Super-Scaffold_100012	15700208	15728763	28555	g_8370	g_8371
Super-Scaffold_100012	15730613	15731273	660	g_8371	g_8372
Super-Scaffold_100012	15742406	15744400	1994	g_8372	g_8373
Super-Scaffold_100012	15745037	15747315	2278	g_8373	g_8374
Super-Scaffold_100012	15748052	15755928	7876	g_8374	g_8375
Super-Scaffold_100012	15756585	15757754	1169	g_8375	g_8376
Super-Scaffold_100012	15758463	15759215	752	g_8376	g_8377
Super-Scaffold_100012	15759923	15761100	1177	g_8377	g_8378
Super-Scaffold_100012	15761809	15762561	752	g_8378	g_8379
Super-Scaffold_100012	15763262	15771177	7915	g_8379	g_8380
Super-Scaffold_100012	15777194	15783044	5850	g_8380	g_8381
Super-Scaffold_100012	15783304	15808525	25221	g_8381	g_8383
Super-Scaffold_100012	15816930	15819239	2309	g_8383	g_8384
Super-Scaffold_100012	15819775	15832993	13218	g_8384	g_8385
Super-Scaffold_100012	15837926	15844797	6871	g_8385	g_8386
Super-Scaffold_100012	15851016	15855664	4648	g_8386	g_8387
Super-Scaffold_100012	15871999	15891237	19238	g_8387	g_8389
Super-Scaffold_100012	15891536	15903088	11552	g_8389	g_8390
Super-Scaffold_100012	15911126	15914039	2913	g_8390	g_8391
Super-Scaffold_100012	15921791	15924150	2359	g_8391	g_8392
Super-Scaffold_100012	15929592	15932824	3232	g_8392	g_8393
Super-Scaffold_100012	15936348	15939255	2907	g_8393	g_8394
Super-Scaffold_100012	15941329	15943264	1935	g_8394	g_8395
Super-Scaffold_100012	15953757	15990900	37143	g_8395	g_8396
Super-Scaffold_100012	15992015	15998032	6017	g_8396	g_8397
Super-Scaffold_100012	16009008	16011127	2119	g_8397	g_8398
Super-Scaffold_100012	16014255	16014901	646	g_8398	g_8399
Super-Scaffold_100012	16015830	16023010	7180	g_8399	g_8400
Super-Scaffold_100012	16026450	16029328	2878	g_8400	g_8401
Super-Scaffold_100012	16033883	16034517	634	g_8401	g_8402
Super-Scaffold_100012	16039160	16040319	1159	g_8402	g_43479
Super-Scaffold_100012	16054053	16081825	27772	g_43479	g_8403
Super-Scaffold_100012	16082049	16095418	13369	g_8403	g_8404
Super-Scaffold_100012	16118075	16137158	19083	g_8404	g_8405
Super-Scaffold_100012	16137466	16157051	19585	g_8405	g_8407
Super-Scaffold_100012	16200027	16209330	9303	g_8407	g_8408
Super-Scaffold_100012	16214548	16255800	41252	g_8408	g_8410
Super-Scaffold_100012	16272860	16275829	2969	g_8410	g_8411
Super-Scaffold_100012	16277284	16282824	5540	g_8411	g_8412
Super-Scaffold_100012	16284601	16286251	1650	g_8412	g_43480
Super-Scaffold_100012	16290269	16292923	2654	g_43480	g_8413
Super-Scaffold_100012	16313435	16316658	3223	g_8413	g_8414
Super-Scaffold_100012	16323107	16331906	8799	g_8414	g_8415
Super-Scaffold_100012	16349636	16350382	746	g_8415	g_8416
Super-Scaffold_100012	16356544	16358015	1471	g_8416	g_8417
Super-Scaffold_100012	16369102	16389856	20754	g_8417	g_8418
Super-Scaffold_100012	16400191	16406110	5919	g_8418	g_43481
Super-Scaffold_100012	16409059	16412692	3633	g_43481	g_8419
Super-Scaffold_100012	16437486	16440890	3404	g_8419	g_8420
Super-Scaffold_100012	16448192	16449805	1613	g_8420	g_8421
Super-Scaffold_100012	16457773	16461819	4046	g_8421	g_8423
Super-Scaffold_100012	16476892	16478224	1332	g_8423	g_8424
Super-Scaffold_100012	16490504	16492534	2030	g_8424	g_8425
Super-Scaffold_100012	16498256	16499225	969	g_8425	g_8426
Super-Scaffold_100012	16501909	16502868	959	g_8426	g_8427
Super-Scaffold_100012	16504849	16505188	339	g_8427	g_43482
Super-Scaffold_100012	16507841	16511593	3752	g_43482	g_8428
Super-Scaffold_100012	16513612	16518919	5307	g_8428	g_43483
Super-Scaffold_100012	16520932	16521264	332	g_43483	g_8429
Super-Scaffold_100012	16523630	16527862	4232	g_8429	g_8430
Super-Scaffold_100012	16530308	16531381	1073	g_8430	g_8431
Super-Scaffold_100012	16535904	16536936	1032	g_8431	g_8432
Super-Scaffold_100012	16538220	16541761	3541	g_41385	g_8433
Super-Scaffold_100012	16548477	16554226	5749	g_8433	g_8434
Super-Scaffold_100012	16554639	16664366	109727	g_8434	g_8439
Super-Scaffold_100012	16664629	16664785	156	g_8439	g_41391
Super-Scaffold_100012	16665006	16669457	4451	g_41391	g_8440
Super-Scaffold_100012	16695772	16704092	8320	g_8440	g_8441
Super-Scaffold_100012	16707791	16722561	14770	g_8441	g_8442
Super-Scaffold_100012	16736890	16742678	5788	g_8442	g_8443
Super-Scaffold_100012	16743747	16747831	4084	g_8443	g_8444
Super-Scaffold_100012	16750174	16751322	1148	g_8444	g_8445
Super-Scaffold_100012	16754541	16758829	4288	g_8445	g_8446
Super-Scaffold_100012	16784110	16784634	524	g_8446	g_8447
Super-Scaffold_100012	16787808	16826612	38804	g_8447	g_8448
Super-Scaffold_100012	16831992	16832160	168	g_8448	g_8449
Super-Scaffold_100012	16835289	16837639	2350	g_8449	g_43484
Super-Scaffold_100012	16839930	16845012	5082	g_43484	g_8450
Super-Scaffold_100012	16846869	16850445	3576	g_8450	g_8451
Super-Scaffold_100012	16855513	16857721	2208	g_8451	g_8452
Super-Scaffold_100012	16864402	16868714	4312	g_8452	g_8453
Super-Scaffold_100012	16877301	16887246	9945	g_8453	g_43485
Super-Scaffold_100012	16891283	16893820	2537	g_43485	g_8454
Super-Scaffold_100012	16895782	16896962	1180	g_8454	g_8455
Super-Scaffold_100012	16897858	16897994	136	g_8455	g_43486
Super-Scaffold_100012	16899428	16904669	5241	g_43486	g_8456
Super-Scaffold_100012	16906666	16907688	1022	g_8456	g_8457
Super-Scaffold_100012	16908647	16926637	17990	g_8457	g_41393
Super-Scaffold_100012	16926894	16949160	22266	g_41393	g_8458
Super-Scaffold_100012	16961423	16998984	37561	g_8458	g_8459
Super-Scaffold_100012	16999652	17000218	566	g_8459	g_8460
Super-Scaffold_100012	17000439	17001831	1392	g_8460	g_8461
Super-Scaffold_100012	17005858	17007069	1211	g_8461	g_8462
Super-Scaffold_100012	17008454	17009892	1438	g_8462	g_8463
Super-Scaffold_100012	17018652	17020992	2340	g_8463	g_8464
Super-Scaffold_100012	17021639	17022712	1073	g_8464	g_8465
Super-Scaffold_100012	17023137	17023339	202	g_8465	g_8466
Super-Scaffold_100012	17025527	17027505	1978	g_8466	g_8467
Super-Scaffold_100012	17029257	17030705	1448	g_8467	g_8468
Super-Scaffold_100012	17037050	17039292	2242	g_8468	g_8469
Super-Scaffold_100012	17040445	17047720	7275	g_8469	g_8470
Super-Scaffold_100012	17055552	17056877	1325	g_8470	g_8471
Super-Scaffold_100012	17057310	17058499	1189	g_8471	g_8472
Super-Scaffold_100012	17060476	17062083	1607	g_8472	g_8473
Super-Scaffold_100012	17075370	17076145	775	g_8473	g_8475
Super-Scaffold_100012	17078055	17079629	1574	g_8475	g_8476
Super-Scaffold_100012	17095537	17096817	1280	g_8476	g_8477
Super-Scaffold_100012	17097029	17100876	3847	g_8477	g_8478
Super-Scaffold_100012	17101313	17125276	23963	g_8478	g_8480
Super-Scaffold_100012	17132082	17142513	10431	g_8480	g_8481
Super-Scaffold_100012	17147461	17150126	2665	g_8481	g_8482
Super-Scaffold_100012	17155108	17159101	3993	g_8482	g_8483
Super-Scaffold_100012	17159727	17164705	4978	g_8483	g_8484
Super-Scaffold_100012	17180268	17193291	13023	g_8484	g_8485
Super-Scaffold_100012	17193695	17204995	11300	g_8485	g_8486
Super-Scaffold_100012	17215031	17221830	6799	g_41395	g_41396
Super-Scaffold_100012	17222033	17239530	17497	g_41396	g_8488
Super-Scaffold_100012	17240394	17257473	17079	g_8488	g_8490
Super-Scaffold_100012	17258513	17356688	98175	g_8490	g_8493
Super-Scaffold_100012	17357548	17382887	25339	g_8493	g_41400
Super-Scaffold_100012	17383291	17395730	12439	g_41400	g_8494
Super-Scaffold_100012	17418807	17421521	2714	g_8494	g_8495
Super-Scaffold_100012	17426356	17442710	16354	g_8495	g_8496
Super-Scaffold_100012	17467483	17479692	12209	g_8496	g_8497
Super-Scaffold_100012	17487856	17509979	22123	g_8497	g_8498
Super-Scaffold_100012	17512674	17522671	9997	g_8498	g_8500
Super-Scaffold_100012	17525268	17526286	1018	g_8500	g_8501
Super-Scaffold_100012	17526854	17528436	1582	g_8501	g_8502
Super-Scaffold_100012	17529759	17534045	4286	g_8502	g_8503
Super-Scaffold_100012	17535275	17537924	2649	g_8503	g_43487
Super-Scaffold_100012	17541167	17544171	3004	g_43487	g_8504
Super-Scaffold_100012	17546533	17551284	4751	g_8504	g_8505
Super-Scaffold_100012	17554077	17555238	1161	g_8505	g_8506
Super-Scaffold_100012	17564053	17585237	21184	g_8506	g_8507
Super-Scaffold_100012	17586559	17590027	3468	g_8507	g_8508
Super-Scaffold_100012	17591169	17601302	10133	g_8508	g_8509
Super-Scaffold_100012	17603814	17605064	1250	g_8509	g_8510
Super-Scaffold_100012	17607097	17608166	1069	g_8510	g_43488
Super-Scaffold_100012	17610898	17624697	13799	g_43488	g_8511
Super-Scaffold_100012	17630173	17631933	1760	g_8511	g_8512
Super-Scaffold_100012	17634921	17635366	445	g_8512	g_8513
Super-Scaffold_100012	17636802	17638691	1889	g_8513	g_8514
Super-Scaffold_100012	17641518	17642918	1400	g_8514	g_8515
Super-Scaffold_100012	17651251	17652670	1419	g_8515	g_8516
Super-Scaffold_100012	17654777	17658785	4008	g_8516	g_41402
Super-Scaffold_100012	17659006	17712671	53665	g_41402	g_8519
Super-Scaffold_100012	17734602	17751640	17038	g_8519	g_8520
Super-Scaffold_100012	17756366	17770321	13955	g_8520	g_43489
Super-Scaffold_100012	17778146	17813364	35218	g_43489	g_8521
Super-Scaffold_100012	17813981	17828932	14951	g_8521	g_8522
Super-Scaffold_100012	17840524	17881025	40501	g_8522	g_8524
Super-Scaffold_100012	17892743	17897827	5084	g_8524	g_8525
Super-Scaffold_100012	17903200	17910344	7144	g_8525	g_8526
Super-Scaffold_100012	17911309	17911923	614	g_8526	g_8527
Super-Scaffold_100012	17913113	17932098	18985	g_8527	g_8529
Super-Scaffold_100012	17935118	17938554	3436	g_8529	g_8530
Super-Scaffold_100012	17945009	17945115	106	g_8530	g_43490
Super-Scaffold_100012	17945369	17951432	6063	g_43490	g_8531
Super-Scaffold_100012	17954271	17955447	1176	g_8531	g_8532
Super-Scaffold_100012	17960985	17965652	4667	g_8532	g_8533
Super-Scaffold_100012	17968222	17969437	1215	g_8533	g_8534
Super-Scaffold_100012	17977296	17980513	3217	g_8534	g_8535
Super-Scaffold_100012	17982085	18021206	39121	g_8535	g_8537
Super-Scaffold_100012	18026873	18031336	4463	g_8537	g_8538
Super-Scaffold_100012	18032247	18034151	1904	g_8538	g_8539
Super-Scaffold_100012	18036878	18047635	10757	g_8539	g_43491
Super-Scaffold_100012	18048266	18054535	6269	g_43491	g_8540
Super-Scaffold_100012	18062282	18064688	2406	g_8540	g_8541
Super-Scaffold_100012	18072641	18073408	767	g_8541	g_8542
Super-Scaffold_100012	18074808	18079256	4448	g_8542	g_8543
Super-Scaffold_100012	18079822	18226720	146898	g_8543	g_8545
Super-Scaffold_100012	18228840	18264016	35176	g_8545	g_8547
Super-Scaffold_100012	18264246	18264530	284	g_8547	g_41413
Super-Scaffold_100012	18264742	18269780	5038	g_41413	g_8548
Super-Scaffold_100012	18270058	18274929	4871	g_8548	g_41414
Super-Scaffold_100012	18275210	18395268	120058	g_41414	g_8551
Super-Scaffold_100012	18396380	18402011	5631	g_8551	g_8552
Super-Scaffold_100012	18415740	18428477	12737	g_8552	g_8553
Super-Scaffold_100012	18429552	18430721	1169	g_41420	g_8554
Super-Scaffold_100012	18431636	18478525	46889	g_8554	g_8555
Super-Scaffold_100012	18480470	18572336	91866	g_8555	g_8558
Super-Scaffold_100012	18577031	18579583	2552	g_8558	g_8559
Super-Scaffold_100012	18594428	18595735	1307	g_8559	g_8560
Super-Scaffold_100012	18599688	18599792	104	g_8560	g_8561
Super-Scaffold_100012	18601752	18602573	821	g_8561	g_8562
Super-Scaffold_100012	18607846	18654271	46425	g_8562	g_8563
Super-Scaffold_100012	18664990	18671456	6466	g_8563	g_8564
Super-Scaffold_100012	18672097	18676148	4051	g_8564	g_8565
Super-Scaffold_100012	18680594	18686714	6120	g_8565	g_8566
Super-Scaffold_100012	18689711	18693877	4166	g_8566	g_8567
Super-Scaffold_100012	18698988	18699438	450	g_8567	g_8568
Super-Scaffold_100012	18705656	18750078	44422	g_8568	g_8571
Super-Scaffold_100012	18752135	18791093	38958	g_8571	g_8573
Super-Scaffold_100012	18804256	18805883	1627	g_8573	g_8574
Super-Scaffold_100012	18806086	18808885	2799	g_8574	g_8575
Super-Scaffold_100012	18812798	18834652	21854	g_8575	g_8577
Super-Scaffold_100012	18840244	18845161	4917	g_8577	g_8578
Super-Scaffold_100012	18857699	18879416	21717	g_8578	g_8580
Super-Scaffold_100012	18888924	18894174	5250	g_8580	g_8581
Super-Scaffold_100012	18931144	18932828	1684	g_8581	g_8582
Super-Scaffold_100012	18943799	18944804	1005	g_8582	g_8583
Super-Scaffold_100012	18952420	18954706	2286	g_8583	g_8584
Super-Scaffold_100012	18959493	18960311	818	g_8584	g_8585
Super-Scaffold_100012	18982621	19025182	42561	g_8585	g_8587
Super-Scaffold_100012	19051053	19064492	13439	g_8587	g_8588
Super-Scaffold_100012	19072288	19126034	53746	g_8588	g_8591
Super-Scaffold_100012	19126237	19154001	27764	g_8591	g_43492
Super-Scaffold_100012	19163031	19169159	6128	g_43492	g_43493
Super-Scaffold_100012	19178265	19192353	14088	g_43493	g_8592
Super-Scaffold_100012	19201045	19218625	17580	g_8592	g_8593
Super-Scaffold_100012	19240091	19257906	17815	g_8593	g_8594
Super-Scaffold_100012	19263320	19281300	17980	g_8594	g_8595
Super-Scaffold_100012	19290624	19296491	5867	g_8595	g_8596
Super-Scaffold_100012	19303563	19321192	17629	g_8596	g_8597
Super-Scaffold_100012	19326459	19333352	6893	g_8597	g_8598
Super-Scaffold_100012	19343293	19346771	3478	g_8598	g_8599
Super-Scaffold_100012	19352610	19369885	17275	g_8599	g_8600
Super-Scaffold_100012	19381582	19384445	2863	g_8600	g_8601
Super-Scaffold_100012	19390734	19402343	11609	g_41434	g_8602
Super-Scaffold_100012	19404964	19422150	17186	g_8602	g_8603
Super-Scaffold_100012	19426414	19434342	7928	g_8603	g_8604
Super-Scaffold_100012	19448463	19465632	17169	g_8604	g_8605
Super-Scaffold_100012	19466656	19468976	2320	g_8605	g_8606
Super-Scaffold_100012	19473997	19476718	2721	g_8606	g_8607
Super-Scaffold_100012	19478156	19480367	2211	g_8607	g_8608
Super-Scaffold_100012	19484638	19485407	769	g_8608	g_8609
Super-Scaffold_100012	19493129	19497136	4007	g_8609	g_8610
Super-Scaffold_100012	19505597	19526530	20933	g_8610	g_8611
Super-Scaffold_100012	19540661	19542757	2096	g_8611	g_8612
Super-Scaffold_100012	19548719	19549917	1198	g_8612	g_43494
Super-Scaffold_100012	19550697	19550735	38	g_43494	g_43495
Super-Scaffold_100012	19556828	19563610	6782	g_43495	g_8614
Super-Scaffold_100012	19570480	19572330	1850	g_8614	g_8615
Super-Scaffold_100012	19574674	19577685	3011	g_8615	g_8616
Super-Scaffold_100012	19582022	19583830	1808	g_8616	g_8617
Super-Scaffold_100012	19586585	19588734	2149	g_8617	g_8618
Super-Scaffold_100012	19590736	19593173	2437	g_8618	g_8619
Super-Scaffold_100012	19596942	19627184	30242	g_8619	g_8620
Super-Scaffold_100012	19638650	19642424	3774	g_8620	g_8621
Super-Scaffold_100012	19645726	19649321	3595	g_8621	g_8622
Super-Scaffold_100012	19650946	19751815	100869	g_41436	g_8624
Super-Scaffold_100012	19752875	19755141	2266	g_8624	g_43496
Super-Scaffold_100012	19756201	19758481	2280	g_43496	g_43497
Super-Scaffold_100012	19759508	19863869	104361	g_43497	g_8628
Super-Scaffold_100012	19864105	19868837	4732	g_8628	g_8627
Super-Scaffold_100012	19881647	19927177	45530	g_8627	g_8630
Super-Scaffold_100012	19939502	19944901	5399	g_8630	g_8631
Super-Scaffold_100012	19964511	19986848	22337	g_8631	g_8633
Super-Scaffold_100012	19994034	20000852	6818	g_8633	g_8634
Super-Scaffold_100012	20004817	20007446	2629	g_8634	g_43498
Super-Scaffold_100012	20016180	20022670	6490	g_43498	g_43499
Super-Scaffold_100012	20041093	20073865	32772	g_43499	g_8635
Super-Scaffold_100012	20079786	20087100	7314	g_8635	g_8636
Super-Scaffold_100012	20089496	20093718	4222	g_8636	g_8637
Super-Scaffold_100012	20097018	20099136	2118	g_8637	g_8638
Super-Scaffold_100012	20099483	20100129	646	g_8638	g_8639
Super-Scaffold_100012	20102479	20105289	2810	g_8639	g_8640
Super-Scaffold_100012	20125537	20127149	1612	g_8640	g_8641
Super-Scaffold_100012	20133017	20136396	3379	g_8641	g_43500
Super-Scaffold_100012	20141487	20141594	107	g_43500	g_43501
Super-Scaffold_100012	20149600	20157477	7877	g_43501	g_8642
Super-Scaffold_100012	20160559	20162309	1750	g_8642	g_43502
Super-Scaffold_100012	20168161	20170082	1921	g_43502	g_8643
Super-Scaffold_100012	20173472	20175015	1543	g_8643	g_8644
Super-Scaffold_100012	20177551	20177974	423	g_8644	g_8645
Super-Scaffold_100012	20178636	20187756	9120	g_8645	g_8646
Super-Scaffold_100012	20201347	20214445	13098	g_8646	g_8647
Super-Scaffold_100012	20215727	20222376	6649	g_8647	g_8648
Super-Scaffold_100012	20224443	20230404	5961	g_8648	g_43503
Super-Scaffold_100012	20239026	20240143	1117	g_43503	g_8649
Super-Scaffold_100012	20244344	20245362	1018	g_8649	g_8650
Super-Scaffold_100012	20247405	20248238	833	g_8650	g_8651
Super-Scaffold_100012	20249987	20251300	1313	g_8651	g_43504
Super-Scaffold_100012	20253160	20253798	638	g_43504	g_8652
Super-Scaffold_100012	20265412	20269227	3815	g_8652	g_8653
Super-Scaffold_100012	20274486	20278558	4072	g_8653	g_43505
Super-Scaffold_100012	20281112	20281722	610	g_43505	g_8654
Super-Scaffold_100012	20282049	20282807	758	g_8654	g_43506
Super-Scaffold_100012	20285322	20286099	777	g_43506	g_8655
Super-Scaffold_100012	20302843	20307571	4728	g_8655	g_8656
Super-Scaffold_100012	20319767	20323304	3537	g_8656	g_8657
Super-Scaffold_100012	20333895	20337936	4041	g_8657	g_8658
Super-Scaffold_100012	20338385	20384123	45738	g_8658	g_8660
Super-Scaffold_100012	20392239	20411959	19720	g_8660	g_8661
Super-Scaffold_100012	20418850	20419514	664	g_8661	g_8662
Super-Scaffold_100012	20419810	20573311	153501	g_8662	g_8666
Super-Scaffold_100012	20584078	20630623	46545	g_8666	g_8668
Super-Scaffold_100012	20634761	20638425	3664	g_8668	g_8669
Super-Scaffold_100012	20650060	20654497	4437	g_8669	g_8670
Super-Scaffold_100012	20679510	20681938	2428	g_8670	g_8671
Super-Scaffold_100012	20683921	20687049	3128	g_8671	g_43507
Super-Scaffold_100012	20688225	20690639	2414	g_43507	g_43508
Super-Scaffold_100012	20691794	20696111	4317	g_43508	g_8672
Super-Scaffold_100012	20697954	20706002	8048	g_8672	g_43509
Super-Scaffold_100012	20709045	20712045	3000	g_43509	g_8673
Super-Scaffold_100012	20714257	20719325	5068	g_8673	g_8674
Super-Scaffold_100012	20732038	20736683	4645	g_8674	g_8675
Super-Scaffold_100012	20745808	20803758	57950	g_8675	g_41444
Super-Scaffold_100012	20804066	20806232	2166	g_41444	g_8678
Super-Scaffold_100012	20809396	20811632	2236	g_8678	g_8679
Super-Scaffold_100012	20813745	20815732	1987	g_8679	g_8680
Super-Scaffold_100012	20823142	20823399	257	g_8680	g_8681
Super-Scaffold_100012	20829859	20831639	1780	g_8681	g_8682
Super-Scaffold_100012	20839764	20845882	6118	g_8682	g_8683
Super-Scaffold_100012	20854002	20865095	11093	g_8683	g_8684
Super-Scaffold_100012	20866712	20908763	42051	g_8684	g_8686
Super-Scaffold_100012	20910984	20922429	11445	g_8686	g_8687
Super-Scaffold_100012	20923445	20930265	6820	g_8687	g_43510
Super-Scaffold_100012	20931317	20933402	2085	g_43510	g_8688
Super-Scaffold_100012	20934265	20937078	2813	g_8688	g_8689
Super-Scaffold_100012	20938238	20943670	5432	g_8689	g_8690
Super-Scaffold_100012	20944641	20948189	3548	g_8690	g_8691
Super-Scaffold_100012	20949403	20952382	2979	g_8691	g_43511
Super-Scaffold_100012	20953353	20963595	10242	g_43511	g_43512
Super-Scaffold_100012	20964581	20966849	2268	g_43512	g_43513
Super-Scaffold_100012	20968111	20980097	11986	g_43513	g_8692
Super-Scaffold_100012	20990848	21030886	40038	g_8692	g_8694
Super-Scaffold_100012	21042367	21047996	5629	g_8694	g_43514
Super-Scaffold_100012	21062976	21069776	6800	g_43514	g_8695
Super-Scaffold_100012	21072568	21074153	1585	g_8695	g_8696
Super-Scaffold_100012	21076947	21079868	2921	g_8696	g_8697
Super-Scaffold_100012	21081271	21081489	218	g_8697	g_8698
Super-Scaffold_100012	21082763	21085682	2919	g_8698	g_43515
Super-Scaffold_100012	21088474	21097493	9019	g_43515	g_8700
Super-Scaffold_100012	21100295	21107697	7402	g_8700	g_8701
Super-Scaffold_100012	21110481	21118560	8079	g_8701	g_8702
Super-Scaffold_100012	21121365	21129087	7722	g_8702	g_8704
Super-Scaffold_100012	21131864	21139891	8027	g_8704	g_8706
Super-Scaffold_100012	21141318	21142850	1532	g_8706	g_8707
Super-Scaffold_100012	21145654	21153389	7735	g_8707	g_8708
Super-Scaffold_100012	21156173	21164136	7963	g_8708	g_8711
Super-Scaffold_100012	21165563	21167095	1532	g_8711	g_8712
Super-Scaffold_100012	21169898	21177302	7404	g_8712	g_8713
Super-Scaffold_100012	21180085	21188052	7967	g_8713	g_8715
Super-Scaffold_100012	21189488	21191020	1532	g_8715	g_8716
Super-Scaffold_100012	21193852	21201458	7606	g_8716	g_8718
Super-Scaffold_100012	21204272	21222006	17734	g_8718	g_8719
Super-Scaffold_100012	21224802	21232200	7398	g_8719	g_8720
Super-Scaffold_100012	21234977	21240003	5026	g_8720	g_8721
Super-Scaffold_100012	21242816	21250329	7513	g_8721	g_8722
Super-Scaffold_100012	21253121	21262808	9687	g_8722	g_8723
Super-Scaffold_100012	21265631	21273129	7498	g_8723	g_8725
Super-Scaffold_100012	21275921	21281613	5692	g_8725	g_8726
Super-Scaffold_100012	21283166	21305237	22071	g_8726	g_8727
Super-Scaffold_100012	21307957	21309795	1838	g_8727	g_43516
Super-Scaffold_100012	21312518	21322107	9589	g_43516	g_8728
Super-Scaffold_100012	21324898	21326538	1640	g_8728	g_43517
Super-Scaffold_100012	21329186	21332159	2973	g_43517	g_43518
Super-Scaffold_100012	21336453	21338664	2211	g_43518	g_43519
Super-Scaffold_100012	21341531	21362819	21288	g_43519	g_8729
Super-Scaffold_100012	21368717	21369880	1163	g_8729	g_8730
Super-Scaffold_100012	21375794	21377744	1950	g_8730	g_8731
Super-Scaffold_100012	21381302	21386046	4744	g_8731	g_43520
Super-Scaffold_100012	21400206	21403426	3220	g_43520	g_43521
Super-Scaffold_100012	21406985	21408599	1614	g_43521	g_8732
Super-Scaffold_100012	21422516	21429717	7201	g_8732	g_8733
Super-Scaffold_100012	21432624	21434676	2052	g_8733	g_43522
Super-Scaffold_100012	21441665	21445971	4306	g_43522	g_8734
Super-Scaffold_100012	21457701	21461440	3739	g_8734	g_8735
Super-Scaffold_100012	21462514	21467590	5076	g_8735	g_8736
Super-Scaffold_100012	21475225	21478483	3258	g_8736	g_43523
Super-Scaffold_100012	21491056	21510250	19194	g_43523	g_43524
Super-Scaffold_100012	21512053	21521557	9504	g_43524	g_8738
Super-Scaffold_100012	21524393	21526010	1617	g_8738	g_8739
Super-Scaffold_100012	21532940	21534776	1836	g_8739	g_8740
Super-Scaffold_100012	21535720	21540731	5011	g_8740	g_8741
Super-Scaffold_100012	21545391	21575548	30157	g_8741	g_8743
Super-Scaffold_100012	21585628	21607124	21496	g_8743	g_8744
Super-Scaffold_100012	21609899	21617077	7178	g_8744	g_8745
Super-Scaffold_100012	21620928	21636366	15438	g_8745	g_8746
Super-Scaffold_100012	21640500	21652150	11650	g_8746	g_8747
Super-Scaffold_100012	21655335	21723607	68272	g_8747	g_8748
Super-Scaffold_100012	21742044	21775882	33838	g_8748	g_41450
Super-Scaffold_100012	21776121	21780931	4810	g_41450	g_8749
Super-Scaffold_100012	21781215	21836482	55267	g_8749	g_8751
Super-Scaffold_100012	21838099	21843842	5743	g_8751	g_8752
Super-Scaffold_100012	21849794	21852054	2260	g_8752	g_8753
Super-Scaffold_100012	21858991	21921777	62786	g_8753	g_8754
Super-Scaffold_100012	21925248	21996873	71625	g_8754	g_8757
Super-Scaffold_100012	22004530	22006795	2265	g_8757	g_8758
Super-Scaffold_100012	22008042	22009335	1293	g_8758	g_8759
Super-Scaffold_100012	22009782	22013492	3710	g_8759	g_8760
Super-Scaffold_100012	22017655	22018360	705	g_8760	g_8761
Super-Scaffold_100012	22031050	22032167	1117	g_8761	g_8762
Super-Scaffold_100012	22033774	22041589	7815	g_8762	g_8765
Super-Scaffold_100012	22041942	22058079	16137	g_8765	g_8766
Super-Scaffold_100012	22058780	22126161	67381	g_8766	g_8767
Super-Scaffold_100012	22126697	22136450	9753	g_8767	g_8768
Super-Scaffold_100012	22142541	22160171	17630	g_8768	g_8771
Super-Scaffold_100012	22160389	22161139	750	g_8771	g_8772
Super-Scaffold_100012	22164710	22169589	4879	g_8772	g_8773
Super-Scaffold_100012	22174531	22213935	39404	g_8773	g_8774
Super-Scaffold_100012	22214399	22214512	113	g_8774	g_8775
Super-Scaffold_100012	22217388	22224869	7481	g_8775	g_8777
Super-Scaffold_100012	22225181	22234285	9104	g_8777	g_8778
Super-Scaffold_100012	22234731	22235780	1049	g_8778	g_8779
Super-Scaffold_100012	22236154	22237103	949	g_8779	g_43525
Super-Scaffold_100012	22237553	22238365	812	g_43525	g_43526
Super-Scaffold_100012	22238808	22240778	1970	g_43526	g_8780
Super-Scaffold_100012	22241134	22247482	6348	g_8780	g_43527
Super-Scaffold_100012	22247929	22250706	2777	g_43527	g_43528
Super-Scaffold_100012	22251146	22253175	2029	g_43528	g_43529
Super-Scaffold_100012	22253597	22254453	856	g_43529	g_43530
Super-Scaffold_100012	22254903	22255751	848	g_43530	g_43531
Super-Scaffold_100012	22256173	22256617	444	g_43531	g_8781
Super-Scaffold_100012	22257075	22257857	782	g_8781	g_43532
Super-Scaffold_100012	22258304	22259223	919	g_43532	g_43533
Super-Scaffold_100012	22259676	22260468	792	g_43533	g_43534
Super-Scaffold_100012	22262602	22264014	1412	g_43534	g_43535
Super-Scaffold_100012	22264464	22265277	813	g_43535	g_43536
Super-Scaffold_100012	22265703	22266786	1083	g_43536	g_8782
Super-Scaffold_100012	22267172	22268690	1518	g_8782	g_43537
Super-Scaffold_100012	22269140	22269950	810	g_43537	g_43538
Super-Scaffold_100012	22270396	22270906	510	g_43538	g_8783
Super-Scaffold_100012	22271422	22272345	923	g_8783	g_8784
Super-Scaffold_100012	22272789	22273586	797	g_8784	g_43539
Super-Scaffold_100012	22274051	22274817	766	g_43539	g_43540
Super-Scaffold_100012	22275305	22276991	1686	g_43540	g_8785
Super-Scaffold_100012	22277362	22278311	949	g_8785	g_43541
Super-Scaffold_100012	22278761	22282949	4188	g_43541	g_43542
Super-Scaffold_100012	22283387	22284179	792	g_43542	g_8786
Super-Scaffold_100012	22284544	22285452	908	g_8786	g_8787
Super-Scaffold_100012	22285902	22288951	3049	g_8787	g_43543
Super-Scaffold_100012	22289401	22292393	2992	g_43543	g_43544
Super-Scaffold_100012	22293114	22294021	907	g_43544	g_8788
Super-Scaffold_100012	22294471	22295152	681	g_8788	g_43545
Super-Scaffold_100012	22295517	22297568	2051	g_43545	g_8789
Super-Scaffold_100012	22298018	22315131	17113	g_8789	g_8791
Super-Scaffold_100012	22315584	22316392	808	g_8791	g_43546
Super-Scaffold_100012	22316835	22317317	482	g_43546	g_8792
Super-Scaffold_100012	22317774	22318566	792	g_8792	g_8793
Super-Scaffold_100012	22319081	22321065	1984	g_8793	g_8794
Super-Scaffold_100012	22321514	22323487	1973	g_8794	g_8795
Super-Scaffold_100012	22323852	22324802	950	g_8795	g_43547
Super-Scaffold_100012	22325252	22326440	1188	g_43547	g_8796
Super-Scaffold_100012	22328444	22328918	474	g_8796	g_8797
Super-Scaffold_100012	22329474	22330790	1316	g_8797	g_43548
Super-Scaffold_100012	22331240	22333767	2527	g_43548	g_43549
Super-Scaffold_100012	22334234	22338035	3801	g_43549	g_8799
Super-Scaffold_100012	22338465	22341117	2652	g_8799	g_8800
Super-Scaffold_100012	22341555	22342350	795	g_8800	g_43550
Super-Scaffold_100012	22342793	22344556	1763	g_43550	g_43551
Super-Scaffold_100012	22345021	22348026	3005	g_43551	g_43552
Super-Scaffold_100012	22348472	22348907	435	g_43552	g_8801
Super-Scaffold_100012	22349364	22350149	785	g_8801	g_43553
Super-Scaffold_100012	22350595	22351507	912	g_43553	g_8802
Super-Scaffold_100012	22357403	22359269	1866	g_8802	g_43554
Super-Scaffold_100012	22359718	22360764	1046	g_43554	g_8803
Super-Scaffold_100012	22361249	22367934	6685	g_8803	g_8804
Super-Scaffold_100012	22368393	22369297	904	g_8804	g_8805
Super-Scaffold_100012	22369747	22370726	979	g_8805	g_8806
Super-Scaffold_100012	22371175	22372653	1478	g_8806	g_8807
Super-Scaffold_100012	22372973	22376328	3355	g_8807	g_8809
Super-Scaffold_100012	22376772	22378740	1968	g_8809	g_43555
Super-Scaffold_100012	22379193	22380005	812	g_43555	g_43556
Super-Scaffold_100012	22381681	22382634	953	g_43556	g_8810
Super-Scaffold_100012	22383084	22385909	2825	g_8810	g_43557
Super-Scaffold_100012	22386362	22387188	826	g_43557	g_8811
Super-Scaffold_100012	22387634	22389588	1954	g_8811	g_8812
Super-Scaffold_100012	22389944	22390846	902	g_8812	g_8813
Super-Scaffold_100012	22391296	22392200	904	g_8813	g_8814
Super-Scaffold_100012	22392650	22395861	3211	g_8814	g_8815
Super-Scaffold_100012	22396304	22398272	1968	g_8815	g_43570
Super-Scaffold_100012	22398628	22399538	910	g_43570	g_8816
Super-Scaffold_100012	22400003	22400814	811	g_8816	g_8817
Super-Scaffold_100012	22401257	22403020	1763	g_8817	g_8818
Super-Scaffold_100012	22403479	22404311	832	g_8818	g_43558
Super-Scaffold_100012	22404754	22409504	4750	g_43558	g_8819
Super-Scaffold_100012	22409957	22410783	826	g_8819	g_8820
Super-Scaffold_100012	22411229	22413197	1968	g_8820	g_8821
Super-Scaffold_100012	22413641	22414452	811	g_8821	g_8822
Super-Scaffold_100012	22414902	22415868	966	g_8822	g_43559
Super-Scaffold_100012	22416173	22423412	7239	g_43559	g_43560
Super-Scaffold_100012	22424282	22426092	1810	g_43560	g_43561
Super-Scaffold_100012	22426542	22428481	1939	g_43561	g_8823
Super-Scaffold_100012	22428925	22429734	809	g_8823	g_8824
Super-Scaffold_100012	22430177	22435378	5201	g_8824	g_43562
Super-Scaffold_100012	22435837	22436660	823	g_43562	g_43563
Super-Scaffold_100012	22437103	22437544	441	g_43563	g_8825
Super-Scaffold_100012	22438002	22438783	781	g_8825	g_43564
Super-Scaffold_100012	22439215	22440000	785	g_43564	g_8826
Super-Scaffold_100012	22440449	22441016	567	g_8826	g_8827
Super-Scaffold_100012	22441429	22442289	860	g_8827	g_43565
Super-Scaffold_100012	22442732	22443820	1088	g_43565	g_8828
Super-Scaffold_100012	22444264	22445087	823	g_8828	g_8829
Super-Scaffold_100012	22445549	22447067	1518	g_8829	g_43566
Super-Scaffold_100012	22447507	22450417	2910	g_43566	g_8830
Super-Scaffold_100012	22450855	22451645	790	g_8830	g_8831
Super-Scaffold_100012	22452010	22452972	962	g_8831	g_43567
Super-Scaffold_100012	22453424	22454216	792	g_43567	g_8832
Super-Scaffold_100012	22454665	22455414	749	g_8832	g_8833
Super-Scaffold_100012	22455761	22456569	808	g_8833	g_43568
Super-Scaffold_100012	22457012	22458647	1635	g_43568	g_8834
Super-Scaffold_100012	22459094	22461023	1929	g_8834	g_43569
Super-Scaffold_100012	22461388	22465175	3787	g_43569	g_8835
Super-Scaffold_100012	22465618	22467861	2243	g_8835	g_43571
Super-Scaffold_100012	22468283	22469137	854	g_43571	g_43572
Super-Scaffold_100012	22469587	22470405	818	g_43572	g_43573
Super-Scaffold_100012	22470848	22471293	445	g_43573	g_8836
Super-Scaffold_100012	22471749	22472521	772	g_8836	g_43574
Super-Scaffold_100012	22472983	22473592	609	g_43574	g_43575
Super-Scaffold_100012	22474113	22474806	693	g_43575	g_43576
Super-Scaffold_100012	22475252	22477009	1757	g_43576	g_43577
Super-Scaffold_100012	22477450	22479406	1956	g_43577	g_43578
Super-Scaffold_100012	22479850	22480595	745	g_43578	g_43579
Super-Scaffold_100012	22481041	22483063	2022	g_43579	g_8837
Super-Scaffold_100012	22483428	22484379	951	g_8837	g_8838
Super-Scaffold_100012	22484832	22485615	783	g_8838	g_43580
Super-Scaffold_100012	22487153	22487950	797	g_43580	g_43581
Super-Scaffold_100012	22488393	22490428	2035	g_43581	g_43582
Super-Scaffold_100012	22490850	22493845	2995	g_43582	g_43583
Super-Scaffold_100012	22494295	22495205	910	g_43583	g_8840
Super-Scaffold_100012	22495633	22496463	830	g_8840	g_43584
Super-Scaffold_100012	22496903	22498627	1724	g_43584	g_43585
Super-Scaffold_100012	22499077	22499887	810	g_43585	g_8841
Super-Scaffold_100012	22500388	22500901	513	g_8841	g_8842
Super-Scaffold_100012	22501361	22502286	925	g_8842	g_8843
Super-Scaffold_100012	22502642	22503528	886	g_8843	g_8844
Super-Scaffold_100012	22503993	22508626	4633	g_8844	g_8845
Super-Scaffold_100012	22508991	22509938	947	g_8845	g_8846
Super-Scaffold_100012	22510391	22515276	4885	g_8846	g_8847
Super-Scaffold_100012	22515728	22517113	1385	g_8847	g_8848
Super-Scaffold_100012	22517460	22518406	946	g_8848	g_43586
Super-Scaffold_100012	22518856	22520646	1790	g_43586	g_8849
Super-Scaffold_100012	22521142	22522063	921	g_8849	g_43587
Super-Scaffold_100012	22522507	22523321	814	g_43587	g_43588
Super-Scaffold_100012	22523771	22524684	913	g_43588	g_43589
Super-Scaffold_100012	22525137	22529482	4345	g_43589	g_43590
Super-Scaffold_100012	22529935	22535453	5518	g_43590	g_8852
Super-Scaffold_100012	22535903	22536709	806	g_8852	g_43591
Super-Scaffold_100012	22537155	22537665	510	g_43591	g_8853
Super-Scaffold_100012	22538181	22539104	923	g_8853	g_8854
Super-Scaffold_100012	22539548	22540384	836	g_8854	g_43592
Super-Scaffold_100012	22540837	22541659	822	g_43592	g_43593
Super-Scaffold_100012	22542196	22543019	823	g_43593	g_43594
Super-Scaffold_100012	22543462	22543945	483	g_43594	g_43595
Super-Scaffold_100012	22544151	22544703	552	g_43595	g_8855
Super-Scaffold_100012	22545101	22545277	176	g_8855	g_8856
Super-Scaffold_100012	22545720	22565016	19296	g_8856	g_8858
Super-Scaffold_100012	22565463	22568133	2670	g_8858	g_43596
Super-Scaffold_100012	22568583	22571577	2994	g_43596	g_43597
Super-Scaffold_100012	22572020	22572518	498	g_43597	g_8859
Super-Scaffold_100012	22573070	22573995	925	g_8859	g_43598
Super-Scaffold_100012	22574439	22575251	812	g_43598	g_43599
Super-Scaffold_100012	22575704	22576513	809	g_43599	g_43600
Super-Scaffold_100012	22576956	22577937	981	g_43600	g_8860
Super-Scaffold_100012	22579206	22581174	1968	g_8860	g_8861
Super-Scaffold_100012	22581623	22583596	1973	g_8861	g_8862
Super-Scaffold_100012	22583961	22584906	945	g_8862	g_43601
Super-Scaffold_100012	22585359	22586150	791	g_43601	g_43602
Super-Scaffold_100012	22586600	22588489	1889	g_43602	g_43603
Super-Scaffold_100012	22588932	22590020	1088	g_43603	g_43604
Super-Scaffold_100012	22590464	22591276	812	g_43604	g_43605
Super-Scaffold_100012	22591726	22592553	827	g_43605	g_43606
Super-Scaffold_100012	22592996	22593479	483	g_43606	g_43607
Super-Scaffold_100012	22593936	22594722	786	g_43607	g_43608
Super-Scaffold_100012	22595172	22598370	3198	g_43608	g_43609
Super-Scaffold_100012	22598816	22600705	1889	g_43609	g_8863
Super-Scaffold_100012	22601061	22601948	887	g_8863	g_43610
Super-Scaffold_100012	22602410	22603868	1458	g_43610	g_43611
Super-Scaffold_100012	22604311	22606279	1968	g_43611	g_8864
Super-Scaffold_100012	22606723	22607545	822	g_8864	g_43612
Super-Scaffold_100012	22608010	22608821	811	g_43612	g_43613
Super-Scaffold_100012	22609264	22611027	1763	g_43613	g_43614
Super-Scaffold_100012	22611486	22612319	833	g_43614	g_43615
Super-Scaffold_100012	22612765	22614292	1527	g_43615	g_8865
Super-Scaffold_100012	22614748	22616929	2181	g_8865	g_8866
Super-Scaffold_100012	22617294	22618249	955	g_8866	g_43616
Super-Scaffold_100012	22618699	22621020	2321	g_43616	g_43617
Super-Scaffold_100012	22621463	22623707	2244	g_43617	g_43618
Super-Scaffold_100012	22624129	22624983	854	g_43618	g_43619
Super-Scaffold_100012	22625433	22626251	818	g_43619	g_43620
Super-Scaffold_100012	22626694	22627139	445	g_43620	g_8867
Super-Scaffold_100012	22627595	22628367	772	g_8867	g_43621
Super-Scaffold_100012	22628829	22636814	7985	g_43621	g_8868
Super-Scaffold_100012	22637264	22639087	1823	g_8868	g_43622
Super-Scaffold_100012	22639533	22641276	1743	g_43622	g_43623
Super-Scaffold_100012	22641729	22643685	1956	g_43623	g_43624
Super-Scaffold_100012	22644129	22645311	1182	g_43624	g_43625
Super-Scaffold_100012	22645754	22646227	473	g_43625	g_8869
Super-Scaffold_100012	22646783	22647705	922	g_8869	g_43626
Super-Scaffold_100012	22648149	22648956	807	g_43626	g_43627
Super-Scaffold_100012	22649406	22652451	3045	g_43627	g_43628
Super-Scaffold_100012	22652939	22653690	751	g_43628	g_8871
Super-Scaffold_100012	22654181	22654975	794	g_8871	g_43629
Super-Scaffold_100012	22655397	22657185	1788	g_43629	g_8872
Super-Scaffold_100012	22657592	22658546	954	g_8872	g_8873
Super-Scaffold_100012	22658996	22663696	4700	g_8873	g_8874
Super-Scaffold_100012	22664034	22667672	3638	g_8874	g_43630
Super-Scaffold_100012	22668119	22669954	1835	g_43630	g_43631
Super-Scaffold_100012	22670380	22671300	920	g_43631	g_8875
Super-Scaffold_100012	22671665	22672611	946	g_8875	g_43632
Super-Scaffold_100012	22673064	22674866	1802	g_43632	g_8876
Super-Scaffold_100012	22675316	22677257	1941	g_8876	g_43633
Super-Scaffold_100012	22677701	22690072	12371	g_43633	g_43634
Super-Scaffold_100012	22690519	22691638	1119	g_43634	g_43635
Super-Scaffold_100012	22693859	22694713	854	g_43635	g_43636
Super-Scaffold_100012	22695163	22695981	818	g_43636	g_43637
Super-Scaffold_100012	22696424	22696869	445	g_43637	g_8877
Super-Scaffold_100012	22697325	22698097	772	g_8877	g_43638
Super-Scaffold_100012	22698559	22706546	7987	g_43638	g_8878
Super-Scaffold_100012	22706996	22708819	1823	g_8878	g_43639
Super-Scaffold_100012	22709265	22711022	1757	g_43639	g_43640
Super-Scaffold_100012	22711463	22713439	1976	g_43640	g_43641
Super-Scaffold_100012	22713883	22714628	745	g_43641	g_43642
Super-Scaffold_100012	22715074	22717098	2024	g_43642	g_8879
Super-Scaffold_100012	22717463	22718413	950	g_8879	g_43643
Super-Scaffold_100012	22718866	22719649	783	g_43643	g_43644
Super-Scaffold_100012	22721187	22721987	800	g_43644	g_43645
Super-Scaffold_100012	22722430	22723001	571	g_43645	g_8880
Super-Scaffold_100012	22723461	22724386	925	g_8880	g_8881
Super-Scaffold_100012	22724742	22725627	885	g_8881	g_43646
Super-Scaffold_100012	22726092	22726902	810	g_43646	g_43647
Super-Scaffold_100012	22727348	22729042	1694	g_43647	g_8882
Super-Scaffold_100012	22729413	22730361	948	g_8882	g_43648
Super-Scaffold_100012	22730811	22731621	810	g_43648	g_43649
Super-Scaffold_100012	22732064	22732624	560	g_43649	g_8883
Super-Scaffold_100012	22733003	22733795	792	g_8883	g_8884
Super-Scaffold_100012	22734310	22736282	1972	g_8884	g_43650
Super-Scaffold_100012	22736731	22739969	3238	g_43650	g_8885
Super-Scaffold_100012	22740175	22741602	1427	g_8885	g_43651
Super-Scaffold_100012	22742048	22742596	548	g_43651	g_8886
Super-Scaffold_100012	22742934	22746401	3467	g_8886	g_43652
Super-Scaffold_100012	22746851	22748690	1839	g_43652	g_8887
Super-Scaffold_100012	22749116	22750076	960	g_8887	g_8888
Super-Scaffold_100012	22750441	22751389	948	g_8888	g_43653
Super-Scaffold_100012	22751842	22753644	1802	g_43653	g_8889
Super-Scaffold_100012	22754094	22756031	1937	g_8889	g_43654
Super-Scaffold_100012	22756475	22757283	808	g_43654	g_43655
Super-Scaffold_100012	22757726	22768849	11123	g_43655	g_43656
Super-Scaffold_100012	22769296	22770117	821	g_43656	g_43657
Super-Scaffold_100012	22770563	22772586	2023	g_43657	g_8890
Super-Scaffold_100012	22772963	22773921	958	g_8890	g_43658
Super-Scaffold_100012	22774361	22775188	827	g_43658	g_8891
Super-Scaffold_100012	22775918	22777943	2025	g_8891	g_8892
Super-Scaffold_100012	22778308	22779972	1664	g_8892	g_8893
Super-Scaffold_100012	22780505	22780581	76	g_8893	g_8894
Super-Scaffold_100012	22781024	22798958	17934	g_8894	g_8897
Super-Scaffold_100012	22799405	22803556	4151	g_8897	g_8900
Super-Scaffold_100012	22803978	22804835	857	g_8900	g_8901
Super-Scaffold_100012	22805285	22806099	814	g_8901	g_8902
Super-Scaffold_100012	22806542	22807013	471	g_8902	g_8903
Super-Scaffold_100012	22807463	22808277	814	g_8903	g_8904
Super-Scaffold_100012	22808720	22810417	1697	g_8904	g_8906
Super-Scaffold_100012	22810947	22812355	1408	g_8906	g_8907
Super-Scaffold_100012	22812702	22813645	943	g_8907	g_8908
Super-Scaffold_100012	22814107	22815416	1309	g_8908	g_8909
Super-Scaffold_100012	22815874	22824982	9108	g_8909	g_8912
Super-Scaffold_100012	22825432	22826374	942	g_8912	g_8913
Super-Scaffold_100012	22826700	22828478	1778	g_8913	g_8914
Super-Scaffold_100012	22828925	22830860	1935	g_8914	g_8915
Super-Scaffold_100012	22831225	22835026	3801	g_8915	g_8917
Super-Scaffold_100012	22835456	22839334	3878	g_8917	g_8918
Super-Scaffold_100012	22839777	22841540	1763	g_8918	g_43659
Super-Scaffold_100012	22842005	22845012	3007	g_43659	g_43660
Super-Scaffold_100012	22845458	22845893	435	g_43660	g_8919
Super-Scaffold_100012	22846350	22847135	785	g_8919	g_43661
Super-Scaffold_100012	22847581	22848493	912	g_43661	g_8920
Super-Scaffold_100012	22854415	22856281	1866	g_8920	g_43662
Super-Scaffold_100012	22856730	22857662	932	g_43662	g_8921
Super-Scaffold_100012	22858276	22859060	784	g_41459	g_8922
Super-Scaffold_100012	22860649	22864847	4198	g_8922	g_8923
Super-Scaffold_100012	22865306	22866208	902	g_8923	g_8924
Super-Scaffold_100012	22866658	22869549	2891	g_8924	g_43663
Super-Scaffold_100012	22869992	22871967	1975	g_43663	g_43664
Super-Scaffold_100012	22873674	22874491	817	g_43664	g_8925
Super-Scaffold_100012	22874787	22879960	5173	g_8925	g_8926
Super-Scaffold_100012	22880382	22882404	2022	g_8926	g_8927
Super-Scaffold_100012	22882769	22883710	941	g_8927	g_43665
Super-Scaffold_100012	22884171	22886072	1901	g_43665	g_43666
Super-Scaffold_100012	22886525	22889239	2714	g_43666	g_43667
Super-Scaffold_100012	22889698	22890540	842	g_43667	g_43668
Super-Scaffold_100012	22890983	22892945	1962	g_43668	g_43669
Super-Scaffold_100012	22893389	22894200	811	g_43669	g_43670
Super-Scaffold_100012	22894650	22895616	966	g_43670	g_43671
Super-Scaffold_100012	22895921	22899473	3552	g_43671	g_8928
Super-Scaffold_100012	22899790	22900262	472	g_8928	g_8929
Super-Scaffold_100012	22900828	22900881	53	g_8929	g_8930
Super-Scaffold_100012	22901609	22901645	36	g_8930	g_8931
Super-Scaffold_100012	22901848	22903094	1246	g_8931	g_8932
Super-Scaffold_100012	22903720	22905712	1992	g_8932	g_8933
Super-Scaffold_100012	22906162	22908101	1939	g_8933	g_8934
Super-Scaffold_100012	22908545	22909354	809	g_8934	g_8935
Super-Scaffold_100012	22909797	22915020	5223	g_8935	g_8936
Super-Scaffold_100012	22915467	22916290	823	g_8936	g_8937
Super-Scaffold_100012	22916733	22917174	441	g_8937	g_8938
Super-Scaffold_100012	22917631	22918412	781	g_8938	g_8939
Super-Scaffold_100012	22918844	22919635	791	g_8939	g_8940
Super-Scaffold_100012	22920084	22920651	567	g_8940	g_8941
Super-Scaffold_100012	22921067	22921954	887	g_8941	g_8942
Super-Scaffold_100012	22922397	22924594	2197	g_8942	g_8943
Super-Scaffold_100012	22925044	22925870	826	g_8943	g_8944
Super-Scaffold_100012	22926313	22926796	483	g_8944	g_8945
Super-Scaffold_100012	22927253	22928039	786	g_8945	g_8946
Super-Scaffold_100012	22928489	22931677	3188	g_8946	g_8947
Super-Scaffold_100012	22932123	22932667	544	g_8947	g_8948
Super-Scaffold_100012	22933169	22937407	4238	g_8948	g_43672
Super-Scaffold_100012	22937851	22938666	815	g_43672	g_8949
Super-Scaffold_100012	22939116	22939943	827	g_8949	g_8950
Super-Scaffold_100012	22940386	22943293	2907	g_8950	g_8951
Super-Scaffold_100012	22943731	22944521	790	g_8951	g_8952
Super-Scaffold_100012	22944886	22945839	953	g_8952	g_8953
Super-Scaffold_100012	22946289	22947101	812	g_8953	g_43673
Super-Scaffold_100012	22947547	22949225	1678	g_43673	g_8955
Super-Scaffold_100012	22949675	22950405	730	g_8955	g_8956
Super-Scaffold_100012	22950914	22952682	1768	g_8956	g_8957
Super-Scaffold_100012	22953128	22953642	514	g_8957	g_8958
Super-Scaffold_100012	22954177	22955101	924	g_8958	g_8959
Super-Scaffold_100012	22955545	22956359	814	g_8959	g_8960
Super-Scaffold_100012	22956809	22957719	910	g_8960	g_43674
Super-Scaffold_100012	22958172	22959005	833	g_43674	g_8961
Super-Scaffold_100012	22959448	22961524	2076	g_8961	g_8962
Super-Scaffold_100012	22961974	22966191	4217	g_8962	g_8963
Super-Scaffold_100012	22966629	22967419	790	g_8963	g_8964
Super-Scaffold_100012	22967784	22968746	962	g_8964	g_8965
Super-Scaffold_100012	22969199	22972315	3116	g_8965	g_8966
Super-Scaffold_100012	22972758	22974393	1635	g_8966	g_8967
Super-Scaffold_100012	22974840	22976782	1942	g_8967	g_43675
Super-Scaffold_100012	22977147	22981453	4306	g_43675	g_8969
Super-Scaffold_100012	22981839	22984221	2382	g_8969	g_8970
Super-Scaffold_100012	22984674	22985584	910	g_8970	g_43676
Super-Scaffold_100012	22986034	22992278	6244	g_43676	g_43677
Super-Scaffold_100012	22992721	23003362	10641	g_43677	g_8971
Super-Scaffold_100012	23003778	23003954	176	g_8971	g_8972
Super-Scaffold_100012	23004397	23020609	16212	g_8972	g_8973
Super-Scaffold_100012	23021062	23025250	4188	g_8973	g_43678
Super-Scaffold_100012	23025688	23026480	792	g_43678	g_8974
Super-Scaffold_100012	23026845	23027799	954	g_8974	g_43679
Super-Scaffold_100012	23028252	23030194	1942	g_43679	g_43680
Super-Scaffold_100012	23030400	23034743	4343	g_43680	g_8975
Super-Scaffold_100012	23035190	23035964	774	g_8975	g_43681
Super-Scaffold_100012	23036413	23037897	1484	g_43681	g_43682
Super-Scaffold_100012	23038337	23040366	2029	g_43682	g_43683
Super-Scaffold_100012	23040788	23041644	856	g_43683	g_43684
Super-Scaffold_100012	23042094	23042942	848	g_43684	g_43685
Super-Scaffold_100012	23043364	23043960	596	g_43685	g_8976
Super-Scaffold_100012	23044297	23044886	589	g_8976	g_43686
Super-Scaffold_100012	23045342	23046269	927	g_43686	g_43687
Super-Scaffold_100012	23046815	23047732	917	g_43687	g_8978
Super-Scaffold_100012	23049418	23050681	1263	g_8977	g_43688
Super-Scaffold_100012	23051046	23052096	1050	g_43688	g_8979
Super-Scaffold_100012	23052626	23053541	915	g_8979	g_8980
Super-Scaffold_100012	23054000	23054810	810	g_8980	g_43689
Super-Scaffold_100012	23055253	23057206	1953	g_43689	g_8981
Super-Scaffold_100012	23058915	23059868	953	g_8982	g_8983
Super-Scaffold_100012	23060191	23063110	2919	g_8983	g_8984
Super-Scaffold_100012	23063553	23063998	445	g_8984	g_8985
Super-Scaffold_100012	23064456	23065241	785	g_8985	g_8986
Super-Scaffold_100012	23065691	23066484	793	g_8986	g_8987
Super-Scaffold_100012	23066933	23068813	1880	g_8987	g_8988
Super-Scaffold_100012	23069256	23070344	1088	g_8988	g_8989
Super-Scaffold_100012	23070788	23071600	812	g_8989	g_8990
Super-Scaffold_100012	23072050	23072877	827	g_8990	g_8991
Super-Scaffold_100012	23073320	23073803	483	g_8991	g_8992
Super-Scaffold_100012	23074260	23075046	786	g_8992	g_8993
Super-Scaffold_100012	23075496	23078684	3188	g_8993	g_8994
Super-Scaffold_100012	23079130	23079674	544	g_8994	g_8995
Super-Scaffold_100012	23080176	23084414	4238	g_8995	g_43690
Super-Scaffold_100012	23084858	23085673	815	g_43690	g_8996
Super-Scaffold_100012	23086123	23086950	827	g_8996	g_8997
Super-Scaffold_100012	23087393	23090300	2907	g_8997	g_8998
Super-Scaffold_100012	23090738	23091528	790	g_8998	g_8999
Super-Scaffold_100012	23091893	23092846	953	g_8999	g_9000
Super-Scaffold_100012	23093296	23094108	812	g_9000	g_9001
Super-Scaffold_100012	23094554	23096232	1678	g_9001	g_9003
Super-Scaffold_100012	23096682	23097412	730	g_9003	g_9004
Super-Scaffold_100012	23097921	23099689	1768	g_9004	g_9005
Super-Scaffold_100012	23100135	23100649	514	g_9005	g_9006
Super-Scaffold_100012	23101184	23102108	924	g_9006	g_9007
Super-Scaffold_100012	23102552	23103366	814	g_9007	g_9008
Super-Scaffold_100012	23103816	23104726	910	g_9008	g_9009
Super-Scaffold_100012	23105179	23106012	833	g_9009	g_9010
Super-Scaffold_100012	23106455	23108531	2076	g_9010	g_9011
Super-Scaffold_100012	23108981	23113206	4225	g_9011	g_9012
Super-Scaffold_100012	23113644	23114434	790	g_9012	g_9013
Super-Scaffold_100012	23114799	23115761	962	g_9013	g_9014
Super-Scaffold_100012	23116214	23117008	794	g_9014	g_43691
Super-Scaffold_100012	23117457	23118206	749	g_43691	g_9015
Super-Scaffold_100012	23118553	23119332	779	g_9015	g_43692
Super-Scaffold_100012	23119775	23121410	1635	g_43692	g_9016
Super-Scaffold_100012	23121857	23123799	1942	g_9016	g_43693
Super-Scaffold_100012	23124164	23128413	4249	g_43693	g_9017
Super-Scaffold_100012	23128856	23131099	2243	g_9017	g_43694
Super-Scaffold_100012	23131521	23132375	854	g_43694	g_43695
Super-Scaffold_100012	23132825	23133643	818	g_43695	g_43696
Super-Scaffold_100012	23134086	23134531	445	g_43696	g_9018
Super-Scaffold_100012	23134987	23135759	772	g_9018	g_43697
Super-Scaffold_100012	23136221	23136830	609	g_43697	g_43698
Super-Scaffold_100012	23137351	23138044	693	g_43698	g_43699
Super-Scaffold_100012	23138490	23140247	1757	g_43699	g_43700
Super-Scaffold_100012	23140688	23142644	1956	g_43700	g_43701
Super-Scaffold_100012	23143088	23143833	745	g_43701	g_43702
Super-Scaffold_100012	23144279	23146301	2022	g_43702	g_9019
Super-Scaffold_100012	23146666	23147617	951	g_9019	g_9020
Super-Scaffold_100012	23148070	23148853	783	g_9020	g_43703
Super-Scaffold_100012	23150391	23151202	811	g_43703	g_43704
Super-Scaffold_100012	23151645	23153680	2035	g_43704	g_43705
Super-Scaffold_100012	23154102	23157097	2995	g_43705	g_43706
Super-Scaffold_100012	23157547	23158457	910	g_43706	g_9022
Super-Scaffold_100012	23158885	23159715	830	g_9022	g_43707
Super-Scaffold_100012	23160155	23161879	1724	g_43707	g_43708
Super-Scaffold_100012	23162329	23163139	810	g_43708	g_43709
Super-Scaffold_100012	23163582	23164153	571	g_43709	g_9024
Super-Scaffold_100012	23164613	23165538	925	g_9024	g_9025
Super-Scaffold_100012	23165894	23166818	924	g_9025	g_43710
Super-Scaffold_100012	23167268	23168079	811	g_43710	g_43711
Super-Scaffold_100012	23168525	23170288	1763	g_43711	g_43712
Super-Scaffold_100012	23170747	23171580	833	g_43712	g_43713
Super-Scaffold_100012	23172026	23173553	1527	g_43713	g_43714
Super-Scaffold_100012	23174006	23174939	933	g_43714	g_43715
Super-Scaffold_100012	23175485	23176402	917	g_43715	g_43716
Super-Scaffold_100012	23176846	23177659	813	g_43716	g_43717
Super-Scaffold_100012	23178109	23181135	3026	g_43717	g_43718
Super-Scaffold_100012	23181581	23182332	751	g_43718	g_9027
Super-Scaffold_100012	23182823	23185401	2578	g_9027	g_43719
Super-Scaffold_100012	23185852	23186706	854	g_43719	g_9029
Super-Scaffold_100012	23187113	23188067	954	g_9029	g_43720
Super-Scaffold_100012	23188517	23192136	3619	g_43720	g_43721
Super-Scaffold_100012	23192579	23196274	3695	g_43721	g_9030
Super-Scaffold_100012	23199290	23201995	2705	g_9030	g_9031
Super-Scaffold_100012	23204736	23207312	2576	g_9031	g_9032
Super-Scaffold_100012	23228365	23232348	3983	g_9032	g_43722
Super-Scaffold_100012	23235028	23237599	2571	g_43722	g_43723
Super-Scaffold_100012	23242422	23244077	1655	g_43723	g_9033
Super-Scaffold_100012	23265619	23267297	1678	g_9033	g_43724
Super-Scaffold_100012	23270094	23271729	1635	g_43724	g_9034
Super-Scaffold_100012	23277603	23290941	13338	g_9034	g_9036
Super-Scaffold_100012	23300908	23303236	2328	g_9036	g_43725
Super-Scaffold_100012	23321954	23326192	4238	g_43725	g_9037
Super-Scaffold_100012	23329994	23332540	2546	g_9037	g_9038
Super-Scaffold_100012	23342167	23347697	5530	g_9038	g_9039
Super-Scaffold_100012	23354033	23355233	1200	g_9039	g_9040
Super-Scaffold_100012	23357728	23358998	1270	g_9040	g_9041
Super-Scaffold_100012	23360720	23361595	875	g_9041	g_9042
Super-Scaffold_100012	23364826	23365709	883	g_9042	g_9043
Super-Scaffold_100012	23370668	23378778	8110	g_9043	g_9044
Super-Scaffold_100012	23380061	23390753	10692	g_9044	g_9045
Super-Scaffold_100012	23402749	23403866	1117	g_9045	g_9046
Super-Scaffold_100012	23406835	23408823	1988	g_9046	g_9047
Super-Scaffold_100012	23411707	23415185	3478	g_9047	g_43726
Super-Scaffold_100012	23417180	23420593	3413	g_43726	g_9048
Super-Scaffold_100012	23423203	23426754	3551	g_9048	g_9049
Super-Scaffold_100012	23443666	23446053	2387	g_9049	g_9050
Super-Scaffold_100012	23449178	23454826	5648	g_9050	g_9051
Super-Scaffold_100012	23455083	23455251	168	g_9051	g_9052
Super-Scaffold_100012	23485979	23488968	2989	g_9052	g_9053
Super-Scaffold_100012	23492179	23493471	1292	g_9053	g_43727
Super-Scaffold_100012	23494639	23498742	4103	g_43727	g_9054
Super-Scaffold_100012	23502137	23504971	2834	g_9054	g_9055
Super-Scaffold_100012	23510048	23514594	4546	g_9055	g_9056
Super-Scaffold_100012	23518042	23522502	4460	g_9056	g_9057
Super-Scaffold_100012	23528433	23536511	8078	g_9057	g_9058
Super-Scaffold_100012	23545304	23546409	1105	g_9058	g_9059
Super-Scaffold_100012	23550335	23553036	2701	g_9059	g_9060
Super-Scaffold_100012	23560093	23571885	11792	g_9060	g_9061
Super-Scaffold_100012	23592456	23614416	21960	g_9061	g_9062
Super-Scaffold_100012	23623824	23647954	24130	g_9062	g_9064
Super-Scaffold_100012	23655552	23664214	8662	g_9064	g_9065
Super-Scaffold_100012	23680867	23683081	2214	g_9065	g_9066
Super-Scaffold_100012	23689739	23694566	4827	g_9066	g_9068
Super-Scaffold_100012	23697750	23702501	4751	g_9068	g_9069
Super-Scaffold_100012	23728444	23730799	2355	g_9069	g_9070
Super-Scaffold_100012	23734410	23743528	9118	g_41465	g_9071
Super-Scaffold_100012	23749542	23758212	8670	g_9071	g_9072
Super-Scaffold_100012	23760770	23762194	1424	g_9072	g_9073
Super-Scaffold_100012	23764439	23767670	3231	g_9073	g_9074
Super-Scaffold_100012	23769042	23783434	14392	g_9074	g_9075
Super-Scaffold_100012	23793330	23900554	107224	g_9075	g_9077
Super-Scaffold_100012	23903207	23944135	40928	g_9077	g_9079
Super-Scaffold_100012	23955606	23972115	16509	g_9079	g_9080
Super-Scaffold_100012	23991127	24046204	55077	g_9080	g_9081
Super-Scaffold_100012	24047883	24056819	8936	g_9081	g_9082
Super-Scaffold_100012	24058873	24076922	18049	g_9082	g_9083
Super-Scaffold_100012	24077548	24082549	5001	g_9083	g_9084
Super-Scaffold_100012	24090616	24093346	2730	g_9084	g_9085
Super-Scaffold_100012	24098588	24104698	6110	g_9085	g_43728
Super-Scaffold_100012	24117333	24121056	3723	g_43728	g_9086
Super-Scaffold_100012	24134671	24154321	19650	g_9086	g_9087
Super-Scaffold_100012	24169726	24176710	6984	g_9087	g_9088
Super-Scaffold_100012	24202242	24263942	61700	g_9088	g_9091
Super-Scaffold_100012	24278762	24283146	4384	g_9091	g_9092
Super-Scaffold_100012	24285594	24344680	59086	g_9092	g_41470
Super-Scaffold_100012	24344964	24346380	1416	g_41470	g_9093
Super-Scaffold_100012	24346892	24400847	53955	g_9093	g_9095
Super-Scaffold_100012	24466428	24517266	50838	g_9095	g_9097
Super-Scaffold_100012	24517529	24840090	322561	g_9097	g_9102
Super-Scaffold_100012	24841232	24842601	1369	g_9102	g_9103
Super-Scaffold_100012	24843977	24844032	55	g_9103	g_9104
Super-Scaffold_100012	24844343	24847344	3001	g_9104	g_9105
Super-Scaffold_100012	24847787	24857817	10030	g_9105	g_9106
Super-Scaffold_100012	24859549	24874071	14522	g_9106	g_43729
Super-Scaffold_100012	24879743	24887749	8006	g_43729	g_9108
Super-Scaffold_100012	24889930	24933344	43414	g_9108	g_9109
Super-Scaffold_100012	24942785	24952220	9435	g_9109	g_9111
Super-Scaffold_100012	24963604	24967165	3561	g_9111	g_9112
Super-Scaffold_100012	24967434	24968300	866	g_9112	g_9113
Super-Scaffold_100012	25009680	25018298	8618	g_9113	g_9114
Super-Scaffold_100012	25018984	25159208	140224	g_9114	g_9120
Super-Scaffold_100012	25159432	25177451	18019	g_9120	g_9121
Super-Scaffold_100012	25184050	25202173	18123	g_9121	g_9122
Super-Scaffold_100012	25224319	25268847	44528	g_9122	g_9123
Super-Scaffold_100012	25292345	25299665	7320	g_9123	g_9124
Super-Scaffold_100012	25302093	25303075	982	g_9124	g_9125
Super-Scaffold_100012	25305476	25310852	5376	g_9125	g_9126
Super-Scaffold_100012	25316262	25318649	2387	g_9126	g_9127
Super-Scaffold_100012	25341754	25346341	4587	g_9127	g_9128
Super-Scaffold_100012	25349086	25360838	11752	g_9128	g_9129
Super-Scaffold_100012	25366615	25370002	3387	g_9129	g_9130
Super-Scaffold_100012	25373584	25375303	1719	g_9130	g_9131
Super-Scaffold_100012	25395207	25402331	7124	g_9131	g_43730
Super-Scaffold_100012	25424267	25426735	2468	g_43730	g_9132
Super-Scaffold_100012	25426965	25430554	3589	g_9132	g_9133
Super-Scaffold_100012	25432316	25433575	1259	g_9133	g_9134
Super-Scaffold_100012	25437665	25438460	795	g_9134	g_9135
Super-Scaffold_100012	25440817	25443548	2731	g_9135	g_9136
Super-Scaffold_100012	25459420	25466025	6605	g_9136	g_9137
Super-Scaffold_100012	25472945	25475947	3002	g_9137	g_9138
Super-Scaffold_100012	25477321	25477861	540	g_9138	g_9139
Super-Scaffold_100012	25482248	25494028	11780	g_9139	g_9140
Super-Scaffold_100012	25536577	25536649	72	g_9140	g_9141
Super-Scaffold_100012	25539701	25558977	19276	g_9141	g_9142
Super-Scaffold_100012	25559825	25561159	1334	g_9142	g_9143
Super-Scaffold_100012	25579221	25586063	6842	g_9143	g_41476
Super-Scaffold_100012	25587577	25587897	320	g_41476	g_9145
Super-Scaffold_100012	25605051	25606350	1299	g_9145	g_9146
Super-Scaffold_100012	25610375	25705654	95279	g_9146	g_41477
Super-Scaffold_100012	25708155	25763020	54865	g_41477	g_9148
Super-Scaffold_100012	25763610	25811017	47407	g_9148	g_9149
Super-Scaffold_100012	25840652	25852048	11396	g_9149	g_9151
Super-Scaffold_100012	25858716	25859798	1082	g_9151	g_9152
Super-Scaffold_100012	25863514	25867788	4274	g_9152	g_43731
Super-Scaffold_100012	25869869	25876835	6966	g_43731	g_9153
Super-Scaffold_100012	25882611	25884713	2102	g_9153	g_9154
Super-Scaffold_100012	25892772	25894197	1425	g_9154	g_9155
Super-Scaffold_100012	25903590	25924617	21027	g_9155	g_9156
Super-Scaffold_100012	25935758	25942356	6598	g_9156	g_9157
Super-Scaffold_100012	25960049	25963738	3689	g_9157	g_9158
Super-Scaffold_100012	25966965	26001553	34588	g_9158	g_9159
Super-Scaffold_100012	26001756	26023898	22142	g_9159	g_43732
Super-Scaffold_100012	26037553	26045238	7685	g_43732	g_9160
Super-Scaffold_100012	26058089	26074637	16548	g_9160	g_9161
Super-Scaffold_100012	26074894	26086921	12027	g_9161	g_9162
Super-Scaffold_100012	26090773	26091836	1063	g_9162	g_43733
Super-Scaffold_100012	26102695	26104074	1379	g_43733	g_9163
Super-Scaffold_100012	26109935	26119674	9739	g_9163	g_9164
Super-Scaffold_100012	26121264	26125820	4556	g_9164	g_9165
Super-Scaffold_100012	26132896	26137857	4961	g_9165	g_9166
Super-Scaffold_100012	26142243	26145247	3004	g_9166	g_9167
Super-Scaffold_100012	26147691	26152599	4908	g_9167	g_43734
Super-Scaffold_100012	26157830	26161288	3458	g_43734	g_9168
Super-Scaffold_100012	26163142	26164670	1528	g_9168	g_9169
Super-Scaffold_100012	26166621	26169081	2460	g_9169	g_43735
Super-Scaffold_100012	26172427	26189903	17476	g_43735	g_9170
Super-Scaffold_100012	26196155	26210343	14188	g_9170	g_9171
Super-Scaffold_100012	26211872	26219498	7626	g_9171	g_9172
Super-Scaffold_100012	26225349	26237293	11944	g_9172	g_9173
Super-Scaffold_100012	26237527	26241732	4205	g_41480	g_9174
Super-Scaffold_100012	26261803	26277217	15414	g_9174	g_9175
Super-Scaffold_100012	26294505	26297232	2727	g_9175	g_9176
Super-Scaffold_100012	26309628	26315220	5592	g_9176	g_9177
Super-Scaffold_100012	26324527	26338412	13885	g_9177	g_9179
Super-Scaffold_100012	26355391	26360225	4834	g_9179	g_9180
Super-Scaffold_100012	26369517	26412662	43145	g_9180	g_9181
Super-Scaffold_100012	26413531	26446839	33308	g_9181	g_9182
Super-Scaffold_100012	26448906	26460637	11731	g_9182	g_9183
Super-Scaffold_100012	26465285	26470919	5634	g_9183	g_9184
Super-Scaffold_100012	26472621	26480629	8008	g_9184	g_9185
Super-Scaffold_100012	26483214	26496232	13018	g_9185	g_9187
Super-Scaffold_100012	26552857	26553621	764	g_9187	g_9188
Super-Scaffold_100012	26554469	26555651	1182	g_9188	g_9189
Super-Scaffold_100012	26558968	26578980	20012	g_9189	g_9190
Super-Scaffold_100012	26595463	26610013	14550	g_9190	g_9191
Super-Scaffold_100012	26610324	26612924	2600	g_9191	g_43736
Super-Scaffold_100012	26616090	26617310	1220	g_43736	g_9192
Super-Scaffold_100012	26622885	26625928	3043	g_9192	g_9193
Super-Scaffold_100012	26631638	26634430	2792	g_9193	g_9194
Super-Scaffold_100012	26639090	26639729	639	g_9194	g_9195
Super-Scaffold_100012	26642447	26646882	4435	g_9195	g_9196
Super-Scaffold_100012	26652460	26654595	2135	g_9196	g_9197
Super-Scaffold_100012	26674968	26681546	6578	g_9197	g_9198
Super-Scaffold_100012	26686793	26696803	10010	g_9198	g_9199
Super-Scaffold_100012	26736532	26742147	5615	g_9199	g_9200
Super-Scaffold_100012	26752489	26753748	1259	g_9200	g_9201
Super-Scaffold_100012	26762525	26764960	2435	g_9201	g_9202
Super-Scaffold_100012	26767077	26768075	998	g_9202	g_9203
Super-Scaffold_100012	26777979	26780556	2577	g_9203	g_43737
Super-Scaffold_100012	26788905	26791831	2926	g_43737	g_9204
Super-Scaffold_100012	26812190	26817922	5732	g_9204	g_9205
Super-Scaffold_100012	26822474	26826695	4221	g_9205	g_41483
Super-Scaffold_100012	26826895	26831538	4643	g_41483	g_9206
Super-Scaffold_100012	26833384	26838938	5554	g_9206	g_9207
Super-Scaffold_100012	26852318	26857151	4833	g_9207	g_9208
Super-Scaffold_100012	26861836	26867607	5771	g_9208	g_9209
Super-Scaffold_100012	26870638	26875659	5021	g_9209	g_9210
Super-Scaffold_100012	26884874	26893347	8473	g_9210	g_9211
Super-Scaffold_100012	26911017	26914389	3372	g_9211	g_9212
Super-Scaffold_100012	26919206	26920684	1478	g_9212	g_9213
Super-Scaffold_100012	26927585	26930513	2928	g_9213	g_9214
Super-Scaffold_100012	26936464	26938979	2515	g_9214	g_9215
Super-Scaffold_100012	26940346	26942367	2021	g_9215	g_9216
Super-Scaffold_100012	26946641	26969481	22840	g_9216	g_9218
Super-Scaffold_100012	26994586	26999300	4714	g_9218	g_9219
Super-Scaffold_100012	27015404	27022432	7028	g_9219	g_9220
Super-Scaffold_100012	27029921	27036582	6661	g_9220	g_43738
Super-Scaffold_100012	27047725	27050932	3207	g_43738	g_9221
Super-Scaffold_100012	27059081	27062458	3377	g_9221	g_9222
Super-Scaffold_100012	27066831	27067602	771	g_9222	g_43739
Super-Scaffold_100012	27069102	27072052	2950	g_43739	g_9223
Super-Scaffold_100012	27083438	27084647	1209	g_9223	g_9224
Super-Scaffold_100012	27092856	27094029	1173	g_9224	g_9225
Super-Scaffold_100012	27097643	27109124	11481	g_9225	g_9226
Super-Scaffold_100012	27112380	27135386	23006	g_9226	g_9227
Super-Scaffold_100012	27136762	27142285	5523	g_9227	g_9228
Super-Scaffold_100012	27145530	27147749	2219	g_9228	g_9229
Super-Scaffold_100012	27150575	27153701	3126	g_9229	g_43740
Super-Scaffold_100012	27177553	27221620	44067	g_43740	g_9231
Super-Scaffold_100012	27294059	27301289	7230	g_9231	g_43741
Super-Scaffold_100012	27310008	27312186	2178	g_43741	g_9232
Super-Scaffold_100012	27314048	27315735	1687	g_9232	g_9233
Super-Scaffold_100012	27350938	27355292	4354	g_9233	g_9234
Super-Scaffold_100012	27358904	27360450	1546	g_9234	g_43742
Super-Scaffold_100012	27373663	27392920	19257	g_43742	g_9236
Super-Scaffold_100012	27394801	27400170	5369	g_9236	g_9237
Super-Scaffold_100012	27410777	27412705	1928	g_9237	g_9238
Super-Scaffold_100012	27418369	27421387	3018	g_9238	g_9239
Super-Scaffold_100012	27424170	27425463	1293	g_9239	g_9240
Super-Scaffold_100012	27433301	27434833	1532	g_9240	g_9241
Super-Scaffold_100012	27440810	27445505	4695	g_9241	g_9242
Super-Scaffold_100012	27454953	27458124	3171	g_9242	g_9243
Super-Scaffold_100012	27460179	27529437	69258	g_9243	g_9245
Super-Scaffold_100012	27529943	27559892	29949	g_9245	g_9247
Super-Scaffold_100012	27560137	27572617	12480	g_9247	g_9248
Super-Scaffold_100012	27574131	27688236	114105	g_9248	g_9251
Super-Scaffold_100012	27699303	27708914	9611	g_9251	g_43743
Super-Scaffold_100012	27720989	27723766	2777	g_43743	g_9252
Super-Scaffold_100012	27728418	27749773	21355	g_9252	g_9253
Super-Scaffold_100012	27765603	27768336	2733	g_9253	g_9254
Super-Scaffold_100012	27774703	27782201	7498	g_9254	g_43744
Super-Scaffold_100012	27799783	27803575	3792	g_43744	g_43745
Super-Scaffold_100012	27813292	27830059	16767	g_43745	g_9256
Super-Scaffold_100012	27830316	27830449	133	g_9256	g_9257
Super-Scaffold_100012	27831081	27870556	39475	g_9257	g_9260
Super-Scaffold_100012	27887779	27916261	28482	g_9260	g_9261
Super-Scaffold_100012	27917691	27923391	5700	g_9261	g_9262
Super-Scaffold_100012	27931295	27937573	6278	g_9262	g_9263
Super-Scaffold_100012	27938864	27975043	36179	g_9263	g_9264
Super-Scaffold_100012	27980300	27992588	12288	g_9264	g_9265
Super-Scaffold_100012	27994238	27998332	4094	g_9265	g_9266
Super-Scaffold_100012	28000083	28001382	1299	g_9266	g_9267
Super-Scaffold_100012	28011212	28020677	9465	g_9267	g_9268
Super-Scaffold_100012	28030011	28030690	679	g_9268	g_9269
Super-Scaffold_100012	28035068	28038386	3318	g_9269	g_9270
Super-Scaffold_100012	28043886	28048979	5093	g_9270	g_9271
Super-Scaffold_100012	28060950	28079253	18303	g_9271	g_9272
Super-Scaffold_100012	28081564	28086623	5059	g_9272	g_9273
Super-Scaffold_100012	28088002	28097152	9150	g_9273	g_9274
Super-Scaffold_100012	28107438	28146253	38815	g_9274	g_9275
Super-Scaffold_100012	28151080	28213904	62824	g_9275	g_9276
Super-Scaffold_100012	28215850	28216685	835	g_9276	g_43746
Super-Scaffold_100012	28217476	28239789	22313	g_43746	g_9277
Super-Scaffold_100012	28251857	28277449	25592	g_9277	g_9278
Super-Scaffold_100012	28277733	28311690	33957	g_9278	g_41491
Super-Scaffold_100012	28311998	28347921	35923	g_41491	g_9279
Super-Scaffold_100012	28350257	28355006	4749	g_9279	g_9280
Super-Scaffold_100012	28359324	28393631	34307	g_9280	g_9281
Super-Scaffold_100012	28394734	28413932	19198	g_9281	g_9282
Super-Scaffold_100012	28415629	28433632	18003	g_9282	g_9284
Super-Scaffold_100012	28433838	28464145	30307	g_9284	g_9285
Super-Scaffold_100012	28481129	28494873	13744	g_9285	g_43747
Super-Scaffold_100012	28513648	28525910	12262	g_43747	g_9286
Super-Scaffold_100012	28533022	28536154	3132	g_9286	g_9287
Super-Scaffold_100012	28537738	28541444	3706	g_9287	g_9288
Super-Scaffold_100012	28553329	28555082	1753	g_9288	g_43748
Super-Scaffold_100012	28576410	28578963	2553	g_43748	g_43749
Super-Scaffold_100012	28580842	28641930	61088	g_43749	g_9290
Super-Scaffold_100012	28667063	28687482	20419	g_9290	g_9291
Super-Scaffold_100012	28688762	28692501	3739	g_9291	g_9292
Super-Scaffold_100012	28701656	28733795	32139	g_9292	g_9294
Super-Scaffold_100012	28734046	28746911	12865	g_9294	g_41494
Super-Scaffold_100012	28747111	28786720	39609	g_41494	g_9297
Super-Scaffold_100012	28816914	28827995	11081	g_9297	g_9298
Super-Scaffold_100012	28847197	28854067	6870	g_9298	g_9299
Super-Scaffold_100012	28861730	28887956	26226	g_9299	g_9300
Super-Scaffold_100012	28897806	28899582	1776	g_9300	g_9301
Super-Scaffold_100012	28910664	28913799	3135	g_9301	g_9302
Super-Scaffold_100012	28929341	28946759	17418	g_9302	g_9303
Super-Scaffold_100012	28947583	28951710	4127	g_9303	g_9304
Super-Scaffold_100012	28956266	28985994	29728	g_9304	g_9305
Super-Scaffold_100012	29028349	29033129	4780	g_9305	g_9306
Super-Scaffold_100012	29041613	29048294	6681	g_9306	g_9307
Super-Scaffold_100012	29050763	29053498	2735	g_9307	g_9308
Super-Scaffold_100012	29069930	29083734	13804	g_9308	g_9309
Super-Scaffold_100012	29088715	29094803	6088	g_9309	g_9310
Super-Scaffold_100012	29123696	29208263	84567	g_9310	g_9311
Super-Scaffold_100012	29209222	29218386	9164	g_9311	g_41496
Super-Scaffold_100012	29218616	29230667	12051	g_41496	g_9312
Super-Scaffold_100012	29243306	29291922	48616	g_9312	g_9313
Super-Scaffold_100012	29293649	29314683	21034	g_9313	g_9314
Super-Scaffold_100012	29355009	29366519	11510	g_9314	g_9315
Super-Scaffold_100012	29374432	29431612	57180	g_9315	g_9317
Super-Scaffold_100012	29451984	29461753	9769	g_9317	g_9318
Super-Scaffold_100012	29480303	29482167	1864	g_9318	g_9319
Super-Scaffold_100012	29490788	29500289	9501	g_9319	g_9320
Super-Scaffold_100012	29501491	29569287	67796	g_9320	g_9322
Super-Scaffold_100012	29570153	29589937	19784	g_9322	g_9323
Super-Scaffold_100012	29590329	29613985	23656	g_9323	g_9325
Super-Scaffold_100012	29621009	29623294	2285	g_9325	g_9326
Super-Scaffold_100012	29638212	29642860	4648	g_9326	g_9327
Super-Scaffold_100012	29652150	29683425	31275	g_9327	g_9328
Super-Scaffold_100012	29703427	29707289	3862	g_9328	g_9329
Super-Scaffold_100012	29713047	29749589	36542	g_9329	g_9330
Super-Scaffold_100012	29756857	29759479	2622	g_9330	g_9331
Super-Scaffold_100012	29763364	29764005	641	g_9331	g_9332
Super-Scaffold_100012	29779881	29781654	1773	g_9332	g_9333
Super-Scaffold_100012	29791236	29792629	1393	g_9333	g_9334
Super-Scaffold_100012	29810140	29817302	7162	g_9334	g_43750
Super-Scaffold_100012	29827744	29884204	56460	g_43750	g_9335
Super-Scaffold_100012	29885376	29885420	44	g_9335	g_9336
Super-Scaffold_100012	29886001	29886232	231	g_9336	g_9337
Super-Scaffold_100012	29887197	29894071	6874	g_9337	g_9339
Super-Scaffold_100012	29894280	29894656	376	g_9339	g_9340
Super-Scaffold_100012	29894910	29926158	31248	g_9340	g_9347
Super-Scaffold_100012	29927363	29954107	26744	g_9347	g_9350
Super-Scaffold_100012	29977186	29989897	12711	g_9350	g_43751
Super-Scaffold_100012	30013950	30033419	19469	g_43751	g_9352
Super-Scaffold_100012	30035362	30038596	3234	g_9352	g_9353
Super-Scaffold_100012	30048803	30050258	1455	g_9353	g_9354
Super-Scaffold_100012	30069059	30075159	6100	g_9354	g_9355
Super-Scaffold_100012	30076241	30089876	13635	g_9355	g_9356
Super-Scaffold_100012	30090247	30169315	79068	g_9356	g_9360
Super-Scaffold_100012	30169554	30290088	120534	g_9360	g_9364
Super-Scaffold_100012	30291836	30293538	1702	g_9364	g_43752
Super-Scaffold_100012	30312002	30343139	31137	g_43752	g_41503
Super-Scaffold_100012	30344526	30373807	29281	g_9365	g_9366
Super-Scaffold_100012	30374050	30470170	96120	g_41504	g_9369
Super-Scaffold_100012	30479231	30559019	79788	g_9369	g_41506
Super-Scaffold_100012	30559720	30572749	13029	g_41506	g_9371
Super-Scaffold_100012	30580716	30597369	16653	g_9371	g_9372
Super-Scaffold_100012	30613094	30621443	8349	g_9372	g_9373
Super-Scaffold_100012	30624276	30632123	7847	g_9373	g_9375
Super-Scaffold_100012	30680790	30710628	29838	g_9375	g_43753
Super-Scaffold_100012	30720809	30727366	6557	g_43753	g_9376
Super-Scaffold_100012	30738509	30830842	92333	g_9376	g_9378
Super-Scaffold_100012	30848103	30850253	2150	g_9378	g_9379
Super-Scaffold_100012	30856456	30856639	183	g_9379	g_9380
Super-Scaffold_100012	30856869	30869821	12952	g_9380	g_9381
Super-Scaffold_100012	30871128	30875848	4720	g_9381	g_9382
Super-Scaffold_100012	30877191	30886461	9270	g_9382	g_9383
Super-Scaffold_100012	30893663	30895842	2179	g_9383	g_43754
Super-Scaffold_100012	30914981	30917660	2679	g_43754	g_9384
Super-Scaffold_100012	30919642	30942703	23061	g_9384	g_43755
Super-Scaffold_100012	30943008	30952787	9779	g_43755	g_9385
Super-Scaffold_100012	30953056	30957070	4014	g_9385	g_9386
Super-Scaffold_100012	30957327	31000313	42986	g_9386	g_9388
Super-Scaffold_100012	31000747	31033574	32827	g_9388	g_9389
Super-Scaffold_100012	31033777	31153964	120187	g_9389	g_41511
Super-Scaffold_100012	31154188	31170343	16155	g_41511	g_9393
Super-Scaffold_100012	31181791	31199789	17998	g_9393	g_9394
Super-Scaffold_100012	31201129	31221449	20320	g_9394	g_9395
Super-Scaffold_100012	31226391	31254200	27809	g_9395	g_9398
Super-Scaffold_100012	31274399	31426089	151690	g_9398	g_9400
Super-Scaffold_100012	31434769	31441110	6341	g_9400	g_9401
Super-Scaffold_100012	31459208	31477922	18714	g_9401	g_9403
Super-Scaffold_100012	31482945	31498960	16015	g_9403	g_9404
Super-Scaffold_100012	31499751	31508981	9230	g_9404	g_9405
Super-Scaffold_100012	31524662	31539766	15104	g_9405	g_9407
Super-Scaffold_100012	31542343	31562279	19936	g_9407	g_43756
Super-Scaffold_100012	31562599	31562638	39	g_43756	g_9408
Super-Scaffold_100012	31563189	31563557	368	g_9408	g_9409
Super-Scaffold_100012	31564108	31567383	3275	g_9409	g_9410
Super-Scaffold_100012	31576106	31581453	5347	g_9410	g_9411
Super-Scaffold_100012	31585569	31592622	7053	g_9411	g_9412
Super-Scaffold_100012	31601056	31605578	4522	g_9412	g_9413
Super-Scaffold_100012	31609943	31613863	3920	g_9413	g_9414
Super-Scaffold_100012	31618581	31619526	945	g_9414	g_9415
Super-Scaffold_100012	31628473	31637565	9092	g_9415	g_43757
Super-Scaffold_100012	31638715	31646192	7477	g_43757	g_43758
Super-Scaffold_100012	31654153	31663960	9807	g_43758	g_9416
Super-Scaffold_100012	31668751	31674947	6196	g_9416	g_9417
Super-Scaffold_100012	31675195	31723315	48120	g_9417	g_9418
Super-Scaffold_100012	31729509	31735439	5930	g_9418	g_9419
Super-Scaffold_100012	31741704	31770936	29232	g_9419	g_9420
Super-Scaffold_100012	31777510	31779757	2247	g_9420	g_9421
Super-Scaffold_100012	31792312	31801034	8722	g_9421	g_9422
Super-Scaffold_100012	31802938	31814574	11636	g_9422	g_9423
Super-Scaffold_100012	31834080	31840401	6321	g_9423	g_9424
Super-Scaffold_100012	31842928	31863347	20419	g_9424	g_9426
Super-Scaffold_100012	31865014	31889617	24603	g_9426	g_9427
Super-Scaffold_100012	31906764	31912745	5981	g_9427	g_9428
Super-Scaffold_100012	31920659	31932131	11472	g_9428	g_9429
Super-Scaffold_100012	31935047	31947711	12664	g_9429	g_43759
Super-Scaffold_100012	31955714	31964907	9193	g_43759	g_9430
Super-Scaffold_100012	31965659	31990776	25117	g_9430	g_9431
Super-Scaffold_100012	31998628	32002476	3848	g_9431	g_9433
Super-Scaffold_100013	17916	31876	13960	g_18554	g_18556
Super-Scaffold_100013	46497	53966	7469	g_18556	g_18557
Super-Scaffold_100013	54340	64572	10232	g_18557	g_18559
Super-Scaffold_100013	64919	64990	71	g_18559	g_18560
Super-Scaffold_100013	65766	69562	3796	g_18560	g_18562
Super-Scaffold_100013	76840	114078	37238	g_18562	g_18563
Super-Scaffold_100013	134772	152747	17975	g_18563	g_18564
Super-Scaffold_100013	162321	165148	2827	g_18564	g_18565
Super-Scaffold_100013	167004	171853	4849	g_18565	g_18566
Super-Scaffold_100013	190214	369719	179505	g_18566	g_18567
Super-Scaffold_100013	376891	556588	179697	g_18567	g_18570
Super-Scaffold_100013	561749	574473	12724	g_38631	g_38632
Super-Scaffold_100013	574838	580838	6000	g_38632	g_18571
Super-Scaffold_100013	589038	593982	4944	g_18571	g_18573
Super-Scaffold_100013	594461	594486	25	g_18573	g_18574
Super-Scaffold_100013	595796	610979	15183	g_18574	g_18575
Super-Scaffold_100013	651236	679836	28600	g_18575	g_18577
Super-Scaffold_100013	697025	770777	73752	g_18577	g_18579
Super-Scaffold_100013	799902	800198	296	g_18579	g_18580
Super-Scaffold_100013	801841	802606	765	g_18580	g_18581
Super-Scaffold_100013	804844	869369	64525	g_18581	g_18587
Super-Scaffold_100013	870319	879827	9508	g_18587	g_18589
Super-Scaffold_100013	880345	888237	7892	g_18589	g_38634
Super-Scaffold_100013	888830	893219	4389	g_38634	g_18592
Super-Scaffold_100013	893865	893932	67	g_18592	g_18591
Super-Scaffold_100013	894216	894661	445	g_18591	g_18593
Super-Scaffold_100013	896250	908323	12073	g_18593	g_18595
Super-Scaffold_100013	908703	910875	2172	g_18595	g_18596
Super-Scaffold_100013	914132	925565	11433	g_18596	g_18598
Super-Scaffold_100013	926050	926099	49	g_18598	g_18599
Super-Scaffold_100013	926434	926485	51	g_18599	g_18600
Super-Scaffold_100013	926877	936647	9770	g_18600	g_18602
Super-Scaffold_100013	937021	949187	12166	g_18602	g_18603
Super-Scaffold_100013	950044	950509	465	g_18603	g_18604
Super-Scaffold_100013	951765	974436	22671	g_18604	g_18605
Super-Scaffold_100013	975581	1034326	58745	g_18605	g_18606
Super-Scaffold_100013	1043646	1086838	43192	g_18606	g_18610
Super-Scaffold_100013	1087149	1091176	4027	g_18610	g_18611
Super-Scaffold_100013	1102219	1116830	14611	g_18611	g_18612
Super-Scaffold_100013	1134627	1148803	14176	g_18612	g_18614
Super-Scaffold_100013	1152237	1236572	84335	g_18614	g_18615
Super-Scaffold_100013	1239477	1267883	28406	g_18615	g_18618
Super-Scaffold_100013	1268884	1292443	23559	g_18618	g_18620
Super-Scaffold_100013	1292652	1313377	20725	g_18620	g_18621
Super-Scaffold_100013	1313700	1314278	578	g_18621	g_18622
Super-Scaffold_100013	1314541	1314568	27	g_18622	g_18623
Super-Scaffold_100013	1314891	1315874	983	g_18623	g_18624
Super-Scaffold_100013	1331753	1339613	7860	g_18624	g_18625
Super-Scaffold_100013	1347128	1369091	21963	g_38639	g_18626
Super-Scaffold_100013	1370825	1375952	5127	g_18626	g_18627
Super-Scaffold_100013	1379760	1419478	39718	g_38640	g_18628
Super-Scaffold_100013	1423845	1428356	4511	g_18628	g_18629
Super-Scaffold_100013	1429430	1442054	12624	g_18629	g_18630
Super-Scaffold_100013	1443239	1445488	2249	g_18630	g_18631
Super-Scaffold_100013	1455659	1466390	10731	g_18631	g_18632
Super-Scaffold_100013	1471278	1475290	4012	g_18632	g_18633
Super-Scaffold_100013	1496600	1505226	8626	g_18633	g_44451
Super-Scaffold_100013	1515415	1518411	2996	g_44451	g_18634
Super-Scaffold_100013	1520054	1527779	7725	g_18634	g_38641
Super-Scaffold_100013	1528126	1528571	445	g_38641	g_18635
Super-Scaffold_100013	1528916	1528935	19	g_18635	g_18636
Super-Scaffold_100013	1529372	1529399	27	g_18636	g_44452
Super-Scaffold_100013	1529866	1529915	49	g_44452	g_44453
Super-Scaffold_100013	1530520	1548343	17823	g_44453	g_18637
Super-Scaffold_100013	1549986	1565599	15613	g_18637	g_18638
Super-Scaffold_100013	1566370	1567033	663	g_18638	g_18639
Super-Scaffold_100013	1567512	1585024	17512	g_18639	g_18640
Super-Scaffold_100013	1586667	1599881	13214	g_18640	g_18641
Super-Scaffold_100013	1603519	1620057	16538	g_18641	g_18642
Super-Scaffold_100013	1620602	1620651	49	g_18642	g_44454
Super-Scaffold_100013	1621118	1621145	27	g_44454	g_44455
Super-Scaffold_100013	1621672	1621691	19	g_44455	g_18643
Super-Scaffold_100013	1622036	1622481	445	g_18643	g_38643
Super-Scaffold_100013	1622828	1639600	16772	g_38643	g_18644
Super-Scaffold_100013	1641243	1655317	14074	g_18644	g_18646
Super-Scaffold_100013	1661343	1669971	8628	g_18646	g_18647
Super-Scaffold_100013	1679158	1702277	23119	g_18647	g_18649
Super-Scaffold_100013	1704567	1765638	61071	g_38644	g_18652
Super-Scaffold_100013	1766360	1770162	3802	g_18652	g_44456
Super-Scaffold_100013	1795411	1803790	8379	g_44456	g_18653
Super-Scaffold_100013	1812359	1825940	13581	g_18653	g_18654
Super-Scaffold_100013	1826419	1835887	9468	g_18654	g_18655
Super-Scaffold_100013	1841604	1851742	10138	g_38645	g_18656
Super-Scaffold_100013	1851957	1880189	28232	g_18656	g_18658
Super-Scaffold_100013	1888550	1896323	7773	g_18658	g_18659
Super-Scaffold_100013	1901336	1903132	1796	g_18659	g_18660
Super-Scaffold_100013	1910648	1932177	21529	g_18660	g_18662
Super-Scaffold_100013	1940436	1963878	23442	g_18662	g_18663
Super-Scaffold_100013	1967741	1978204	10463	g_18663	g_44457
Super-Scaffold_100013	1992353	2042733	50380	g_44457	g_18666
Super-Scaffold_100013	2043026	2128686	85660	g_18666	g_18668
Super-Scaffold_100013	2149218	2159486	10268	g_18668	g_18669
Super-Scaffold_100013	2160022	2163054	3032	g_18669	g_18670
Super-Scaffold_100013	2187649	2191549	3900	g_18670	g_44458
Super-Scaffold_100013	2214033	2452333	238300	g_44458	g_18673
Super-Scaffold_100013	2454456	2588683	134227	g_18673	g_18675
Super-Scaffold_100013	2589321	2642941	53620	g_18675	g_18677
Super-Scaffold_100013	2643156	2797685	154529	g_18677	g_18683
Super-Scaffold_100013	2807392	2818542	11150	g_18683	g_38657
Super-Scaffold_100013	2820717	2849368	28651	g_18685	g_18687
Super-Scaffold_100013	2861338	2867258	5920	g_18687	g_18688
Super-Scaffold_100013	2875835	2879024	3189	g_18688	g_44459
Super-Scaffold_100013	2884727	2906966	22239	g_44459	g_18690
Super-Scaffold_100013	2907211	2907593	382	g_18690	g_18691
Super-Scaffold_100013	2907901	2915475	7574	g_18691	g_18689
Super-Scaffold_100013	2921940	2924471	2531	g_18689	g_44460
Super-Scaffold_100013	2926547	2932252	5705	g_44460	g_44461
Super-Scaffold_100013	2934264	2952254	17990	g_44461	g_18694
Super-Scaffold_100013	2954255	2978546	24291	g_18694	g_44462
Super-Scaffold_100013	2980529	2986266	5737	g_44462	g_44463
Super-Scaffold_100013	2988279	2992578	4299	g_44463	g_18695
Super-Scaffold_100013	3003409	3014679	11270	g_18695	g_44464
Super-Scaffold_100013	3016917	3019849	2932	g_44464	g_18696
Super-Scaffold_100013	3020724	3030170	9446	g_18696	g_18697
Super-Scaffold_100013	3041986	3044363	2377	g_18697	g_18698
Super-Scaffold_100013	3047775	3050090	2315	g_18698	g_18699
Super-Scaffold_100013	3059290	3075665	16375	g_18699	g_18700
Super-Scaffold_100013	3077377	3087251	9874	g_18700	g_18701
Super-Scaffold_100013	3090714	3100235	9521	g_18701	g_18702
Super-Scaffold_100013	3100546	3102755	2209	g_18702	g_18703
Super-Scaffold_100013	3103135	3105586	2451	g_18703	g_18704
Super-Scaffold_100013	3105996	3107106	1110	g_18704	g_18705
Super-Scaffold_100013	3107873	3114789	6916	g_18705	g_18706
Super-Scaffold_100013	3115400	3125303	9903	g_18706	g_18708
Super-Scaffold_100013	3125713	3129959	4246	g_18708	g_18709
Super-Scaffold_100013	3130342	3131734	1392	g_18709	g_18710
Super-Scaffold_100013	3132114	3135923	3809	g_18710	g_18711
Super-Scaffold_100013	3136234	3137426	1192	g_18711	g_18712
Super-Scaffold_100013	3137809	3141184	3375	g_18712	g_18713
Super-Scaffold_100013	3141564	3143501	1937	g_18713	g_18714
Super-Scaffold_100013	3143881	3144948	1067	g_18714	g_18715
Super-Scaffold_100013	3145331	3146755	1424	g_18715	g_18716
Super-Scaffold_100013	3147165	3153135	5970	g_18716	g_18717
Super-Scaffold_100013	3153863	3158057	4194	g_18717	g_18718
Super-Scaffold_100013	3158311	3164838	6527	g_18718	g_18719
Super-Scaffold_100013	3165221	3168895	3674	g_18719	g_18720
Super-Scaffold_100013	3169275	3177050	7775	g_18720	g_18721
Super-Scaffold_100013	3177430	3179294	1864	g_18721	g_18722
Super-Scaffold_100013	3179677	3183794	4117	g_18722	g_18723
Super-Scaffold_100013	3184417	3193144	8727	g_18723	g_18724
Super-Scaffold_100013	3193524	3195152	1628	g_18724	g_18725
Super-Scaffold_100013	3195562	3196532	970	g_18725	g_18726
Super-Scaffold_100013	3197152	3202194	5042	g_18726	g_18727
Super-Scaffold_100013	3202505	3214148	11643	g_18727	g_18729
Super-Scaffold_100013	3214531	3217649	3118	g_18729	g_18730
Super-Scaffold_100013	3218059	3219171	1112	g_18730	g_18731
Super-Scaffold_100013	3219551	3222616	3065	g_18731	g_18732
Super-Scaffold_100013	3222996	3224965	1969	g_18732	g_18733
Super-Scaffold_100013	3225276	3234524	9248	g_18733	g_18734
Super-Scaffold_100013	3237032	3277651	40619	g_18734	g_18735
Super-Scaffold_100013	3280432	3288120	7688	g_18735	g_18737
Super-Scaffold_100013	3291929	3297831	5902	g_18737	g_18739
Super-Scaffold_100013	3364244	3477409	113165	g_18739	g_18741
Super-Scaffold_100013	3479064	3488556	9492	g_18741	g_18742
Super-Scaffold_100013	3518958	3532221	13263	g_18742	g_18744
Super-Scaffold_100013	3533069	3543484	10415	g_18744	g_18745
Super-Scaffold_100013	3556919	3562073	5154	g_18745	g_18746
Super-Scaffold_100013	3584967	3591555	6588	g_18746	g_18747
Super-Scaffold_100013	3610187	3739572	129385	g_18747	g_18749
Super-Scaffold_100013	3740450	3740494	44	g_18749	g_18750
Super-Scaffold_100013	3741078	3742850	1772	g_18750	g_18751
Super-Scaffold_100013	3744496	3751786	7290	g_18751	g_18752
Super-Scaffold_100013	3753390	3759452	6062	g_18752	g_18753
Super-Scaffold_100013	3761083	3788343	27260	g_18753	g_44465
Super-Scaffold_100013	3789989	3796691	6702	g_44465	g_18754
Super-Scaffold_100013	3798295	3804321	6026	g_18754	g_18755
Super-Scaffold_100013	3805961	3858100	52139	g_18755	g_18756
Super-Scaffold_100013	3876834	3887349	10515	g_18756	g_18757
Super-Scaffold_100013	3901365	3928311	26946	g_18759	g_18760
Super-Scaffold_100013	3929102	3940423	11321	g_18760	g_18762
Super-Scaffold_100013	3942081	3950483	8402	g_18762	g_18763
Super-Scaffold_100013	3993819	4013518	19699	g_18763	g_44466
Super-Scaffold_100013	4013751	4015408	1657	g_44466	g_18764
Super-Scaffold_100013	4015860	4025581	9721	g_18764	g_18765
Super-Scaffold_100013	4025838	4033997	8159	g_18765	g_18766
Super-Scaffold_100013	4068153	4072572	4419	g_18766	g_18767
Super-Scaffold_100013	4073645	4081547	7902	g_18767	g_18768
Super-Scaffold_100013	4083205	4089829	6624	g_18768	g_18769
Super-Scaffold_100013	4091481	4099128	7647	g_18769	g_18770
Super-Scaffold_100013	4100789	4108240	7451	g_18770	g_18771
Super-Scaffold_100013	4109907	4117317	7410	g_18771	g_18772
Super-Scaffold_100013	4118984	4126052	7068	g_18772	g_18773
Super-Scaffold_100013	4127707	4135636	7929	g_18773	g_18774
Super-Scaffold_100013	4137303	4167646	30343	g_18774	g_18775
Super-Scaffold_100013	4169307	4175491	6184	g_18775	g_18776
Super-Scaffold_100013	4177143	4185132	7989	g_18776	g_18777
Super-Scaffold_100013	4186799	4195194	8395	g_18777	g_18778
Super-Scaffold_100013	4196844	4211405	14561	g_18778	g_18779
Super-Scaffold_100013	4213066	4219893	6827	g_18779	g_18780
Super-Scaffold_100013	4221554	4228515	6961	g_18780	g_18781
Super-Scaffold_100013	4230182	4237777	7595	g_18781	g_18782
Super-Scaffold_100013	4257186	4264092	6906	g_18782	g_18783
Super-Scaffold_100013	4265165	4276201	11036	g_18783	g_18784
Super-Scaffold_100013	4283679	4288626	4947	g_18784	g_18785
Super-Scaffold_100013	4290272	4297478	7206	g_18785	g_18786
Super-Scaffold_100013	4299145	4305280	6135	g_18786	g_18787
Super-Scaffold_100013	4306941	4332135	25194	g_18787	g_18788
Super-Scaffold_100013	4333784	4343926	10142	g_18788	g_18789
Super-Scaffold_100013	4345596	4427807	82211	g_18789	g_38665
Super-Scaffold_100013	4428031	4471412	43381	g_38665	g_18791
Super-Scaffold_100013	4471705	4563963	92258	g_18791	g_18793
Super-Scaffold_100013	4567117	4577209	10092	g_18793	g_18794
Super-Scaffold_100013	4583758	4617138	33380	g_18794	g_44467
Super-Scaffold_100013	4652271	4660092	7821	g_44467	g_44468
Super-Scaffold_100013	4697426	4700456	3030	g_44468	g_18795
Super-Scaffold_100013	4726263	4845908	119645	g_18795	g_18796
Super-Scaffold_100013	4851423	4949820	98397	g_18796	g_18798
Super-Scaffold_100013	4951040	4956559	5519	g_18798	g_44469
Super-Scaffold_100013	4957779	5135784	178005	g_44469	g_18800
Super-Scaffold_100013	5136041	5192936	56895	g_18800	g_18801
Super-Scaffold_100013	5194675	5204507	9832	g_18801	g_38671
Super-Scaffold_100013	5206676	5209288	2612	g_18802	g_18803
Super-Scaffold_100013	5219002	5240148	21146	g_18803	g_18805
Super-Scaffold_100013	5253486	5306739	53253	g_18805	g_18807
Super-Scaffold_100013	5307744	5453056	145312	g_18807	g_18810
Super-Scaffold_100013	5481386	5490877	9491	g_18810	g_18811
Super-Scaffold_100013	5491263	5512173	20910	g_18811	g_38672
Super-Scaffold_100013	5512403	5677891	165488	g_38672	g_18815
Super-Scaffold_100013	5678322	5679231	909	g_18815	g_18816
Super-Scaffold_100013	5681016	5711630	30614	g_18816	g_18817
Super-Scaffold_100013	5712656	5778323	65667	g_18817	g_18819
Super-Scaffold_100013	5802549	5823342	20793	g_18819	g_18820
Super-Scaffold_100013	5825009	5834540	9531	g_18820	g_18821
Super-Scaffold_100013	5836210	5877341	41131	g_18821	g_18822
Super-Scaffold_100013	5878816	5894778	15962	g_18822	g_18824
Super-Scaffold_100013	5928294	5939182	10888	g_18824	g_18825
Super-Scaffold_100013	5956101	6032907	76806	g_18825	g_18826
Super-Scaffold_100013	6049065	6062038	12973	g_18826	g_18827
Super-Scaffold_100013	6081827	6084214	2387	g_18827	g_18828
Super-Scaffold_100013	6085570	6147491	61921	g_18828	g_18829
Super-Scaffold_100013	6236442	6282097	45655	g_18829	g_18831
Super-Scaffold_100013	6282911	6328132	45221	g_18831	g_18833
Super-Scaffold_100013	6328332	6345679	17347	g_18833	g_18834
Super-Scaffold_100013	6363517	6425499	61982	g_18834	g_18837
Super-Scaffold_100013	6447391	6450506	3115	g_18837	g_18838
Super-Scaffold_100013	6457899	6522520	64621	g_18838	g_38684
Super-Scaffold_100013	6522978	6547673	24695	g_38684	g_18843
Super-Scaffold_100013	6577953	6625176	47223	g_18843	g_18844
Super-Scaffold_100013	6633216	6638454	5238	g_18844	g_18845
Super-Scaffold_100013	6654960	6672192	17232	g_18845	g_18846
Super-Scaffold_100013	6678513	6704470	25957	g_18846	g_18847
Super-Scaffold_100013	6714945	6722330	7385	g_18847	g_44470
Super-Scaffold_100013	6725460	6731611	6151	g_44470	g_18849
Super-Scaffold_100013	6731913	6772952	41039	g_18849	g_18851
Super-Scaffold_100013	6773305	6799571	26266	g_18851	g_18852
Super-Scaffold_100013	6808855	6817470	8615	g_18852	g_44471
Super-Scaffold_100013	6820654	6826793	6139	g_44471	g_18854
Super-Scaffold_100013	6827146	6859155	32009	g_18854	g_18856
Super-Scaffold_100013	6860819	6889190	28371	g_18856	g_18857
Super-Scaffold_100013	6890867	6901157	10290	g_18857	g_18858
Super-Scaffold_100013	6901456	6918844	17388	g_18858	g_18859
Super-Scaffold_100013	6920505	6946185	25680	g_18859	g_18861
Super-Scaffold_100013	6948643	6952422	3779	g_18861	g_18862
Super-Scaffold_100013	6952775	6958336	5561	g_18862	g_18864
Super-Scaffold_100013	6961522	6965227	3705	g_18864	g_18865
Super-Scaffold_100013	6966888	6997892	31004	g_18865	g_18867
Super-Scaffold_100013	7001506	7004766	3260	g_18867	g_18868
Super-Scaffold_100013	7005119	7005227	108	g_18868	g_18869
Super-Scaffold_100013	7010824	7018409	7585	g_18869	g_18870
Super-Scaffold_100013	7029251	7031603	2352	g_18870	g_18871
Super-Scaffold_100013	7033309	7038593	5284	g_18871	g_18872
Super-Scaffold_100013	7057725	7087438	29713	g_18872	g_18874
Super-Scaffold_100013	7087755	7139456	51701	g_18874	g_18877
Super-Scaffold_100013	7142137	7149013	6876	g_18877	g_18878
Super-Scaffold_100013	7156593	7194623	38030	g_18878	g_44472
Super-Scaffold_100013	7195354	7195399	45	g_44472	g_18879
Super-Scaffold_100013	7196169	7196407	238	g_18879	g_18880
Super-Scaffold_100013	7196685	7198799	2114	g_18880	g_18881
Super-Scaffold_100013	7208477	7231926	23449	g_18881	g_18883
Super-Scaffold_100013	7238466	7254024	15558	g_44473	g_18884
Super-Scaffold_100013	7265991	7268891	2900	g_18884	g_18885
Super-Scaffold_100013	7272675	7274142	1467	g_18885	g_18886
Super-Scaffold_100013	7274726	7275577	851	g_18886	g_18887
Super-Scaffold_100013	7278585	7280231	1646	g_18887	g_18888
Super-Scaffold_100013	7297702	7314713	17011	g_18888	g_18889
Super-Scaffold_100013	7321959	7323479	1520	g_18889	g_18890
Super-Scaffold_100013	7323805	7326039	2234	g_18890	g_18891
Super-Scaffold_100013	7326320	7327724	1404	g_18891	g_44474
Super-Scaffold_100013	7357534	7405561	48027	g_44474	g_18892
Super-Scaffold_100013	7413152	7470577	57425	g_18892	g_18895
Super-Scaffold_100013	7475166	7503900	28734	g_18895	g_18898
Super-Scaffold_100013	7504223	7542143	37920	g_18898	g_18900
Super-Scaffold_100013	7542697	7564895	22198	g_18900	g_18901
Super-Scaffold_100013	7574193	7578349	4156	g_18901	g_44475
Super-Scaffold_100013	7582210	7594643	12433	g_44475	g_38696
Super-Scaffold_100013	7594864	7597406	2542	g_38696	g_18904
Super-Scaffold_100013	7597699	7599615	1916	g_18904	g_38697
Super-Scaffold_100013	7599899	7630740	30841	g_38697	g_18906
Super-Scaffold_100013	7660173	7673655	13482	g_18906	g_18907
Super-Scaffold_100013	7674752	7677344	2592	g_18907	g_18908
Super-Scaffold_100013	7685527	7698489	12962	g_18908	g_18909
Super-Scaffold_100013	7698701	7699763	1062	g_18909	g_18910
Super-Scaffold_100013	7701006	7703717	2711	g_18910	g_44476
Super-Scaffold_100013	7706027	7707982	1955	g_44476	g_18911
Super-Scaffold_100013	7713197	7719418	6221	g_18911	g_18912
Super-Scaffold_100013	7720996	7734493	13497	g_18912	g_44477
Super-Scaffold_100013	7742442	7748116	5674	g_44477	g_18913
Super-Scaffold_100013	7754351	7762721	8370	g_18913	g_18914
Super-Scaffold_100013	7762933	7769752	6819	g_18914	g_18915
Super-Scaffold_100013	7780809	7783307	2498	g_18915	g_18916
Super-Scaffold_100013	7783819	7783847	28	g_18916	g_18917
Super-Scaffold_100013	7784896	7785036	140	g_18917	g_18918
Super-Scaffold_100013	7786427	7786769	342	g_18918	g_18919
Super-Scaffold_100013	7788348	7806621	18273	g_18919	g_18921
Super-Scaffold_100013	7811026	7818834	7808	g_18921	g_44478
Super-Scaffold_100013	7824387	7829729	5342	g_44478	g_18922
Super-Scaffold_100013	7841576	7861555	19979	g_18922	g_18923
Super-Scaffold_100013	7875338	7883102	7764	g_18923	g_18924
Super-Scaffold_100013	7885985	7889291	3306	g_18924	g_44479
Super-Scaffold_100013	7894510	7896409	1899	g_44479	g_18925
Super-Scaffold_100013	7899374	7900553	1179	g_18925	g_44480
Super-Scaffold_100013	7909922	7913096	3174	g_44480	g_18926
Super-Scaffold_100013	7914931	7936072	21141	g_18926	g_18927
Super-Scaffold_100013	7949145	7955659	6514	g_18927	g_18928
Super-Scaffold_100013	7958844	7961008	2164	g_18928	g_18929
Super-Scaffold_100013	7983087	7986505	3418	g_18929	g_18930
Super-Scaffold_100013	7988422	7990996	2574	g_18930	g_18931
Super-Scaffold_100013	7997069	8014718	17649	g_18931	g_18932
Super-Scaffold_100013	8029942	8030655	713	g_18932	g_44481
Super-Scaffold_100013	8046310	8048581	2271	g_44481	g_18933
Super-Scaffold_100013	8052656	8061777	9121	g_18933	g_38698
Super-Scaffold_100013	8061980	8064306	2326	g_38698	g_18934
Super-Scaffold_100013	8065187	8071404	6217	g_18934	g_18935
Super-Scaffold_100013	8089137	8090712	1575	g_18935	g_18936
Super-Scaffold_100013	8090951	8097682	6731	g_18936	g_18937
Super-Scaffold_100013	8101319	8104556	3237	g_18937	g_18938
Super-Scaffold_100013	8107616	8108293	677	g_18938	g_18939
Super-Scaffold_100013	8116043	8117480	1437	g_18939	g_18940
Super-Scaffold_100013	8133855	8135302	1447	g_18940	g_18941
Super-Scaffold_100013	8142658	8154080	11422	g_18941	g_18942
Super-Scaffold_100013	8156389	8157049	660	g_18942	g_18943
Super-Scaffold_100013	8157816	8161102	3286	g_18943	g_18944
Super-Scaffold_100013	8168553	8173932	5379	g_18944	g_18945
Super-Scaffold_100013	8179748	8181379	1631	g_18945	g_18946
Super-Scaffold_100013	8212720	8214787	2067	g_18946	g_44482
Super-Scaffold_100013	8236467	8241900	5433	g_44482	g_44483
Super-Scaffold_100013	8264728	8275000	10272	g_44483	g_18948
Super-Scaffold_100013	8284513	8296877	12364	g_18948	g_18949
Super-Scaffold_100013	8297083	8297864	781	g_18949	g_18950
Super-Scaffold_100013	8304492	8330672	26180	g_18950	g_18951
Super-Scaffold_100013	8331565	8368814	37249	g_18951	g_18952
Super-Scaffold_100013	8370025	8375819	5794	g_18952	g_18953
Super-Scaffold_100013	8380882	8382704	1822	g_18953	g_44484
Super-Scaffold_100013	8392307	8396487	4180	g_44484	g_18954
Super-Scaffold_100013	8399927	8405136	5209	g_18954	g_18955
Super-Scaffold_100013	8408621	8409872	1251	g_18955	g_18956
Super-Scaffold_100013	8417899	8439251	21352	g_18956	g_18958
Super-Scaffold_100013	8440134	8443100	2966	g_18958	g_18959
Super-Scaffold_100013	8449628	8520457	70829	g_18959	g_18961
Super-Scaffold_100013	8526498	8592315	65817	g_18961	g_18964
Super-Scaffold_100013	8609656	8626915	17259	g_18964	g_18965
Super-Scaffold_100013	8647478	8702506	55028	g_18965	g_18966
Super-Scaffold_100013	8711379	8713875	2496	g_18966	g_18968
Super-Scaffold_100013	8727379	8736504	9125	g_18968	g_18969
Super-Scaffold_100013	8755324	8761467	6143	g_18969	g_18970
Super-Scaffold_100013	8772834	8783894	11060	g_18970	g_18971
Super-Scaffold_100013	8791474	8792920	1446	g_18971	g_44485
Super-Scaffold_100013	8803975	8805123	1148	g_44485	g_18972
Super-Scaffold_100013	8808787	8826083	17296	g_18972	g_18973
Super-Scaffold_100013	8830991	8833069	2078	g_18973	g_18974
Super-Scaffold_100013	8836951	8838891	1940	g_18974	g_18975
Super-Scaffold_100013	8841746	8843091	1345	g_18975	g_18976
Super-Scaffold_100013	8843390	8851854	8464	g_18976	g_18977
Super-Scaffold_100013	8875372	8880583	5211	g_18977	g_18978
Super-Scaffold_100013	8898018	8905083	7065	g_18978	g_18979
Super-Scaffold_100013	8909039	8910032	993	g_18979	g_44486
Super-Scaffold_100013	8910979	8911438	459	g_44486	g_18980
Super-Scaffold_100013	8921256	8924124	2868	g_18980	g_18981
Super-Scaffold_100013	8946107	8950950	4843	g_18981	g_18982
Super-Scaffold_100013	8951438	8964056	12618	g_18982	g_18983
Super-Scaffold_100013	8969766	8975151	5385	g_18983	g_18984
Super-Scaffold_100013	8984646	8989458	4812	g_18984	g_44487
Super-Scaffold_100013	8994188	9002244	8056	g_44487	g_18985
Super-Scaffold_100013	9091118	9095954	4836	g_18985	g_18986
Super-Scaffold_100013	9099723	9113184	13461	g_18986	g_18987
Super-Scaffold_100013	9118701	9121700	2999	g_18987	g_18988
Super-Scaffold_100013	9128129	9201482	73353	g_18988	g_18990
Super-Scaffold_100013	9215512	9216548	1036	g_18990	g_18991
Super-Scaffold_100013	9223035	9239927	16892	g_18991	g_18992
Super-Scaffold_100013	9258851	9262654	3803	g_18992	g_18993
Super-Scaffold_100013	9277212	9281405	4193	g_18993	g_18994
Super-Scaffold_100013	9290921	9305762	14841	g_18994	g_44488
Super-Scaffold_100013	9320602	9323880	3278	g_44488	g_18995
Super-Scaffold_100013	9336453	9339505	3052	g_18995	g_18996
Super-Scaffold_100013	9339738	9379352	39614	g_18996	g_18997
Super-Scaffold_100013	9380518	9440640	60122	g_18997	g_19000
Super-Scaffold_100013	9442181	9464065	21884	g_19000	g_19002
Super-Scaffold_100013	9464268	9471840	7572	g_19002	g_19003
Super-Scaffold_100013	9486510	9498767	12257	g_19003	g_19004
Super-Scaffold_100013	9499466	9561203	61737	g_38704	g_19008
Super-Scaffold_100013	9575115	9628231	53116	g_19008	g_19010
Super-Scaffold_100013	9629130	9635431	6301	g_19010	g_19011
Super-Scaffold_100013	9635742	9638480	2738	g_19011	g_19012
Super-Scaffold_100013	9644244	9646270	2026	g_19012	g_19013
Super-Scaffold_100013	9647295	9649254	1959	g_19013	g_19014
Super-Scaffold_100013	9651278	9654816	3538	g_19014	g_19015
Super-Scaffold_100013	9665286	9670445	5159	g_19015	g_19016
Super-Scaffold_100013	9670825	9681209	10384	g_19016	g_19017
Super-Scaffold_100013	9700490	9703982	3492	g_19017	g_19018
Super-Scaffold_100013	9743521	9763688	20167	g_19018	g_19019
Super-Scaffold_100013	9776168	9783951	7783	g_19019	g_19020
Super-Scaffold_100013	9810326	9891647	81321	g_19020	g_19021
Super-Scaffold_100013	9897761	9944870	47109	g_19021	g_19023
Super-Scaffold_100013	9945091	9971580	26489	g_19023	g_19025
Super-Scaffold_100013	9971996	9990583	18587	g_19025	g_19026
Super-Scaffold_100013	9991218	10012248	21030	g_19026	g_19027
Super-Scaffold_100013	10022529	10036189	13660	g_19027	g_19028
Super-Scaffold_100013	10036437	10047925	11488	g_19028	g_38709
Super-Scaffold_100013	10048149	10091107	42958	g_38709	g_19030
Super-Scaffold_100013	10096017	10101108	5091	g_19030	g_19031
Super-Scaffold_100013	10107419	10107924	505	g_19031	g_44489
Super-Scaffold_100013	10108685	10110732	2047	g_44489	g_19032
Super-Scaffold_100013	10113203	10117892	4689	g_19032	g_19033
Super-Scaffold_100013	10120604	10121477	873	g_19033	g_19034
Super-Scaffold_100013	10123355	10123698	343	g_19034	g_19035
Super-Scaffold_100013	10127251	10289060	161809	g_19035	g_19036
Super-Scaffold_100013	10289305	10323722	34417	g_19036	g_19037
Super-Scaffold_100013	10323970	10324577	607	g_19037	g_19038
Super-Scaffold_100013	10324900	10467663	142763	g_19038	g_19041
Super-Scaffold_100013	10467887	10468004	117	g_19041	g_19042
Super-Scaffold_100013	10468222	10468270	48	g_19042	g_19043
Super-Scaffold_100013	10468560	10468608	48	g_19043	g_19044
Super-Scaffold_100013	10468808	10470244	1436	g_19044	g_19046
Super-Scaffold_100013	10474298	10478318	4020	g_19046	g_19047
Super-Scaffold_100013	10479654	10488715	9061	g_19047	g_19049
Super-Scaffold_100013	10489882	10508620	18738	g_19049	g_19050
Super-Scaffold_100013	10521955	10529441	7486	g_19050	g_19051
Super-Scaffold_100013	10530344	10534869	4525	g_19051	g_19052
Super-Scaffold_100013	10539922	10542362	2440	g_19052	g_44490
Super-Scaffold_100013	10544171	10545295	1124	g_44490	g_19053
Super-Scaffold_100013	10548899	10550521	1622	g_19053	g_19054
Super-Scaffold_100013	10554058	10557327	3269	g_19054	g_19055
Super-Scaffold_100013	10559694	10561328	1634	g_19055	g_44491
Super-Scaffold_100013	10565440	10569966	4526	g_44491	g_44492
Super-Scaffold_100013	10572925	10589907	16982	g_38710	g_19056
Super-Scaffold_100013	10598046	10601282	3236	g_19056	g_19057
Super-Scaffold_100013	10612429	10620288	7859	g_19057	g_19058
Super-Scaffold_100013	10641455	10683378	41923	g_19058	g_19059
Super-Scaffold_100013	10698127	10699803	1676	g_19059	g_19060
Super-Scaffold_100013	10726761	10750576	23815	g_19060	g_19061
Super-Scaffold_100013	10753464	10767106	13642	g_19061	g_19062
Super-Scaffold_100013	10770830	10777964	7134	g_19062	g_19063
Super-Scaffold_100013	10780014	10784072	4058	g_19063	g_19064
Super-Scaffold_100013	10789254	10803709	14455	g_19064	g_19065
Super-Scaffold_100013	10807360	10811771	4411	g_19065	g_19066
Super-Scaffold_100013	10848605	10850003	1398	g_19066	g_19067
Super-Scaffold_100013	10853154	10854967	1813	g_19067	g_19068
Super-Scaffold_100013	10869999	10873287	3288	g_19068	g_19069
Super-Scaffold_100013	10874879	10926124	51245	g_19069	g_19071
Super-Scaffold_100013	10940474	10944818	4344	g_19071	g_19072
Super-Scaffold_100013	10949445	10952543	3098	g_19072	g_19073
Super-Scaffold_100013	10961670	10974701	13031	g_19073	g_19074
Super-Scaffold_100013	10993896	11006960	13064	g_19074	g_38712
Super-Scaffold_100013	11007214	11022070	14856	g_38712	g_19077
Super-Scaffold_100013	11031504	11036688	5184	g_19077	g_19078
Super-Scaffold_100013	11037575	11049277	11702	g_19078	g_19079
Super-Scaffold_100013	11060280	11066738	6458	g_19079	g_19080
Super-Scaffold_100013	11076330	11077335	1005	g_19080	g_19081
Super-Scaffold_100013	11082258	11093014	10756	g_19081	g_19082
Super-Scaffold_100013	11095103	11098385	3282	g_19082	g_19083
Super-Scaffold_100013	11100278	11107548	7270	g_19083	g_19084
Super-Scaffold_100013	11109159	11120817	11658	g_19084	g_19085
Super-Scaffold_100013	11126053	11145691	19638	g_19085	g_19086
Super-Scaffold_100013	11145921	11156973	11052	g_19086	g_19087
Super-Scaffold_100013	11157203	11191832	34629	g_19087	g_19088
Super-Scaffold_100013	11196680	11200294	3614	g_19088	g_44493
Super-Scaffold_100013	11218004	11218936	932	g_44493	g_44494
Super-Scaffold_100013	11227995	11233702	5707	g_44494	g_19089
Super-Scaffold_100013	11234814	11259926	25112	g_19089	g_19093
Super-Scaffold_100013	11289141	11290273	1132	g_19093	g_19094
Super-Scaffold_100013	11299815	11301688	1873	g_19094	g_44495
Super-Scaffold_100013	11303933	11306069	2136	g_44495	g_19095
Super-Scaffold_100013	11335455	11338350	2895	g_19095	g_19096
Super-Scaffold_100013	11353104	11359546	6442	g_19096	g_19097
Super-Scaffold_100013	11375467	11381277	5810	g_19097	g_44496
Super-Scaffold_100013	11394357	11409122	14765	g_19098	g_19099
Super-Scaffold_100013	11423894	11435115	11221	g_19099	g_19100
Super-Scaffold_100013	11451680	11463789	12109	g_19100	g_19101
Super-Scaffold_100013	11482460	11491288	8828	g_19101	g_19102
Super-Scaffold_100013	11503939	11523729	19790	g_19102	g_19103
Super-Scaffold_100013	11523947	11531921	7974	g_19103	g_19104
Super-Scaffold_100013	11538682	11542536	3854	g_19104	g_19105
Super-Scaffold_100013	11551258	11591310	40052	g_19105	g_19107
Super-Scaffold_100013	11595255	11597386	2131	g_19107	g_19108
Super-Scaffold_100013	11614240	11633699	19459	g_19108	g_19110
Super-Scaffold_100013	11636048	11641109	5061	g_19110	g_19111
Super-Scaffold_100013	11641324	11682340	41016	g_19111	g_19112
Super-Scaffold_100013	11682546	11767721	85175	g_19112	g_19113
Super-Scaffold_100013	11785813	11790514	4701	g_19113	g_19115
Super-Scaffold_100013	11815565	11821189	5624	g_19115	g_19116
Super-Scaffold_100013	11842266	11845834	3568	g_19116	g_19117
Super-Scaffold_100013	11847771	11849435	1664	g_19117	g_19118
Super-Scaffold_100013	11851608	11855989	4381	g_19118	g_19119
Super-Scaffold_100013	11859672	11864071	4399	g_19119	g_44497
Super-Scaffold_100013	11867265	11877434	10169	g_44497	g_19120
Super-Scaffold_100013	11895760	11898528	2768	g_19120	g_19121
Super-Scaffold_100013	11906717	11911047	4330	g_19121	g_19122
Super-Scaffold_100013	11916736	11921878	5142	g_19122	g_19123
Super-Scaffold_100013	11930622	11946869	16247	g_19123	g_19124
Super-Scaffold_100013	11955090	11989443	34353	g_19124	g_19127
Super-Scaffold_100013	11989721	11995664	5943	g_19127	g_38718
Super-Scaffold_100013	11995879	12065597	69718	g_38718	g_19130
Super-Scaffold_100013	12066589	12152161	85572	g_19130	g_19131
Super-Scaffold_100013	12153204	12156127	2923	g_19131	g_19132
Super-Scaffold_100013	12170750	12207232	36482	g_19132	g_19135
Super-Scaffold_100013	12223763	12229437	5674	g_19135	g_19136
Super-Scaffold_100013	12238533	12255761	17228	g_19136	g_19137
Super-Scaffold_100013	12256736	12263559	6823	g_19137	g_19138
Super-Scaffold_100013	12270079	12274563	4484	g_19138	g_19139
Super-Scaffold_100013	12278740	12279549	809	g_19139	g_19140
Super-Scaffold_100013	12283448	12285783	2335	g_19140	g_19141
Super-Scaffold_100013	12286921	12289113	2192	g_19141	g_19142
Super-Scaffold_100013	12289811	12292965	3154	g_19142	g_19143
Super-Scaffold_100013	12307130	12312038	4908	g_19143	g_44498
Super-Scaffold_100013	12314767	12314814	47	g_44498	g_44499
Super-Scaffold_100013	12315373	12322978	7605	g_44499	g_44500
Super-Scaffold_100013	12338111	12339346	1235	g_44500	g_19144
Super-Scaffold_100013	12341175	12461959	120784	g_19144	g_19148
Super-Scaffold_100013	12462372	12483087	20715	g_19148	g_19150
Super-Scaffold_100013	12487430	12523817	36387	g_19150	g_19151
Super-Scaffold_100013	12538285	12599166	60881	g_19151	g_19153
Super-Scaffold_100013	12601487	12601802	315	g_19153	g_19154
Super-Scaffold_100013	12603509	12604341	832	g_19154	g_19155
Super-Scaffold_100013	12610958	12614771	3813	g_19155	g_19156
Super-Scaffold_100013	12616641	12621917	5276	g_19156	g_19157
Super-Scaffold_100013	12623595	12625438	1843	g_19157	g_19158
Super-Scaffold_100013	12629044	12631949	2905	g_19158	g_19159
Super-Scaffold_100013	12636592	12637248	656	g_19159	g_19160
Super-Scaffold_100013	12638015	12640063	2048	g_19160	g_19161
Super-Scaffold_100013	12641370	12644809	3439	g_19161	g_19162
Super-Scaffold_100013	12657520	12665747	8227	g_19162	g_19163
Super-Scaffold_100013	12666832	12668478	1646	g_19163	g_19164
Super-Scaffold_100013	12671328	12673529	2201	g_19164	g_38723
Super-Scaffold_100013	12673735	12677790	4055	g_38723	g_19165
Super-Scaffold_100013	12678861	12686491	7630	g_19165	g_19166
Super-Scaffold_100013	12687577	12689863	2286	g_19166	g_19167
Super-Scaffold_100013	12693364	12707854	14490	g_19167	g_19169
Super-Scaffold_100013	12709304	12714344	5040	g_19169	g_19170
Super-Scaffold_100013	12727535	12750362	22827	g_19170	g_19173
Super-Scaffold_100013	12770716	12774017	3301	g_19173	g_19174
Super-Scaffold_100013	12789319	12797484	8165	g_19174	g_19175
Super-Scaffold_100013	12815528	12830285	14757	g_19175	g_19176
Super-Scaffold_100013	12830539	12850261	19722	g_19176	g_19177
Super-Scaffold_100013	12853759	12875125	21366	g_19177	g_19179
Super-Scaffold_100013	12877920	12881269	3349	g_19179	g_19180
Super-Scaffold_100013	12889506	12908702	19196	g_19180	g_19181
Super-Scaffold_100013	12927749	12930679	2930	g_19181	g_19182
Super-Scaffold_100013	12941366	12947311	5945	g_19182	g_19183
Super-Scaffold_100013	12968695	12980617	11922	g_19183	g_19185
Super-Scaffold_100013	12980946	12989260	8314	g_19185	g_19186
Super-Scaffold_100013	12989538	13001892	12354	g_19186	g_19188
Super-Scaffold_100013	13024154	13026539	2385	g_19188	g_19189
Super-Scaffold_100013	13033657	13034694	1037	g_19189	g_19190
Super-Scaffold_100013	13040418	13053372	12954	g_19190	g_19192
Super-Scaffold_100013	13055303	13152902	97599	g_19192	g_19193
Super-Scaffold_100013	13156324	13163216	6892	g_19193	g_19194
Super-Scaffold_100013	13166017	13214330	48313	g_19194	g_19195
Super-Scaffold_100013	13235181	13244035	8854	g_19195	g_19197
Super-Scaffold_100013	13249204	13255172	5968	g_19197	g_19198
Super-Scaffold_100013	13261949	13264809	2860	g_19198	g_38731
Super-Scaffold_100013	13267082	13272071	4989	g_38731	g_19199
Super-Scaffold_100013	13273606	13285181	11575	g_19199	g_19200
Super-Scaffold_100013	13286422	13289193	2771	g_19200	g_44501
Super-Scaffold_100013	13291930	13292435	505	g_44501	g_19201
Super-Scaffold_100013	13294778	13296113	1335	g_19201	g_19202
Super-Scaffold_100013	13300954	13387772	86818	g_19202	g_19205
Super-Scaffold_100013	13399402	13409435	10033	g_19205	g_38734
Super-Scaffold_100013	13409734	13415580	5846	g_38734	g_19206
Super-Scaffold_100013	13416512	13419801	3289	g_19206	g_19207
Super-Scaffold_100013	13422787	13426551	3764	g_19207	g_19208
Super-Scaffold_100013	13428325	13431076	2751	g_19208	g_19209
Super-Scaffold_100013	13432164	13445846	13682	g_19209	g_19210
Super-Scaffold_100013	13503595	13514891	11296	g_19210	g_19211
Super-Scaffold_100013	13524102	13525015	913	g_19211	g_19212
Super-Scaffold_100013	13530330	13531955	1625	g_19212	g_44502
Super-Scaffold_100013	13535810	13543392	7582	g_44502	g_19213
Super-Scaffold_100013	13559012	13570480	11468	g_19213	g_19214
Super-Scaffold_100013	13571064	13638933	67869	g_19214	g_19215
Super-Scaffold_100013	13639532	13647263	7731	g_19215	g_19216
Super-Scaffold_100013	13647692	13652667	4975	g_19216	g_19217
Super-Scaffold_100013	13656923	13659796	2873	g_19217	g_19218
Super-Scaffold_100013	13661327	13669802	8475	g_19218	g_19219
Super-Scaffold_100013	13692936	13722501	29565	g_19219	g_44503
Super-Scaffold_100013	13738579	13754557	15978	g_44503	g_38736
Super-Scaffold_100013	13754820	13778292	23472	g_38736	g_19220
Super-Scaffold_100013	13778669	13778939	270	g_19220	g_19221
Super-Scaffold_100013	13779145	13787611	8466	g_19221	g_19222
Super-Scaffold_100013	13799019	13825124	26105	g_19222	g_19223
Super-Scaffold_100013	13844838	13856771	11933	g_19223	g_19224
Super-Scaffold_100013	13861915	13868947	7032	g_19224	g_19225
Super-Scaffold_100013	13890038	13890749	711	g_19225	g_19226
Super-Scaffold_100013	13890985	13906220	15235	g_19226	g_19227
Super-Scaffold_100013	13907570	13920129	12559	g_19227	g_19228
Super-Scaffold_100013	13920467	13966323	45856	g_19228	g_19231
Super-Scaffold_100013	13970421	13972959	2538	g_19231	g_19232
Super-Scaffold_100013	13979922	13983832	3910	g_19232	g_19233
Super-Scaffold_100013	13984707	13985531	824	g_19233	g_19234
Super-Scaffold_100013	13996301	14011866	15565	g_38737	g_19235
Super-Scaffold_100013	14012135	14026274	14139	g_19235	g_19236
Super-Scaffold_100013	14032686	14040528	7842	g_19236	g_19237
Super-Scaffold_100013	14055175	14061491	6316	g_19237	g_19238
Super-Scaffold_100013	14078725	14087999	9274	g_19238	g_19239
Super-Scaffold_100013	14090869	14133355	42486	g_19239	g_19241
Super-Scaffold_100013	14157517	14160176	2659	g_19241	g_19242
Super-Scaffold_100013	14161620	14164933	3313	g_19242	g_19243
Super-Scaffold_100013	14168429	14172441	4012	g_19243	g_19244
Super-Scaffold_100013	14177716	14181635	3919	g_38739	g_19245
Super-Scaffold_100013	14191353	14191982	629	g_19245	g_19246
Super-Scaffold_100013	14192986	14194490	1504	g_19246	g_19247
Super-Scaffold_100013	14199380	14256549	57169	g_19247	g_19250
Super-Scaffold_100013	14256836	14297709	40873	g_19250	g_19252
Super-Scaffold_100013	14315947	14346239	30292	g_19252	g_19253
Super-Scaffold_100013	14355387	14357326	1939	g_19253	g_19254
Super-Scaffold_100013	14359288	14360470	1182	g_19254	g_19255
Super-Scaffold_100013	14365217	14366733	1516	g_19255	g_19256
Super-Scaffold_100013	14372379	14373885	1506	g_19256	g_19257
Super-Scaffold_100013	14378126	14378596	470	g_19257	g_19258
Super-Scaffold_100013	14387495	14388529	1034	g_19258	g_19259
Super-Scaffold_100013	14390268	14390845	577	g_19259	g_19260
Super-Scaffold_100013	14397076	14414091	17015	g_19260	g_19261
Super-Scaffold_100013	14430316	14436042	5726	g_19261	g_44504
Super-Scaffold_100013	14436383	14452139	15756	g_44504	g_19263
Super-Scaffold_100013	14452393	14470803	18410	g_19263	g_19265
Super-Scaffold_100013	14471048	14568207	97159	g_19265	g_19270
Super-Scaffold_100013	14569628	14579210	9582	g_19270	g_19271
Super-Scaffold_100013	14581762	14583724	1962	g_19271	g_19272
Super-Scaffold_100013	14584554	14615528	30974	g_19272	g_19273
Super-Scaffold_100013	14620325	14622669	2344	g_19273	g_44505
Super-Scaffold_100013	14625922	14628446	2524	g_44505	g_19274
Super-Scaffold_100013	14632614	14637655	5041	g_19274	g_19275
Super-Scaffold_100013	14650683	14665530	14847	g_19275	g_19276
Super-Scaffold_100013	14672014	14673737	1723	g_19276	g_19277
Super-Scaffold_100013	14689874	14710613	20739	g_19277	g_19278
Super-Scaffold_100013	14712247	14717318	5071	g_19278	g_19279
Super-Scaffold_100013	14737442	14753733	16291	g_19279	g_19281
Super-Scaffold_100013	14754047	14756518	2471	g_19281	g_19282
Super-Scaffold_100013	14760412	14769988	9576	g_19282	g_19283
Super-Scaffold_100013	14773660	14788503	14843	g_19283	g_44506
Super-Scaffold_100013	14801474	14804504	3030	g_44506	g_19284
Super-Scaffold_100013	14805221	14806826	1605	g_19284	g_19285
Super-Scaffold_100013	14807998	14809765	1767	g_19285	g_19286
Super-Scaffold_100013	14813591	14825091	11500	g_19286	g_44507
Super-Scaffold_100013	14833319	14836074	2755	g_44507	g_44508
Super-Scaffold_100013	14848960	14857815	8855	g_44508	g_19287
Super-Scaffold_100013	14873404	14914281	40877	g_19287	g_19289
Super-Scaffold_100013	14918227	14923361	5134	g_19289	g_19290
Super-Scaffold_100013	14930132	14933902	3770	g_19290	g_19291
Super-Scaffold_100013	14940065	15035525	95460	g_19291	g_19293
Super-Scaffold_100013	15067437	15180705	113268	g_38745	g_19295
Super-Scaffold_100013	15184090	15196417	12327	g_19295	g_19296
Super-Scaffold_100013	15202891	15225663	22772	g_19296	g_19298
Super-Scaffold_100013	15228418	15229202	784	g_19298	g_19299
Super-Scaffold_100013	15237201	15260472	23271	g_19299	g_19302
Super-Scaffold_100013	15260759	15277487	16728	g_19302	g_19304
Super-Scaffold_100013	15277852	15291965	14113	g_19304	g_19307
Super-Scaffold_100013	15292273	15306094	13821	g_19307	g_19309
Super-Scaffold_100013	15306462	15327855	21393	g_19309	g_19311
Super-Scaffold_100013	15328202	15357433	29231	g_19311	g_19313
Super-Scaffold_100013	15363103	15371766	8663	g_19313	g_19314
Super-Scaffold_100013	15377632	15381079	3447	g_19314	g_44509
Super-Scaffold_100013	15390167	15392934	2767	g_44509	g_19315
Super-Scaffold_100013	15400328	15455731	55403	g_19315	g_44510
Super-Scaffold_100013	15458239	15459729	1490	g_44510	g_19316
Super-Scaffold_100013	15467371	15470985	3614	g_19316	g_19317
Super-Scaffold_100013	15475197	15479137	3940	g_19317	g_19318
Super-Scaffold_100013	15498774	15504820	6046	g_19318	g_19320
Super-Scaffold_100013	15526005	15642913	116908	g_19320	g_19324
Super-Scaffold_100013	15643155	15659839	16684	g_19324	g_19325
Super-Scaffold_100013	15683263	15686908	3645	g_19325	g_19326
Super-Scaffold_100013	15711713	15724833	13120	g_19326	g_44511
Super-Scaffold_100013	15734805	15824309	89504	g_44511	g_19333
Super-Scaffold_100013	15826452	15851001	24549	g_19333	g_19334
Super-Scaffold_100013	15851375	15869753	18378	g_19334	g_19335
Super-Scaffold_100013	15870373	15873507	3134	g_19335	g_19336
Super-Scaffold_100013	15877470	15891252	13782	g_19336	g_19337
Super-Scaffold_100013	15904488	15906625	2137	g_19337	g_44512
Super-Scaffold_100013	15912373	15915657	3284	g_44512	g_19338
Super-Scaffold_100013	15917383	15920444	3061	g_19338	g_19339
Super-Scaffold_100013	15924785	15927317	2532	g_19339	g_19340
Super-Scaffold_100013	15928556	15933028	4472	g_19340	g_19341
Super-Scaffold_100013	15944732	15962028	17296	g_19341	g_19342
Super-Scaffold_100013	15970057	15971714	1657	g_19342	g_44513
Super-Scaffold_100013	15973307	15990072	16765	g_44513	g_19343
Super-Scaffold_100013	15992351	15992761	410	g_19343	g_19344
Super-Scaffold_100013	16014103	16017345	3242	g_19344	g_19345
Super-Scaffold_100013	16020008	16027961	7953	g_19345	g_19346
Super-Scaffold_100013	16043406	16049710	6304	g_19346	g_19347
Super-Scaffold_100013	16056780	16063697	6917	g_19347	g_19348
Super-Scaffold_100013	16071877	16074759	2882	g_19348	g_19349
Super-Scaffold_100013	16078265	16084486	6221	g_19349	g_19350
Super-Scaffold_100013	16087218	16090613	3395	g_19350	g_44514
Super-Scaffold_100013	16093733	16096141	2408	g_44514	g_19351
Super-Scaffold_100013	16098267	16105967	7700	g_19351	g_19352
Super-Scaffold_100013	16113078	16115089	2011	g_19352	g_19353
Super-Scaffold_100013	16118527	16119016	489	g_19353	g_19354
Super-Scaffold_100013	16123029	16126544	3515	g_19354	g_19355
Super-Scaffold_100013	16126744	16128184	1440	g_19355	g_19356
Super-Scaffold_100013	16148379	16156651	8272	g_19356	g_19357
Super-Scaffold_100013	16160369	16161342	973	g_19357	g_19358
Super-Scaffold_100013	16166855	16171231	4376	g_19358	g_19359
Super-Scaffold_100013	16176408	16183437	7029	g_19359	g_44515
Super-Scaffold_100013	16183703	16191176	7473	g_44515	g_19360
Super-Scaffold_100013	16196721	16202687	5966	g_19360	g_19361
Super-Scaffold_100013	16206166	16207316	1150	g_19361	g_19362
Super-Scaffold_100013	16210816	16406870	196054	g_19362	g_19364
Super-Scaffold_100013	16421395	16441772	20377	g_19364	g_19365
Super-Scaffold_100013	16442089	16450790	8701	g_19365	g_19366
Super-Scaffold_100013	16475514	16505985	30471	g_19366	g_19367
Super-Scaffold_100013	16508580	16510870	2290	g_19367	g_19368
Super-Scaffold_100013	16517614	16546427	28813	g_19368	g_38756
Super-Scaffold_100013	16546699	16568360	21661	g_38756	g_19369
Super-Scaffold_100013	16576653	16582898	6245	g_19369	g_19370
Super-Scaffold_100013	16591180	16598394	7214	g_19370	g_19371
Super-Scaffold_100013	16598654	16611309	12655	g_19371	g_19372
Super-Scaffold_100013	16637130	16690974	53844	g_19372	g_19375
Super-Scaffold_100013	16699927	16707120	7193	g_19375	g_19376
Super-Scaffold_100013	16710639	16724053	13414	g_19376	g_19378
Super-Scaffold_100013	16724874	16729098	4224	g_19378	g_19379
Super-Scaffold_100013	16730537	16734771	4234	g_19379	g_19380
Super-Scaffold_100013	16735838	16740085	4247	g_19380	g_19381
Super-Scaffold_100013	16741347	16745591	4244	g_19381	g_19382
Super-Scaffold_100013	16746859	16756051	9192	g_19382	g_19384
Super-Scaffold_100013	16756908	16763837	6929	g_19384	g_19386
Super-Scaffold_100013	16765078	16769316	4238	g_19386	g_19387
Super-Scaffold_100013	16770779	16849453	78674	g_19387	g_19392
Super-Scaffold_100013	16850083	16852741	2658	g_19392	g_19393
Super-Scaffold_100013	16862177	16864399	2222	g_19393	g_44516
Super-Scaffold_100013	16866259	16868261	2002	g_44516	g_44517
Super-Scaffold_100013	16871122	16874343	3221	g_44517	g_44518
Super-Scaffold_100013	16874861	16875776	915	g_44518	g_19394
Super-Scaffold_100013	16876306	16886401	10095	g_19394	g_19395
Super-Scaffold_100013	16892578	16895188	2610	g_19395	g_19396
Super-Scaffold_100013	16897274	16904439	7165	g_19396	g_19397
Super-Scaffold_100013	16906816	16910395	3579	g_19397	g_19398
Super-Scaffold_100013	16916436	16916937	501	g_19398	g_19399
Super-Scaffold_100013	16917347	16921122	3775	g_19399	g_19400
Super-Scaffold_100013	16922345	16925520	3175	g_19400	g_19401
Super-Scaffold_100013	16934260	16938975	4715	g_19401	g_19402
Super-Scaffold_100013	16941560	16942211	651	g_19402	g_19403
Super-Scaffold_100013	16944431	16945873	1442	g_19403	g_19404
Super-Scaffold_100013	16949058	16967430	18372	g_19404	g_19405
Super-Scaffold_100013	16986482	16999502	13020	g_19405	g_19406
Super-Scaffold_100013	17022091	17022815	724	g_19406	g_19407
Super-Scaffold_100013	17042690	17046039	3349	g_19407	g_19408
Super-Scaffold_100013	17061551	17073976	12425	g_19408	g_19409
Super-Scaffold_100013	17082899	17096274	13375	g_19409	g_44519
Super-Scaffold_100013	17112617	17116367	3750	g_44519	g_38760
Super-Scaffold_100013	17116654	17123920	7266	g_38760	g_19410
Super-Scaffold_100013	17124231	17169603	45372	g_19410	g_38762
Super-Scaffold_100013	17169863	17226346	56483	g_38762	g_19414
Super-Scaffold_100013	17242170	17338207	96037	g_19414	g_19417
Super-Scaffold_100013	17406361	17565416	159055	g_19417	g_19418
Super-Scaffold_100013	17581154	17595280	14126	g_19418	g_19419
Super-Scaffold_100013	17612334	17618725	6391	g_19419	g_19420
Super-Scaffold_100013	17619378	17628238	8860	g_19420	g_44520
Super-Scaffold_100013	17634215	17639294	5079	g_44520	g_19421
Super-Scaffold_100013	17639629	17645674	6045	g_19421	g_19422
Super-Scaffold_100013	17647476	17649388	1912	g_19422	g_19423
Super-Scaffold_100013	17652850	17652935	85	g_19423	g_19424
Super-Scaffold_100013	17655751	17656755	1004	g_19424	g_19425
Super-Scaffold_100013	17666128	17702706	36578	g_19425	g_19428
Super-Scaffold_100013	17711604	17717002	5398	g_19428	g_19429
Super-Scaffold_100013	17717550	17733214	15664	g_19429	g_19430
Super-Scaffold_100013	17736608	17747373	10765	g_19430	g_19431
Super-Scaffold_100013	17747615	17752927	5312	g_19431	g_19432
Super-Scaffold_100013	17753388	17770522	17134	g_19432	g_19435
Super-Scaffold_100013	17793937	17796893	2956	g_19435	g_19436
Super-Scaffold_100013	17806229	17807658	1429	g_19436	g_19437
Super-Scaffold_100013	17810411	17811972	1561	g_19437	g_19438
Super-Scaffold_100013	17812928	17819198	6270	g_19438	g_19439
Super-Scaffold_100013	17832991	17839289	6298	g_19439	g_19440
Super-Scaffold_100013	17861128	17863304	2176	g_19440	g_19441
Super-Scaffold_100013	17868878	17942438	73560	g_19441	g_19444
Super-Scaffold_100013	17943293	17950764	7471	g_19444	g_19445
Super-Scaffold_100013	17954175	17954983	808	g_19445	g_19446
Super-Scaffold_100013	17958333	17958521	188	g_19446	g_44521
Super-Scaffold_100013	17959404	17960643	1239	g_44521	g_19447
Super-Scaffold_100013	17972494	17981968	9474	g_19447	g_19448
Super-Scaffold_100013	17988793	17990634	1841	g_19448	g_19449
Super-Scaffold_100013	17996202	17998131	1929	g_19449	g_19450
Super-Scaffold_100013	17999471	18004171	4700	g_19450	g_19451
Super-Scaffold_100013	18008771	18010087	1316	g_19451	g_19453
Super-Scaffold_100013	18016429	18045190	28761	g_19453	g_19455
Super-Scaffold_100013	18046938	18049071	2133	g_19455	g_44522
Super-Scaffold_100013	18079508	18084586	5078	g_44522	g_19456
Super-Scaffold_100013	18094821	18096960	2139	g_19456	g_19457
Super-Scaffold_100013	18105391	18110119	4728	g_19457	g_19458
Super-Scaffold_100013	18117775	18121177	3402	g_19458	g_44523
Super-Scaffold_100013	18129461	18133807	4346	g_44523	g_44524
Super-Scaffold_100013	18163698	18165016	1318	g_44524	g_19459
Super-Scaffold_100013	18169434	18171592	2158	g_19459	g_19460
Super-Scaffold_100013	18179938	18181858	1920	g_19460	g_19461
Super-Scaffold_100013	18187160	18193378	6218	g_19461	g_19462
Super-Scaffold_100013	18195793	18214380	18587	g_19462	g_19463
Super-Scaffold_100013	18221005	18221403	398	g_19463	g_19464
Super-Scaffold_100013	18221789	18224927	3138	g_19464	g_19465
Super-Scaffold_100013	18242399	18245195	2796	g_19465	g_19466
Super-Scaffold_100013	18246264	18247629	1365	g_19466	g_19467
Super-Scaffold_100013	18248718	18251931	3213	g_19467	g_19468
Super-Scaffold_100013	18254906	18259043	4137	g_19468	g_19469
Super-Scaffold_100013	18287745	18336550	48805	g_19469	g_19471
Super-Scaffold_100013	18336792	18352154	15362	g_19471	g_19474
Super-Scaffold_100013	18356530	18360424	3894	g_19474	g_19475
Super-Scaffold_100013	18363194	18377692	14498	g_19475	g_19477
Super-Scaffold_100013	18385999	18388438	2439	g_19477	g_19478
Super-Scaffold_100013	18394959	18398880	3921	g_19478	g_19479
Super-Scaffold_100013	18401516	18403334	1818	g_19479	g_19480
Super-Scaffold_100013	18407654	18416146	8492	g_19480	g_19481
Super-Scaffold_100013	18423667	18426711	3044	g_19481	g_38775
Super-Scaffold_100013	18426995	18429496	2501	g_38775	g_19482
Super-Scaffold_100013	18435707	18435886	179	g_19482	g_44525
Super-Scaffold_100013	18440808	18444346	3538	g_44525	g_19483
Super-Scaffold_100013	18450642	18451105	463	g_19483	g_19484
Super-Scaffold_100013	18455915	18459121	3206	g_19484	g_19485
Super-Scaffold_100013	18460323	18462567	2244	g_19485	g_19486
Super-Scaffold_100013	18463001	18475365	12364	g_19486	g_19487
Super-Scaffold_100013	18475889	18476374	485	g_19487	g_19488
Super-Scaffold_100013	18477633	18477666	33	g_19488	g_19489
Super-Scaffold_100013	18478124	18478685	561	g_19489	g_19490
Super-Scaffold_100013	18479203	18510761	31558	g_19490	g_19492
Super-Scaffold_100013	18515466	18527536	12070	g_19492	g_19494
Super-Scaffold_100013	18535093	18538477	3384	g_19494	g_19495
Super-Scaffold_100013	18541162	18543270	2108	g_19495	g_19496
Super-Scaffold_100013	18545309	18546039	730	g_19496	g_19497
Super-Scaffold_100013	18548380	18610352	61972	g_19497	g_19499
Super-Scaffold_100013	18612706	18624926	12220	g_19499	g_19501
Super-Scaffold_100013	18636507	18647376	10869	g_19501	g_19502
Super-Scaffold_100013	18653159	18654885	1726	g_19502	g_44526
Super-Scaffold_100013	18658497	18666246	7749	g_44526	g_19503
Super-Scaffold_100013	18682054	18689757	7703	g_19503	g_19504
Super-Scaffold_100013	18693303	18696315	3012	g_19504	g_19505
Super-Scaffold_100013	18699921	18712501	12580	g_19505	g_19506
Super-Scaffold_100013	18735149	18741698	6549	g_19506	g_19508
Super-Scaffold_100013	18745465	18747674	2209	g_19508	g_19509
Super-Scaffold_100013	18759427	18767316	7889	g_19509	g_19510
Super-Scaffold_100013	18776553	18785110	8557	g_19510	g_19511
Super-Scaffold_100013	18787579	18803996	16417	g_19511	g_19512
Super-Scaffold_100013	18814398	18817319	2921	g_19512	g_19513
Super-Scaffold_100013	18819297	18820545	1248	g_19513	g_19514
Super-Scaffold_100013	18826577	18827494	917	g_19514	g_19515
Super-Scaffold_100013	18833009	18836738	3729	g_19515	g_19516
Super-Scaffold_100013	18840062	18843068	3006	g_19516	g_19517
Super-Scaffold_100013	18849817	18854749	4932	g_19517	g_19518
Super-Scaffold_100013	18869379	18877153	7774	g_19518	g_19519
Super-Scaffold_100013	18878019	18881854	3835	g_19519	g_19520
Super-Scaffold_100013	18895599	18914064	18465	g_19520	g_19521
Super-Scaffold_100013	18917277	18924139	6862	g_19521	g_19522
Super-Scaffold_100013	18929035	19008025	78990	g_19522	g_19524
Super-Scaffold_100013	19009878	19013399	3521	g_19524	g_19525
Super-Scaffold_100013	19014834	19036376	21542	g_19525	g_19526
Super-Scaffold_100013	19038212	19038249	37	g_19526	g_19527
Super-Scaffold_100013	19039884	19042032	2148	g_19527	g_19528
Super-Scaffold_100013	19058149	19068597	10448	g_19528	g_19529
Super-Scaffold_100013	19085154	19093957	8803	g_19529	g_19530
Super-Scaffold_100013	19094325	19095450	1125	g_19530	g_19531
Super-Scaffold_100013	19095755	19100233	4478	g_19531	g_19532
Super-Scaffold_100013	19101703	19102822	1119	g_19532	g_19533
Super-Scaffold_100013	19103595	19112909	9314	g_19533	g_19534
Super-Scaffold_100013	19113319	19122068	8749	g_19534	g_38781
Super-Scaffold_100013	19122268	19192137	69869	g_38781	g_19537
Super-Scaffold_100013	19193822	19357253	163431	g_19537	g_19541
Super-Scaffold_100013	19367670	19370569	2899	g_19541	g_44527
Super-Scaffold_100013	19374552	19374731	179	g_44527	g_44528
Super-Scaffold_100013	19393720	19399971	6251	g_38787	g_19542
Super-Scaffold_100013	19410162	19411238	1076	g_19542	g_19543
Super-Scaffold_100013	19437381	19456479	19098	g_19543	g_19544
Super-Scaffold_100013	19460740	19463915	3175	g_19544	g_19545
Super-Scaffold_100013	19472716	19474726	2010	g_19545	g_19546
Super-Scaffold_100013	19479997	19483106	3109	g_19546	g_19547
Super-Scaffold_100013	19485112	19492122	7010	g_19547	g_19548
Super-Scaffold_100013	19499360	19502758	3398	g_19548	g_19549
Super-Scaffold_100013	19517158	19520430	3272	g_19549	g_19550
Super-Scaffold_100013	19532856	19534525	1669	g_19550	g_19551
Super-Scaffold_100013	19545275	19547789	2514	g_19551	g_19552
Super-Scaffold_100013	19550155	19552053	1898	g_19552	g_19553
Super-Scaffold_100013	19557212	19575504	18292	g_19553	g_38788
Super-Scaffold_100013	19575704	19745913	170209	g_38788	g_19557
Super-Scaffold_100013	19746653	19782252	35599	g_19557	g_19560
Super-Scaffold_100013	19797431	19803796	6365	g_19560	g_19561
Super-Scaffold_100013	19805825	19808596	2771	g_19561	g_19562
Super-Scaffold_100013	19813820	19813873	53	g_19562	g_19563
Super-Scaffold_100013	19814103	19815692	1589	g_19563	g_44529
Super-Scaffold_100013	19824870	19833595	8725	g_44529	g_19564
Super-Scaffold_100013	19833870	19839778	5908	g_19564	g_44530
Super-Scaffold_100013	19845541	19856215	10674	g_44530	g_19565
Super-Scaffold_100013	19874873	19877683	2810	g_19565	g_44531
Super-Scaffold_100013	19877898	19878901	1003	g_44531	g_44532
Super-Scaffold_100013	19891792	19894222	2430	g_44532	g_19566
Super-Scaffold_100013	19896268	19899032	2764	g_19566	g_19567
Super-Scaffold_100013	19899946	19903381	3435	g_19567	g_19568
Super-Scaffold_100013	19908553	19914042	5489	g_19568	g_19569
Super-Scaffold_100013	19938210	19954037	15827	g_19569	g_19570
Super-Scaffold_100013	19954303	19956899	2596	g_19570	g_38794
Super-Scaffold_100013	19957105	19966471	9366	g_38794	g_19572
Super-Scaffold_100013	19969554	19977405	7851	g_19572	g_19573
Super-Scaffold_100013	19986589	19998743	12154	g_19573	g_19575
Super-Scaffold_100013	19999114	20007027	7913	g_19575	g_19576
Super-Scaffold_100013	20030086	20039558	9472	g_19576	g_19577
Super-Scaffold_100013	20041294	20044448	3154	g_19577	g_19578
Super-Scaffold_100013	20045678	20049681	4003	g_19578	g_19579
Super-Scaffold_100013	20054190	20054983	793	g_19579	g_44533
Super-Scaffold_100013	20066184	20073023	6839	g_44533	g_19580
Super-Scaffold_100013	20075998	20080941	4943	g_19580	g_19581
Super-Scaffold_100013	20086335	20090312	3977	g_19581	g_19582
Super-Scaffold_100013	20093234	20096002	2768	g_19582	g_19583
Super-Scaffold_100013	20106317	20110451	4134	g_19583	g_19584
Super-Scaffold_100013	20115608	20133247	17639	g_19584	g_19585
Super-Scaffold_100013	20134497	20135719	1222	g_19585	g_19586
Super-Scaffold_100013	20139521	20143706	4185	g_19586	g_19587
Super-Scaffold_100013	20144440	20172479	28039	g_19587	g_19588
Super-Scaffold_100013	20173837	20232738	58901	g_19588	g_19590
Super-Scaffold_100013	20236315	20239374	3059	g_19590	g_19591
Super-Scaffold_100013	20247684	20251450	3766	g_19591	g_19592
Super-Scaffold_100013	20256960	20272993	16033	g_19592	g_19593
Super-Scaffold_100013	20277260	20295817	18557	g_19593	g_19594
Super-Scaffold_100013	20316791	20319485	2694	g_19594	g_19595
Super-Scaffold_100013	20320591	20322175	1584	g_19595	g_19596
Super-Scaffold_100013	20323099	20327136	4037	g_19596	g_19597
Super-Scaffold_100013	20329386	20333940	4554	g_19597	g_44534
Super-Scaffold_100013	20342623	20352060	9437	g_44534	g_19598
Super-Scaffold_100013	20352884	20353862	978	g_19598	g_19599
Super-Scaffold_100013	20361325	20383186	21861	g_19599	g_19600
Super-Scaffold_100013	20393355	20403581	10226	g_19600	g_44535
Super-Scaffold_100013	20420222	20440906	20684	g_44535	g_19603
Super-Scaffold_100013	20441136	20449302	8166	g_19603	g_19605
Super-Scaffold_100013	20450863	20471714	20851	g_19605	g_19606
Super-Scaffold_100013	20480512	20481392	880	g_19606	g_19607
Super-Scaffold_100013	20483750	20484036	286	g_19607	g_19608
Super-Scaffold_100013	20488518	20496429	7911	g_19608	g_19609
Super-Scaffold_100013	20498508	20547620	49112	g_19609	g_19611
Super-Scaffold_100013	20554903	20571250	16347	g_19611	g_19612
Super-Scaffold_100013	20578961	20583218	4257	g_19612	g_19613
Super-Scaffold_100013	20584795	20585607	812	g_19613	g_19614
Super-Scaffold_100013	20585825	20599620	13795	g_19614	g_19615
Super-Scaffold_100013	20610967	20615561	4594	g_19615	g_19616
Super-Scaffold_100013	20628099	20656720	28621	g_19616	g_19617
Super-Scaffold_100013	20682127	20694869	12742	g_19617	g_38800
Super-Scaffold_100013	20702521	20704897	2376	g_19618	g_19619
Super-Scaffold_100013	20705154	20724238	19084	g_19619	g_19620
Super-Scaffold_100013	20724441	20752923	28482	g_19620	g_19621
Super-Scaffold_100013	20753246	20762679	9433	g_19621	g_19622
Super-Scaffold_100013	20767733	20790797	23064	g_19622	g_19623
Super-Scaffold_100013	20795985	20865531	69546	g_19623	g_19625
Super-Scaffold_100013	20865947	21062124	196177	g_19625	g_19627
Super-Scaffold_100013	21065780	21102415	36635	g_19627	g_19628
Super-Scaffold_100013	21102801	21248816	146015	g_19628	g_19630
Super-Scaffold_100013	21249226	21344601	95375	g_19630	g_19632
Super-Scaffold_100013	21417575	21684191	266616	g_19632	g_19636
Super-Scaffold_100013	21684608	21693156	8548	g_19636	g_19637
Super-Scaffold_100013	21763468	21771175	7707	g_19637	g_19638
Super-Scaffold_100013	21788888	21791638	2750	g_19638	g_19639
Super-Scaffold_100013	21813112	21823392	10280	g_19639	g_19640
Super-Scaffold_100013	21842685	21881470	38785	g_19640	g_19642
Super-Scaffold_100013	21906545	21920875	14330	g_19642	g_19644
Super-Scaffold_100013	21928882	21958944	30062	g_19644	g_19646
Super-Scaffold_100013	21969815	21971180	1365	g_19646	g_19647
Super-Scaffold_100013	21972713	21973696	983	g_19647	g_44536
Super-Scaffold_100013	21986893	21994076	7183	g_44536	g_19648
Super-Scaffold_100013	22000011	22006596	6585	g_19648	g_19649
Super-Scaffold_100013	22010313	22187862	177549	g_19649	g_19650
Super-Scaffold_100013	22188913	22195162	6249	g_19650	g_19651
Super-Scaffold_100013	22207625	22210305	2680	g_19651	g_19652
Super-Scaffold_100013	22210604	22211121	517	g_19652	g_44537
Super-Scaffold_100013	22213114	22215164	2050	g_44537	g_44538
Super-Scaffold_100013	22219490	22220289	799	g_44538	g_19653
Super-Scaffold_100013	22223132	22228640	5508	g_19653	g_19654
Super-Scaffold_100013	22228840	22252356	23516	g_19654	g_19655
Super-Scaffold_100013	22253530	22259105	5575	g_19655	g_38806
Super-Scaffold_100013	22259374	22305194	45820	g_38806	g_19657
Super-Scaffold_100013	22305742	22317050	11308	g_19657	g_19658
Super-Scaffold_100013	22317256	22335243	17987	g_19658	g_44539
Super-Scaffold_100013	22335494	22346231	10737	g_44539	g_44540
Super-Scaffold_100013	22361259	22371825	10566	g_44540	g_19659
Super-Scaffold_100013	22382341	22383817	1476	g_19659	g_19660
Super-Scaffold_100013	22385861	22393638	7777	g_19660	g_19661
Super-Scaffold_100013	22395262	22397286	2024	g_19661	g_19662
Super-Scaffold_100013	22397726	22565061	167335	g_19662	g_19665
Super-Scaffold_100013	22565720	22580785	15065	g_19665	g_19666
Super-Scaffold_100013	22581030	22670941	89911	g_19666	g_19667
Super-Scaffold_100013	22717323	22791446	74123	g_19667	g_19668
Super-Scaffold_100013	22793030	22802769	9739	g_19668	g_44541
Super-Scaffold_100013	22806336	22881850	75514	g_44541	g_19670
Super-Scaffold_100013	22897757	22935367	37610	g_19670	g_19671
Super-Scaffold_100013	22940328	22962490	22162	g_19671	g_19672
Super-Scaffold_100013	22969553	22972897	3344	g_19672	g_19673
Super-Scaffold_100013	22974355	22975102	747	g_19673	g_19674
Super-Scaffold_100013	22982134	22986518	4384	g_19674	g_19675
Super-Scaffold_100013	23001001	23015458	14457	g_19675	g_19676
Super-Scaffold_100013	23027847	23030841	2994	g_19676	g_19677
Super-Scaffold_100013	23065049	23068508	3459	g_19678	g_19679
Super-Scaffold_100013	23080519	23083786	3267	g_19679	g_19680
Super-Scaffold_100013	23089321	23093703	4382	g_19680	g_19681
Super-Scaffold_100013	23107891	23144271	36380	g_19681	g_19682
Super-Scaffold_100013	23150320	23178769	28449	g_19682	g_19684
Super-Scaffold_100013	23183820	23190771	6951	g_19684	g_19685
Super-Scaffold_100013	23191130	23200209	9079	g_19685	g_44542
Super-Scaffold_100013	23214192	23217597	3405	g_44542	g_19686
Super-Scaffold_100013	23232022	23252901	20879	g_19686	g_19687
Super-Scaffold_100013	23260157	23261864	1707	g_19687	g_19688
Super-Scaffold_100013	23265120	23306703	41583	g_19688	g_19690
Super-Scaffold_100013	23310785	23314382	3597	g_19690	g_19691
Super-Scaffold_100013	23320618	23336180	15562	g_19691	g_19692
Super-Scaffold_100013	23339446	23340964	1518	g_19692	g_19693
Super-Scaffold_100013	23354297	23359904	5607	g_19693	g_44543
Super-Scaffold_100013	23363500	23365415	1915	g_44543	g_19694
Super-Scaffold_100013	23366630	23367734	1104	g_19694	g_19695
Super-Scaffold_100013	23376767	23382695	5928	g_19695	g_19696
Super-Scaffold_100013	23384108	23388167	4059	g_19696	g_19697
Super-Scaffold_100013	23391666	23394090	2424	g_19697	g_44544
Super-Scaffold_100013	23395695	23397671	1976	g_44544	g_19698
Super-Scaffold_100013	23404618	23404790	172	g_19698	g_19699
Super-Scaffold_100013	23405155	23407135	1980	g_19699	g_19700
Super-Scaffold_100013	23410813	23413202	2389	g_19700	g_19701
Super-Scaffold_100013	23415456	23415907	451	g_19701	g_19702
Super-Scaffold_100013	23417463	23418435	972	g_19702	g_19703
Super-Scaffold_100013	23425264	23426525	1261	g_19703	g_19704
Super-Scaffold_100013	23430323	23458615	28292	g_19704	g_19705
Super-Scaffold_100013	23471430	23486402	14972	g_19705	g_19706
Super-Scaffold_100013	23489731	23507733	18002	g_19706	g_38812
Super-Scaffold_100013	23508290	23515691	7401	g_38812	g_19707
Super-Scaffold_100013	23524924	23531111	6187	g_19707	g_44545
Super-Scaffold_100013	23567229	23576034	8805	g_44545	g_19708
Super-Scaffold_100013	23586185	23588475	2290	g_19708	g_19709
Super-Scaffold_100013	23593815	23596210	2395	g_19709	g_19710
Super-Scaffold_100013	23601286	23616110	14824	g_19710	g_19711
Super-Scaffold_100013	23629613	23631876	2263	g_19711	g_19712
Super-Scaffold_100013	23633462	23635472	2010	g_19712	g_19713
Super-Scaffold_100013	23642152	23645280	3128	g_19713	g_19714
Super-Scaffold_100013	23652479	23668176	15697	g_19714	g_19715
Super-Scaffold_100013	23673129	23674805	1676	g_19715	g_44546
Super-Scaffold_100013	23681255	23684349	3094	g_44546	g_44547
Super-Scaffold_100013	23698678	23703610	4932	g_44547	g_19716
Super-Scaffold_100013	23714421	23721146	6725	g_19716	g_19717
Super-Scaffold_100013	23736968	23739734	2766	g_19717	g_19718
Super-Scaffold_100013	23746427	23750172	3745	g_19718	g_19719
Super-Scaffold_100013	23755841	23758432	2591	g_19719	g_19720
Super-Scaffold_100013	23774271	23781273	7002	g_19720	g_19721
Super-Scaffold_100013	23782938	23792732	9794	g_19721	g_19722
Super-Scaffold_100013	23794339	23795389	1050	g_19722	g_19723
Super-Scaffold_100013	23801917	23802939	1022	g_19723	g_19724
Super-Scaffold_100013	23806861	23810255	3394	g_19724	g_19725
Super-Scaffold_100013	23816719	23834976	18257	g_19725	g_19726
Super-Scaffold_100013	23839412	23843167	3755	g_19726	g_44548
Super-Scaffold_100013	23845624	23846669	1045	g_44548	g_19727
Super-Scaffold_100013	23854980	23857276	2296	g_19727	g_19728
Super-Scaffold_100013	23882575	23886423	3848	g_19728	g_19729
Super-Scaffold_100013	23888273	23890508	2235	g_19729	g_19730
Super-Scaffold_100013	23895576	23901791	6215	g_19730	g_19731
Super-Scaffold_100013	23908139	23910862	2723	g_19731	g_19732
Super-Scaffold_100013	23922055	23931430	9375	g_19732	g_19733
Super-Scaffold_100013	23951026	23951593	567	g_19733	g_19734
Super-Scaffold_100013	23952878	23953809	931	g_19734	g_19735
Super-Scaffold_100013	23987282	23989903	2621	g_19735	g_19736
Super-Scaffold_100013	23992718	23995887	3169	g_19736	g_19737
Super-Scaffold_100013	23997866	23999462	1596	g_19737	g_19738
Super-Scaffold_100013	24003169	24011471	8302	g_19738	g_19739
Super-Scaffold_100013	24012708	24014227	1519	g_19739	g_19740
Super-Scaffold_100013	24035695	24038300	2605	g_19740	g_19741
Super-Scaffold_100013	24047015	24052755	5740	g_19741	g_19742
Super-Scaffold_100013	24054488	24064590	10102	g_19742	g_19744
Super-Scaffold_100013	24072187	24073262	1075	g_19744	g_19745
Super-Scaffold_100013	24074296	24075171	875	g_19745	g_44549
Super-Scaffold_100013	24083288	24088720	5432	g_44549	g_19746
Super-Scaffold_100013	24088971	24228754	139783	g_19746	g_19750
Super-Scaffold_100013	24229083	24378746	149663	g_19750	g_19752
Super-Scaffold_100013	24385410	24396591	11181	g_19752	g_38822
Super-Scaffold_100013	24396794	24396959	165	g_38822	g_19753
Super-Scaffold_100013	24484507	24499524	15017	g_19753	g_19754
Super-Scaffold_100013	24499934	24517778	17844	g_19754	g_19756
Super-Scaffold_100013	24520233	24564886	44653	g_19756	g_19757
Super-Scaffold_100013	24571965	24580436	8471	g_19757	g_19758
Super-Scaffold_100013	24581204	24584239	3035	g_19758	g_19759
Super-Scaffold_100013	24585090	24595687	10597	g_19759	g_19760
Super-Scaffold_100013	24596241	24596530	289	g_19760	g_44550
Super-Scaffold_100013	24596868	24625225	28357	g_44550	g_19761
Super-Scaffold_100013	24627646	24690274	62628	g_19761	g_19763
Super-Scaffold_100013	24696902	24702734	5832	g_19763	g_19764
Super-Scaffold_100013	24709549	24723808	14259	g_19764	g_19765
Super-Scaffold_100013	24742114	24780631	38517	g_19765	g_19767
Super-Scaffold_100013	24788025	24789331	1306	g_19767	g_44551
Super-Scaffold_100013	24799612	24801873	2261	g_44551	g_19768
Super-Scaffold_100013	24805014	24806360	1346	g_19768	g_19769
Super-Scaffold_100013	24810213	24820502	10289	g_19769	g_19770
Super-Scaffold_100013	24821085	24829472	8387	g_19770	g_44552
Super-Scaffold_100013	24832140	24837011	4871	g_44552	g_44553
Super-Scaffold_100013	24864842	24867383	2541	g_44553	g_19771
Super-Scaffold_100013	24885048	25099534	214486	g_19771	g_19776
Super-Scaffold_100013	25101161	25112517	11356	g_19776	g_19777
Super-Scaffold_100013	25112897	25189753	76856	g_19777	g_19778
Super-Scaffold_100013	25190802	25257178	66376	g_19778	g_38824
Super-Scaffold_100013	25257483	25266026	8543	g_38824	g_19779
Super-Scaffold_100013	25286034	25337215	51181	g_19779	g_19782
Super-Scaffold_100013	25337418	25345381	7963	g_19782	g_19783
Super-Scaffold_100013	25355852	25376256	20404	g_19783	g_19784
Super-Scaffold_100013	25385629	25387158	1529	g_19784	g_19785
Super-Scaffold_100013	25397030	25403599	6569	g_19785	g_19786
Super-Scaffold_100013	25414925	25416535	1610	g_19786	g_19787
Super-Scaffold_100013	25419452	25442212	22760	g_19787	g_19788
Super-Scaffold_100013	25454294	25455879	1585	g_19788	g_19789
Super-Scaffold_100013	25463790	25465434	1644	g_19789	g_19790
Super-Scaffold_100013	25471017	25471491	474	g_19790	g_19791
Super-Scaffold_100013	25483396	25488066	4670	g_19791	g_19792
Super-Scaffold_100013	25507453	25597301	89848	g_19792	g_19795
Super-Scaffold_100013	25623352	25626638	3286	g_19795	g_44554
Super-Scaffold_100013	25649189	25659818	10629	g_44554	g_19797
Super-Scaffold_100013	25662626	25663605	979	g_19797	g_19798
Super-Scaffold_100013	25663874	25664414	540	g_19798	g_44555
Super-Scaffold_100013	25667855	25669274	1419	g_44555	g_19799
Super-Scaffold_100013	25686092	25690739	4647	g_19799	g_19800
Super-Scaffold_100013	25691686	25694499	2813	g_19800	g_19801
Super-Scaffold_100013	25701878	25708054	6176	g_19801	g_19802
Super-Scaffold_100013	25712663	25719998	7335	g_19802	g_19803
Super-Scaffold_100013	25733998	25747636	13638	g_19803	g_19804
Super-Scaffold_100013	25757824	25765894	8070	g_19804	g_19805
Super-Scaffold_100013	25767279	25769049	1770	g_19805	g_19806
Super-Scaffold_100013	25776567	25777296	729	g_19806	g_19807
Super-Scaffold_100013	25787767	25788562	795	g_19807	g_19808
Super-Scaffold_100013	25801927	25813474	11547	g_19808	g_19809
Super-Scaffold_100013	25818964	25823130	4166	g_19809	g_38830
Super-Scaffold_100013	25823483	25849796	26313	g_38830	g_19813
Super-Scaffold_100013	25862253	25868167	5914	g_19813	g_19814
Super-Scaffold_100013	25881552	25907920	26368	g_19814	g_19815
Super-Scaffold_100013	25910326	25915335	5009	g_19815	g_19816
Super-Scaffold_100013	25924417	25927505	3088	g_19816	g_19817
Super-Scaffold_100013	25932948	25961770	28822	g_19817	g_19818
Super-Scaffold_100013	25969918	25986059	16141	g_19818	g_19820
Super-Scaffold_100013	25986508	26129052	142544	g_19820	g_19823
Super-Scaffold_100013	26133150	26152409	19259	g_19823	g_19825
Super-Scaffold_100013	26153104	26155749	2645	g_19825	g_19826
Super-Scaffold_100013	26156464	26188954	32490	g_19826	g_19827
Super-Scaffold_100013	26190748	26233867	43119	g_19827	g_19828
Super-Scaffold_100013	26234124	26277918	43794	g_19828	g_44556
Super-Scaffold_100013	26292139	26304936	12797	g_44556	g_19829
Super-Scaffold_100013	26338522	26340220	1698	g_19829	g_44557
Super-Scaffold_100013	26342995	26344912	1917	g_44557	g_19830
Super-Scaffold_100013	26350192	26350842	650	g_19830	g_19831
Super-Scaffold_100013	26362042	26363173	1131	g_19831	g_19832
Super-Scaffold_100013	26366682	26368082	1400	g_19832	g_19833
Super-Scaffold_100013	26372211	26379611	7400	g_19833	g_19834
Super-Scaffold_100013	26385269	26387708	2439	g_19834	g_19835
Super-Scaffold_100013	26402756	26403406	650	g_19835	g_19836
Super-Scaffold_100013	26403741	26407379	3638	g_19836	g_44558
Super-Scaffold_100013	26408192	26412961	4769	g_44558	g_19837
Super-Scaffold_100013	26418830	26429560	10730	g_19837	g_19838
Super-Scaffold_100013	26433854	26457607	23753	g_19838	g_19839
Super-Scaffold_100013	26458089	26470843	12754	g_19839	g_19841
Super-Scaffold_100013	26484871	26490384	5513	g_19841	g_19842
Super-Scaffold_100013	26493031	26493238	207	g_19842	g_19843
Super-Scaffold_100013	26493628	26497805	4177	g_19843	g_19844
Super-Scaffold_100013	26507104	26512505	5401	g_19844	g_19845
Super-Scaffold_100013	26517818	26521253	3435	g_19845	g_19846
Super-Scaffold_100013	26534339	26536081	1742	g_19846	g_44559
Super-Scaffold_100013	26541396	26543085	1689	g_44559	g_19847
Super-Scaffold_100013	26560369	26571750	11381	g_19847	g_19848
Super-Scaffold_100013	26591295	26613664	22369	g_19848	g_19849
Super-Scaffold_100013	26614614	26684344	69730	g_19849	g_19850
Super-Scaffold_100013	26685684	26697045	11361	g_19850	g_19851
Super-Scaffold_100013	26731122	26839105	107983	g_19851	g_19854
Super-Scaffold_100013	26843848	26851386	7538	g_19854	g_44560
Super-Scaffold_100013	26852283	26857405	5122	g_44560	g_44561
Super-Scaffold_100013	26858328	26867909	9581	g_44561	g_44562
Super-Scaffold_100013	26874115	26891054	16939	g_44562	g_19855
Super-Scaffold_100013	26893524	26894314	790	g_19855	g_44563
Super-Scaffold_100013	26896201	26897665	1464	g_44563	g_19856
Super-Scaffold_100013	26908583	26909425	842	g_19856	g_19857
Super-Scaffold_100013	26910684	26912886	2202	g_19857	g_19858
Super-Scaffold_100013	26913206	26914640	1434	g_19858	g_19859
Super-Scaffold_100013	26923036	26932185	9149	g_19859	g_19860
Super-Scaffold_100013	26943425	26955114	11689	g_19860	g_19861
Super-Scaffold_100013	26963285	26965817	2532	g_19861	g_19862
Super-Scaffold_100013	26975742	26978008	2266	g_19862	g_19863
Super-Scaffold_100013	26989790	26993225	3435	g_19863	g_19864
Super-Scaffold_100013	26996056	27008279	12223	g_19864	g_19865
Super-Scaffold_100013	27012516	27030480	17964	g_19865	g_19867
Super-Scaffold_100013	27032201	27061357	29156	g_19867	g_19868
Super-Scaffold_100013	27063225	27067263	4038	g_19868	g_19869
Super-Scaffold_100013	27074314	27074697	383	g_19869	g_19870
Super-Scaffold_100013	27081581	27089021	7440	g_19870	g_44564
Super-Scaffold_100013	27094125	27112931	18806	g_44564	g_19871
Super-Scaffold_100013	27115659	27202469	86810	g_19871	g_19874
Super-Scaffold_100013	27202684	27231546	28862	g_19874	g_19875
Super-Scaffold_100013	27244768	27246749	1981	g_19875	g_19876
Super-Scaffold_100013	27251121	27301038	49917	g_19876	g_19878
Super-Scaffold_100013	27303155	27326958	23803	g_19878	g_19879
Super-Scaffold_100013	27339288	27342296	3008	g_19879	g_19881
Super-Scaffold_100013	27356210	27387109	30899	g_19881	g_19882
Super-Scaffold_100013	27388266	27454665	66399	g_19882	g_19883
Super-Scaffold_100013	27454990	27461356	6366	g_19883	g_19884
Super-Scaffold_100013	27462198	27462543	345	g_19884	g_19885
Super-Scaffold_100013	27465676	27467157	1481	g_19885	g_44565
Super-Scaffold_100013	27480962	27491534	10572	g_44565	g_19887
Super-Scaffold_100013	27494282	27501211	6929	g_19887	g_19888
Super-Scaffold_100013	27506281	27506966	685	g_19888	g_19889
Super-Scaffold_100013	27508330	27508387	57	g_19889	g_19890
Super-Scaffold_100013	27508902	27510455	1553	g_19890	g_19891
Super-Scaffold_100013	27511252	27519703	8451	g_19891	g_44566
Super-Scaffold_100013	27520251	27565118	44867	g_44566	g_19892
Super-Scaffold_100013	27584449	27641029	56580	g_19892	g_19893
Super-Scaffold_100013	27642432	27664997	22565	g_19893	g_19895
Super-Scaffold_100013	27674366	27684892	10526	g_19895	g_19896
Super-Scaffold_100013	27750678	27752288	1610	g_19896	g_19897
Super-Scaffold_100013	27755125	27760881	5756	g_19897	g_19898
Super-Scaffold_100013	27771174	27771974	800	g_19898	g_19899
Super-Scaffold_100013	27773746	27776322	2576	g_19899	g_19900
Super-Scaffold_100013	27782230	27784566	2336	g_19900	g_19901
Super-Scaffold_100013	27788318	27789580	1262	g_19901	g_19902
Super-Scaffold_100013	27793129	27802100	8971	g_19902	g_19903
Super-Scaffold_100013	27809874	27813711	3837	g_19903	g_19904
Super-Scaffold_100013	27816086	27816187	101	g_19904	g_44567
Super-Scaffold_100013	27816489	27817164	675	g_44567	g_19905
Super-Scaffold_100013	27824024	27826544	2520	g_19905	g_19906
Super-Scaffold_100013	27832924	27873698	40774	g_19906	g_19907
Super-Scaffold_100013	27877746	27879503	1757	g_19907	g_19908
Super-Scaffold_100013	27881068	27884423	3355	g_19908	g_19909
Super-Scaffold_100013	27884728	27890238	5510	g_19909	g_19910
Super-Scaffold_100013	27891883	27902991	11108	g_19910	g_19912
Super-Scaffold_100013	27924332	27928204	3872	g_19912	g_19913
Super-Scaffold_100013	27939295	27940033	738	g_19913	g_19914
Super-Scaffold_100013	27967330	27973630	6300	g_19914	g_19915
Super-Scaffold_100013	27980298	27986890	6592	g_19915	g_19916
Super-Scaffold_100013	27992281	27997704	5423	g_19916	g_19917
Super-Scaffold_100013	28000033	28002925	2892	g_19917	g_44568
Super-Scaffold_100013	28015468	28017105	1637	g_44568	g_19918
Super-Scaffold_100013	28022593	28024696	2103	g_19918	g_19919
Super-Scaffold_100013	28028038	28030573	2535	g_19919	g_19920
Super-Scaffold_100013	28038748	28041421	2673	g_19920	g_19921
Super-Scaffold_100013	28051384	28064293	12909	g_19921	g_19922
Super-Scaffold_100013	28065021	28068499	3478	g_19922	g_19923
Super-Scaffold_100013	28075193	28079753	4560	g_19923	g_19924
Super-Scaffold_100013	28085601	28091457	5856	g_19924	g_19926
Super-Scaffold_100013	28091846	28114222	22376	g_19926	g_19927
Super-Scaffold_100013	28122602	28126976	4374	g_19927	g_19928
Super-Scaffold_100013	28162641	28170660	8019	g_19928	g_19929
Super-Scaffold_100013	28174248	28183786	9538	g_19929	g_44569
Super-Scaffold_100013	28184124	28190283	6159	g_44569	g_19930
Super-Scaffold_100013	28192808	28196333	3525	g_19930	g_19931
Super-Scaffold_100013	28202916	28206240	3324	g_19931	g_19932
Super-Scaffold_100013	28212881	28217313	4432	g_19932	g_19933
Super-Scaffold_100013	28240414	28241947	1533	g_19933	g_44570
Super-Scaffold_100013	28247907	28249383	1476	g_44570	g_19934
Super-Scaffold_100013	28267293	28267816	523	g_19934	g_19935
Super-Scaffold_100013	28286891	28289458	2567	g_19935	g_19936
Super-Scaffold_100013	28291786	28301400	9614	g_19936	g_19937
Super-Scaffold_100013	28306282	28310260	3978	g_19937	g_19938
Super-Scaffold_100013	28319862	28342594	22732	g_19938	g_19939
Super-Scaffold_100013	28357090	28366898	9808	g_19939	g_19940
Super-Scaffold_100013	28396875	28422905	26030	g_19940	g_19941
Super-Scaffold_100013	28440613	28443167	2554	g_19941	g_44571
Super-Scaffold_100013	28448729	28533870	85141	g_44571	g_19943
Super-Scaffold_100013	28534837	28546633	11796	g_19943	g_19944
Super-Scaffold_100013	28546845	28547027	182	g_19944	g_19945
Super-Scaffold_100013	28549208	28556167	6959	g_19945	g_19946
Super-Scaffold_100013	28559615	28697480	137865	g_19946	g_19949
Super-Scaffold_100013	28697974	28699135	1161	g_19949	g_19950
Super-Scaffold_100013	28700931	28701689	758	g_19950	g_44572
Super-Scaffold_100013	28708382	28734930	26548	g_44572	g_19951
Super-Scaffold_100013	28735517	28794049	58532	g_19951	g_19953
Super-Scaffold_100013	28794801	28945187	150386	g_19953	g_19955
Super-Scaffold_100013	28945497	28945531	34	g_19955	g_19956
Super-Scaffold_100013	28945776	28959848	14072	g_19956	g_19957
Super-Scaffold_100013	28960549	29105726	145177	g_19957	g_19962
Super-Scaffold_100013	29107404	29198567	91163	g_19962	g_19964
Super-Scaffold_100013	29199407	29199613	206	g_19964	g_44573
Super-Scaffold_100013	29200783	29262963	62180	g_44573	g_19965
Super-Scaffold_100013	29263760	29278345	14585	g_19965	g_19966
Super-Scaffold_100013	29278809	29286543	7734	g_19966	g_19967
Super-Scaffold_100013	29289930	29293489	3559	g_19967	g_19968
Super-Scaffold_100013	29293824	29352741	58917	g_19968	g_19970
Super-Scaffold_100013	29352992	29486877	133885	g_19970	g_19971
Super-Scaffold_100013	29487227	29528337	41110	g_19971	g_38838
Super-Scaffold_100013	29528630	29639173	110543	g_38838	g_19974
Super-Scaffold_100013	29639769	29735249	95480	g_19974	g_19975
Super-Scaffold_100013	29739967	29769411	29444	g_19975	g_19976
Super-Scaffold_100013	29780270	29780315	45	g_19976	g_19977
Super-Scaffold_100013	29780605	29865216	84611	g_19977	g_19979
Super-Scaffold_100013	29866799	29883148	16349	g_19979	g_19980
Super-Scaffold_100013	29893719	29917288	23569	g_19980	g_38841
Super-Scaffold_100013	29917497	29921774	4277	g_38841	g_19982
Super-Scaffold_100013	29934882	29957065	22183	g_19982	g_19983
Super-Scaffold_100013	29957301	29958504	1203	g_19983	g_19984
Super-Scaffold_100013	29959615	29985404	25789	g_19984	g_19986
Super-Scaffold_100013	29985727	30042280	56553	g_19986	g_19988
Super-Scaffold_100013	30057285	30064504	7219	g_19988	g_19989
Super-Scaffold_100013	30085879	30184907	99028	g_19989	g_19991
Super-Scaffold_100013	30185131	30185451	320	g_19991	g_19992
Super-Scaffold_100013	30190823	30214550	23727	g_19992	g_19993
Super-Scaffold_100013	30220457	30240379	19922	g_19993	g_19994
Super-Scaffold_100013	30260727	30266800	6073	g_19994	g_19995
Super-Scaffold_100013	30281441	30285867	4426	g_19995	g_19996
Super-Scaffold_100013	30296728	30311834	15106	g_19996	g_19997
Super-Scaffold_100013	30316474	30322811	6337	g_19997	g_19998
Super-Scaffold_100013	30337836	30357109	19273	g_19998	g_20002
Super-Scaffold_100013	30357387	30358705	1318	g_20002	g_20001
Super-Scaffold_100013	30367014	30370085	3071	g_20001	g_20003
Super-Scaffold_100013	30375059	30413751	38692	g_20003	g_20005
Super-Scaffold_100013	30419408	30500705	81297	g_20005	g_20008
Super-Scaffold_100013	30502844	30504532	1688	g_20008	g_20009
Super-Scaffold_100013	30518105	30521247	3142	g_20009	g_20010
Super-Scaffold_100013	30527875	30530927	3052	g_20010	g_44574
Super-Scaffold_100013	30537011	30542364	5353	g_44574	g_20011
Super-Scaffold_100013	30561041	30623760	62719	g_20011	g_20013
Super-Scaffold_100013	30627336	30650579	23243	g_20013	g_20014
Super-Scaffold_100013	30662340	30705791	43451	g_20014	g_20016
Super-Scaffold_100013	30717797	30724440	6643	g_20016	g_20017
Super-Scaffold_100013	30726401	30749233	22832	g_20017	g_20018
Super-Scaffold_100013	30783663	30802159	18496	g_20018	g_20019
Super-Scaffold_100013	30802605	30802632	27	g_20019	g_20020
Super-Scaffold_100013	30803603	30828426	24823	g_20020	g_20023
Super-Scaffold_100013	30828902	30839062	10160	g_20023	g_20024
Super-Scaffold_100013	30895276	30916180	20904	g_20024	g_20025
Super-Scaffold_100013	30916653	30954249	37596	g_20025	g_20027
Super-Scaffold_100013	30981873	31007528	25655	g_20027	g_20028
Super-Scaffold_100013	31032642	31162649	130007	g_20028	g_20030
Super-Scaffold_100013	31184060	31199621	15561	g_20030	g_20031
Super-Scaffold_100013	31207760	31215175	7415	g_20031	g_20033
Super-Scaffold_100013	31215540	31229204	13664	g_20033	g_20035
Super-Scaffold_100013	31234524	31240735	6211	g_20035	g_20036
Super-Scaffold_100013	31241854	31243720	1866	g_20036	g_20037
Super-Scaffold_100013	31244424	31274481	30057	g_20037	g_20038
Super-Scaffold_100013	31274726	31282244	7518	g_20038	g_20039
Super-Scaffold_100013	31298700	31298795	95	g_20039	g_20040
Super-Scaffold_100013	31307292	31317294	10002	g_20040	g_20041
Super-Scaffold_100013	31338140	31351016	12876	g_20041	g_20042
Super-Scaffold_100013	31353636	31355267	1631	g_20042	g_20043
Super-Scaffold_100013	31356262	31360602	4340	g_20043	g_20044
Super-Scaffold_100013	31360931	31385997	25066	g_20044	g_20045
Super-Scaffold_100013	31389377	31434407	45030	g_20045	g_20048
Super-Scaffold_100013	31436111	31465784	29673	g_20048	g_20050
Super-Scaffold_100013	31466176	31510317	44141	g_20050	g_20051
Super-Scaffold_100013	31529257	31540486	11229	g_20051	g_20052
Super-Scaffold_100013	31540863	31593484	52621	g_20052	g_20053
Super-Scaffold_100013	31597739	31617618	19879	g_20053	g_20055
Super-Scaffold_100013	31618262	31690365	72103	g_20055	g_20056
Super-Scaffold_100013	31691441	31721680	30239	g_20056	g_20057
Super-Scaffold_100013	31722060	31728896	6836	g_20057	g_20058
Super-Scaffold_100013	31730184	31761926	31742	g_20058	g_20059
Super-Scaffold_100013	31768275	31770652	2377	g_20059	g_20060
Super-Scaffold_100013	31771170	31773036	1866	g_20060	g_20061
Super-Scaffold_100013	31783789	31812247	28458	g_20061	g_20062
Super-Scaffold_100013	31831767	31849544	17777	g_20062	g_20064
Super-Scaffold_100013	31852257	31856344	4087	g_20064	g_20065
Super-Scaffold_100013	31856658	31883777	27119	g_20065	g_20067
Super-Scaffold_100013	31884034	31918595	34561	g_20067	g_20068
Super-Scaffold_100013	31941726	32071032	129306	g_20068	g_20069
Super-Scaffold_100013	32084724	32134756	50032	g_20069	g_20071
Super-Scaffold_100013	32135274	32251801	116527	g_20071	g_20074
Super-Scaffold_100013	32252034	32259470	7436	g_20074	g_20075
Super-Scaffold_100013	32267269	32549005	281736	g_20075	g_20076
Super-Scaffold_100013	32549298	32549337	39	g_20076	g_20077
Super-Scaffold_100013	32549540	32549953	413	g_20077	g_20078
Super-Scaffold_100013	32550567	32553601	3034	g_20078	g_20079
Super-Scaffold_100013	32564588	32676450	111862	g_20079	g_20085
Super-Scaffold_100013	32695033	32729304	34271	g_20085	g_20087
Super-Scaffold_100013	32748220	32756404	8184	g_20087	g_44575
Super-Scaffold_100013	32776180	32874252	98072	g_44575	g_20088
Super-Scaffold_100013	32878793	32923991	45198	g_20088	g_20090
Super-Scaffold_100013	32924242	32939547	15305	g_20090	g_20091
Super-Scaffold_100013	32947883	33006660	58777	g_20091	g_20092
Super-Scaffold_100013	33010056	33035944	25888	g_20092	g_38855
Super-Scaffold_100013	33036177	33093702	57525	g_38855	g_38856
Super-Scaffold_100013	33093908	33093966	58	g_38856	g_20094
Super-Scaffold_100013	33094385	33114220	19835	g_20094	g_20095
Super-Scaffold_100013	33126287	33147362	21075	g_20095	g_20096
Super-Scaffold_100013	33148198	33154993	6795	g_20096	g_20097
Super-Scaffold_100013	33159315	33168042	8727	g_20097	g_20098
Super-Scaffold_100013	33194151	33202033	7882	g_20098	g_20099
Super-Scaffold_100013	33220890	33241602	20712	g_20099	g_20100
Super-Scaffold_100013	33252579	33280238	27659	g_20100	g_20102
Super-Scaffold_100013	33286688	33323790	37102	g_20102	g_20103
Super-Scaffold_100013	33325799	33337137	11338	g_20103	g_20105
Super-Scaffold_100013	33390163	33391260	1097	g_20105	g_20106
Super-Scaffold_100013	33393992	33417986	23994	g_38857	g_20107
Super-Scaffold_100013	33420998	33506225	85227	g_20107	g_20108
Super-Scaffold_100013	33530664	33588113	57449	g_20108	g_20109
Super-Scaffold_100013	33589933	33590413	480	g_20109	g_20110
Super-Scaffold_100013	33590709	33638484	47775	g_20110	g_20115
Super-Scaffold_100015	108252	116726	8474	g_21275	g_21277
Super-Scaffold_100015	117934	123514	5580	g_21277	g_21279
Super-Scaffold_100015	139521	235410	95889	g_21279	g_21281
Super-Scaffold_100015	241424	357179	115755	g_21281	g_21282
Super-Scaffold_100015	358600	373183	14583	g_21282	g_21283
Super-Scaffold_100015	374962	403027	28065	g_21283	g_38092
Super-Scaffold_100015	404007	445497	41490	g_38092	g_21286
Super-Scaffold_100015	496014	512910	16896	g_21286	g_21287
Super-Scaffold_100015	524024	525729	1705	g_21287	g_38093
Super-Scaffold_100015	526007	549775	23768	g_38093	g_21288
Super-Scaffold_100015	557692	566991	9299	g_21288	g_21289
Super-Scaffold_100015	575042	585198	10156	g_21289	g_21290
Super-Scaffold_100015	585404	587679	2275	g_21290	g_21291
Super-Scaffold_100015	597598	599250	1652	g_21291	g_21292
Super-Scaffold_100015	611563	616731	5168	g_21292	g_21293
Super-Scaffold_100015	626633	628280	1647	g_21293	g_21294
Super-Scaffold_100015	640558	649935	9377	g_21294	g_21295
Super-Scaffold_100015	662223	665445	3222	g_21295	g_44672
Super-Scaffold_100015	689828	729333	39505	g_44672	g_21296
Super-Scaffold_100015	736948	747302	10354	g_21296	g_21297
Super-Scaffold_100015	755208	807107	51899	g_21297	g_21299
Super-Scaffold_100015	807328	881625	74297	g_21299	g_21300
Super-Scaffold_100015	884592	911420	26828	g_21300	g_21303
Super-Scaffold_100015	917539	923005	5466	g_21303	g_21304
Super-Scaffold_100015	981597	988796	7199	g_21304	g_21305
Super-Scaffold_100015	991594	998131	6537	g_21305	g_21306
Super-Scaffold_100015	1012789	1025957	13168	g_21306	g_21307
Super-Scaffold_100015	1029355	1033157	3802	g_21307	g_21308
Super-Scaffold_100015	1042167	1051563	9396	g_21308	g_21309
Super-Scaffold_100015	1082297	1098908	16611	g_21309	g_21311
Super-Scaffold_100015	1100381	1104364	3983	g_21311	g_21312
Super-Scaffold_100015	1111842	1116840	4998	g_21312	g_21313
Super-Scaffold_100015	1123439	1149957	26518	g_21313	g_21314
Super-Scaffold_100015	1152326	1197661	45335	g_21314	g_44673
Super-Scaffold_100015	1197990	1209808	11818	g_44673	g_21315
Super-Scaffold_100015	1234127	1253819	19692	g_21315	g_21316
Super-Scaffold_100015	1268388	1282206	13818	g_21316	g_44674
Super-Scaffold_100015	1290318	1299641	9323	g_44674	g_21317
Super-Scaffold_100015	1299871	1359963	60092	g_21317	g_21319
Super-Scaffold_100015	1361066	1361592	526	g_21319	g_21320
Super-Scaffold_100015	1412462	1436471	24009	g_21320	g_21321
Super-Scaffold_100015	1436755	1437268	513	g_21321	g_21322
Super-Scaffold_100015	1460136	1502223	42087	g_21322	g_21323
Super-Scaffold_100015	1502961	1596946	93985	g_21323	g_21325
Super-Scaffold_100015	1607518	1619131	11613	g_21325	g_21326
Super-Scaffold_100015	1620468	1622481	2013	g_21326	g_21327
Super-Scaffold_100015	1636175	1723174	86999	g_21327	g_21330
Super-Scaffold_100015	1744393	1747785	3392	g_21330	g_21331
Super-Scaffold_100015	1751247	1757919	6672	g_21331	g_21332
Super-Scaffold_100015	1759310	1763284	3974	g_21332	g_21333
Super-Scaffold_100015	1764178	1764224	46	g_21333	g_21334
Super-Scaffold_100015	1766906	1768423	1517	g_21334	g_21336
Super-Scaffold_100015	1771261	1771319	58	g_21336	g_21337
Super-Scaffold_100015	1772550	1836270	63720	g_21337	g_21338
Super-Scaffold_100015	1836593	2108524	271931	g_21338	g_38101
Super-Scaffold_100015	2109093	2135251	26158	g_38101	g_21342
Super-Scaffold_100015	2135568	2374148	238580	g_21342	g_21346
Super-Scaffold_100015	2374417	2610122	235705	g_21346	g_38106
Super-Scaffold_100015	2610730	2701643	90913	g_38106	g_21350
Super-Scaffold_100015	2725657	2728337	2680	g_21350	g_21351
Super-Scaffold_100015	2733213	2735934	2721	g_21351	g_21352
Super-Scaffold_100015	2750320	2751065	745	g_21352	g_21353
Super-Scaffold_100015	2760354	2777193	16839	g_21353	g_21354
Super-Scaffold_100015	2821175	2845228	24053	g_21354	g_21355
Super-Scaffold_100015	2854678	2857720	3042	g_21355	g_21356
Super-Scaffold_100015	2874188	2879415	5227	g_21356	g_21357
Super-Scaffold_100015	2880164	2880571	407	g_21357	g_21358
Super-Scaffold_100015	2886624	2950725	64101	g_21358	g_21360
Super-Scaffold_100015	2963587	2968287	4700	g_21360	g_21361
Super-Scaffold_100015	2987718	3043338	55620	g_21361	g_21362
Super-Scaffold_100015	3049116	3052502	3386	g_21362	g_21363
Super-Scaffold_100015	3054647	3082037	27390	g_21363	g_21364
Super-Scaffold_100015	3085769	3097588	11819	g_21364	g_21365
Super-Scaffold_100015	3110283	3115614	5331	g_21365	g_21366
Super-Scaffold_100015	3137116	3141635	4519	g_21366	g_21367
Super-Scaffold_100015	3144016	3229633	85617	g_21367	g_21369
Super-Scaffold_100015	3261624	3596653	335029	g_21369	g_38109
Super-Scaffold_100015	3596910	3745894	148984	g_38109	g_38110
Super-Scaffold_100015	3746097	3865628	119531	g_38110	g_21374
Super-Scaffold_100015	3867458	3872188	4730	g_21374	g_21375
Super-Scaffold_100015	3874018	3878825	4807	g_21375	g_21376
Super-Scaffold_100015	3880655	3909991	29336	g_21376	g_21377
Super-Scaffold_100015	3910743	3950184	39441	g_21377	g_21378
Super-Scaffold_100015	3950420	3977098	26678	g_21378	g_21379
Super-Scaffold_100015	3990110	3995235	5125	g_21379	g_21380
Super-Scaffold_100015	4001658	4014287	12629	g_21380	g_21381
Super-Scaffold_100015	4049121	4053927	4806	g_21381	g_38112
Super-Scaffold_100015	4063450	4078912	15462	g_21382	g_21383
Super-Scaffold_100015	4083660	4085639	1979	g_21383	g_21384
Super-Scaffold_100015	4085890	4085903	13	g_21384	g_21385
Super-Scaffold_100015	4086388	4087943	1555	g_21385	g_21386
Super-Scaffold_100015	4098177	4101261	3084	g_21386	g_21387
Super-Scaffold_100015	4102202	4105444	3242	g_21387	g_21388
Super-Scaffold_100015	4137167	4150818	13651	g_21388	g_21389
Super-Scaffold_100015	4152588	4157937	5349	g_21389	g_21390
Super-Scaffold_100015	4158674	4172186	13512	g_21390	g_21391
Super-Scaffold_100015	4172644	4178707	6063	g_21391	g_21392
Super-Scaffold_100015	4184560	4190124	5564	g_21392	g_44675
Super-Scaffold_100015	4210914	4245952	35038	g_44675	g_21394
Super-Scaffold_100015	4284143	4353165	69022	g_21394	g_21398
Super-Scaffold_100015	4354313	4374735	20422	g_21398	g_21399
Super-Scaffold_100015	4382149	4397352	15203	g_21399	g_21401
Super-Scaffold_100015	4397690	4438770	41080	g_21401	g_21403
Super-Scaffold_100015	4439051	4457003	17952	g_21403	g_21404
Super-Scaffold_100015	4494338	4501116	6778	g_21404	g_21405
Super-Scaffold_100015	4504856	4511240	6384	g_21405	g_21406
Super-Scaffold_100015	4511503	4525786	14283	g_21406	g_21407
Super-Scaffold_100015	4570704	4606810	36106	g_21407	g_21409
Super-Scaffold_100015	4607388	4616145	8757	g_21409	g_21410
Super-Scaffold_100015	4628483	4629414	931	g_21410	g_21411
Super-Scaffold_100015	4633272	4640434	7162	g_21411	g_21413
Super-Scaffold_100015	4657701	4664104	6403	g_21413	g_21414
Super-Scaffold_100015	4664448	4681401	16953	g_21414	g_21415
Super-Scaffold_100015	4681874	4699108	17234	g_21415	g_21416
Super-Scaffold_100015	4735781	4747725	11944	g_21416	g_21417
Super-Scaffold_100015	4763132	4778914	15782	g_21417	g_44676
Super-Scaffold_100015	4779123	4782336	3213	g_44676	g_21418
Super-Scaffold_100015	4785950	4803005	17055	g_21418	g_21419
Super-Scaffold_100015	4823022	4824985	1963	g_21419	g_44677
Super-Scaffold_100015	4835478	4842021	6543	g_44677	g_21420
Super-Scaffold_100015	4869677	4885585	15908	g_21420	g_21421
Super-Scaffold_100015	4892721	4913455	20734	g_21421	g_21422
Super-Scaffold_100015	4915863	5022901	107038	g_21422	g_21425
Super-Scaffold_100015	5023128	5027364	4236	g_21425	g_21426
Super-Scaffold_100015	5035005	5059421	24416	g_21426	g_21427
Super-Scaffold_100015	5064026	5121408	57382	g_21427	g_21428
Super-Scaffold_100015	5122601	5163308	40707	g_21428	g_38120
Super-Scaffold_100015	5163514	5188017	24503	g_38120	g_21431
Super-Scaffold_100015	5203687	5284108	80421	g_21431	g_21433
Super-Scaffold_100015	5298295	5303014	4719	g_21433	g_21434
Super-Scaffold_100015	5303319	5306268	2949	g_21434	g_44678
Super-Scaffold_100015	5309942	5398755	88813	g_44678	g_21437
Super-Scaffold_100015	5404290	5427038	22748	g_21437	g_21439
Super-Scaffold_100015	5446269	5448506	2237	g_21439	g_21440
Super-Scaffold_100015	5455495	5460208	4713	g_21440	g_21441
Super-Scaffold_100015	5473585	5520080	46495	g_21441	g_21442
Super-Scaffold_100015	5547963	5550929	2966	g_21442	g_21443
Super-Scaffold_100015	5560798	5579926	19128	g_21443	g_21444
Super-Scaffold_100015	5587386	5588337	951	g_21444	g_21445
Super-Scaffold_100015	5603868	5613055	9187	g_21445	g_21446
Super-Scaffold_100015	5632806	5771764	138958	g_21446	g_21450
Super-Scaffold_100015	5785705	5788931	3226	g_21450	g_21451
Super-Scaffold_100015	5789194	5790899	1705	g_21451	g_21452
Super-Scaffold_100015	5791105	5851843	60738	g_21452	g_21455
Super-Scaffold_100015	5852148	5935959	83811	g_21455	g_21458
Super-Scaffold_100015	5936534	5938267	1733	g_21458	g_21459
Super-Scaffold_100015	5938647	5970372	31725	g_21459	g_21462
Super-Scaffold_100015	5975364	6061581	86217	g_21462	g_21463
Super-Scaffold_100015	6063034	6063863	829	g_21463	g_21464
Super-Scaffold_100015	6079888	6080527	639	g_21464	g_21465
Super-Scaffold_100015	6087744	6088161	417	g_21465	g_21466
Super-Scaffold_100015	6091946	6094899	2953	g_21466	g_21467
Super-Scaffold_100015	6101814	6107913	6099	g_21467	g_21468
Super-Scaffold_100015	6108176	6119568	11392	g_21468	g_21469
Super-Scaffold_100015	6119957	6122559	2602	g_21469	g_21470
Super-Scaffold_100015	6125591	6133397	7806	g_21470	g_21471
Super-Scaffold_100015	6133741	6191388	57647	g_21471	g_21473
Super-Scaffold_100015	6226875	6237501	10626	g_21473	g_21474
Super-Scaffold_100015	6252528	6255524	2996	g_21474	g_21475
Super-Scaffold_100015	6258455	6259821	1366	g_21475	g_21476
Super-Scaffold_100015	6263416	6267172	3756	g_21476	g_21477
Super-Scaffold_100015	6278535	6288224	9689	g_21477	g_21478
Super-Scaffold_100015	6302461	6351453	48992	g_21478	g_21480
Super-Scaffold_100015	6356931	6363159	6228	g_21480	g_21481
Super-Scaffold_100015	6367686	6385072	17386	g_21481	g_21482
Super-Scaffold_100015	6406936	6408804	1868	g_21482	g_21483
Super-Scaffold_100015	6409214	6495336	86122	g_21483	g_21486
Super-Scaffold_100015	6499492	6662825	163333	g_21486	g_38137
Super-Scaffold_100015	6665171	6673450	8279	g_38137	g_21488
Super-Scaffold_100015	6693391	6695880	2489	g_21488	g_21489
Super-Scaffold_100015	6699193	6702076	2883	g_21489	g_44679
Super-Scaffold_100015	6711388	6725268	13880	g_44679	g_21490
Super-Scaffold_100015	6731595	6732405	810	g_21490	g_21491
Super-Scaffold_100015	6734521	6736927	2406	g_21491	g_21492
Super-Scaffold_100015	6753279	6762169	8890	g_21492	g_21493
Super-Scaffold_100015	6767716	6785210	17494	g_21493	g_21494
Super-Scaffold_100015	6797189	6992921	195732	g_21494	g_21496
Super-Scaffold_100015	6996183	7003701	7518	g_21496	g_21497
Super-Scaffold_100015	7007178	7012412	5234	g_21497	g_21498
Super-Scaffold_100015	7017656	7019065	1409	g_21498	g_21499
Super-Scaffold_100015	7035076	7042023	6947	g_21499	g_21500
Super-Scaffold_100015	7049824	7066655	16831	g_21500	g_21501
Super-Scaffold_100015	7089277	7102981	13704	g_21501	g_21502
Super-Scaffold_100015	7103217	7111422	8205	g_21502	g_21503
Super-Scaffold_100015	7111670	7116119	4449	g_21503	g_38142
Super-Scaffold_100015	7119301	7123471	4170	g_21504	g_21506
Super-Scaffold_100015	7124037	7179937	55900	g_21506	g_21509
Super-Scaffold_100015	7199220	7232323	33103	g_21509	g_21512
Super-Scaffold_100015	7232739	7247014	14275	g_21512	g_21514
Super-Scaffold_100015	7255475	7267709	12234	g_21514	g_21515
Super-Scaffold_100015	7275689	7281146	5457	g_21515	g_21516
Super-Scaffold_100015	7281346	7292486	11140	g_21516	g_21518
Super-Scaffold_100015	7294216	7297337	3121	g_21518	g_21519
Super-Scaffold_100015	7304881	7312254	7373	g_21519	g_44680
Super-Scaffold_100015	7323920	7365095	41175	g_44680	g_21521
Super-Scaffold_100015	7365340	7390710	25370	g_21521	g_21520
Super-Scaffold_100015	7415161	7420481	5320	g_21520	g_21522
Super-Scaffold_100015	7429127	7433195	4068	g_21522	g_44681
Super-Scaffold_100015	7433452	7442779	9327	g_44681	g_21523
Super-Scaffold_100015	7448438	7449447	1009	g_21523	g_44682
Super-Scaffold_100015	7475253	7478899	3646	g_44682	g_21524
Super-Scaffold_100015	7480659	7480796	137	g_21524	g_21525
Super-Scaffold_100015	7482000	7482969	969	g_21525	g_21526
Super-Scaffold_100015	7487753	7488913	1160	g_21526	g_21527
Super-Scaffold_100015	7499112	7499620	508	g_21527	g_21528
Super-Scaffold_100015	7520474	7522593	2119	g_21528	g_21529
Super-Scaffold_100015	7550057	7583312	33255	g_21529	g_21530
Super-Scaffold_100015	7585018	7620316	35298	g_21530	g_21531
Super-Scaffold_100015	7627096	7631146	4050	g_21531	g_21532
Super-Scaffold_100015	7638685	7638873	188	g_21532	g_21533
Super-Scaffold_100015	7646350	7646925	575	g_21533	g_21534
Super-Scaffold_100015	7651780	7722978	71198	g_21534	g_21535
Super-Scaffold_100015	7743240	7753770	10530	g_21535	g_21536
Super-Scaffold_100015	7754030	7826500	72470	g_21536	g_21538
Super-Scaffold_100015	7829210	7844540	15330	g_21538	g_21539
Super-Scaffold_100015	7844824	7850772	5948	g_21539	g_21540
Super-Scaffold_100015	7853325	7871297	17972	g_21540	g_21541
Super-Scaffold_100015	7871515	7943393	71878	g_21541	g_21543
Super-Scaffold_100015	7958463	7973247	14784	g_21543	g_21545
Super-Scaffold_100015	7989123	7992434	3311	g_21545	g_21546
Super-Scaffold_100015	7995550	7998774	3224	g_21546	g_21547
Super-Scaffold_100015	7999995	8033368	33373	g_21547	g_21549
Super-Scaffold_100015	8049323	8053803	4480	g_21549	g_21551
Super-Scaffold_100015	8054402	8059303	4901	g_21551	g_21552
Super-Scaffold_100015	8068627	8071555	2928	g_21552	g_38152
Super-Scaffold_100015	8071755	8072178	423	g_38152	g_21554
Super-Scaffold_100015	8080045	8082647	2602	g_21554	g_44683
Super-Scaffold_100015	8091877	8238206	146329	g_44683	g_38155
Super-Scaffold_100015	8241122	8246953	5831	g_21559	g_21560
Super-Scaffold_100015	8255235	8263186	7951	g_21560	g_21561
Super-Scaffold_100015	8266194	8268910	2716	g_21561	g_21562
Super-Scaffold_100015	8286402	8305146	18744	g_21562	g_21564
Super-Scaffold_100015	8306972	8347684	40712	g_21564	g_21567
Super-Scaffold_100015	8347995	8353672	5677	g_21567	g_21568
Super-Scaffold_100015	8355538	8387888	32350	g_21568	g_21570
Super-Scaffold_100015	8405216	8410262	5046	g_21570	g_21571
Super-Scaffold_100015	8425991	8431987	5996	g_21571	g_21572
Super-Scaffold_100015	8432415	8464406	31991	g_21572	g_21573
Super-Scaffold_100015	8465137	8480443	15306	g_21573	g_38159
Super-Scaffold_100015	8480661	8495883	15222	g_38159	g_21575
Super-Scaffold_100015	8496752	8515003	18251	g_21575	g_21576
Super-Scaffold_100015	8515779	8522674	6895	g_21576	g_21577
Super-Scaffold_100015	8535893	8540608	4715	g_21577	g_44684
Super-Scaffold_100015	8544706	8550269	5563	g_44684	g_21578
Super-Scaffold_100015	8568455	8570651	2196	g_21578	g_21579
Super-Scaffold_100015	8596124	8604711	8587	g_21579	g_21580
Super-Scaffold_100015	8615838	8629703	13865	g_21580	g_21581
Super-Scaffold_100015	8629981	8650692	20711	g_21581	g_21582
Super-Scaffold_100015	8650970	8671189	20219	g_21582	g_21583
Super-Scaffold_100015	8674771	8685771	11000	g_21583	g_38163
Super-Scaffold_100015	8686736	8704612	17876	g_21584	g_21585
Super-Scaffold_100015	8716707	8744876	28169	g_21585	g_21587
Super-Scaffold_100015	8756567	8761107	4540	g_21587	g_21588
Super-Scaffold_100015	8761613	8767959	6346	g_21588	g_21589
Super-Scaffold_100015	8782555	8786899	4344	g_21589	g_21590
Super-Scaffold_100015	8801256	8870604	69348	g_21590	g_21591
Super-Scaffold_100015	8872523	9157801	285278	g_21591	g_21595
Super-Scaffold_100015	9158370	9171160	12790	g_21595	g_21596
Super-Scaffold_100015	9182784	9193967	11183	g_21596	g_44685
Super-Scaffold_100015	9197469	9214379	16910	g_44685	g_21597
Super-Scaffold_100015	9220193	9228064	7871	g_21597	g_21598
Super-Scaffold_100015	9233388	9235050	1662	g_38166	g_21599
Super-Scaffold_100015	9238633	9240120	1487	g_21599	g_21600
Super-Scaffold_100015	9248634	9249704	1070	g_21600	g_21601
Super-Scaffold_100015	9254488	9257128	2640	g_21601	g_21602
Super-Scaffold_100015	9261942	9270231	8289	g_21602	g_21603
Super-Scaffold_100015	9270585	9279425	8840	g_21603	g_44686
Super-Scaffold_100015	9287931	9289394	1463	g_44686	g_21604
Super-Scaffold_100015	9305661	9310598	4937	g_21604	g_21605
Super-Scaffold_100015	9390087	9503003	112916	g_21605	g_21606
Super-Scaffold_100015	9504925	9508835	3910	g_21606	g_21607
Super-Scaffold_100015	9542582	9546103	3521	g_21607	g_21608
Super-Scaffold_100015	9546681	9554068	7387	g_21608	g_21609
Super-Scaffold_100015	9564125	9609564	45439	g_21609	g_21610
Super-Scaffold_100015	9612074	9675038	62964	g_21610	g_21612
Super-Scaffold_100015	9675298	9677463	2165	g_21612	g_21613
Super-Scaffold_100015	9690776	9692378	1602	g_21613	g_21614
Super-Scaffold_100015	9711965	9714145	2180	g_21614	g_44687
Super-Scaffold_100015	9720506	9727012	6506	g_44687	g_21615
Super-Scaffold_100015	9740611	9746258	5647	g_21615	g_44688
Super-Scaffold_100015	9750900	9783387	32487	g_44688	g_21617
Super-Scaffold_100015	9805846	9817627	11781	g_21617	g_21618
Super-Scaffold_100015	9817941	9899841	81900	g_21618	g_21621
Super-Scaffold_100015	9905916	9909860	3944	g_21621	g_44689
Super-Scaffold_100015	9934002	9941334	7332	g_44689	g_21622
Super-Scaffold_100015	9943259	9943984	725	g_21622	g_21623
Super-Scaffold_100015	9950415	9951687	1272	g_21623	g_21624
Super-Scaffold_100015	9959529	9960326	797	g_21624	g_21625
Super-Scaffold_100015	9978450	9980001	1551	g_21625	g_44690
Super-Scaffold_100015	9986356	10006116	19760	g_44690	g_21626
Super-Scaffold_100015	10024835	10025965	1130	g_21626	g_21627
Super-Scaffold_100015	10033728	10035446	1718	g_21627	g_21628
Super-Scaffold_100015	10037943	10041720	3777	g_21628	g_21629
Super-Scaffold_100015	10050284	10055971	5687	g_21629	g_21630
Super-Scaffold_100015	10061901	10063873	1972	g_21630	g_21631
Super-Scaffold_100015	10065651	10083983	18332	g_21631	g_21632
Super-Scaffold_100015	10085811	10092524	6713	g_21632	g_21633
Super-Scaffold_100015	10094003	10098741	4738	g_21633	g_38171
Super-Scaffold_100015	10098974	10182227	83253	g_38171	g_21635
Super-Scaffold_100015	10185084	10200807	15723	g_21635	g_21636
Super-Scaffold_100015	10214097	10242077	27980	g_21636	g_21637
Super-Scaffold_100015	10244186	10246097	1911	g_21637	g_21638
Super-Scaffold_100015	10246366	10275654	29288	g_21638	g_21640
Super-Scaffold_100015	10286621	10304415	17794	g_21640	g_21641
Super-Scaffold_100015	10309642	10314976	5334	g_21641	g_21642
Super-Scaffold_100015	10328796	10333417	4621	g_21642	g_21643
Super-Scaffold_100015	10347556	10402348	54792	g_21643	g_21646
Super-Scaffold_100015	10403339	10404440	1101	g_21646	g_44691
Super-Scaffold_100015	10407469	10408676	1207	g_44691	g_21647
Super-Scaffold_100015	10419900	10421868	1968	g_21647	g_21648
Super-Scaffold_100015	10422071	10491430	69359	g_21648	g_21649
Super-Scaffold_100015	10498581	10514048	15467	g_21649	g_44692
Super-Scaffold_100015	10523124	10546757	23633	g_44692	g_21651
Super-Scaffold_100015	10549140	10549349	209	g_21651	g_21652
Super-Scaffold_100015	10550635	10570956	20321	g_21652	g_21653
Super-Scaffold_100015	10571216	10573465	2249	g_21653	g_21654
Super-Scaffold_100015	10574634	10633551	58917	g_21654	g_21657
Super-Scaffold_100015	10633766	10646532	12766	g_21657	g_21658
Super-Scaffold_100015	10656458	10658620	2162	g_21658	g_44693
Super-Scaffold_100015	10659363	10671874	12511	g_44693	g_21660
Super-Scaffold_100015	10672260	10674994	2734	g_21660	g_21661
Super-Scaffold_100015	10675230	10714774	39544	g_21661	g_21663
Super-Scaffold_100015	10715016	10725342	10326	g_21663	g_21664
Super-Scaffold_100015	10741897	10752073	10176	g_21664	g_21665
Super-Scaffold_100015	10761870	10789773	27903	g_21665	g_21666
Super-Scaffold_100015	10790051	10802770	12719	g_21666	g_21667
Super-Scaffold_100015	10802994	10811221	8227	g_21667	g_21668
Super-Scaffold_100015	10816419	10834325	17906	g_21668	g_21670
Super-Scaffold_100015	10836831	10846603	9772	g_21670	g_44694
Super-Scaffold_100015	10847793	10849626	1833	g_44694	g_21671
Super-Scaffold_100015	10852669	10855225	2556	g_21671	g_21672
Super-Scaffold_100015	10861053	10866109	5056	g_21672	g_21673
Super-Scaffold_100015	10880409	10896201	15792	g_21673	g_21674
Super-Scaffold_100015	10897790	10914756	16966	g_21674	g_21676
Super-Scaffold_100015	10915517	10925436	9919	g_21676	g_44695
Super-Scaffold_100015	10952635	10957465	4830	g_44695	g_21677
Super-Scaffold_100015	10994755	11011071	16316	g_21677	g_38180
Super-Scaffold_100015	11011280	11042913	31633	g_38180	g_21678
Super-Scaffold_100015	11067254	11074838	7584	g_21678	g_21679
Super-Scaffold_100015	11117759	11120686	2927	g_21679	g_21680
Super-Scaffold_100015	11140125	11143469	3344	g_21680	g_21681
Super-Scaffold_100015	11155026	11173689	18663	g_21681	g_21682
Super-Scaffold_100015	11174800	11174968	168	g_21682	g_21683
Super-Scaffold_100015	11193355	11193599	244	g_21683	g_21684
Super-Scaffold_100015	11197478	11198690	1212	g_21684	g_21685
Super-Scaffold_100015	11200306	11250201	49895	g_21685	g_21686
Super-Scaffold_100015	11256132	11257765	1633	g_21686	g_21687
Super-Scaffold_100015	11258154	11263464	5310	g_21687	g_21688
Super-Scaffold_100015	11281130	11284422	3292	g_21688	g_21689
Super-Scaffold_100015	11290130	11291063	933	g_21689	g_21690
Super-Scaffold_100015	11294773	11308716	13943	g_21690	g_38182
Super-Scaffold_100015	11308946	11310134	1188	g_38182	g_21691
Super-Scaffold_100015	11314922	11330156	15234	g_21691	g_21692
Super-Scaffold_100015	11330443	11332938	2495	g_21692	g_44696
Super-Scaffold_100015	11333198	11336512	3314	g_44696	g_21693
Super-Scaffold_100015	11341599	11414482	72883	g_21693	g_21694
Super-Scaffold_100015	11415678	11441148	25470	g_21694	g_21696
Super-Scaffold_100015	11441375	11460420	19045	g_21696	g_21697
Super-Scaffold_100015	11464566	11660911	196345	g_21697	g_21698
Super-Scaffold_100015	11661219	11661305	86	g_21698	g_21699
Super-Scaffold_100015	11661637	11661670	33	g_21699	g_21700
Super-Scaffold_100015	11662173	11662218	45	g_21700	g_44697
Super-Scaffold_100015	11662667	11663399	732	g_44697	g_21701
Super-Scaffold_100015	11663602	11699061	35459	g_21701	g_21702
Super-Scaffold_100015	11703306	11722208	18902	g_21702	g_21703
Super-Scaffold_100015	11726656	11732733	6077	g_21703	g_21704
Super-Scaffold_100015	11741357	11794328	52971	g_21704	g_21706
Super-Scaffold_100015	11795255	11799545	4290	g_21706	g_21707
Super-Scaffold_100015	11806948	11809436	2488	g_21707	g_21708
Super-Scaffold_100015	11813595	11814653	1058	g_21708	g_21709
Super-Scaffold_100015	11817782	11819170	1388	g_21709	g_21710
Super-Scaffold_100015	11821666	11822887	1221	g_21710	g_21711
Super-Scaffold_100015	11825760	11834024	8264	g_21711	g_21712
Super-Scaffold_100015	11838609	11854561	15952	g_21712	g_21714
Super-Scaffold_100015	11857519	11859425	1906	g_21714	g_21715
Super-Scaffold_100015	11863065	11866738	3673	g_21715	g_44698
Super-Scaffold_100015	11870139	11872864	2725	g_44698	g_21716
Super-Scaffold_100015	11881663	11883206	1543	g_21716	g_21717
Super-Scaffold_100015	11885964	11911598	25634	g_21717	g_21719
Super-Scaffold_100015	11911828	11961731	49903	g_21719	g_21721
Super-Scaffold_100015	11963779	12064150	100371	g_21721	g_21723
Super-Scaffold_100015	12064362	12115251	50889	g_21723	g_21724
Super-Scaffold_100015	12115454	12359021	243567	g_21724	g_21733
Super-Scaffold_100015	12368234	12403823	35589	g_21733	g_21735
Super-Scaffold_100015	12405685	12409751	4066	g_21735	g_21736
Super-Scaffold_100015	12420395	12483934	63539	g_21736	g_21742
Super-Scaffold_100015	12484242	12535458	51216	g_21742	g_38196
Super-Scaffold_100015	12535763	12537716	1953	g_38196	g_21744
Super-Scaffold_100015	12541374	12544289	2915	g_21744	g_21745
Super-Scaffold_100015	12546510	12547938	1428	g_21745	g_21746
Super-Scaffold_100015	12552905	12555143	2238	g_21746	g_44699
Super-Scaffold_100015	12557076	12559051	1975	g_44699	g_21747
Super-Scaffold_100015	12561641	12563937	2296	g_21747	g_21748
Super-Scaffold_100015	12574547	12601490	26943	g_21748	g_21749
Super-Scaffold_100015	12602605	12604596	1991	g_21749	g_21750
Super-Scaffold_100015	12608700	12608979	279	g_21750	g_21751
Super-Scaffold_100015	12611121	12617908	6787	g_21751	g_44700
Super-Scaffold_100015	12622587	12626893	4306	g_44700	g_44701
Super-Scaffold_100015	12631512	12637387	5875	g_44701	g_21752
Super-Scaffold_100015	12644236	12647874	3638	g_21752	g_21753
Super-Scaffold_100015	12649389	12746592	97203	g_21753	g_21755
Super-Scaffold_100015	12746792	12757273	10481	g_21755	g_21756
Super-Scaffold_100015	12757485	12824600	67115	g_21756	g_21758
Super-Scaffold_100015	12827076	12836278	9202	g_21758	g_21759
Super-Scaffold_100015	12847733	12851854	4121	g_21759	g_21760
Super-Scaffold_100015	12855907	12856101	194	g_21760	g_44702
Super-Scaffold_100015	12859746	12863434	3688	g_44702	g_21761
Super-Scaffold_100015	12868117	12884128	16011	g_21761	g_38200
Super-Scaffold_100015	12884358	12884567	209	g_38200	g_21762
Super-Scaffold_100015	12886126	12887855	1729	g_21762	g_21763
Super-Scaffold_100015	12893507	12897030	3523	g_21763	g_21764
Super-Scaffold_100015	12897501	12899896	2395	g_21764	g_21765
Super-Scaffold_100015	12914470	12917963	3493	g_21765	g_44703
Super-Scaffold_100015	12938547	12969446	30899	g_44703	g_21767
Super-Scaffold_100015	12972622	12974136	1514	g_21767	g_44704
Super-Scaffold_100015	12976047	12976937	890	g_44704	g_21768
Super-Scaffold_100015	12982563	12987008	4445	g_21768	g_44705
Super-Scaffold_100015	12991368	12993713	2345	g_44705	g_21769
Super-Scaffold_100015	13024055	13032962	8907	g_21769	g_21770
Super-Scaffold_100015	13047199	13063622	16423	g_21770	g_21771
Super-Scaffold_100015	13064271	13072283	8012	g_21771	g_21772
Super-Scaffold_100015	13082862	13091266	8404	g_21772	g_21773
Super-Scaffold_100015	13113435	13123248	9813	g_21773	g_21774
Super-Scaffold_100015	13137657	13158577	20920	g_21774	g_21775
Super-Scaffold_100015	13158894	13182078	23184	g_21775	g_21777
Super-Scaffold_100015	13182284	13191594	9310	g_21777	g_21778
Super-Scaffold_100015	13195352	13199205	3853	g_21778	g_21779
Super-Scaffold_100015	13213764	13217958	4194	g_21779	g_21780
Super-Scaffold_100015	13222067	13227321	5254	g_21780	g_21781
Super-Scaffold_100015	13228785	13234154	5369	g_21781	g_21782
Super-Scaffold_100015	13236227	13243569	7342	g_21782	g_21783
Super-Scaffold_100015	13255143	13259520	4377	g_21783	g_21784
Super-Scaffold_100015	13265317	13280055	14738	g_21784	g_21785
Super-Scaffold_100015	13283248	13287639	4391	g_21785	g_21786
Super-Scaffold_100015	13289309	13315150	25841	g_21786	g_21788
Super-Scaffold_100015	13315488	13328842	13354	g_21788	g_21789
Super-Scaffold_100015	13343546	13345915	2369	g_21789	g_21790
Super-Scaffold_100015	13348753	13350136	1383	g_21790	g_21791
Super-Scaffold_100015	13353818	13357311	3493	g_21791	g_21792
Super-Scaffold_100015	13364230	13367576	3346	g_21792	g_21793
Super-Scaffold_100015	13396837	13399126	2289	g_21793	g_21794
Super-Scaffold_100015	13403222	13406607	3385	g_21794	g_21795
Super-Scaffold_100015	13413996	13417661	3665	g_21795	g_21796
Super-Scaffold_100015	13431732	13506008	74276	g_21796	g_21799
Super-Scaffold_100015	13515164	13517987	2823	g_21799	g_21800
Super-Scaffold_100015	13527864	13530441	2577	g_21800	g_21801
Super-Scaffold_100015	13537971	13541897	3926	g_21801	g_21802
Super-Scaffold_100015	13544626	13556774	12148	g_21802	g_21803
Super-Scaffold_100015	13557271	13560517	3246	g_21803	g_21804
Super-Scaffold_100015	13561558	13636062	74504	g_21804	g_21805
Super-Scaffold_100015	13656401	13686335	29934	g_21805	g_21806
Super-Scaffold_100015	13687174	13714867	27693	g_21806	g_21807
Super-Scaffold_100015	13726550	13753132	26582	g_21807	g_21808
Super-Scaffold_100015	13761428	13773602	12174	g_21808	g_21809
Super-Scaffold_100015	13790459	13808289	17830	g_21809	g_21810
Super-Scaffold_100015	13827558	13833868	6310	g_21810	g_21811
Super-Scaffold_100015	13839979	13841630	1651	g_21811	g_44706
Super-Scaffold_100015	13848634	13856395	7761	g_44706	g_21812
Super-Scaffold_100015	13861309	13880604	19295	g_21812	g_21813
Super-Scaffold_100015	13882021	13885677	3656	g_21813	g_21814
Super-Scaffold_100015	13887907	13895792	7885	g_21814	g_21816
Super-Scaffold_100015	13901877	13905036	3159	g_21816	g_21817
Super-Scaffold_100015	13917326	13947193	29867	g_21817	g_21819
Super-Scaffold_100015	13967761	13975394	7633	g_21819	g_21820
Super-Scaffold_100015	13979781	13979885	104	g_21820	g_44707
Super-Scaffold_100015	13981246	13982127	881	g_44707	g_21821
Super-Scaffold_100015	13984955	13986139	1184	g_21821	g_21822
Super-Scaffold_100015	13989627	13993202	3575	g_21822	g_21823
Super-Scaffold_100015	13995449	13998395	2946	g_21823	g_21824
Super-Scaffold_100015	14012030	14018375	6345	g_21824	g_38204
Super-Scaffold_100015	14022256	14081217	58961	g_38204	g_38205
Super-Scaffold_100015	14081429	14088474	7045	g_38205	g_21828
Super-Scaffold_100015	14088818	14097746	8928	g_21828	g_21829
Super-Scaffold_100015	14112041	14118240	6199	g_21829	g_21830
Super-Scaffold_100015	14124763	14129766	5003	g_21830	g_21831
Super-Scaffold_100015	14140045	14142237	2192	g_21831	g_44708
Super-Scaffold_100015	14161641	14168209	6568	g_44708	g_21832
Super-Scaffold_100015	14169636	14171852	2216	g_21832	g_21833
Super-Scaffold_100015	14174407	14175078	671	g_21833	g_21834
Super-Scaffold_100015	14178251	14180974	2723	g_21834	g_21835
Super-Scaffold_100015	14188728	14202494	13766	g_21835	g_21836
Super-Scaffold_100015	14202745	14283721	80976	g_21836	g_21838
Super-Scaffold_100015	14283924	14363038	79114	g_21838	g_21841
Super-Scaffold_100015	14365842	14370476	4634	g_21841	g_21842
Super-Scaffold_100015	14381360	14387559	6199	g_21842	g_21843
Super-Scaffold_100015	14394394	14404316	9922	g_21843	g_21845
Super-Scaffold_100015	14404783	14407095	2312	g_21845	g_21846
Super-Scaffold_100015	14416243	14418636	2393	g_21846	g_21847
Super-Scaffold_100015	14428674	14431502	2828	g_21847	g_21848
Super-Scaffold_100015	14434594	14441160	6566	g_21848	g_21849
Super-Scaffold_100015	14441486	14442350	864	g_21849	g_21850
Super-Scaffold_100015	14450300	14453623	3323	g_21850	g_21851
Super-Scaffold_100015	14460157	14464545	4388	g_21851	g_21852
Super-Scaffold_100015	14467509	14469131	1622	g_21852	g_21853
Super-Scaffold_100015	14471528	14473842	2314	g_21853	g_44709
Super-Scaffold_100015	14479535	14480955	1420	g_44709	g_21854
Super-Scaffold_100015	14490550	14492640	2090	g_21854	g_21855
Super-Scaffold_100015	14492923	14516164	23241	g_38214	g_21856
Super-Scaffold_100015	14518239	14522383	4144	g_21856	g_21857
Super-Scaffold_100015	14525376	14545348	19972	g_21857	g_21859
Super-Scaffold_100015	14547257	14556698	9441	g_21859	g_21860
Super-Scaffold_100015	14576997	14580024	3027	g_21860	g_21861
Super-Scaffold_100015	14589908	14592131	2223	g_21861	g_21862
Super-Scaffold_100015	14603619	14605467	1848	g_21862	g_44710
Super-Scaffold_100015	14610286	14612225	1939	g_44710	g_21863
Super-Scaffold_100015	14638532	14638733	201	g_21863	g_21864
Super-Scaffold_100015	14639536	14642035	2499	g_21864	g_21865
Super-Scaffold_100015	14651923	14654832	2909	g_21865	g_21866
Super-Scaffold_100015	14661791	14683769	21978	g_21866	g_21867
Super-Scaffold_100015	14688070	14691409	3339	g_21867	g_44711
Super-Scaffold_100015	14705039	14732166	27127	g_44711	g_21868
Super-Scaffold_100015	14736744	14780854	44110	g_21868	g_21869
Super-Scaffold_100015	14785560	14794457	8897	g_21869	g_21870
Super-Scaffold_100015	14796041	14800457	4416	g_21870	g_21871
Super-Scaffold_100015	14801283	14801481	198	g_21871	g_21872
Super-Scaffold_100015	14807128	14808894	1766	g_21872	g_44712
Super-Scaffold_100015	14812426	14813276	850	g_44712	g_44713
Super-Scaffold_100015	14817522	14818834	1312	g_44713	g_44714
Super-Scaffold_100015	14821311	14822575	1264	g_44714	g_21873
Super-Scaffold_100015	14823045	14824383	1338	g_21873	g_44715
Super-Scaffold_100015	14828903	14834864	5961	g_44715	g_21874
Super-Scaffold_100015	14836057	14842581	6524	g_21874	g_21875
Super-Scaffold_100015	14842907	14855310	12403	g_21875	g_21876
Super-Scaffold_100015	14856502	14857868	1366	g_21876	g_21877
Super-Scaffold_100015	14860280	14862264	1984	g_21877	g_21878
Super-Scaffold_100015	14872005	14872957	952	g_21878	g_21879
Super-Scaffold_100015	14877290	14883296	6006	g_21879	g_21880
Super-Scaffold_100015	14887706	14890841	3135	g_21880	g_21881
Super-Scaffold_100015	14896721	14901487	4766	g_21881	g_21882
Super-Scaffold_100015	14904055	14936743	32688	g_21882	g_21883
Super-Scaffold_100015	14940143	14942248	2105	g_21883	g_21884
Super-Scaffold_100015	14949934	14951809	1875	g_21884	g_21885
Super-Scaffold_100015	14953336	14958679	5343	g_21885	g_21886
Super-Scaffold_100015	14959486	14964123	4637	g_21886	g_21887
Super-Scaffold_100015	14966398	14974368	7970	g_21887	g_21888
Super-Scaffold_100015	14975723	14978767	3044	g_21888	g_21889
Super-Scaffold_100015	14989521	15001775	12254	g_21889	g_21890
Super-Scaffold_100015	15012380	15019418	7038	g_21890	g_21891
Super-Scaffold_100015	15027796	15034690	6894	g_21891	g_21892
Super-Scaffold_100015	15036273	15037913	1640	g_21892	g_21893
Super-Scaffold_100015	15043617	15043743	126	g_21893	g_21894
Super-Scaffold_100015	15054693	15058954	4261	g_21894	g_21895
Super-Scaffold_100015	15068327	15072070	3743	g_21895	g_21896
Super-Scaffold_100015	15072387	15075556	3169	g_21896	g_21897
Super-Scaffold_100015	15083033	15085808	2775	g_21897	g_44716
Super-Scaffold_100015	15087810	15090416	2606	g_44716	g_21898
Super-Scaffold_100015	15095193	15099765	4572	g_21898	g_44717
Super-Scaffold_100015	15125907	15240208	114301	g_44717	g_21899
Super-Scaffold_100015	15245508	15279783	34275	g_21899	g_21900
Super-Scaffold_100015	15289214	15300972	11758	g_21900	g_21901
Super-Scaffold_100015	15312652	15312760	108	g_21901	g_38219
Super-Scaffold_100015	15312963	15321159	8196	g_38219	g_21902
Super-Scaffold_100015	15328697	15331046	2349	g_21902	g_21903
Super-Scaffold_100015	15347752	15357121	9369	g_21903	g_21904
Super-Scaffold_100015	15368983	15371888	2905	g_21904	g_21905
Super-Scaffold_100015	15401024	15404267	3243	g_21905	g_21906
Super-Scaffold_100015	15421383	15421871	488	g_21906	g_44718
Super-Scaffold_100015	15445044	15483270	38226	g_44718	g_21908
Super-Scaffold_100015	15487851	15489622	1771	g_21908	g_21909
Super-Scaffold_100015	15498541	15501316	2775	g_21909	g_21910
Super-Scaffold_100015	15502663	15507835	5172	g_21910	g_21911
Super-Scaffold_100015	15526472	15568937	42465	g_21911	g_21913
Super-Scaffold_100015	15592419	15634541	42122	g_21913	g_21914
Super-Scaffold_100015	15637850	15648113	10263	g_21914	g_44719
Super-Scaffold_100015	15651114	15655666	4552	g_44719	g_44720
Super-Scaffold_100015	15663688	15664662	974	g_44720	g_21915
Super-Scaffold_100015	15677215	15718440	41225	g_21915	g_21916
Super-Scaffold_100015	15729017	15752197	23180	g_21916	g_21917
Super-Scaffold_100015	15754563	15771230	16667	g_21917	g_21918
Super-Scaffold_100015	15800096	15809369	9273	g_21918	g_21919
Super-Scaffold_100015	15828644	15831364	2720	g_21919	g_21920
Super-Scaffold_100015	15831780	15859639	27859	g_21920	g_21921
Super-Scaffold_100015	15859869	15899977	40108	g_21921	g_21923
Super-Scaffold_100015	15900756	15949273	48517	g_21923	g_21924
Super-Scaffold_100015	16006522	16014459	7937	g_21924	g_21925
Super-Scaffold_100015	16043459	16090483	47024	g_21925	g_21926
Super-Scaffold_100015	16099247	16179827	80580	g_21926	g_21927
Super-Scaffold_100015	16186300	16191420	5120	g_21927	g_21928
Super-Scaffold_100015	16208126	16211441	3315	g_21928	g_21929
Super-Scaffold_100015	16222500	16224210	1710	g_21929	g_21930
Super-Scaffold_100015	16229843	16235039	5196	g_21930	g_21931
Super-Scaffold_100015	16241111	16242399	1288	g_21931	g_21932
Super-Scaffold_100015	16255153	16255822	669	g_21932	g_44721
Super-Scaffold_100015	16258734	16261243	2509	g_44721	g_21933
Super-Scaffold_100015	16281093	16344236	63143	g_21933	g_21935
Super-Scaffold_100015	16348926	16351857	2931	g_21935	g_21936
Super-Scaffold_100015	16371853	16374183	2330	g_21936	g_21937
Super-Scaffold_100015	16377380	16391370	13990	g_21937	g_21938
Super-Scaffold_100015	16407075	16430720	23645	g_21938	g_21939
Super-Scaffold_100015	16460480	16463378	2898	g_21939	g_21940
Super-Scaffold_100015	16486853	16489500	2647	g_21940	g_21941
Super-Scaffold_100015	16491143	16493036	1893	g_21941	g_21942
Super-Scaffold_100015	16497739	16642060	144321	g_21942	g_21943
Super-Scaffold_100015	16642749	16643333	584	g_21943	g_21944
Super-Scaffold_100015	16643932	16643996	64	g_21944	g_21945
Super-Scaffold_100015	16645162	16645220	58	g_21945	g_21946
Super-Scaffold_100015	16645879	16652539	6660	g_21946	g_21947
Super-Scaffold_100015	16655466	16656532	1066	g_21947	g_44722
Super-Scaffold_100015	16657062	16668582	11520	g_44722	g_21948
Super-Scaffold_100015	16669406	16802809	133403	g_21948	g_38224
Super-Scaffold_100015	16803066	17034791	231725	g_38224	g_21955
Super-Scaffold_100015	17043808	17045991	2183	g_21955	g_21956
Super-Scaffold_100015	17056029	17064427	8398	g_21956	g_44723
Super-Scaffold_100015	17075865	17081348	5483	g_44723	g_21957
Super-Scaffold_100015	17086709	17101848	15139	g_21957	g_38226
Super-Scaffold_100015	17102201	17106989	4788	g_38226	g_21959
Super-Scaffold_100015	17116707	17118389	1682	g_21959	g_21960
Super-Scaffold_100015	17125677	17144174	18497	g_21960	g_21961
Super-Scaffold_100015	17145058	17165853	20795	g_21961	g_21962
Super-Scaffold_100015	17166200	17190382	24182	g_21962	g_21963
Super-Scaffold_100015	17212984	17215077	2093	g_21963	g_44724
Super-Scaffold_100015	17230896	17232102	1206	g_44724	g_21964
Super-Scaffold_100015	17232311	17242375	10064	g_21964	g_44725
Super-Scaffold_100015	17259258	17259294	36	g_44725	g_21965
Super-Scaffold_100015	17259566	17262908	3342	g_21965	g_21966
Super-Scaffold_100015	17268636	17272914	4278	g_21966	g_21967
Super-Scaffold_100015	17280220	17281736	1516	g_21967	g_21968
Super-Scaffold_100015	17293754	17303176	9422	g_21968	g_21969
Super-Scaffold_100015	17308322	17309418	1096	g_21969	g_44726
Super-Scaffold_100015	17329877	17342820	12943	g_44726	g_21970
Super-Scaffold_100015	17354364	17357447	3083	g_21970	g_21971
Super-Scaffold_100015	17358214	17359893	1679	g_21971	g_44727
Super-Scaffold_100015	17370500	17371337	837	g_44727	g_21972
Super-Scaffold_100015	17374115	17456154	82039	g_21972	g_21977
Super-Scaffold_100015	17459283	17462118	2835	g_21977	g_44728
Super-Scaffold_100015	17464675	17465849	1174	g_44728	g_21978
Super-Scaffold_100015	17476951	17482274	5323	g_21978	g_21980
Super-Scaffold_100015	17490247	17538566	48319	g_21980	g_21981
Super-Scaffold_100015	17538778	17571015	32237	g_21981	g_21982
Super-Scaffold_100015	17582673	17586526	3853	g_21982	g_21983
Super-Scaffold_100015	17597056	17597431	375	g_21983	g_21984
Super-Scaffold_100015	17597757	17599634	1877	g_21984	g_21985
Super-Scaffold_100015	17608266	17611234	2968	g_21985	g_21986
Super-Scaffold_100015	17614677	17623457	8780	g_21986	g_44729
Super-Scaffold_100015	17630668	17762788	132120	g_38227	g_21991
Super-Scaffold_100015	17765015	17766981	1966	g_21991	g_21992
Super-Scaffold_100015	17780270	17794732	14462	g_21992	g_21994
Super-Scaffold_100015	17810038	17814909	4871	g_21994	g_21995
Super-Scaffold_100015	17819428	17826212	6784	g_21995	g_21996
Super-Scaffold_100015	17827912	17831203	3291	g_21996	g_21997
Super-Scaffold_100015	17834754	17838925	4171	g_21997	g_44730
Super-Scaffold_100015	17849848	17858525	8677	g_44730	g_21998
Super-Scaffold_100015	17859699	17861080	1381	g_21998	g_44731
Super-Scaffold_100015	17867867	17874184	6317	g_44731	g_21999
Super-Scaffold_100015	17881304	17883912	2608	g_21999	g_44732
Super-Scaffold_100015	17892813	17895930	3117	g_44732	g_22000
Super-Scaffold_100015	17898762	17901448	2686	g_22000	g_44733
Super-Scaffold_100015	17903198	17905659	2461	g_44733	g_22001
Super-Scaffold_100015	17916407	17923707	7300	g_22001	g_22002
Super-Scaffold_100015	17929519	17930184	665	g_22002	g_22003
Super-Scaffold_100015	17931535	17932024	489	g_22003	g_22004
Super-Scaffold_100015	17933823	17935964	2141	g_22004	g_22005
Super-Scaffold_100015	17937929	17941196	3267	g_22005	g_22006
Super-Scaffold_100015	17942965	17943390	425	g_22006	g_22007
Super-Scaffold_100015	17946318	17946896	578	g_22007	g_22008
Super-Scaffold_100015	17950218	17974944	24726	g_22008	g_22010
Super-Scaffold_100015	17975504	17976758	1254	g_22010	g_44734
Super-Scaffold_100015	17982541	17983346	805	g_44734	g_22011
Super-Scaffold_100015	17984860	17985037	177	g_22011	g_22012
Super-Scaffold_100015	17985870	17985918	48	g_22012	g_22013
Super-Scaffold_100015	17986241	17996643	10402	g_22013	g_22014
Super-Scaffold_100015	17997080	18030370	33290	g_22014	g_22016
Super-Scaffold_100015	18030615	18240020	209405	g_22016	g_38238
Super-Scaffold_100015	18240298	18295005	54707	g_38238	g_38240
Super-Scaffold_100015	18295241	18343964	48723	g_38240	g_22022
Super-Scaffold_100015	18345919	18404898	58979	g_22022	g_22025
Super-Scaffold_100015	18411013	18420213	9200	g_22025	g_22026
Super-Scaffold_100015	18439310	18449064	9754	g_22026	g_22027
Super-Scaffold_100015	18458379	18463542	5163	g_22027	g_22028
Super-Scaffold_100015	18484970	18538962	53992	g_22028	g_22030
Super-Scaffold_100015	18543557	18547039	3482	g_22030	g_38242
Super-Scaffold_100015	18547263	18567905	20642	g_38242	g_22031
Super-Scaffold_100015	18580408	18620868	40460	g_22031	g_22032
Super-Scaffold_100015	18621107	18645253	24146	g_22032	g_22033
Super-Scaffold_100015	18670690	18677965	7275	g_22033	g_22035
Super-Scaffold_100015	18678288	18692239	13951	g_22035	g_22037
Super-Scaffold_100015	18692496	18705549	13053	g_22037	g_22039
Super-Scaffold_100015	18708362	18711622	3260	g_22039	g_22040
Super-Scaffold_100015	18716638	18717865	1227	g_22040	g_22041
Super-Scaffold_100015	18720704	18734293	13589	g_22041	g_22042
Super-Scaffold_100015	18734595	18735963	1368	g_22042	g_22043
Super-Scaffold_100015	18742635	18751408	8773	g_22043	g_22044
Super-Scaffold_100015	18765426	18769768	4342	g_22044	g_22045
Super-Scaffold_100015	18795129	18796387	1258	g_22045	g_22046
Super-Scaffold_100015	18813137	18814064	927	g_22046	g_22047
Super-Scaffold_100015	18815920	18817412	1492	g_22047	g_22048
Super-Scaffold_100015	18824457	18829142	4685	g_22048	g_22049
Super-Scaffold_100015	18838079	18840638	2559	g_22049	g_22050
Super-Scaffold_100015	18860855	18872133	11278	g_22050	g_22051
Super-Scaffold_100015	18876187	18957376	81189	g_22051	g_22055
Super-Scaffold_100015	18959225	18983624	24399	g_22055	g_22058
Super-Scaffold_100015	18985036	19027641	42605	g_22058	g_22059
Super-Scaffold_100015	19038565	19050974	12409	g_22059	g_22060
Super-Scaffold_100015	19058520	19063758	5238	g_22060	g_22061
Super-Scaffold_100015	19071704	19136144	64440	g_22061	g_22062
Super-Scaffold_100015	19150578	19154767	4189	g_22062	g_22063
Super-Scaffold_100015	19158412	19188407	29995	g_22063	g_22064
Super-Scaffold_100015	19189144	19191860	2716	g_22064	g_22065
Super-Scaffold_100015	19198739	19365562	166823	g_22065	g_22068
Super-Scaffold_100015	19365780	19380530	14750	g_22068	g_22069
Super-Scaffold_100015	19382926	19383958	1032	g_22069	g_44735
Super-Scaffold_100015	19386928	19394392	7464	g_44735	g_22070
Super-Scaffold_100015	19424208	19424369	161	g_22070	g_22071
Super-Scaffold_100015	19424596	19438243	13647	g_22071	g_22072
Super-Scaffold_100015	19445702	19454199	8497	g_22072	g_38255
Super-Scaffold_100015	19454588	19456190	1602	g_38255	g_22073
Super-Scaffold_100015	19460535	19467534	6999	g_22073	g_22075
Super-Scaffold_100015	19472037	19521243	49206	g_22075	g_22076
Super-Scaffold_100015	19522883	19522981	98	g_22076	g_44736
Super-Scaffold_100015	19523466	19621408	97942	g_44736	g_22077
Super-Scaffold_100015	19622358	19772494	150136	g_22077	g_22080
Super-Scaffold_100015	19775175	19779282	4107	g_22080	g_22081
Super-Scaffold_100015	19779551	19783840	4289	g_22081	g_22082
Super-Scaffold_100015	19801871	19851021	49150	g_22082	g_22086
Super-Scaffold_100015	19865681	19868008	2327	g_22086	g_44737
Super-Scaffold_100015	19879190	19883928	4738	g_44737	g_44738
Super-Scaffold_100015	19904049	19908694	4645	g_44738	g_22087
Super-Scaffold_100015	19920717	19929410	8693	g_22087	g_22089
Super-Scaffold_100015	19929721	19933911	4190	g_22089	g_22090
Super-Scaffold_100015	19934354	19941766	7412	g_22090	g_22091
Super-Scaffold_100015	19965000	19970417	5417	g_22091	g_22092
Super-Scaffold_100015	19974786	19975838	1052	g_22092	g_22093
Super-Scaffold_100015	19980490	19981789	1299	g_22093	g_22094
Super-Scaffold_100015	19984714	19986786	2072	g_22094	g_22095
Super-Scaffold_100015	19992206	19997558	5352	g_22095	g_44739
Super-Scaffold_100015	19999062	20106915	107853	g_44739	g_22097
Super-Scaffold_100015	20107690	20111061	3371	g_22097	g_22098
Super-Scaffold_100015	20111339	20112549	1210	g_22098	g_44740
Super-Scaffold_100015	20138143	20187966	49823	g_44740	g_38263
Super-Scaffold_100015	20188250	20214384	26134	g_38263	g_22101
Super-Scaffold_100015	20214641	20234293	19652	g_22101	g_22102
Super-Scaffold_100015	20249822	20339234	89412	g_38266	g_22103
Super-Scaffold_100015	20340617	20341714	1097	g_22103	g_44741
Super-Scaffold_100015	20342967	20352859	9892	g_44741	g_22105
Super-Scaffold_100015	20365139	20524275	159136	g_22105	g_22110
Super-Scaffold_100015	20524499	20532898	8399	g_22110	g_22111
Super-Scaffold_100015	20541317	20553521	12204	g_22111	g_22112
Super-Scaffold_100015	20570783	20571090	307	g_22112	g_22113
Super-Scaffold_100015	20571593	20574236	2643	g_22113	g_22114
Super-Scaffold_100015	20586182	20600776	14594	g_22114	g_22116
Super-Scaffold_100015	20619648	20621372	1724	g_22116	g_22117
Super-Scaffold_100015	20626030	20627748	1718	g_22117	g_22118
Super-Scaffold_100015	20649090	20671375	22285	g_22118	g_22120
Super-Scaffold_100015	20671581	20682839	11258	g_22120	g_22121
Super-Scaffold_100015	20687150	20706773	19623	g_22121	g_22122
Super-Scaffold_100015	20724915	20726970	2055	g_22122	g_22123
Super-Scaffold_100015	20735963	20751226	15263	g_22123	g_22124
Super-Scaffold_100015	20757957	20760483	2526	g_22124	g_22125
Super-Scaffold_100015	20761990	20770199	8209	g_22125	g_22126
Super-Scaffold_100015	20788575	20789629	1054	g_22126	g_22127
Super-Scaffold_100015	20791025	20831196	40171	g_22127	g_22128
Super-Scaffold_100015	20831987	20845321	13334	g_22128	g_22133
Super-Scaffold_100015	20847757	20848620	863	g_22133	g_22134
Super-Scaffold_100015	20853059	20854864	1805	g_22134	g_44742
Super-Scaffold_100015	20857505	20861527	4022	g_44742	g_22135
Super-Scaffold_100015	20881770	20889337	7567	g_22135	g_22136
Super-Scaffold_100015	20889765	20892333	2568	g_22136	g_22137
Super-Scaffold_100015	20897376	20900578	3202	g_22137	g_22138
Super-Scaffold_100015	20907105	20909555	2450	g_22138	g_22139
Super-Scaffold_100015	20913973	20916340	2367	g_22139	g_22140
Super-Scaffold_100015	20929725	20932531	2806	g_22140	g_22141
Super-Scaffold_100015	20940028	20940628	600	g_22141	g_22142
Super-Scaffold_100015	20949563	20951274	1711	g_22142	g_22143
Super-Scaffold_100015	20954175	20959430	5255	g_22143	g_44743
Super-Scaffold_100015	20981779	20985991	4212	g_44743	g_22144
Super-Scaffold_100015	21011381	21012296	915	g_22144	g_22145
Super-Scaffold_100015	21014523	21017440	2917	g_22145	g_22146
Super-Scaffold_100015	21026935	21032897	5962	g_22146	g_22147
Super-Scaffold_100015	21033520	21034380	860	g_22147	g_22148
Super-Scaffold_100015	21041935	21047910	5975	g_22148	g_22149
Super-Scaffold_100015	21078082	21093340	15258	g_22149	g_22150
Super-Scaffold_100015	21105357	21127547	22190	g_22150	g_22151
Super-Scaffold_100015	21131909	21188533	56624	g_22151	g_22152
Super-Scaffold_100015	21198707	21285788	87081	g_22152	g_22154
Super-Scaffold_100015	21288970	21292053	3083	g_22154	g_22155
Super-Scaffold_100015	21300675	21302420	1745	g_22155	g_22156
Super-Scaffold_100015	21306049	21307533	1484	g_22156	g_22157
Super-Scaffold_100015	21311250	21312021	771	g_22157	g_22158
Super-Scaffold_100015	21316298	21318054	1756	g_22158	g_22159
Super-Scaffold_100015	21328527	21330296	1769	g_22159	g_44744
Super-Scaffold_100015	21335265	21336910	1645	g_44744	g_22160
Super-Scaffold_100015	21342463	21348334	5871	g_22160	g_22161
Super-Scaffold_100015	21355657	21368628	12971	g_22161	g_22162
Super-Scaffold_100015	21368930	21370371	1441	g_22162	g_44745
Super-Scaffold_100015	21378203	21421576	43373	g_44745	g_22163
Super-Scaffold_100015	21421995	21430317	8322	g_22163	g_22165
Super-Scaffold_100015	21430799	21433115	2316	g_22165	g_22167
Super-Scaffold_100015	21434641	21436578	1937	g_22167	g_44746
Super-Scaffold_100015	21440685	21445009	4324	g_44746	g_22168
Super-Scaffold_100015	21445302	21446985	1683	g_22168	g_22169
Super-Scaffold_100015	21450860	21468987	18127	g_22170	g_22171
Super-Scaffold_100015	21470876	21473065	2189	g_22171	g_22172
Super-Scaffold_100015	21477086	21481603	4517	g_22172	g_22174
Super-Scaffold_100015	21482247	21482631	384	g_22174	g_22175
Super-Scaffold_100015	21482957	21483051	94	g_22175	g_22176
Super-Scaffold_100015	21485504	21562846	77342	g_22176	g_22179
Super-Scaffold_100015	21569318	21572143	2825	g_22179	g_22180
Super-Scaffold_100015	21578007	21586926	8919	g_22180	g_22181
Super-Scaffold_100015	21593361	21615154	21793	g_22181	g_22183
Super-Scaffold_100015	21640204	21644614	4410	g_22183	g_22185
Super-Scaffold_100015	21657033	21660081	3048	g_22185	g_44747
Super-Scaffold_100015	21664176	21676013	11837	g_44747	g_22186
Super-Scaffold_100015	21691780	21694914	3134	g_22186	g_22187
Super-Scaffold_100015	21706492	21710911	4419	g_22187	g_22188
Super-Scaffold_100015	21719515	21724009	4494	g_22188	g_22189
Super-Scaffold_100015	21731719	21769528	37809	g_22189	g_22190
Super-Scaffold_100015	21770078	21838572	68494	g_22190	g_22193
Super-Scaffold_100015	21838841	21898228	59387	g_22193	g_22196
Super-Scaffold_100015	21898545	21928044	29499	g_22196	g_22197
Super-Scaffold_100015	21928262	21943168	14906	g_22197	g_22199
Super-Scaffold_100015	21943497	21986904	43407	g_22199	g_22201
Super-Scaffold_100015	21987236	22061343	74107	g_22201	g_22203
Super-Scaffold_100015	22062846	22065883	3037	g_22203	g_22204
Super-Scaffold_100015	22092624	22110306	17682	g_22204	g_22205
Super-Scaffold_100015	22110593	22125987	15394	g_22205	g_44748
Super-Scaffold_100015	22178006	22180583	2577	g_44748	g_22207
Super-Scaffold_100015	22213236	22216719	3483	g_22207	g_22208
Super-Scaffold_100015	22219024	22223368	4344	g_22208	g_22209
Super-Scaffold_100015	22223619	22223723	104	g_22209	g_22210
Super-Scaffold_100015	22225775	22275494	49719	g_22210	g_22212
Super-Scaffold_100015	22275760	22278373	2613	g_22212	g_44749
Super-Scaffold_100015	22282446	22291915	9469	g_44749	g_22213
Super-Scaffold_100015	22298373	22358420	60047	g_22213	g_22214
Super-Scaffold_100015	22379326	22382280	2954	g_22214	g_38287
Super-Scaffold_100015	22382507	22402321	19814	g_38287	g_22215
Super-Scaffold_100015	22403906	22406495	2589	g_22215	g_22216
Super-Scaffold_100015	22407904	22410698	2794	g_22216	g_22217
Super-Scaffold_100015	22413291	22443181	29890	g_22217	g_38288
Super-Scaffold_100015	22443402	22449928	6526	g_38288	g_22218
Super-Scaffold_100015	22456400	22464130	7730	g_22218	g_22219
Super-Scaffold_100015	22465815	22471459	5644	g_22219	g_22220
Super-Scaffold_100015	22471755	22522598	50843	g_22220	g_22222
Super-Scaffold_100015	22524977	22530025	5048	g_22222	g_22223
Super-Scaffold_100015	22535838	22538826	2988	g_22223	g_22224
Super-Scaffold_100015	22550343	22559028	8685	g_22224	g_22225
Super-Scaffold_100015	22568370	22616179	47809	g_22225	g_22233
Super-Scaffold_100015	22633216	22636706	3490	g_22233	g_22234
Super-Scaffold_100015	22644473	22659613	15140	g_22234	g_22235
Super-Scaffold_100015	22665546	22733200	67654	g_22235	g_22236
Super-Scaffold_100015	22747960	22751378	3418	g_22236	g_22237
Super-Scaffold_100015	22751749	22751916	167	g_22237	g_22238
Super-Scaffold_100015	22755179	22781638	26459	g_22238	g_22240
Super-Scaffold_100015	22784892	22807380	22488	g_22240	g_22241
Super-Scaffold_100015	22808030	23016838	208808	g_22241	g_22247
Super-Scaffold_100015	23017089	23303876	286787	g_22247	g_38297
Super-Scaffold_100015	23304079	23408274	104195	g_38297	g_22255
Super-Scaffold_100015	23408546	23412607	4061	g_22255	g_38299
Super-Scaffold_100015	23412879	23508158	95279	g_38299	g_22256
Super-Scaffold_100015	23508472	23662962	154490	g_22256	g_22259
Super-Scaffold_100015	23687521	23687569	48	g_22259	g_22260
Super-Scaffold_100015	23707500	23767994	60494	g_22260	g_22262
Super-Scaffold_100015	23768299	23793065	24766	g_22262	g_22263
Super-Scaffold_100015	23802965	23958535	155570	g_22263	g_22265
Super-Scaffold_100015	23961302	23966666	5364	g_22265	g_22267
Super-Scaffold_100015	23970192	24016215	46023	g_22267	g_22268
Super-Scaffold_100015	24016466	24143370	126904	g_22268	g_22270
Super-Scaffold_100015	24147928	24156116	8188	g_22270	g_22271
Super-Scaffold_100015	24158677	24221585	62908	g_22271	g_22272
Super-Scaffold_100015	24227396	24246083	18687	g_22272	g_22274
Super-Scaffold_100015	24246631	24268063	21432	g_22274	g_22275
Super-Scaffold_100015	24282488	24294970	12482	g_22275	g_22276
Super-Scaffold_100015	24301391	24412110	110719	g_22276	g_22277
Super-Scaffold_100015	24432241	24444646	12405	g_22277	g_22278
Super-Scaffold_100015	24445905	24496235	50330	g_22278	g_22280
Super-Scaffold_100015	24497282	24499650	2368	g_22280	g_22281
Super-Scaffold_100015	24515710	24518273	2563	g_22281	g_22282
Super-Scaffold_100015	24520395	24531982	11587	g_22282	g_22283
Super-Scaffold_100015	24532224	24565781	33557	g_22283	g_22285
Super-Scaffold_100015	24568311	24586131	17820	g_22285	g_22286
Super-Scaffold_100015	24607516	24626115	18599	g_22286	g_22287
Super-Scaffold_100015	24626564	24663365	36801	g_22287	g_22289
Super-Scaffold_100015	24663880	24668098	4218	g_22289	g_22290
Super-Scaffold_100015	24669162	24702589	33427	g_22290	g_22292
Super-Scaffold_100015	24703179	24705487	2308	g_22292	g_22293
Super-Scaffold_100015	24707724	24763338	55614	g_22293	g_22294
Super-Scaffold_100015	24777946	24781561	3615	g_22294	g_22295
Super-Scaffold_100015	24799443	24806664	7221	g_22295	g_22296
Super-Scaffold_100015	24820153	24844974	24821	g_22296	g_22299
Super-Scaffold_100015	24865978	24882589	16611	g_22299	g_22300
Super-Scaffold_100015	24883719	24950001	66282	g_22300	g_22301
Super-Scaffold_100015	24977718	24985504	7786	g_22301	g_22302
Super-Scaffold_100015	24991994	25002828	10834	g_22302	g_22303
Super-Scaffold_100015	25006383	25045953	39570	g_22303	g_22305
Super-Scaffold_100015	25046355	25052965	6610	g_22305	g_22306
Super-Scaffold_100015	25053312	25091006	37694	g_22306	g_22308
Super-Scaffold_100015	25106256	25288815	182559	g_22308	g_22310
Super-Scaffold_100015	25289030	25312731	23701	g_22310	g_22312
Super-Scaffold_100015	25313672	25366037	52365	g_22312	g_22316
Super-Scaffold_100015	25367070	25417891	50821	g_22316	g_22318
Super-Scaffold_100015	25437062	25499421	62359	g_22318	g_22319
Super-Scaffold_100015	25505057	25536025	30968	g_22319	g_22320
Super-Scaffold_100015	25543051	25783524	240473	g_22320	g_22323
Super-Scaffold_100015	25787326	25800267	12941	g_22323	g_38314
Super-Scaffold_100015	25801037	25801173	136	g_38314	g_38315
Super-Scaffold_100015	25801715	25801753	38	g_38315	g_38316
Super-Scaffold_100015	25803294	25848215	44921	g_38316	g_22326
Super-Scaffold_100015	25848433	25863651	15218	g_22326	g_22327
Super-Scaffold_100015	25863872	25868928	5056	g_22327	g_22328
Super-Scaffold_100015	25871627	25894901	23274	g_22328	g_22330
Super-Scaffold_100015	25895218	25897597	2379	g_22330	g_22331
Super-Scaffold_100015	25898216	25936566	38350	g_22331	g_22332
Super-Scaffold_100015	25937966	25944893	6927	g_22332	g_22333
Super-Scaffold_100015	25946533	25948074	1541	g_22333	g_22334
Super-Scaffold_100015	25948379	25948420	41	g_22334	g_44750
Super-Scaffold_100015	25948918	25968818	19900	g_44750	g_22335
Super-Scaffold_100015	25969462	25974222	4760	g_22335	g_44751
Super-Scaffold_100015	25976843	26074006	97163	g_44751	g_22338
Super-Scaffold_100015	26075430	26075735	305	g_22338	g_22339
Super-Scaffold_100015	26076862	26077404	542	g_22339	g_22340
Super-Scaffold_100015	26078831	26083651	4820	g_22340	g_22337
Super-Scaffold_100015	26090909	26095889	4980	g_22337	g_22341
Super-Scaffold_100015	26096726	26121909	25183	g_22341	g_22342
Super-Scaffold_100015	26124099	26169860	45761	g_22342	g_38318
Super-Scaffold_100015	26170138	26198007	27869	g_38318	g_22343
Super-Scaffold_100015	26198570	26202376	3806	g_22343	g_22345
Super-Scaffold_100015	26202699	26229240	26541	g_22345	g_22347
Super-Scaffold_100015	26229644	26323790	94146	g_22347	g_22349
Super-Scaffold_100015	26355064	26459606	104542	g_22349	g_22350
Super-Scaffold_100015	26460001	26461359	1358	g_22350	g_22351
Super-Scaffold_100015	26462627	26466810	4183	g_22351	g_44752
Super-Scaffold_100015	26467916	26511498	43582	g_44752	g_22352
Super-Scaffold_100015	26524925	26525032	107	g_22352	g_22353
Super-Scaffold_100015	26525241	26714130	188889	g_22353	g_22354
Super-Scaffold_100015	26715827	26758014	42187	g_22354	g_22357
Super-Scaffold_100015	26758271	26777200	18929	g_22357	g_22359
Super-Scaffold_100015	26777505	26820721	43216	g_22359	g_22361
Super-Scaffold_100015	26821137	26927283	106146	g_22361	g_22364
Super-Scaffold_100015	26927492	26954723	27231	g_22364	g_22365
Super-Scaffold_100015	26965170	27046745	81575	g_22365	g_22367
Super-Scaffold_100015	27072662	27100211	27549	g_22367	g_22369
Super-Scaffold_100015	27115471	27119116	3645	g_22369	g_22370
Super-Scaffold_100015	27127482	27129343	1861	g_22370	g_22371
Super-Scaffold_100015	27137593	27140442	2849	g_22371	g_22372
Super-Scaffold_100015	27146734	27209845	63111	g_22372	g_38323
Super-Scaffold_100015	27210738	27211471	733	g_38323	g_22373
Super-Scaffold_100015	27238746	27310516	71770	g_22373	g_22375
Super-Scaffold_100015	27326550	27345093	18543	g_22375	g_22376
Super-Scaffold_100015	27348858	27368417	19559	g_22376	g_22377
Super-Scaffold_100015	27374024	27375639	1615	g_22377	g_22378
Super-Scaffold_100015	27376341	27381067	4726	g_22378	g_22379
Super-Scaffold_100015	27392679	27413221	20542	g_22379	g_22380
Super-Scaffold_100015	27438614	27460774	22160	g_22380	g_22381
Super-Scaffold_100015	27470449	27486169	15720	g_22381	g_22382
Super-Scaffold_100015	27497266	27502952	5686	g_22382	g_22383
Super-Scaffold_100015	27505180	27511013	5833	g_22383	g_22384
Super-Scaffold_100015	27511789	27555490	43701	g_22384	g_22385
Super-Scaffold_100015	27576636	27580509	3873	g_22385	g_22386
Super-Scaffold_100015	27588925	27613557	24632	g_22386	g_22387
Super-Scaffold_100015	27624957	27625359	402	g_22387	g_44753
Super-Scaffold_100015	27625879	27676890	51011	g_44753	g_22388
Super-Scaffold_100015	27698735	27753296	54561	g_22388	g_44754
Super-Scaffold_100015	27753547	27787283	33736	g_44754	g_22389
Super-Scaffold_100015	27809134	27815720	6586	g_22390	g_38324
Super-Scaffold_100015	27816070	27824515	8445	g_38324	g_38325
Super-Scaffold_100015	27824718	27828718	4000	g_38325	g_22391
Super-Scaffold_100015	27858337	27873470	15133	g_22391	g_44755
Super-Scaffold_100015	27879109	27884691	5582	g_44755	g_22393
Super-Scaffold_100015	27909041	27924504	15463	g_22393	g_22394
Super-Scaffold_100015	27926973	28032025	105052	g_38327	g_22396
Super-Scaffold_100015	28036858	28039058	2200	g_22396	g_22397
Super-Scaffold_100015	28059813	28081119	21306	g_22397	g_22399
Super-Scaffold_100015	28096761	28108380	11619	g_22399	g_22400
Super-Scaffold_100015	28109255	28117860	8605	g_22400	g_22401
Super-Scaffold_100015	28118288	28193083	74795	g_22401	g_22405
Super-Scaffold_100015	28199958	28207712	7754	g_22405	g_22406
Super-Scaffold_100015	28208254	28262015	53761	g_22406	g_22407
Super-Scaffold_100015	28268231	28291146	22915	g_22407	g_22408
Super-Scaffold_100015	28313164	28316491	3327	g_22408	g_22409
Super-Scaffold_100015	28324978	28328683	3705	g_22409	g_22412
Super-Scaffold_100015	28328898	28344177	15279	g_22412	g_44756
Super-Scaffold_100015	28368379	28378751	10372	g_44756	g_22414
Super-Scaffold_100015	28381815	28382203	388	g_22414	g_22415
Super-Scaffold_100015	28383792	28384697	905	g_22415	g_22416
Super-Scaffold_100015	28400032	28443165	43133	g_22416	g_22417
Super-Scaffold_100015	28443605	28443728	123	g_22417	g_22418
Super-Scaffold_100015	28444468	28444821	353	g_22418	g_22419
Super-Scaffold_100015	28445573	28445606	33	g_22419	g_22420
Super-Scaffold_100015	28446244	28499082	52838	g_22420	g_22423
Super-Scaffold_100015	28500029	28515460	15431	g_22423	g_22424
Super-Scaffold_100015	28535594	28547600	12006	g_22424	g_22425
Super-Scaffold_100015	28562332	28579759	17427	g_22425	g_22426
Super-Scaffold_100015	28580043	28583713	3670	g_22426	g_22427
Super-Scaffold_100015	28591730	28659436	67706	g_22427	g_38333
Super-Scaffold_100015	28659687	28674510	14823	g_38333	g_22429
Super-Scaffold_100015	28696552	28734750	38198	g_22429	g_22431
Super-Scaffold_100015	28747765	28827324	79559	g_22431	g_22433
Super-Scaffold_100015	28827533	28989051	161518	g_22433	g_22434
Super-Scaffold_100015	28989266	29016747	27481	g_22434	g_22436
Super-Scaffold_100015	29017061	29049466	32405	g_22436	g_22437
Super-Scaffold_100015	29049789	29076148	26359	g_22437	g_22438
Super-Scaffold_100015	29094427	29154553	60126	g_22438	g_22440
Super-Scaffold_100015	29179173	29267787	88614	g_22440	g_22441
Super-Scaffold_100015	29268095	29298494	30399	g_22441	g_22442
Super-Scaffold_100015	29321103	29349438	28335	g_22442	g_22444
Super-Scaffold_100015	29350089	29350333	244	g_22444	g_22445
Super-Scaffold_100015	29350734	29364626	13892	g_22445	g_22447
Super-Scaffold_100015	29365255	29387892	22637	g_22447	g_22448
Super-Scaffold_100015	29394580	29398116	3536	g_22448	g_22449
Super-Scaffold_100015	29411640	29416774	5134	g_22449	g_22450
Super-Scaffold_100015	29418189	29430646	12457	g_22450	g_22451
Super-Scaffold_100015	29444575	29468835	24260	g_22451	g_22452
Super-Scaffold_100015	29500945	29502184	1239	g_22452	g_22453
Super-Scaffold_100015	29502486	29515160	12674	g_22453	g_22454
Super-Scaffold_100015	29515558	29532370	16812	g_22454	g_22455
Super-Scaffold_100015	29561911	29594925	33014	g_22455	g_22457
Super-Scaffold_100015	29595632	29595997	365	g_22457	g_22458
Super-Scaffold_100015	29597061	29630239	33178	g_22458	g_22460
Super-Scaffold_100015	29632250	29656283	24033	g_22460	g_22461
Super-Scaffold_100015	29668943	29673683	4740	g_22461	g_22462
Super-Scaffold_100015	29680895	29702751	21856	g_22462	g_44757
Super-Scaffold_100015	29725668	29746005	20337	g_44757	g_22464
Super-Scaffold_100015	29752212	29757136	4924	g_22464	g_22465
Super-Scaffold_100015	29766929	29772442	5513	g_22465	g_22466
Super-Scaffold_100015	29785806	29816430	30624	g_22466	g_22467
Super-Scaffold_100015	29819569	29820386	817	g_22467	g_22468
Super-Scaffold_100015	29829364	29871665	42301	g_22468	g_22470
Super-Scaffold_100015	29882363	29884797	2434	g_22470	g_22471
Super-Scaffold_100015	29889481	29962225	72744	g_22471	g_22475
Super-Scaffold_100015	29962560	29972629	10069	g_22475	g_22474
Super-Scaffold_100015	29976262	29984498	8236	g_22474	g_22476
Super-Scaffold_100015	29988388	30041356	52968	g_22476	g_22478
Super-Scaffold_100015	30056542	30079822	23280	g_22478	g_22479
Super-Scaffold_100015	30081257	30094697	13440	g_22479	g_22480
Super-Scaffold_100015	30095768	30096801	1033	g_22480	g_44758
Super-Scaffold_100015	30097781	30105941	8160	g_44758	g_22482
Super-Scaffold_100015	30108091	30120588	12497	g_22482	g_22484
Super-Scaffold_100015	30121313	30183163	61850	g_22484	g_22485
Super-Scaffold_100015	30186591	30233666	47075	g_22485	g_22487
Super-Scaffold_100015	30238849	30244351	5502	g_22487	g_22488
Super-Scaffold_100015	30244866	30244957	91	g_22488	g_44759
Super-Scaffold_100015	30245454	30269006	23552	g_44759	g_22489
Super-Scaffold_100015	30272112	30311257	39145	g_22489	g_22490
Super-Scaffold_100015	30312165	30312365	200	g_22490	g_22491
Super-Scaffold_100015	30313243	30320769	7526	g_22491	g_22492
Super-Scaffold_100015	30323304	30360757	37453	g_22492	g_22494
Super-Scaffold_100015	30364029	30365023	994	g_22494	g_22495
Super-Scaffold_100015	30367716	30398950	31234	g_22495	g_22497
Super-Scaffold_100015	30399171	30403997	4826	g_22497	g_22498
Super-Scaffold_100015	30405816	30415865	10049	g_22498	g_22499
Super-Scaffold_100015	30420069	30439340	19271	g_22499	g_22500
Super-Scaffold_100015	30444068	30469403	25335	g_22500	g_22501
Super-Scaffold_100015	30469960	30481600	11640	g_22501	g_22502
Super-Scaffold_100015	30481914	30487353	5439	g_22502	g_22504
Super-Scaffold_100015	30487754	30488803	1049	g_22504	g_22505
Super-Scaffold_100015	30489402	30489740	338	g_22505	g_22506
Super-Scaffold_100015	30490174	30604567	114393	g_22506	g_22507
Super-Scaffold_100015	30608175	30617887	9712	g_22507	g_22508
Super-Scaffold_100015	30630533	30637960	7427	g_22508	g_22509
Super-Scaffold_100015	30644378	30659988	15610	g_22509	g_22510
Super-Scaffold_100015	30661809	30701712	39903	g_22510	g_22511
Super-Scaffold_100015	30703222	30704708	1486	g_22511	g_44760
Super-Scaffold_100015	30716652	30718273	1621	g_44760	g_22512
Super-Scaffold_100018	39688	47414	7726	g_22514	g_22515
Super-Scaffold_100018	47893	60408	12515	g_22515	g_22516
Super-Scaffold_100018	75539	91301	15762	g_22516	g_22517
Super-Scaffold_100018	94490	102543	8053	g_22517	g_22518
Super-Scaffold_100018	103022	133135	30113	g_22518	g_22520
Super-Scaffold_100018	153816	173558	19742	g_22520	g_22522
Super-Scaffold_100018	173959	212207	38248	g_22522	g_22523
Super-Scaffold_100018	215673	264583	48910	g_22523	g_22525
Super-Scaffold_100018	289238	298452	9214	g_22525	g_22526
Super-Scaffold_100018	313644	324955	11311	g_22526	g_22528
Super-Scaffold_100018	329723	333516	3793	g_22528	g_22529
Super-Scaffold_100018	345318	346775	1457	g_22529	g_22530
Super-Scaffold_100018	350086	350823	737	g_22530	g_22531
Super-Scaffold_100018	361911	421904	59993	g_22531	g_22532
Super-Scaffold_100018	444611	623169	178558	g_22532	g_37767
Super-Scaffold_100018	623426	785661	162235	g_37767	g_22538
Super-Scaffold_100018	807423	820739	13316	g_22538	g_22539
Super-Scaffold_100018	831269	839589	8320	g_22539	g_22540
Super-Scaffold_100018	843878	874999	31121	g_22540	g_22541
Super-Scaffold_100018	895800	919185	23385	g_22541	g_22542
Super-Scaffold_100018	924172	964894	40722	g_22542	g_22544
Super-Scaffold_100018	965271	1132270	166999	g_22544	g_22545
Super-Scaffold_100018	1133367	1234936	101569	g_22545	g_22547
Super-Scaffold_100018	1235547	1379571	144024	g_22547	g_22549
Super-Scaffold_100018	1386477	1394149	7672	g_22549	g_22550
Super-Scaffold_100018	1395756	1395857	101	g_22550	g_22551
Super-Scaffold_100018	1396503	1426738	30235	g_22551	g_22552
Super-Scaffold_100018	1429772	1439339	9567	g_22552	g_22553
Super-Scaffold_100018	1442553	1445555	3002	g_22553	g_44761
Super-Scaffold_100018	1454210	1461992	7782	g_44761	g_22554
Super-Scaffold_100018	1462198	1465224	3026	g_22554	g_22555
Super-Scaffold_100018	1469887	1532764	62877	g_22555	g_22558
Super-Scaffold_100018	1533717	1589428	55711	g_22558	g_22559
Super-Scaffold_100018	1621396	1626908	5512	g_22559	g_22560
Super-Scaffold_100018	1657578	1663659	6081	g_22560	g_22561
Super-Scaffold_100018	1679676	1813645	133969	g_22561	g_22566
Super-Scaffold_100018	1834281	1836432	2151	g_22566	g_22567
Super-Scaffold_100018	1874212	1878013	3801	g_22567	g_22568
Super-Scaffold_100018	1895454	1940593	45139	g_22568	g_22569
Super-Scaffold_100018	1947600	2112350	164750	g_22569	g_22572
Super-Scaffold_100018	2112565	2119544	6979	g_22572	g_22573
Super-Scaffold_100018	2124091	2173035	48944	g_22573	g_22574
Super-Scaffold_100018	2173661	2199018	25357	g_22574	g_22575
Super-Scaffold_100018	2199761	2200878	1117	g_22575	g_22576
Super-Scaffold_100018	2201234	2247855	46621	g_22576	g_22577
Super-Scaffold_100018	2249555	2382799	133244	g_22577	g_22580
Super-Scaffold_100018	2383005	2569804	186799	g_22580	g_22585
Super-Scaffold_100018	2578994	2589449	10455	g_22585	g_22586
Super-Scaffold_100018	2597861	2603220	5359	g_22586	g_22587
Super-Scaffold_100018	2609580	2685942	76362	g_22587	g_22589
Super-Scaffold_100018	2687881	2725477	37596	g_22589	g_22591
Super-Scaffold_100018	2727243	2936372	209129	g_22591	g_22596
Super-Scaffold_100018	3002970	3007932	4962	g_22596	g_22597
Super-Scaffold_100018	3011877	3020763	8886	g_22597	g_44762
Super-Scaffold_100018	3021821	3035274	13453	g_44762	g_22598
Super-Scaffold_100018	3044249	3049303	5054	g_22598	g_22599
Super-Scaffold_100018	3049626	3049710	84	g_22599	g_22600
Super-Scaffold_100018	3051629	3088621	36992	g_22600	g_22601
Super-Scaffold_100018	3090254	3094828	4574	g_22601	g_22602
Super-Scaffold_100018	3096649	3102950	6301	g_22602	g_22603
Super-Scaffold_100018	3104769	3107039	2270	g_22603	g_22604
Super-Scaffold_100018	3108725	3110317	1592	g_22604	g_22605
Super-Scaffold_100018	3113667	3133293	19626	g_22605	g_37781
Super-Scaffold_100018	3133517	3149798	16281	g_37781	g_22606
Super-Scaffold_100018	3151851	3162238	10387	g_22606	g_44763
Super-Scaffold_100018	3180041	3265242	85201	g_44763	g_22608
Super-Scaffold_100018	3273234	3278467	5233	g_22608	g_22609
Super-Scaffold_100018	3285996	3288278	2282	g_22609	g_22610
Super-Scaffold_100018	3288982	3290929	1947	g_22610	g_22611
Super-Scaffold_100018	3291877	3294562	2685	g_22611	g_22612
Super-Scaffold_100018	3307423	3317207	9784	g_22612	g_22613
Super-Scaffold_100018	3325574	3342561	16987	g_22613	g_22615
Super-Scaffold_100018	3354502	3360502	6000	g_22615	g_22616
Super-Scaffold_100018	3360918	3454636	93718	g_22616	g_22618
Super-Scaffold_100018	3459477	3465317	5840	g_22618	g_22619
Super-Scaffold_100018	3467445	3477546	10101	g_22619	g_22620
Super-Scaffold_100018	3477785	3544105	66320	g_22620	g_37785
Super-Scaffold_100018	3544305	3585814	41509	g_37785	g_22622
Super-Scaffold_100018	3618275	3625112	6837	g_22622	g_22623
Super-Scaffold_100018	3631977	3634511	2534	g_22623	g_44764
Super-Scaffold_100018	3642162	3644657	2495	g_44764	g_22624
Super-Scaffold_100018	3645190	3646139	949	g_22624	g_22625
Super-Scaffold_100018	3655749	3660790	5041	g_22625	g_22626
Super-Scaffold_100018	3662363	3732692	70329	g_22626	g_22628
Super-Scaffold_100018	3733345	3744338	10993	g_22628	g_22629
Super-Scaffold_100018	3746826	3760309	13483	g_22629	g_22630
Super-Scaffold_100018	3777175	3793214	16039	g_22630	g_22631
Super-Scaffold_100018	3811570	3815196	3626	g_22631	g_22632
Super-Scaffold_100018	3825279	3840907	15628	g_22632	g_22633
Super-Scaffold_100018	3841976	3858625	16649	g_22633	g_22634
Super-Scaffold_100018	3861901	3868386	6485	g_22634	g_22635
Super-Scaffold_100018	3873934	3890761	16827	g_22635	g_22636
Super-Scaffold_100018	3891630	3908399	16769	g_22636	g_37789
Super-Scaffold_100018	3908671	3941381	32710	g_37789	g_22640
Super-Scaffold_100018	3941638	3961442	19804	g_22640	g_22642
Super-Scaffold_100018	3961645	3982682	21037	g_22642	g_22643
Super-Scaffold_100018	3982933	4023009	40076	g_22643	g_22644
Super-Scaffold_100018	4023467	4034780	11313	g_22644	g_22645
Super-Scaffold_100018	4035562	4146043	110481	g_22645	g_22646
Super-Scaffold_100018	4153701	4207707	54006	g_22646	g_22650
Super-Scaffold_100018	4210289	4220428	10139	g_22650	g_22651
Super-Scaffold_100018	4230150	4359154	129004	g_22651	g_37794
Super-Scaffold_100018	4359486	4368690	9204	g_37794	g_37795
Super-Scaffold_100018	4368932	4447759	78827	g_37795	g_22655
Super-Scaffold_100018	4453059	4471881	18822	g_22655	g_22656
Super-Scaffold_100018	4472162	4475235	3073	g_22656	g_22657
Super-Scaffold_100018	4497337	4578587	81250	g_22657	g_22658
Super-Scaffold_100018	4613291	4621394	8103	g_22658	g_22659
Super-Scaffold_100018	4623469	4672374	48905	g_22659	g_22661
Super-Scaffold_100018	4679533	4689894	10361	g_22661	g_22662
Super-Scaffold_100018	4695243	4758637	63394	g_22662	g_22663
Super-Scaffold_100018	4759348	4785072	25724	g_22663	g_22664
Super-Scaffold_100018	4786606	4815384	28778	g_22664	g_22666
Super-Scaffold_100018	4826952	4852769	25817	g_22666	g_22668
Super-Scaffold_100018	4866410	4872589	6179	g_22668	g_22669
Super-Scaffold_100018	4876641	4919055	42414	g_22669	g_22670
Super-Scaffold_100018	4951373	4992672	41299	g_22670	g_22671
Super-Scaffold_100018	4995410	5007453	12043	g_22671	g_44765
Super-Scaffold_100018	5007695	5087907	80212	g_44765	g_22672
Super-Scaffold_100018	5088290	5090302	2012	g_22672	g_37800
Super-Scaffold_100018	5090523	5149979	59456	g_37800	g_22674
Super-Scaffold_100018	5159002	5185838	26836	g_22674	g_22676
Super-Scaffold_100018	5186692	5189041	2349	g_22676	g_22678
Super-Scaffold_100018	5203513	5213951	10438	g_22678	g_22680
Super-Scaffold_100018	5223349	5229503	6154	g_22680	g_22681
Super-Scaffold_100018	5237322	5246292	8970	g_22681	g_22682
Super-Scaffold_100018	5252448	5295842	43394	g_22682	g_22683
Super-Scaffold_100018	5300971	5312510	11539	g_22683	g_22686
Super-Scaffold_100018	5316644	5332328	15684	g_22686	g_22687
Super-Scaffold_100018	5332645	5352517	19872	g_22687	g_44766
Super-Scaffold_100018	5356850	5366295	9445	g_44766	g_22688
Super-Scaffold_100018	5380647	5381857	1210	g_22688	g_22689
Super-Scaffold_100018	5386563	5491974	105411	g_22689	g_22691
Super-Scaffold_100018	5493893	5515220	21327	g_22691	g_22692
Super-Scaffold_100018	5519146	5614001	94855	g_22692	g_22694
Super-Scaffold_100018	5614219	5767849	153630	g_22694	g_37808
Super-Scaffold_100018	5768049	5977718	209669	g_37808	g_22697
Super-Scaffold_100018	5978632	6010963	32331	g_22697	g_22698
Super-Scaffold_100018	6045685	6191025	145340	g_22698	g_22700
Super-Scaffold_100018	6197892	6220278	22386	g_22700	g_22701
Super-Scaffold_100018	6238254	6259167	20913	g_22701	g_22702
Super-Scaffold_100018	6278311	6348135	69824	g_22702	g_37813
Super-Scaffold_100018	6348371	6396590	48219	g_37813	g_22703
Super-Scaffold_100018	6396859	6434219	37360	g_22703	g_22705
Super-Scaffold_100018	6555580	6583246	27666	g_22705	g_37815
Super-Scaffold_100018	6583458	6680049	96591	g_37815	g_22708
Super-Scaffold_100018	6686461	6856583	170122	g_22708	g_22710
Super-Scaffold_100018	6856828	6879754	22926	g_22710	g_22711
Super-Scaffold_100018	6881243	6882878	1635	g_22711	g_44767
Super-Scaffold_100018	6887522	6892517	4995	g_44767	g_22712
Super-Scaffold_100018	6892789	6901739	8950	g_22712	g_22713
Super-Scaffold_100018	6902890	7007301	104411	g_22713	g_22714
Super-Scaffold_100018	7030363	7038121	7758	g_22714	g_22715
Super-Scaffold_100018	7043594	7044705	1111	g_22715	g_22716
Super-Scaffold_100018	7047283	7047909	626	g_22716	g_44768
Super-Scaffold_100018	7050754	7065538	14784	g_44768	g_22717
Super-Scaffold_100018	7068928	7072608	3680	g_22717	g_22718
Super-Scaffold_100018	7075697	7077380	1683	g_22718	g_44769
Super-Scaffold_100018	7079955	7083255	3300	g_44769	g_22719
Super-Scaffold_100018	7086327	7139302	52975	g_22719	g_22720
Super-Scaffold_100018	7162860	7164778	1918	g_22720	g_22721
Super-Scaffold_100018	7165497	7173958	8461	g_22721	g_22722
Super-Scaffold_100018	7174281	7205558	31277	g_22722	g_22724
Super-Scaffold_100018	7215758	7219028	3270	g_22724	g_22725
Super-Scaffold_100018	7225215	7226526	1311	g_22725	g_22726
Super-Scaffold_100018	7230958	7234558	3600	g_22726	g_22727
Super-Scaffold_100018	7238322	7242933	4611	g_22727	g_22728
Super-Scaffold_100018	7248145	7251620	3475	g_22728	g_44770
Super-Scaffold_100018	7257101	7263704	6603	g_44770	g_22729
Super-Scaffold_100018	7271897	7272799	902	g_22729	g_22730
Super-Scaffold_100018	7279838	7281348	1510	g_22730	g_22731
Super-Scaffold_100018	7285468	7286722	1254	g_22731	g_22732
Super-Scaffold_100018	7289236	7330977	41741	g_22732	g_22735
Super-Scaffold_100018	7339887	7341990	2103	g_22735	g_22736
Super-Scaffold_100018	7348206	7351946	3740	g_22736	g_22737
Super-Scaffold_100018	7365913	7406881	40968	g_22737	g_22738
Super-Scaffold_100018	7409871	7435946	26075	g_22738	g_22740
Super-Scaffold_100018	7438516	7476814	38298	g_22740	g_22741
Super-Scaffold_100018	7489152	7531935	42783	g_22741	g_22742
Super-Scaffold_100018	7536466	7538513	2047	g_22742	g_22743
Super-Scaffold_100018	7544087	7546992	2905	g_22743	g_22744
Super-Scaffold_100018	7553021	7555392	2371	g_22744	g_22745
Super-Scaffold_100018	7570639	7580721	10082	g_22745	g_22746
Super-Scaffold_100018	7589181	7591336	2155	g_22746	g_22747
Super-Scaffold_100018	7597263	7600160	2897	g_22747	g_22748
Super-Scaffold_100018	7622624	7632061	9437	g_22748	g_37825
Super-Scaffold_100018	7634687	7670961	36274	g_22749	g_22750
Super-Scaffold_100018	7693439	7701744	8305	g_22750	g_22752
Super-Scaffold_100018	7702532	7707964	5432	g_22752	g_22754
Super-Scaffold_100018	7728541	7752039	23498	g_22754	g_22755
Super-Scaffold_100018	7756279	7766456	10177	g_22755	g_22757
Super-Scaffold_100018	7778829	7790348	11519	g_22757	g_22758
Super-Scaffold_100018	7794142	7797638	3496	g_22758	g_22760
Super-Scaffold_100018	7798420	7813803	15383	g_22760	g_22761
Super-Scaffold_100018	7819826	7854451	34625	g_22761	g_22762
Super-Scaffold_100018	7857398	7863992	6594	g_22762	g_22763
Super-Scaffold_100018	7864366	7931228	66862	g_22763	g_22764
Super-Scaffold_100018	7946118	7946167	49	g_22764	g_22765
Super-Scaffold_100018	7946394	7946487	93	g_22765	g_22766
Super-Scaffold_100018	7946882	7957407	10525	g_22766	g_44771
Super-Scaffold_100018	7972103	8051067	78964	g_44771	g_22770
Super-Scaffold_100018	8053897	8122204	68307	g_22770	g_22772
Super-Scaffold_100018	8141502	8145585	4083	g_22772	g_22773
Super-Scaffold_100018	8151729	8153495	1766	g_22773	g_22774
Super-Scaffold_100018	8166150	8197096	30946	g_22774	g_22775
Super-Scaffold_100018	8197881	8198639	758	g_22775	g_37826
Super-Scaffold_100018	8198920	8200797	1877	g_37826	g_22776
Super-Scaffold_100018	8204865	8231196	26331	g_22776	g_22777
Super-Scaffold_100018	8233178	8279741	46563	g_22777	g_22779
Super-Scaffold_100018	8280175	8291934	11759	g_22779	g_37827
Super-Scaffold_100018	8292164	8299163	6999	g_37827	g_37828
Super-Scaffold_100018	8299435	8307641	8206	g_37828	g_22780
Super-Scaffold_100018	8307856	8314630	6774	g_22780	g_22781
Super-Scaffold_100018	8318297	8333997	15700	g_22781	g_22782
Super-Scaffold_100018	8336529	8345070	8541	g_22782	g_22783
Super-Scaffold_100018	8347689	8349377	1688	g_22783	g_22784
Super-Scaffold_100018	8349757	8354869	5112	g_22784	g_22785
Super-Scaffold_100018	8357991	8359551	1560	g_22785	g_22786
Super-Scaffold_100018	8371864	8388111	16247	g_22786	g_22787
Super-Scaffold_100018	8390603	8392988	2385	g_22787	g_22788
Super-Scaffold_100018	8407221	8417947	10726	g_22788	g_22790
Super-Scaffold_100018	8420337	8425669	5332	g_22790	g_22791
Super-Scaffold_100018	8430855	8434822	3967	g_22791	g_22792
Super-Scaffold_100018	8453928	8456427	2499	g_22792	g_22793
Super-Scaffold_100018	8478277	8498397	20120	g_22793	g_22795
Super-Scaffold_100018	8500976	8502954	1978	g_22795	g_22796
Super-Scaffold_100018	8503241	8510453	7212	g_22796	g_22797
Super-Scaffold_100018	8511891	8522541	10650	g_22797	g_22798
Super-Scaffold_100018	8524218	8529935	5717	g_22798	g_22799
Super-Scaffold_100018	8532077	8536433	4356	g_22799	g_22800
Super-Scaffold_100018	8537610	8541467	3857	g_22800	g_44772
Super-Scaffold_100018	8543081	8548393	5312	g_44772	g_22802
Super-Scaffold_100018	8549834	8558272	8438	g_22802	g_22803
Super-Scaffold_100018	8559546	8570675	11129	g_22803	g_22804
Super-Scaffold_100018	8574552	8578807	4255	g_22804	g_22805
Super-Scaffold_100018	8580494	8584331	3837	g_22805	g_22806
Super-Scaffold_100018	8585717	8651029	65312	g_22806	g_22812
Super-Scaffold_100018	8652607	8657922	5315	g_22812	g_22813
Super-Scaffold_100018	8659200	8661897	2697	g_22813	g_44773
Super-Scaffold_100018	8667501	8708951	41450	g_44773	g_22814
Super-Scaffold_100018	8709250	8718091	8841	g_22814	g_22815
Super-Scaffold_100018	8720351	8723459	3108	g_22815	g_44774
Super-Scaffold_100018	8725087	8727789	2702	g_44774	g_22816
Super-Scaffold_100018	8735277	8736845	1568	g_22816	g_22817
Super-Scaffold_100018	8740431	8742939	2508	g_22817	g_22818
Super-Scaffold_100018	8748783	8753649	4866	g_22818	g_22819
Super-Scaffold_100018	8753987	8764678	10691	g_22819	g_22820
Super-Scaffold_100018	8770593	8773622	3029	g_22820	g_22821
Super-Scaffold_100018	8791333	8801042	9709	g_22821	g_22822
Super-Scaffold_100018	8809699	8810097	398	g_22822	g_22823
Super-Scaffold_100018	8837487	8862573	25086	g_22823	g_22825
Super-Scaffold_100018	8862791	8862818	27	g_22825	g_22826
Super-Scaffold_100018	8863120	8867118	3998	g_22826	g_22824
Super-Scaffold_100018	8867543	8870263	2720	g_22824	g_22827
Super-Scaffold_100018	8886409	8895204	8795	g_22827	g_22828
Super-Scaffold_100018	8907567	8962693	55126	g_22828	g_22829
Super-Scaffold_100018	8963202	8971944	8742	g_22829	g_22830
Super-Scaffold_100018	8977159	8983005	5846	g_22830	g_22831
Super-Scaffold_100018	8989050	8993617	4567	g_22831	g_22832
Super-Scaffold_100018	9012130	9020415	8285	g_22832	g_22834
Super-Scaffold_100018	9027159	9029541	2382	g_22834	g_44775
Super-Scaffold_100018	9030181	9034672	4491	g_44775	g_22835
Super-Scaffold_100018	9038521	9049873	11352	g_22835	g_44776
Super-Scaffold_100018	9051070	9062194	11124	g_44776	g_22836
Super-Scaffold_100018	9072187	9090906	18719	g_22836	g_22837
Super-Scaffold_100018	9099629	9102716	3087	g_22837	g_22838
Super-Scaffold_100018	9104173	9108809	4636	g_22838	g_22840
Super-Scaffold_100018	9110394	9134965	24571	g_22840	g_22843
Super-Scaffold_100018	9135210	9143319	8109	g_22843	g_22842
Super-Scaffold_100018	9145182	9259400	114218	g_22842	g_22845
Super-Scaffold_100018	9270776	9273785	3009	g_22845	g_22847
Super-Scaffold_100018	9281293	9284871	3578	g_22847	g_22848
Super-Scaffold_100018	9288714	9291654	2940	g_22848	g_22849
Super-Scaffold_100018	9325042	9336849	11807	g_22849	g_22851
Super-Scaffold_100018	9346569	9349227	2658	g_22851	g_22852
Super-Scaffold_100018	9358761	9369980	11219	g_22852	g_22853
Super-Scaffold_100018	9371937	9371970	33	g_22853	g_37839
Super-Scaffold_100018	9373553	9373581	28	g_37839	g_37840
Super-Scaffold_100018	9377533	9377626	93	g_37840	g_37841
Super-Scaffold_100018	9381216	9381778	562	g_37841	g_37842
Super-Scaffold_100018	9385135	9437928	52793	g_37842	g_22854
Super-Scaffold_100018	9439051	9440041	990	g_22854	g_22855
Super-Scaffold_100018	9458489	9461328	2839	g_22855	g_22856
Super-Scaffold_100018	9462873	9501567	38694	g_22856	g_22857
Super-Scaffold_100018	9533535	9557616	24081	g_22857	g_22858
Super-Scaffold_100018	9568981	9584387	15406	g_22858	g_44777
Super-Scaffold_100018	9653025	9656031	3006	g_44777	g_22859
Super-Scaffold_100018	9664032	9682503	18471	g_22859	g_22860
Super-Scaffold_100018	9692639	9703953	11314	g_22860	g_44778
Super-Scaffold_100018	9711028	9714791	3763	g_44778	g_22861
Super-Scaffold_100018	9724516	9728857	4341	g_22861	g_44779
Super-Scaffold_100018	9731243	9742622	11379	g_44779	g_22862
Super-Scaffold_100018	9755633	9758024	2391	g_22862	g_22863
Super-Scaffold_100018	9762685	9763200	515	g_22863	g_22864
Super-Scaffold_100018	9764122	9767164	3042	g_22864	g_22865
Super-Scaffold_100018	9786428	9800524	14096	g_22865	g_22866
Super-Scaffold_100018	9801105	9803357	2252	g_22866	g_22868
Super-Scaffold_100018	9803785	9815934	12149	g_22868	g_22869
Super-Scaffold_100018	9819396	9822322	2926	g_22869	g_22870
Super-Scaffold_100018	9829489	9833965	4476	g_22870	g_22871
Super-Scaffold_100018	9835011	9863661	28650	g_22871	g_22872
Super-Scaffold_100018	9878725	9882573	3848	g_22872	g_22873
Super-Scaffold_100018	9884451	9899048	14597	g_22873	g_22874
Super-Scaffold_100018	9906189	9909790	3601	g_22874	g_22875
Super-Scaffold_100018	9920147	9929253	9106	g_22875	g_22876
Super-Scaffold_100018	9929741	9934789	5048	g_22876	g_44780
Super-Scaffold_100018	9935277	9949664	14387	g_44780	g_22878
Super-Scaffold_100018	9950077	9988533	38456	g_22878	g_22880
Super-Scaffold_100018	9990626	9997183	6557	g_22880	g_22881
Super-Scaffold_100018	10008155	10016673	8518	g_22881	g_22882
Super-Scaffold_100018	10018437	10019158	721	g_22882	g_22883
Super-Scaffold_100018	10026294	10027086	792	g_22883	g_22884
Super-Scaffold_100018	10030541	10031200	659	g_22884	g_22885
Super-Scaffold_100018	10040404	10051204	10800	g_22885	g_22886
Super-Scaffold_100018	10059943	10071738	11795	g_22886	g_22887
Super-Scaffold_100018	10080074	10082367	2293	g_22887	g_44781
Super-Scaffold_100018	10098630	10102526	3896	g_44781	g_22888
Super-Scaffold_100018	10102885	10104749	1864	g_22888	g_44782
Super-Scaffold_100018	10111850	10115260	3410	g_44782	g_22889
Super-Scaffold_100018	10125322	10127641	2319	g_22889	g_22890
Super-Scaffold_100018	10128697	10132687	3990	g_22890	g_22891
Super-Scaffold_100018	10134064	10150998	16934	g_22891	g_22892
Super-Scaffold_100018	10158560	10160329	1769	g_22892	g_22893
Super-Scaffold_100018	10166064	10182211	16147	g_22893	g_22895
Super-Scaffold_100018	10185821	10194363	8542	g_22895	g_22896
Super-Scaffold_100018	10197946	10199718	1772	g_22896	g_22897
Super-Scaffold_100018	10220855	10250961	30106	g_22897	g_22899
Super-Scaffold_100018	10260588	10263153	2565	g_22899	g_44783
Super-Scaffold_100018	10274265	10285482	11217	g_44783	g_22900
Super-Scaffold_100018	10287775	10293161	5386	g_22900	g_44784
Super-Scaffold_100018	10298120	10326902	28782	g_44784	g_22902
Super-Scaffold_100018	10340365	10441436	101071	g_22902	g_22905
Super-Scaffold_100018	10441738	10444763	3025	g_22905	g_22906
Super-Scaffold_100018	10445110	10477979	32869	g_22906	g_22908
Super-Scaffold_100018	10488723	10493242	4519	g_22908	g_44785
Super-Scaffold_100018	10506299	10528062	21763	g_44785	g_22909
Super-Scaffold_100018	10528379	10529246	867	g_22909	g_22910
Super-Scaffold_100018	10547820	10550524	2704	g_22910	g_22911
Super-Scaffold_100018	10556640	10592822	36182	g_22911	g_22912
Super-Scaffold_100018	10594521	10631856	37335	g_37853	g_22913
Super-Scaffold_100018	10632110	10643183	11073	g_22913	g_22914
Super-Scaffold_100018	10654177	10662810	8633	g_22914	g_22915
Super-Scaffold_100018	10674325	10674582	257	g_22915	g_22916
Super-Scaffold_100018	10676294	10676475	181	g_22916	g_22917
Super-Scaffold_100018	10677972	10678725	753	g_22917	g_44786
Super-Scaffold_100018	10680273	10682398	2125	g_44786	g_22918
Super-Scaffold_100018	10684053	10684234	181	g_22918	g_22919
Super-Scaffold_100018	10685733	10686486	753	g_22919	g_44787
Super-Scaffold_100018	10688033	10689434	1401	g_44787	g_22920
Super-Scaffold_100018	10698539	10701702	3163	g_22920	g_22921
Super-Scaffold_100018	10703282	10709374	6092	g_22921	g_22922
Super-Scaffold_100018	10710366	10712617	2251	g_22922	g_22923
Super-Scaffold_100018	10719615	10722930	3315	g_22923	g_22924
Super-Scaffold_100018	10728066	10731790	3724	g_22924	g_22925
Super-Scaffold_100018	10737135	10748700	11565	g_22925	g_22926
Super-Scaffold_100018	10749260	10751373	2113	g_22926	g_22927
Super-Scaffold_100018	10760504	10769809	9305	g_22927	g_44788
Super-Scaffold_100018	10779128	10781037	1909	g_44788	g_22928
Super-Scaffold_100018	10785533	10791255	5722	g_22928	g_37856
Super-Scaffold_100018	10809729	10816312	6583	g_22929	g_22930
Super-Scaffold_100018	10824524	10854513	29989	g_22930	g_22931
Super-Scaffold_100018	10871861	10880925	9064	g_22931	g_22933
Super-Scaffold_100018	10885746	10887980	2234	g_22933	g_22934
Super-Scaffold_100018	10892424	10893511	1087	g_22934	g_22935
Super-Scaffold_100018	10896113	10901420	5307	g_22935	g_22936
Super-Scaffold_100018	10904901	10914221	9320	g_22936	g_22937
Super-Scaffold_100018	10920535	10922738	2203	g_22937	g_22938
Super-Scaffold_100018	10931112	10936020	4908	g_22938	g_22939
Super-Scaffold_100018	10947394	10966731	19337	g_22939	g_22940
Super-Scaffold_100018	10984244	10987964	3720	g_22940	g_44789
Super-Scaffold_100018	10998691	11044068	45377	g_44789	g_22942
Super-Scaffold_100018	11065358	11068792	3434	g_22942	g_44790
Super-Scaffold_100018	11084681	11091600	6919	g_44790	g_22943
Super-Scaffold_100018	11102220	11107095	4875	g_22943	g_22944
Super-Scaffold_100018	11111254	11112327	1073	g_22944	g_22945
Super-Scaffold_100018	11121587	11150426	28839	g_22945	g_22946
Super-Scaffold_100018	11175356	11185224	9868	g_22946	g_22947
Super-Scaffold_100018	11190489	11192250	1761	g_22947	g_44791
Super-Scaffold_100018	11198789	11200522	1733	g_44791	g_22948
Super-Scaffold_100018	11209169	11220810	11641	g_22948	g_22949
Super-Scaffold_100018	11230200	11240173	9973	g_22949	g_22950
Super-Scaffold_100018	11240478	11255878	15400	g_22950	g_37859
Super-Scaffold_100018	11256081	11257100	1019	g_37859	g_22951
Super-Scaffold_100018	11278429	11287922	9493	g_22951	g_22954
Super-Scaffold_100018	11290061	11300750	10689	g_22954	g_22955
Super-Scaffold_100018	11300965	11308340	7375	g_22955	g_22956
Super-Scaffold_100018	11325993	11331544	5551	g_22956	g_22957
Super-Scaffold_100018	11334799	11337414	2615	g_22957	g_22958
Super-Scaffold_100018	11343052	11345491	2439	g_22958	g_22959
Super-Scaffold_100018	11347126	11353216	6090	g_22959	g_22960
Super-Scaffold_100018	11366255	11371678	5423	g_22960	g_22961
Super-Scaffold_100018	11375555	11377573	2018	g_22961	g_22962
Super-Scaffold_100018	11384200	11387047	2847	g_22962	g_22963
Super-Scaffold_100018	11389368	11393966	4598	g_22963	g_22964
Super-Scaffold_100018	11397882	11401564	3682	g_22964	g_44792
Super-Scaffold_100018	11404454	11440154	35700	g_44792	g_22965
Super-Scaffold_100018	11458288	11472060	13772	g_22965	g_22966
Super-Scaffold_100018	11472494	11497730	25236	g_22966	g_22967
Super-Scaffold_100018	11497948	11518590	20642	g_22967	g_22968
Super-Scaffold_100018	11518883	11534262	15379	g_22968	g_22969
Super-Scaffold_100018	11534489	11651918	117429	g_22969	g_22975
Super-Scaffold_100018	11658740	11691606	32866	g_22975	g_22976
Super-Scaffold_100018	11696387	11732041	35654	g_22976	g_22977
Super-Scaffold_100018	11732868	11738107	5239	g_22977	g_22978
Super-Scaffold_100018	11760399	11765328	4929	g_22978	g_22979
Super-Scaffold_100018	11767804	11774456	6652	g_22979	g_22980
Super-Scaffold_100018	11791787	11809223	17436	g_22980	g_22981
Super-Scaffold_100018	11811545	11813607	2062	g_22981	g_22982
Super-Scaffold_100018	11820243	11826547	6304	g_22982	g_22983
Super-Scaffold_100018	11829415	11835455	6040	g_22983	g_22984
Super-Scaffold_100018	11840550	11842223	1673	g_22984	g_22985
Super-Scaffold_100018	11845098	11846175	1077	g_22985	g_44793
Super-Scaffold_100018	11849222	11852713	3491	g_44793	g_22986
Super-Scaffold_100018	11868121	11871623	3502	g_22986	g_22987
Super-Scaffold_100018	11871868	11884044	12176	g_22987	g_22989
Super-Scaffold_100018	11884253	11889799	5546	g_22989	g_22990
Super-Scaffold_100018	11895953	11907563	11610	g_22990	g_22991
Super-Scaffold_100018	11911387	11922582	11195	g_22991	g_22992
Super-Scaffold_100018	11931867	11934943	3076	g_22992	g_22993
Super-Scaffold_100018	11937450	11939855	2405	g_22993	g_22994
Super-Scaffold_100018	11941654	11942839	1185	g_22994	g_22995
Super-Scaffold_100018	11957249	11965742	8493	g_22995	g_22996
Super-Scaffold_100018	11973430	11977043	3613	g_22996	g_22997
Super-Scaffold_100018	11980663	11987591	6928	g_22997	g_22998
Super-Scaffold_100018	12002521	12005031	2510	g_22998	g_44794
Super-Scaffold_100018	12011766	12012853	1087	g_44794	g_22999
Super-Scaffold_100018	12016088	12018879	2791	g_22999	g_23000
Super-Scaffold_100018	12020963	12021944	981	g_23000	g_23001
Super-Scaffold_100018	12024641	12025522	881	g_23001	g_23002
Super-Scaffold_100018	12028917	12033306	4389	g_23002	g_23003
Super-Scaffold_100018	12035575	12036737	1162	g_23003	g_23004
Super-Scaffold_100018	12038079	12039349	1270	g_23004	g_23005
Super-Scaffold_100018	12040969	12044263	3294	g_23005	g_23006
Super-Scaffold_100018	12058888	12062565	3677	g_23006	g_23007
Super-Scaffold_100018	12085647	12099949	14302	g_23007	g_23008
Super-Scaffold_100018	12111192	12119206	8014	g_23008	g_23009
Super-Scaffold_100018	12124728	12125091	363	g_23009	g_23010
Super-Scaffold_100018	12126291	12127739	1448	g_23010	g_23011
Super-Scaffold_100018	12129231	12132270	3039	g_23011	g_23012
Super-Scaffold_100018	12134523	12140886	6363	g_23012	g_23013
Super-Scaffold_100018	12163777	12213738	49961	g_23013	g_23017
Super-Scaffold_100018	12220879	12231440	10561	g_23017	g_23018
Super-Scaffold_100018	12233376	12234110	734	g_23018	g_37875
Super-Scaffold_100018	12234349	12237896	3547	g_37875	g_23019
Super-Scaffold_100018	12239630	12283032	43402	g_23019	g_23020
Super-Scaffold_100018	12292416	12308042	15626	g_23020	g_23022
Super-Scaffold_100018	12316243	12330310	14067	g_23022	g_23023
Super-Scaffold_100018	12346664	12371210	24546	g_23023	g_44795
Super-Scaffold_100018	12376554	12381014	4460	g_44795	g_23024
Super-Scaffold_100018	12392894	12427231	34337	g_23024	g_23025
Super-Scaffold_100018	12430439	12431567	1128	g_23025	g_23026
Super-Scaffold_100018	12435431	12436899	1468	g_23026	g_23027
Super-Scaffold_100018	12438209	12451291	13082	g_23027	g_23028
Super-Scaffold_100018	12453822	12553693	99871	g_23028	g_23031
Super-Scaffold_100018	12558522	12567064	8542	g_23031	g_23032
Super-Scaffold_100018	12573166	12581080	7914	g_23032	g_23033
Super-Scaffold_100018	12597034	12600583	3549	g_23033	g_23034
Super-Scaffold_100018	12601428	12614563	13135	g_23034	g_37882
Super-Scaffold_100018	12614769	12634850	20081	g_37882	g_23035
Super-Scaffold_100018	12635173	12651900	16727	g_23035	g_23036
Super-Scaffold_100018	12663144	12668431	5287	g_23036	g_23037
Super-Scaffold_100018	12724465	12857214	132749	g_23037	g_37884
Super-Scaffold_100018	12857507	12885513	28006	g_37884	g_23040
Super-Scaffold_100018	12888339	12893011	4672	g_23040	g_44796
Super-Scaffold_100018	12896996	12899013	2017	g_44796	g_23041
Super-Scaffold_100018	12904800	12910134	5334	g_23041	g_44797
Super-Scaffold_100018	12919799	12922911	3112	g_44797	g_23042
Super-Scaffold_100018	12928830	12931272	2442	g_23042	g_23043
Super-Scaffold_100018	12933730	12937601	3871	g_23043	g_23044
Super-Scaffold_100018	12937972	12943153	5181	g_23044	g_23045
Super-Scaffold_100018	12946318	12949252	2934	g_23045	g_23046
Super-Scaffold_100018	12954998	12959174	4176	g_23046	g_23047
Super-Scaffold_100018	12968318	12971501	3183	g_23047	g_23048
Super-Scaffold_100018	12981957	13004084	22127	g_23048	g_23049
Super-Scaffold_100018	13008979	13018429	9450	g_23049	g_23050
Super-Scaffold_100018	13034154	13038192	4038	g_23050	g_23051
Super-Scaffold_100018	13041203	13042036	833	g_23051	g_44798
Super-Scaffold_100018	13044686	13046403	1717	g_44798	g_44799
Super-Scaffold_100018	13049632	13071902	22270	g_44799	g_23052
Super-Scaffold_100018	13075013	13109003	33990	g_23052	g_23054
Super-Scaffold_100018	13109705	13114782	5077	g_23054	g_23055
Super-Scaffold_100018	13119385	13123576	4191	g_23055	g_23056
Super-Scaffold_100018	13128744	13129891	1147	g_23056	g_23057
Super-Scaffold_100018	13131080	13138314	7234	g_23057	g_23058
Super-Scaffold_100018	13144952	13148639	3687	g_23058	g_23059
Super-Scaffold_100018	13154422	13158761	4339	g_23059	g_23060
Super-Scaffold_100018	13159075	13163221	4146	g_23060	g_23061
Super-Scaffold_100018	13179034	13184021	4987	g_23061	g_23062
Super-Scaffold_100018	13185950	13188246	2296	g_23062	g_23063
Super-Scaffold_100018	13191950	13195525	3575	g_23063	g_23064
Super-Scaffold_100018	13197351	13199476	2125	g_23064	g_23065
Super-Scaffold_100018	13204667	13214992	10325	g_23065	g_37887
Super-Scaffold_100018	13215207	13226462	11255	g_37887	g_23066
Super-Scaffold_100018	13246883	13255604	8721	g_23066	g_23067
Super-Scaffold_100018	13256812	13270323	13511	g_23067	g_23068
Super-Scaffold_100018	13275802	13353227	77425	g_23068	g_23070
Super-Scaffold_100018	13353568	13478683	125115	g_23070	g_23073
Super-Scaffold_100018	13543262	13547101	3839	g_23073	g_37888
Super-Scaffold_100018	13548435	13696370	147935	g_37888	g_23077
Super-Scaffold_100018	13696636	13735058	38422	g_23077	g_23078
Super-Scaffold_100018	13736186	13827282	91096	g_23078	g_23079
Super-Scaffold_100018	13827659	13914780	87121	g_23079	g_37890
Super-Scaffold_100018	13914983	13962972	47989	g_37890	g_23080
Super-Scaffold_100018	13969022	14005648	36626	g_23080	g_23081
Super-Scaffold_100018	14019261	14171046	151785	g_23081	g_23082
Super-Scaffold_100018	14171450	14228302	56852	g_23082	g_23083
Super-Scaffold_100018	14235081	14237473	2392	g_23083	g_23084
Super-Scaffold_100018	14239700	14241233	1533	g_23084	g_23085
Super-Scaffold_100018	14241976	14244456	2480	g_23085	g_23086
Super-Scaffold_100018	14280783	14309077	28294	g_23086	g_23087
Super-Scaffold_100018	14326475	14362015	35540	g_23087	g_23088
Super-Scaffold_100018	14372802	14380389	7587	g_23088	g_23089
Super-Scaffold_100018	14382789	14392514	9725	g_23089	g_44800
Super-Scaffold_100018	14392975	14396172	3197	g_44800	g_23090
Super-Scaffold_100018	14399627	14405040	5413	g_23090	g_23091
Super-Scaffold_100018	14416609	14418070	1461	g_23091	g_23092
Super-Scaffold_100018	14427611	14441398	13787	g_23092	g_23093
Super-Scaffold_100018	14441667	14460024	18357	g_23093	g_23094
Super-Scaffold_100018	14463082	14477384	14302	g_23094	g_23095
Super-Scaffold_100018	14483554	14506242	22688	g_23095	g_37893
Super-Scaffold_100018	14507051	14514074	7023	g_37893	g_23097
Super-Scaffold_100018	14515848	14525043	9195	g_23097	g_23098
Super-Scaffold_100018	14532588	14536105	3517	g_23098	g_23099
Super-Scaffold_100018	14550716	14552307	1591	g_23099	g_23100
Super-Scaffold_100018	14558373	14561046	2673	g_23100	g_44801
Super-Scaffold_100018	14565447	14566570	1123	g_44801	g_23101
Super-Scaffold_100018	14573006	14574592	1586	g_23101	g_23102
Super-Scaffold_100018	14575740	14580032	4292	g_23102	g_23103
Super-Scaffold_100018	14610394	14639973	29579	g_23103	g_23105
Super-Scaffold_100018	14643964	14645069	1105	g_23105	g_23106
Super-Scaffold_100018	14651219	14653174	1955	g_23106	g_23107
Super-Scaffold_100018	14653860	14659790	5930	g_23107	g_23108
Super-Scaffold_100018	14661804	14662868	1064	g_23108	g_44802
Super-Scaffold_100018	14664202	14665503	1301	g_44802	g_23109
Super-Scaffold_100018	14669012	14670386	1374	g_23109	g_23110
Super-Scaffold_100018	14674146	14675425	1279	g_23110	g_23111
Super-Scaffold_100018	14682457	14685241	2784	g_23111	g_23112
Super-Scaffold_100018	14699481	14701127	1646	g_23112	g_23113
Super-Scaffold_100018	14711418	14712407	989	g_23113	g_23114
Super-Scaffold_100018	14714681	14715928	1247	g_23114	g_23115
Super-Scaffold_100018	14719261	14719874	613	g_23115	g_23116
Super-Scaffold_100018	14734070	14734879	809	g_23116	g_23117
Super-Scaffold_100018	14741476	14746553	5077	g_23117	g_23118
Super-Scaffold_100018	14751185	14754735	3550	g_23118	g_23119
Super-Scaffold_100018	14758854	14764728	5874	g_23119	g_23120
Super-Scaffold_100018	14774905	14780036	5131	g_23120	g_23121
Super-Scaffold_100018	14784417	14808376	23959	g_23121	g_23122
Super-Scaffold_100018	14810291	14814099	3808	g_23122	g_37895
Super-Scaffold_100018	14814311	14818486	4175	g_37895	g_23123
Super-Scaffold_100018	14820242	14821626	1384	g_23123	g_23124
Super-Scaffold_100018	14825084	14825583	499	g_23124	g_23125
Super-Scaffold_100018	14827340	14833842	6502	g_23125	g_23126
Super-Scaffold_100018	14835839	14839123	3284	g_23126	g_23127
Super-Scaffold_100018	14843140	14847298	4158	g_23127	g_23128
Super-Scaffold_100018	14850402	14856709	6307	g_23128	g_23129
Super-Scaffold_100018	14858932	14859774	842	g_23129	g_23130
Super-Scaffold_100018	14862781	14866216	3435	g_23130	g_44803
Super-Scaffold_100018	14871037	14872559	1522	g_44803	g_23131
Super-Scaffold_100018	14886294	14890067	3773	g_23131	g_44804
Super-Scaffold_100018	14897235	14899508	2273	g_44804	g_23132
Super-Scaffold_100018	14901679	14902208	529	g_23132	g_44805
Super-Scaffold_100018	14904016	14906750	2734	g_44805	g_23133
Super-Scaffold_100018	14918280	14922893	4613	g_23133	g_23134
Super-Scaffold_100018	14927590	14933492	5902	g_23134	g_23135
Super-Scaffold_100018	14937070	14943481	6411	g_23135	g_23136
Super-Scaffold_100018	14944995	14952337	7342	g_23136	g_23137
Super-Scaffold_100018	14952591	15087187	134596	g_23137	g_23141
Super-Scaffold_100018	15087459	15103657	16198	g_23141	g_23142
Super-Scaffold_100018	15120674	15148729	28055	g_23142	g_23143
Super-Scaffold_100018	15150651	15295507	144856	g_23143	g_23151
Super-Scaffold_100018	15295737	15343952	48215	g_23151	g_23153
Super-Scaffold_100018	15344377	15399472	55095	g_23153	g_23155
Super-Scaffold_100018	15399720	15414309	14589	g_23155	g_23157
Super-Scaffold_100018	15414659	15426432	11773	g_23157	g_23159
Super-Scaffold_100018	15426656	15436429	9773	g_23159	g_23160
Super-Scaffold_100018	15436764	15456139	19375	g_23160	g_23162
Super-Scaffold_100018	15459740	15511226	51486	g_23162	g_23164
Super-Scaffold_100018	15515621	15605913	90292	g_23164	g_23167
Super-Scaffold_100018	15606155	15634170	28015	g_23167	g_23168
Super-Scaffold_100018	15634400	15635754	1354	g_23168	g_23169
Super-Scaffold_100018	15652566	15665511	12945	g_23169	g_23170
Super-Scaffold_100018	15665765	15668916	3151	g_23170	g_23171
Super-Scaffold_100018	15670189	15671545	1356	g_23171	g_23172
Super-Scaffold_100018	15674871	15681151	6280	g_23172	g_44806
Super-Scaffold_100018	15685236	15686192	956	g_44806	g_23173
Super-Scaffold_100018	15687449	15691423	3974	g_23173	g_44807
Super-Scaffold_100018	15697824	15717153	19329	g_44807	g_44808
Super-Scaffold_100018	15723182	15727399	4217	g_44808	g_44809
Super-Scaffold_100018	15730529	15743289	12760	g_44809	g_23176
Super-Scaffold_100018	15749539	15759921	10382	g_23176	g_23177
Super-Scaffold_100018	15771305	15774982	3677	g_23177	g_37907
Super-Scaffold_100018	15775272	15790607	15335	g_37907	g_23179
Super-Scaffold_100018	15804135	15806416	2281	g_23179	g_23180
Super-Scaffold_100018	15808088	15812625	4537	g_23180	g_23181
Super-Scaffold_100018	15813517	15816475	2958	g_23181	g_23182
Super-Scaffold_100018	15821513	15825361	3848	g_23182	g_23183
Super-Scaffold_100018	15826617	15830270	3653	g_23183	g_44810
Super-Scaffold_100018	15836899	15838602	1703	g_44810	g_23184
Super-Scaffold_100018	15842588	15849684	7096	g_23184	g_23185
Super-Scaffold_100018	15873839	15877472	3633	g_23185	g_23186
Super-Scaffold_100018	15883232	15884735	1503	g_23186	g_44811
Super-Scaffold_100018	15886990	15888053	1063	g_44811	g_23187
Super-Scaffold_100018	15896352	15901771	5419	g_23187	g_23188
Super-Scaffold_100018	15913709	15931241	17532	g_23188	g_23189
Super-Scaffold_100018	15940861	15945255	4394	g_23189	g_23190
Super-Scaffold_100018	15945654	15952198	6544	g_23190	g_44812
Super-Scaffold_100018	15952622	15964883	12261	g_44812	g_23192
Super-Scaffold_100018	15978076	15989703	11627	g_23192	g_23193
Super-Scaffold_100018	15989981	15997534	7553	g_23193	g_23194
Super-Scaffold_100018	16000189	16055190	55001	g_23194	g_23195
Super-Scaffold_100018	16064760	16111698	46938	g_23195	g_23198
Super-Scaffold_100018	16111955	16125796	13841	g_23198	g_37913
Super-Scaffold_100018	16126218	16167841	41623	g_37913	g_23201
Super-Scaffold_100018	16169290	16175609	6319	g_23201	g_23202
Super-Scaffold_100018	16182458	16185613	3155	g_23202	g_23203
Super-Scaffold_100018	16187310	16192362	5052	g_23203	g_23204
Super-Scaffold_100018	16193394	16198071	4677	g_23204	g_23205
Super-Scaffold_100018	16199026	16206543	7517	g_23205	g_23206
Super-Scaffold_100018	16212881	16215051	2170	g_23206	g_23207
Super-Scaffold_100018	16218133	16224489	6356	g_23207	g_23208
Super-Scaffold_100018	16240082	16246366	6284	g_23208	g_23209
Super-Scaffold_100018	16267693	16269364	1671	g_23209	g_23210
Super-Scaffold_100018	16272097	16279258	7161	g_23210	g_23212
Super-Scaffold_100018	16306750	16309817	3067	g_23212	g_23214
Super-Scaffold_100018	16312346	16314351	2005	g_23214	g_23215
Super-Scaffold_100018	16318810	16320202	1392	g_23215	g_23216
Super-Scaffold_100018	16329055	16330596	1541	g_23216	g_23217
Super-Scaffold_100018	16334041	16337152	3111	g_23217	g_23218
Super-Scaffold_100018	16346710	16348834	2124	g_23218	g_23219
Super-Scaffold_100018	16350188	16358861	8673	g_23219	g_23220
Super-Scaffold_100018	16360226	16368784	8558	g_23220	g_23221
Super-Scaffold_100018	16370141	16384461	14320	g_23221	g_23222
Super-Scaffold_100018	16389581	16389696	115	g_23222	g_44813
Super-Scaffold_100018	16390715	16392272	1557	g_44813	g_23224
Super-Scaffold_100018	16401369	16408757	7388	g_23224	g_23225
Super-Scaffold_100018	16417632	16422077	4445	g_23225	g_23226
Super-Scaffold_100018	16428056	16430420	2364	g_23226	g_44814
Super-Scaffold_100018	16432385	16444427	12042	g_44814	g_23227
Super-Scaffold_100018	16444765	16447735	2970	g_23227	g_23229
Super-Scaffold_100018	16448001	16451036	3035	g_23229	g_23230
Super-Scaffold_100018	16480160	16483576	3416	g_23230	g_23231
Super-Scaffold_100018	16487994	16527935	39941	g_23231	g_23232
Super-Scaffold_100018	16529074	16532302	3228	g_23232	g_23233
Super-Scaffold_100018	16533441	16537390	3949	g_23233	g_23234
Super-Scaffold_100018	16544687	16550821	6134	g_23234	g_23235
Super-Scaffold_100018	16564530	16614739	50209	g_23235	g_23237
Super-Scaffold_100018	16630440	16637854	7414	g_23237	g_44815
Super-Scaffold_100018	16640290	16654766	14476	g_44815	g_23238
Super-Scaffold_100018	16658579	16659391	812	g_23238	g_23239
Super-Scaffold_100018	16660675	16662140	1465	g_23239	g_23240
Super-Scaffold_100018	16664088	16675664	11576	g_23240	g_23241
Super-Scaffold_100018	16685372	16690563	5191	g_23241	g_23243
Super-Scaffold_100018	16691068	16692649	1581	g_23243	g_23244
Super-Scaffold_100018	16692951	16698667	5716	g_23244	g_23245
Super-Scaffold_100018	16704440	16751336	46896	g_23245	g_37927
Super-Scaffold_100018	16751815	16795710	43895	g_37927	g_37928
Super-Scaffold_100018	16795913	16889122	93209	g_37928	g_23254
Super-Scaffold_100018	16889784	16890166	382	g_23254	g_23255
Super-Scaffold_100018	16891925	16994778	102853	g_23255	g_23258
Super-Scaffold_100018	16996364	17054861	58497	g_23258	g_37933
Super-Scaffold_100018	17055073	17283268	228195	g_37933	g_23266
Super-Scaffold_100018	17283486	17294633	11147	g_23266	g_37936
Super-Scaffold_100018	17294956	17307045	12089	g_37936	g_23267
Super-Scaffold_100018	17350017	17354236	4219	g_23267	g_23268
Super-Scaffold_100018	17361991	17362975	984	g_23268	g_44816
Super-Scaffold_100018	17365741	17381091	15350	g_44816	g_23269
Super-Scaffold_100018	17382041	17433699	51658	g_23269	g_23271
Super-Scaffold_100018	17448009	17450078	2069	g_23271	g_23272
Super-Scaffold_100018	17454068	17472603	18535	g_23272	g_23273
Super-Scaffold_100018	17473283	17484954	11671	g_23273	g_37937
Super-Scaffold_100018	17485316	17486121	805	g_37937	g_23274
Super-Scaffold_100018	17490999	17494792	3793	g_23274	g_23275
Super-Scaffold_100018	17512124	17519665	7541	g_23275	g_44817
Super-Scaffold_100018	17536970	17555773	18803	g_44817	g_23276
Super-Scaffold_100018	17564875	17578826	13951	g_23276	g_23278
Super-Scaffold_100018	17594003	17692308	98305	g_23278	g_23282
Super-Scaffold_100018	17692577	17749357	56780	g_23282	g_23285
Super-Scaffold_100018	17749560	17778141	28581	g_23285	g_23286
Super-Scaffold_100018	17778467	17790933	12466	g_23286	g_37940
Super-Scaffold_100018	17791538	17792692	1154	g_37940	g_23288
Super-Scaffold_100018	17792952	18001184	208232	g_23288	g_23290
Super-Scaffold_100018	18001573	18004485	2912	g_23290	g_23291
Super-Scaffold_100018	18004745	18024690	19945	g_23291	g_23292
Super-Scaffold_100018	18024944	18026640	1696	g_23292	g_23293
Super-Scaffold_100018	18036154	18036891	737	g_23293	g_23294
Super-Scaffold_100018	18039319	18040004	685	g_23294	g_23295
Super-Scaffold_100018	18040693	18048328	7635	g_23295	g_23296
Super-Scaffold_100018	18062305	18070661	8356	g_23296	g_23297
Super-Scaffold_100018	18083137	18089809	6672	g_23297	g_23298
Super-Scaffold_100018	18092364	18093263	899	g_23298	g_44818
Super-Scaffold_100018	18093490	18105809	12319	g_44818	g_23299
Super-Scaffold_100018	18106546	18106850	304	g_23299	g_23300
Super-Scaffold_100018	18117986	18120543	2557	g_23300	g_23301
Super-Scaffold_100018	18120842	18123668	2826	g_23301	g_23302
Super-Scaffold_100018	18135584	18137025	1441	g_23302	g_44819
Super-Scaffold_100018	18142269	18149623	7354	g_44819	g_23303
Super-Scaffold_100018	18172416	18180562	8146	g_23303	g_23304
Super-Scaffold_100018	18186893	18188321	1428	g_23304	g_23305
Super-Scaffold_100018	18194842	18195945	1103	g_23305	g_23306
Super-Scaffold_100018	18200754	18214973	14219	g_23306	g_44820
Super-Scaffold_100018	18221308	18226549	5241	g_44820	g_23308
Super-Scaffold_100018	18227750	18230020	2270	g_23308	g_23309
Super-Scaffold_100018	18233977	18234154	177	g_23309	g_23310
Super-Scaffold_100018	18237105	18259125	22020	g_23310	g_44821
Super-Scaffold_100018	18282063	18294480	12417	g_44821	g_23311
Super-Scaffold_100018	18304510	18308523	4013	g_23311	g_23312
Super-Scaffold_100018	18309966	18317649	7683	g_23312	g_23314
Super-Scaffold_100018	18318065	18319963	1898	g_23314	g_23315
Super-Scaffold_100018	18325018	18338527	13509	g_23315	g_23316
Super-Scaffold_100018	18346000	18351647	5647	g_23316	g_23317
Super-Scaffold_100018	18355136	18364674	9538	g_23317	g_23318
Super-Scaffold_100018	18380301	18396353	16052	g_23318	g_23319
Super-Scaffold_100018	18396658	18435772	39114	g_23319	g_23320
Super-Scaffold_100018	18435984	18444767	8783	g_23320	g_23321
Super-Scaffold_100018	18449113	18450987	1874	g_23321	g_23322
Super-Scaffold_100018	18452104	18453807	1703	g_23322	g_44822
Super-Scaffold_100018	18457644	18486011	28367	g_44822	g_23323
Super-Scaffold_100018	18486364	18517103	30739	g_23323	g_37948
Super-Scaffold_100018	18517333	18530020	12687	g_37948	g_23327
Super-Scaffold_100018	18546110	18570561	24451	g_23327	g_23328
Super-Scaffold_100018	18573261	18579748	6487	g_23328	g_23329
Super-Scaffold_100018	18580277	18584424	4147	g_23329	g_23330
Super-Scaffold_100018	18597000	18610199	13199	g_23330	g_23331
Super-Scaffold_100018	18616107	18623569	7462	g_23331	g_44823
Super-Scaffold_100018	18632605	18634328	1723	g_44823	g_23332
Super-Scaffold_100018	18650160	18665716	15556	g_23332	g_23333
Super-Scaffold_100018	18673551	18697802	24251	g_23333	g_23334
Super-Scaffold_100018	18717500	18735454	17954	g_23334	g_23335
Super-Scaffold_100018	18746227	18753335	7108	g_23335	g_23336
Super-Scaffold_100018	18754321	18757927	3606	g_23336	g_23337
Super-Scaffold_100018	18771978	18815433	43455	g_23337	g_23339
Super-Scaffold_100018	18828796	18832176	3380	g_23339	g_44824
Super-Scaffold_100018	18840266	18894671	54405	g_44824	g_23341
Super-Scaffold_100018	18903723	18906567	2844	g_23341	g_23342
Super-Scaffold_100018	18919816	18951663	31847	g_23342	g_23343
Super-Scaffold_100018	18967267	18967748	481	g_23343	g_23344
Super-Scaffold_100018	18967966	18969244	1278	g_23344	g_23345
Super-Scaffold_100018	18972071	18973712	1641	g_23345	g_44825
Super-Scaffold_100018	18977792	18980970	3178	g_44825	g_23346
Super-Scaffold_100018	18987541	19019664	32123	g_37954	g_23347
Super-Scaffold_100018	19041467	19055810	14343	g_23347	g_23348
Super-Scaffold_100018	19064192	19081876	17684	g_23348	g_23349
Super-Scaffold_100018	19100093	19171583	71490	g_23349	g_23351
Super-Scaffold_100018	19194026	19278006	83980	g_23351	g_23353
Super-Scaffold_100018	19278359	19278988	629	g_23353	g_23354
Super-Scaffold_100018	19279976	19362362	82386	g_23354	g_23356
Super-Scaffold_100018	19362904	19566893	203989	g_23356	g_23358
Super-Scaffold_100018	19567120	19611664	44544	g_23358	g_23359
Super-Scaffold_100018	19615695	19625989	10294	g_23359	g_23360
Super-Scaffold_100018	19643268	19676184	32916	g_23360	g_23362
Super-Scaffold_100018	19701262	19706080	4818	g_23362	g_23363
Super-Scaffold_100018	19711664	19713366	1702	g_23363	g_23364
Super-Scaffold_100018	19714320	19730002	15682	g_23364	g_23365
Super-Scaffold_100018	19730640	19730960	320	g_23365	g_23366
Super-Scaffold_100018	19731223	19732038	815	g_23366	g_23367
Super-Scaffold_100018	19733297	19736945	3648	g_23367	g_23368
Super-Scaffold_100018	19738771	19743288	4517	g_23368	g_23369
Super-Scaffold_100018	19752293	19758240	5947	g_23369	g_23371
Super-Scaffold_100018	19766744	19768374	1630	g_23371	g_23372
Super-Scaffold_100018	19776144	19808356	32212	g_23372	g_23373
Super-Scaffold_100018	19817188	19825440	8252	g_23373	g_23374
Super-Scaffold_100018	19831298	19838561	7263	g_23374	g_23375
Super-Scaffold_100018	19849499	19865818	16319	g_23375	g_23376
Super-Scaffold_100018	19867120	19873047	5927	g_23376	g_23377
Super-Scaffold_100018	19878203	19878260	57	g_23377	g_44826
Super-Scaffold_100018	19880077	19886364	6287	g_44826	g_23378
Super-Scaffold_100018	19887115	19907189	20074	g_23378	g_23379
Super-Scaffold_100018	19912680	19936629	23949	g_23379	g_23381
Super-Scaffold_100018	19936889	19944705	7816	g_23381	g_23383
Super-Scaffold_100018	19960134	19965903	5769	g_23383	g_23384
Super-Scaffold_100018	19966199	20027041	60842	g_23384	g_23386
Super-Scaffold_100018	20029844	20034238	4394	g_23386	g_23387
Super-Scaffold_100018	20038939	20041385	2446	g_23387	g_23388
Super-Scaffold_100018	20054250	20094056	39806	g_23388	g_23390
Super-Scaffold_100018	20094316	20094411	95	g_23390	g_23391
Super-Scaffold_100018	20100018	20172514	72496	g_23391	g_23393
Super-Scaffold_100018	20178263	20179367	1104	g_23393	g_44827
Super-Scaffold_100018	20182381	20183270	889	g_44827	g_23394
Super-Scaffold_100018	20185891	20185991	100	g_23394	g_23395
Super-Scaffold_100018	20188932	20190023	1091	g_23395	g_44828
Super-Scaffold_100018	20193654	20207826	14172	g_44828	g_23397
Super-Scaffold_100018	20212097	20214526	2429	g_23397	g_23398
Super-Scaffold_100018	20221754	20227829	6075	g_23398	g_23399
Super-Scaffold_100018	20233296	20236506	3210	g_23399	g_44829
Super-Scaffold_100018	20242140	20248144	6004	g_44829	g_23400
Super-Scaffold_100018	20257954	20263259	5305	g_23400	g_44830
Super-Scaffold_100018	20270312	20281555	11243	g_44830	g_23402
Super-Scaffold_100018	20281905	20285395	3490	g_23402	g_23403
Super-Scaffold_100018	20300159	20309432	9273	g_23403	g_23404
Super-Scaffold_100018	20316205	20361183	44978	g_23404	g_37962
Super-Scaffold_100018	20361458	20375736	14278	g_37962	g_37964
Super-Scaffold_100018	20375939	20660551	284612	g_37964	g_23409
Super-Scaffold_100018	20671007	20728596	57589	g_23409	g_23410
Super-Scaffold_100018	20729450	20733383	3933	g_23410	g_23411
Super-Scaffold_100018	20750665	20798818	48153	g_23411	g_23414
Super-Scaffold_100018	20799099	20825979	26880	g_23414	g_23416
Super-Scaffold_100018	20839433	20853438	14005	g_23416	g_23418
Super-Scaffold_100018	20853644	20879302	25658	g_23418	g_23420
Super-Scaffold_100018	20897985	20918580	20595	g_23420	g_23421
Super-Scaffold_100018	20951867	20955803	3936	g_23421	g_23422
Super-Scaffold_100018	20968754	20978587	9833	g_23422	g_23423
Super-Scaffold_100018	20979595	20986970	7375	g_23423	g_23425
Super-Scaffold_100018	20988841	20991387	2546	g_23425	g_23426
Super-Scaffold_100018	21001879	21006846	4967	g_23426	g_23427
Super-Scaffold_100018	21007085	21007120	35	g_23427	g_23428
Super-Scaffold_100018	21047063	21054339	7276	g_23428	g_44831
Super-Scaffold_100018	21057827	21059005	1178	g_44831	g_23429
Super-Scaffold_100018	21133368	21140500	7132	g_23429	g_23430
Super-Scaffold_100018	21155823	21166151	10328	g_23430	g_23431
Super-Scaffold_100018	21166420	21204664	38244	g_23431	g_37970
Super-Scaffold_100018	21205071	21230571	25500	g_37970	g_23433
Super-Scaffold_100018	21231002	21265283	34281	g_23433	g_23436
Super-Scaffold_100018	21269771	21275218	5447	g_23436	g_23437
Super-Scaffold_100018	21295714	21298041	2327	g_23437	g_44832
Super-Scaffold_100018	21299912	21321677	21765	g_44832	g_23439
Super-Scaffold_100018	21323104	21323321	217	g_23439	g_23440
Super-Scaffold_100018	21325375	21325416	41	g_23440	g_23441
Super-Scaffold_100018	21326507	21338811	12304	g_23441	g_23442
Super-Scaffold_100018	21358023	21374345	16322	g_23442	g_23444
Super-Scaffold_100018	21407720	21409544	1824	g_23444	g_23445
Super-Scaffold_100018	21432959	21436215	3256	g_23445	g_23446
Super-Scaffold_100018	21439908	21459405	19497	g_23446	g_23448
Super-Scaffold_100018	21467798	21470786	2988	g_23448	g_23449
Super-Scaffold_100018	21477241	21486411	9170	g_23449	g_23450
Super-Scaffold_100018	21491700	21495013	3313	g_23450	g_23451
Super-Scaffold_100018	21510612	21519785	9173	g_23451	g_23452
Super-Scaffold_100018	21525073	21527584	2511	g_37972	g_23453
Super-Scaffold_100018	21530869	21532659	1790	g_23453	g_23454
Super-Scaffold_100018	21539376	21546758	7382	g_23454	g_23455
Super-Scaffold_100018	21557431	21558588	1157	g_23455	g_23456
Super-Scaffold_100018	21573621	21575244	1623	g_23456	g_23457
Super-Scaffold_100018	21577526	21588097	10571	g_23457	g_44833
Super-Scaffold_100018	21596626	21605831	9205	g_37973	g_23458
Super-Scaffold_100018	21608027	21610105	2078	g_23458	g_23459
Super-Scaffold_100018	21611604	21618410	6806	g_23459	g_23460
Super-Scaffold_100018	21620496	21620732	236	g_23460	g_23461
Super-Scaffold_100018	21622198	21622841	643	g_23461	g_23462
Super-Scaffold_100018	21624305	21640871	16566	g_23462	g_23464
Super-Scaffold_100018	21641089	21644712	3623	g_23464	g_23463
Super-Scaffold_100018	21645011	21652251	7240	g_23463	g_23466
Super-Scaffold_100018	21664207	21664749	542	g_23466	g_23467
Super-Scaffold_100018	21675053	21682228	7175	g_23467	g_23468
Super-Scaffold_100018	21691768	21694173	2405	g_23468	g_23469
Super-Scaffold_100018	21694925	21694977	52	g_23469	g_23470
Super-Scaffold_100018	21695864	21699383	3519	g_23470	g_23471
Super-Scaffold_100018	21704104	21724983	20879	g_23471	g_23472
Super-Scaffold_100018	21734424	21735996	1572	g_23472	g_44834
Super-Scaffold_100018	21749772	21750455	683	g_44834	g_23473
Super-Scaffold_100018	21754889	21757582	2693	g_23473	g_23474
Super-Scaffold_100018	21768080	21793249	25169	g_23474	g_23476
Super-Scaffold_100018	21793500	21794455	955	g_23476	g_23475
Super-Scaffold_100018	21847213	21853363	6150	g_23475	g_44835
Super-Scaffold_100018	21855290	21911603	56313	g_44835	g_23478
Super-Scaffold_100018	21912382	21923892	11510	g_23478	g_23479
Super-Scaffold_100018	21926877	21979780	52903	g_23479	g_23481
Super-Scaffold_100018	21980562	22008867	28305	g_23481	g_23482
Super-Scaffold_100018	22023995	22037546	13551	g_23482	g_23484
Super-Scaffold_100018	22037788	22112501	74713	g_23484	g_23486
Super-Scaffold_100018	22152156	22155397	3241	g_23486	g_23488
Super-Scaffold_100018	22158913	22199260	40347	g_23488	g_23489
Super-Scaffold_100018	22220589	22221851	1262	g_23489	g_23490
Super-Scaffold_100018	22226902	22230634	3732	g_23490	g_23491
Super-Scaffold_100018	22232532	22234267	1735	g_23491	g_23492
Super-Scaffold_100018	22237146	22256011	18865	g_23492	g_23493
Super-Scaffold_100018	22258350	22269811	11461	g_23493	g_23495
Super-Scaffold_100018	22283620	22293109	9489	g_23495	g_44836
Super-Scaffold_100018	22309333	22405474	96141	g_44836	g_23498
Super-Scaffold_100018	22405698	22503557	97859	g_23498	g_23501
Super-Scaffold_100018	22503928	22505591	1663	g_23501	g_23502
Super-Scaffold_100018	22506688	22510503	3815	g_23502	g_23504
Super-Scaffold_100018	22517911	22522794	4883	g_23504	g_23505
Super-Scaffold_100018	22526869	22538117	11248	g_37980	g_23506
Super-Scaffold_100018	22538855	22546896	8041	g_23506	g_23507
Super-Scaffold_100018	22547222	22555667	8445	g_23507	g_23508
Super-Scaffold_100018	22556286	22557173	887	g_23508	g_44837
Super-Scaffold_100018	22558613	22558887	274	g_44837	g_44838
Super-Scaffold_100018	22560187	22560227	40	g_44838	g_23509
Super-Scaffold_100018	22561844	22573916	12072	g_23509	g_23510
Super-Scaffold_100018	22586881	22591878	4997	g_23510	g_23511
Super-Scaffold_100018	22596254	22599552	3298	g_23511	g_44839
Super-Scaffold_100018	22608230	22611389	3159	g_44839	g_23512
Super-Scaffold_100018	22617283	22621547	4264	g_23512	g_44840
Super-Scaffold_100018	22625619	22627886	2267	g_44840	g_23513
Super-Scaffold_100018	22628887	22640210	11323	g_23513	g_23514
Super-Scaffold_100018	22641166	22647589	6423	g_23514	g_23515
Super-Scaffold_100018	22660722	22666272	5550	g_23515	g_23516
Super-Scaffold_100018	22670495	22671912	1417	g_23516	g_23517
Super-Scaffold_100018	22692814	22700847	8033	g_23517	g_23518
Super-Scaffold_100018	22702496	22740795	38299	g_23518	g_23519
Super-Scaffold_100018	22753649	22755461	1812	g_23519	g_23520
Super-Scaffold_100018	22760239	22764449	4210	g_23520	g_23521
Super-Scaffold_100018	22769821	22778199	8378	g_23521	g_23522
Super-Scaffold_100018	22782091	22785406	3315	g_23522	g_23523
Super-Scaffold_100018	22788184	22791640	3456	g_23523	g_23524
Super-Scaffold_100018	22793062	22796639	3577	g_23524	g_23525
Super-Scaffold_100018	22800103	22801414	1311	g_23525	g_23526
Super-Scaffold_100018	22814951	22817018	2067	g_23526	g_23527
Super-Scaffold_100018	22823465	22824773	1308	g_23527	g_23528
Super-Scaffold_100018	22829376	22832192	2816	g_23528	g_23529
Super-Scaffold_100018	22837713	22844295	6582	g_23529	g_23530
Super-Scaffold_100018	22856847	22865045	8198	g_23530	g_23531
Super-Scaffold_100018	22871590	22892487	20897	g_23531	g_37983
Super-Scaffold_100018	22893044	22944126	51082	g_37983	g_23532
Super-Scaffold_100018	22945289	22949951	4662	g_23532	g_23533
Super-Scaffold_100018	22989027	23029392	40365	g_23533	g_23535
Super-Scaffold_100018	23030390	23031646	1256	g_23535	g_23536
Super-Scaffold_100018	23031921	23050426	18505	g_23536	g_23537
Super-Scaffold_100018	23050656	23085810	35154	g_23537	g_37986
Super-Scaffold_100018	23086127	23110860	24733	g_37986	g_23539
Super-Scaffold_100018	23113321	23116462	3141	g_23539	g_44841
Super-Scaffold_100018	23117755	23127064	9309	g_44841	g_23540
Super-Scaffold_100018	23129640	23130167	527	g_23540	g_23541
Super-Scaffold_100018	23135257	23136176	919	g_23541	g_23542
Super-Scaffold_100018	23145092	23195519	50427	g_23542	g_23544
Super-Scaffold_100018	23202288	23252413	50125	g_23544	g_23547
Super-Scaffold_100018	23252613	23280013	27400	g_23547	g_23550
Super-Scaffold_100018	23281174	23283457	2283	g_23550	g_23551
Super-Scaffold_100018	23284374	23291126	6752	g_23551	g_23553
Super-Scaffold_100018	23291947	23295072	3125	g_23553	g_23554
Super-Scaffold_100018	23295692	23298617	2925	g_23554	g_23555
Super-Scaffold_100018	23299480	23302419	2939	g_23555	g_23556
Super-Scaffold_100018	23303336	23309069	5733	g_23556	g_23558
Super-Scaffold_100018	23325174	23327050	1876	g_23558	g_23559
Super-Scaffold_100018	23366984	23389437	22453	g_23559	g_37989
Super-Scaffold_100018	23390138	23426655	36517	g_23561	g_23562
Super-Scaffold_100018	23430256	23445448	15192	g_23562	g_23563
Super-Scaffold_100018	23466882	23472972	6090	g_23563	g_23564
Super-Scaffold_100018	23473292	23474830	1538	g_23564	g_44842
Super-Scaffold_100018	23491718	23501503	9785	g_44842	g_23566
Super-Scaffold_100018	23514575	23516043	1468	g_23566	g_23568
Super-Scaffold_100018	23516243	23526128	9885	g_23568	g_23569
Super-Scaffold_100018	23528767	23600928	72161	g_23569	g_23573
Super-Scaffold_100018	23602046	23602111	65	g_23573	g_23574
Super-Scaffold_100018	23603616	23603947	331	g_23574	g_44843
Super-Scaffold_100018	23604531	23627393	22862	g_44843	g_23575
Super-Scaffold_100018	23637188	23660014	22826	g_23575	g_23576
Super-Scaffold_100018	23667770	23735733	67963	g_23576	g_23577
Super-Scaffold_100018	23826125	23838743	12618	g_23577	g_23578
Super-Scaffold_100018	23844581	23847466	2885	g_23578	g_23579
Super-Scaffold_100018	23853823	23859829	6006	g_23579	g_23580
Super-Scaffold_100018	23862991	23863137	146	g_23580	g_23581
Super-Scaffold_100018	23876507	23916349	39842	g_23581	g_23582
Super-Scaffold_100018	23916552	23925729	9177	g_23582	g_23583
Super-Scaffold_100018	23926883	23988222	61339	g_23583	g_23584
Super-Scaffold_100018	23988428	24032967	44539	g_23584	g_37994
Super-Scaffold_100018	24033275	24053329	20054	g_37994	g_23586
Super-Scaffold_100018	24058691	24083931	25240	g_23586	g_23587
Super-Scaffold_100018	24084185	24097883	13698	g_23587	g_23588
Super-Scaffold_100018	24101410	24101624	214	g_23588	g_44844
Super-Scaffold_100018	24103103	24193949	90846	g_44844	g_23589
Super-Scaffold_100018	24194671	24217431	22760	g_23589	g_23590
Super-Scaffold_100018	24224882	24243016	18134	g_23590	g_23591
Super-Scaffold_100018	24251140	24254830	3690	g_23591	g_23592
Super-Scaffold_100018	24255366	24262735	7369	g_23592	g_23593
Super-Scaffold_100018	24266343	24270857	4514	g_23593	g_23594
Super-Scaffold_100018	24290695	24296918	6223	g_23594	g_23595
Super-Scaffold_100018	24316468	24343215	26747	g_23595	g_23596
Super-Scaffold_100018	24357652	24454205	96553	g_23596	g_23597
Super-Scaffold_100018	24479872	24499680	19808	g_23597	g_23598
Super-Scaffold_100018	24517900	24549271	31371	g_23598	g_23599
Super-Scaffold_100018	24549951	24554434	4483	g_23599	g_23600
Super-Scaffold_100018	24554760	24563250	8490	g_23600	g_23601
Super-Scaffold_100018	24570366	24575822	5456	g_23601	g_23602
Super-Scaffold_100018	24577375	24588578	11203	g_23602	g_23604
Super-Scaffold_100018	24597348	24600541	3193	g_23604	g_23605
Super-Scaffold_100018	24609263	24630924	21661	g_23605	g_23607
Super-Scaffold_100018	24633711	24636495	2784	g_23607	g_23608
Super-Scaffold_100018	24646902	24674499	27597	g_23608	g_23609
Super-Scaffold_100018	24675164	24735635	60471	g_23609	g_23610
Super-Scaffold_100018	24737974	24750298	12324	g_23610	g_38003
Super-Scaffold_100018	24752697	24801998	49301	g_38003	g_23613
Super-Scaffold_100018	24802603	24880316	77713	g_23613	g_38005
Super-Scaffold_100018	24880582	24944799	64217	g_38005	g_23614
Super-Scaffold_100018	24945089	24979326	34237	g_23614	g_23616
Super-Scaffold_100018	24986929	24991581	4652	g_23616	g_23617
Super-Scaffold_100018	24991784	24992846	1062	g_23617	g_23618
Super-Scaffold_100018	25004483	25013778	9295	g_23618	g_23619
Super-Scaffold_100018	25016795	25020674	3879	g_23619	g_23620
Super-Scaffold_100018	25035848	25056480	20632	g_23620	g_23621
Super-Scaffold_100018	25058301	25076005	17704	g_23621	g_23622
Super-Scaffold_100018	25079788	25185603	105815	g_23622	g_23626
Super-Scaffold_100018	25185950	25208769	22819	g_23626	g_23627
Super-Scaffold_100018	25209104	25226565	17461	g_23627	g_23629
Super-Scaffold_100018	25240140	25247234	7094	g_23629	g_23630
Super-Scaffold_100018	25247569	25258532	10963	g_23630	g_23632
Super-Scaffold_100018	25258789	25349786	90997	g_23632	g_23633
Super-Scaffold_100018	25350085	25357488	7403	g_23633	g_23635
Super-Scaffold_100018	25365493	25368000	2507	g_23635	g_23636
Super-Scaffold_100018	25371241	25381590	10349	g_23636	g_23637
Super-Scaffold_100018	25387041	25408250	21209	g_23637	g_23639
Super-Scaffold_100018	25430425	25447360	16935	g_23639	g_44845
Super-Scaffold_100018	25450052	25450864	812	g_44845	g_23640
Super-Scaffold_100018	25454006	25456845	2839	g_23640	g_23641
Super-Scaffold_100018	25457105	25464037	6932	g_23641	g_23642
Super-Scaffold_100018	25464936	25485722	20786	g_23642	g_23643
Super-Scaffold_100018	25491188	25492688	1500	g_23643	g_23644
Super-Scaffold_100018	25497885	25507497	9612	g_23644	g_23645
Super-Scaffold_100018	25532541	25536868	4327	g_23645	g_23646
Super-Scaffold_100018	25541676	25707477	165801	g_23646	g_23649
Super-Scaffold_100018	25710863	25752054	41191	g_23649	g_23650
Super-Scaffold_100018	25752449	25815599	63150	g_23650	g_23651
Super-Scaffold_100018	25816057	25818031	1974	g_23651	g_23652
Super-Scaffold_100018	25819365	25819979	614	g_23652	g_23653
Super-Scaffold_100018	25824196	25824349	153	g_23653	g_23654
Super-Scaffold_100018	25824945	25824980	35	g_23654	g_23655
Super-Scaffold_100018	25826908	25849304	22396	g_23655	g_23657
Super-Scaffold_100018	25849684	25872259	22575	g_23657	g_23659
Super-Scaffold_100018	25872807	25875057	2250	g_23659	g_23660
Super-Scaffold_100018	25875750	25887482	11732	g_23660	g_23661
Super-Scaffold_100018	25890888	25910843	19955	g_23661	g_23662
Super-Scaffold_100018	25921347	26019085	97738	g_23662	g_38010
Super-Scaffold_100018	26020380	26026811	6431	g_38010	g_23665
Super-Scaffold_100018	26027140	26027548	408	g_23665	g_44846
Super-Scaffold_100018	26028324	26051902	23578	g_44846	g_23666
Super-Scaffold_100018	26052549	26076870	24321	g_38011	g_23667
Super-Scaffold_100018	26094342	26172956	78614	g_23667	g_23670
Super-Scaffold_100018	26176350	26186328	9978	g_23670	g_23671
Super-Scaffold_100018	26186681	26239398	52717	g_23671	g_23674
Super-Scaffold_100018	26239742	26245480	5738	g_23674	g_23675
Super-Scaffold_100018	26245686	26352620	106934	g_23675	g_23677
Super-Scaffold_100018	26353414	26353459	45	g_23677	g_23678
Super-Scaffold_100018	26354409	26476610	122201	g_23678	g_23680
Super-Scaffold_100018	26477314	26500693	23379	g_23680	g_23681
Super-Scaffold_100018	26502654	26523504	20850	g_23681	g_23683
Super-Scaffold_100018	26523872	26531902	8030	g_23683	g_23684
Super-Scaffold_100018	26532174	26605752	73578	g_23684	g_23685
Super-Scaffold_100018	26606036	26606710	674	g_23685	g_38015
Super-Scaffold_100018	26606970	26620811	13841	g_38015	g_23687
Super-Scaffold_100018	26621287	26810965	189678	g_23687	g_23691
Super-Scaffold_100018	26811861	26838242	26381	g_23691	g_23693
Super-Scaffold_100018	26854747	26855612	865	g_23693	g_23694
Super-Scaffold_100018	26855893	26877281	21388	g_23694	g_23695
Super-Scaffold_100018	26877828	26894224	16396	g_23695	g_23697
Super-Scaffold_100018	26907777	27005843	98066	g_23697	g_23702
Super-Scaffold_100018	27007610	27009990	2380	g_23702	g_23703
Super-Scaffold_100018	27015515	27103858	88343	g_23703	g_23704
Super-Scaffold_100018	27115137	27131232	16095	g_23704	g_38018
Super-Scaffold_100018	27131609	27147295	15686	g_38018	g_23705
Super-Scaffold_100018	27150611	27171031	20420	g_23705	g_23707
Super-Scaffold_100018	27176355	27178484	2129	g_23707	g_23708
Super-Scaffold_100018	27181826	27195179	13353	g_23708	g_23709
Super-Scaffold_100018	27207248	27218555	11307	g_23709	g_23710
Super-Scaffold_100018	27222879	27225631	2752	g_23710	g_23711
Super-Scaffold_100018	27229440	27231209	1769	g_23711	g_23712
Super-Scaffold_100018	27233606	27239270	5664	g_23712	g_23713
Super-Scaffold_100018	27243447	27244742	1295	g_23713	g_23714
Super-Scaffold_100018	27246641	27254842	8201	g_23714	g_23715
Super-Scaffold_100018	27256432	27270343	13911	g_23715	g_23716
Super-Scaffold_100018	27270699	27289063	18364	g_23716	g_23717
Super-Scaffold_100018	27299779	27315222	15443	g_23717	g_23718
Super-Scaffold_100018	27349754	27395131	45377	g_23718	g_38019
Super-Scaffold_100018	27396732	27399723	2991	g_38019	g_23720
Super-Scaffold_100018	27404739	27408765	4026	g_23720	g_23721
Super-Scaffold_100018	27409064	27409644	580	g_23721	g_23722
Super-Scaffold_100018	27412404	27498166	85762	g_23722	g_23724
Super-Scaffold_100018	27510558	27520713	10155	g_23724	g_23725
Super-Scaffold_100018	27541159	27549017	7858	g_23725	g_44847
Super-Scaffold_100018	27549226	27552919	3693	g_44847	g_23726
Super-Scaffold_100018	27564662	27584156	19494	g_23726	g_23727
Super-Scaffold_100018	27584824	27610017	25193	g_23727	g_38020
Super-Scaffold_100018	27611491	27618473	6982	g_23728	g_23730
Super-Scaffold_100018	27618973	27643599	24626	g_23730	g_44848
Super-Scaffold_100018	27645979	27662531	16552	g_44848	g_23731
Super-Scaffold_100018	27670078	27671596	1518	g_23731	g_23733
Super-Scaffold_100018	27674793	27675376	583	g_23733	g_23734
Super-Scaffold_100018	27675972	27680824	4852	g_23734	g_23736
Super-Scaffold_100018	27681039	27708763	27724	g_23736	g_23737
Super-Scaffold_100018	27714797	27717647	2850	g_23737	g_23738
Super-Scaffold_100018	27719375	27739730	20355	g_23738	g_23739
Super-Scaffold_100018	27748422	27752535	4113	g_23739	g_23740
Super-Scaffold_100018	27758209	27758454	245	g_23740	g_23741
Super-Scaffold_100018	27777675	27782751	5076	g_23741	g_44849
Super-Scaffold_100018	27792904	27799372	6468	g_44849	g_23743
Super-Scaffold_100018	27808487	27813429	4942	g_23743	g_23744
Super-Scaffold_100018	27814049	27866532	52483	g_23744	g_23746
Super-Scaffold_100018	27882481	27898551	16070	g_23746	g_38021
Super-Scaffold_100018	27898763	27976164	77401	g_38021	g_23747
Super-Scaffold_100018	27981686	28005748	24062	g_23747	g_44850
Super-Scaffold_100018	28023339	28044936	21597	g_44850	g_23749
Super-Scaffold_100018	28055562	28190245	134683	g_23749	g_23750
Super-Scaffold_100018	28190463	28198865	8402	g_23750	g_23751
Super-Scaffold_100018	28200243	28269967	69724	g_38022	g_23752
Super-Scaffold_100019	25088	33555	8467	g_35	g_36
Super-Scaffold_100019	45884	78925	33041	g_36	g_37
Super-Scaffold_100019	83237	104590	21353	g_37	g_38
Super-Scaffold_100019	119635	135771	16136	g_38	g_39
Super-Scaffold_100019	147880	158429	10549	g_39	g_42898
Super-Scaffold_100019	183418	204529	21111	g_42898	g_40
Super-Scaffold_100019	204804	215086	10282	g_40	g_42
Super-Scaffold_100019	215607	219206	3599	g_42	g_43
Super-Scaffold_100019	227210	240047	12837	g_43	g_45
Super-Scaffold_100019	243577	251749	8172	g_45	g_47
Super-Scaffold_100019	254355	261896	7541	g_47	g_48
Super-Scaffold_100019	270338	271756	1418	g_48	g_49
Super-Scaffold_100019	274232	283219	8987	g_49	g_50
Super-Scaffold_100019	285630	336900	51270	g_50	g_42899
Super-Scaffold_100019	351544	354769	3225	g_42899	g_51
Super-Scaffold_100019	374158	387141	12983	g_51	g_42900
Super-Scaffold_100019	438392	1044536	606144	g_42900	g_52
Super-Scaffold_100019	1046058	1051155	5097	g_52	g_53
Super-Scaffold_100019	1052591	1055428	2837	g_53	g_42901
Super-Scaffold_100019	1064358	1066971	2613	g_42901	g_54
Super-Scaffold_100019	1074682	1085812	11130	g_54	g_55
Super-Scaffold_100019	1100069	1101774	1705	g_55	g_56
Super-Scaffold_100019	1104489	1107824	3335	g_56	g_57
Super-Scaffold_100019	1117520	1121306	3786	g_57	g_58
Super-Scaffold_100019	1138113	1146971	8858	g_58	g_42902
Super-Scaffold_100019	1156724	1167555	10831	g_42902	g_59
Super-Scaffold_100019	1175786	1177383	1597	g_59	g_60
Super-Scaffold_100019	1177910	1190993	13083	g_60	g_61
Super-Scaffold_100019	1191511	1212946	21435	g_61	g_62
Super-Scaffold_100019	1213545	1221315	7770	g_62	g_63
Super-Scaffold_100019	1221887	1225358	3471	g_63	g_64
Super-Scaffold_100019	1252500	1269751	17251	g_64	g_66
Super-Scaffold_100019	1275187	1280522	5335	g_66	g_67
Super-Scaffold_100019	1300935	1307263	6328	g_67	g_68
Super-Scaffold_100019	1331082	1408147	77065	g_68	g_70
Super-Scaffold_100019	1420807	1426437	5630	g_70	g_39150
Super-Scaffold_100019	1426673	1436663	9990	g_39150	g_72
Super-Scaffold_100019	1439749	1442458	2709	g_72	g_73
Super-Scaffold_100019	1455655	1459229	3574	g_73	g_74
Super-Scaffold_100019	1465221	1467150	1929	g_74	g_75
Super-Scaffold_100019	1470747	1485249	14502	g_75	g_76
Super-Scaffold_100019	1491230	1498608	7378	g_76	g_77
Super-Scaffold_100019	1512175	1521404	9229	g_77	g_42903
Super-Scaffold_100019	1527965	1574423	46458	g_42903	g_79
Super-Scaffold_100019	1574911	1595284	20373	g_79	g_80
Super-Scaffold_100019	1601483	1632995	31512	g_80	g_83
Super-Scaffold_100019	1634044	1681483	47439	g_83	g_85
Super-Scaffold_100019	1742307	1745852	3545	g_85	g_86
Super-Scaffold_100019	1757185	1764144	6959	g_86	g_42904
Super-Scaffold_100019	1775935	1780186	4251	g_42904	g_87
Super-Scaffold_100019	1795961	1798146	2185	g_87	g_88
Super-Scaffold_100019	1815573	1819471	3898	g_88	g_89
Super-Scaffold_100019	1845008	1854868	9860	g_89	g_90
Super-Scaffold_100019	1868363	1942339	73976	g_90	g_92
Super-Scaffold_100019	1944303	1997334	53031	g_92	g_93
Super-Scaffold_100019	2008923	2011757	2834	g_93	g_94
Super-Scaffold_100019	2013580	2024203	10623	g_94	g_95
Super-Scaffold_100019	2036203	2038922	2719	g_95	g_97
Super-Scaffold_100019	2044856	2048021	3165	g_97	g_98
Super-Scaffold_100019	2082178	2089966	7788	g_98	g_99
Super-Scaffold_100019	2102850	2107318	4468	g_99	g_100
Super-Scaffold_100019	2113179	2122801	9622	g_100	g_39153
Super-Scaffold_100019	2125686	2127275	1589	g_39153	g_102
Super-Scaffold_100019	2151070	2156750	5680	g_102	g_103
Super-Scaffold_100019	2180419	2188913	8494	g_103	g_104
Super-Scaffold_100019	2190043	2190147	104	g_104	g_42905
Super-Scaffold_100019	2200510	2206672	6162	g_42905	g_105
Super-Scaffold_100019	2222109	2225235	3126	g_105	g_42906
Super-Scaffold_100019	2234334	2239603	5269	g_42906	g_106
Super-Scaffold_100019	2248572	2257034	8462	g_106	g_107
Super-Scaffold_100019	2266016	2270636	4620	g_107	g_108
Super-Scaffold_100019	2279695	2288142	8447	g_108	g_109
Super-Scaffold_100019	2297881	2303248	5367	g_109	g_110
Super-Scaffold_100019	2307777	2316244	8467	g_110	g_111
Super-Scaffold_100019	2325527	2330365	4838	g_111	g_112
Super-Scaffold_100019	2339407	2347876	8469	g_112	g_113
Super-Scaffold_100019	2357518	2367471	9953	g_113	g_114
Super-Scaffold_100019	2409715	2413169	3454	g_114	g_115
Super-Scaffold_100019	2414509	2416480	1971	g_115	g_116
Super-Scaffold_100019	2420968	2424660	3692	g_116	g_118
Super-Scaffold_100019	2432465	2435874	3409	g_118	g_119
Super-Scaffold_100019	2440871	2445305	4434	g_119	g_120
Super-Scaffold_100019	2455200	2457081	1881	g_120	g_121
Super-Scaffold_100019	2470278	2471456	1178	g_121	g_122
Super-Scaffold_100019	2489388	2491345	1957	g_122	g_123
Super-Scaffold_100019	2491695	2506226	14531	g_123	g_124
Super-Scaffold_100019	2507062	2536698	29636	g_124	g_125
Super-Scaffold_100019	2539539	2541839	2300	g_125	g_126
Super-Scaffold_100019	2551612	2554978	3366	g_126	g_127
Super-Scaffold_100019	2574364	2617337	42973	g_127	g_129
Super-Scaffold_100019	2623214	2624701	1487	g_129	g_130
Super-Scaffold_100019	2630973	2634093	3120	g_130	g_131
Super-Scaffold_100019	2640854	2644540	3686	g_131	g_39155
Super-Scaffold_100019	2644740	2656088	11348	g_39155	g_132
Super-Scaffold_100019	2667020	2688091	21071	g_132	g_133
Super-Scaffold_100019	2691373	2700734	9361	g_133	g_134
Super-Scaffold_100019	2710388	2715107	4719	g_134	g_135
Super-Scaffold_100019	2733780	2745436	11656	g_135	g_136
Super-Scaffold_100019	2748702	2752559	3857	g_136	g_137
Super-Scaffold_100019	2753131	2761457	8326	g_137	g_138
Super-Scaffold_100019	2765220	2853787	88567	g_138	g_140
Super-Scaffold_100019	2876186	2883827	7641	g_140	g_141
Super-Scaffold_100019	2884560	2895616	11056	g_141	g_142
Super-Scaffold_100019	2905938	2912341	6403	g_142	g_143
Super-Scaffold_100019	2931828	2936020	4192	g_143	g_42907
Super-Scaffold_100019	2949892	2954714	4822	g_42907	g_42908
Super-Scaffold_100019	2973447	2979163	5716	g_42908	g_144
Super-Scaffold_100019	2985243	2990771	5528	g_144	g_145
Super-Scaffold_100019	3003639	3051977	48338	g_145	g_147
Super-Scaffold_100019	3061413	3073135	11722	g_147	g_148
Super-Scaffold_100019	3077863	3084036	6173	g_148	g_149
Super-Scaffold_100019	3095072	3096166	1094	g_149	g_150
Super-Scaffold_100019	3096384	3130837	34453	g_150	g_152
Super-Scaffold_100019	3155169	3163519	8350	g_152	g_153
Super-Scaffold_100019	3164697	3171014	6317	g_153	g_154
Super-Scaffold_100019	3178988	3179064	76	g_154	g_155
Super-Scaffold_100019	3179276	3188267	8991	g_155	g_156
Super-Scaffold_100019	3213808	3227848	14040	g_156	g_157
Super-Scaffold_100019	3229074	3265352	36278	g_158	g_159
Super-Scaffold_100019	3275574	3280825	5251	g_159	g_160
Super-Scaffold_100019	3292989	3297856	4867	g_160	g_39157
Super-Scaffold_100019	3298449	3305199	6750	g_39157	g_162
Super-Scaffold_100019	3325359	3327708	2349	g_162	g_163
Super-Scaffold_100019	3327995	3328234	239	g_163	g_164
Super-Scaffold_100019	3329159	3334992	5833	g_164	g_165
Super-Scaffold_100019	3352733	3367186	14453	g_165	g_166
Super-Scaffold_100019	3368268	3381788	13520	g_166	g_167
Super-Scaffold_100019	3406104	3424068	17964	g_167	g_168
Super-Scaffold_100019	3433681	3441485	7804	g_168	g_170
Super-Scaffold_100019	3502161	3530847	28686	g_170	g_171
Super-Scaffold_100019	3536881	3543639	6758	g_171	g_172
Super-Scaffold_100019	3554256	3569729	15473	g_172	g_173
Super-Scaffold_100019	3577915	3578566	651	g_173	g_174
Super-Scaffold_100019	3590754	3599290	8536	g_174	g_175
Super-Scaffold_100019	3606388	3610983	4595	g_175	g_176
Super-Scaffold_100019	3620606	3625787	5181	g_176	g_177
Super-Scaffold_100019	3632525	3634502	1977	g_177	g_178
Super-Scaffold_100019	3644852	3646800	1948	g_178	g_179
Super-Scaffold_100019	3653068	3657152	4084	g_179	g_42909
Super-Scaffold_100019	3737589	3765857	28268	g_42909	g_181
Super-Scaffold_100019	3766324	3790653	24329	g_181	g_182
Super-Scaffold_100019	3802368	3817872	15504	g_182	g_39161
Super-Scaffold_100019	3818348	3825923	7575	g_39161	g_184
Super-Scaffold_100019	3827260	3877880	50620	g_184	g_185
Super-Scaffold_100019	3878218	3885010	6792	g_185	g_186
Super-Scaffold_100019	3900428	3905166	4738	g_186	g_187
Super-Scaffold_100019	3915961	3925770	9809	g_187	g_42910
Super-Scaffold_100019	3927185	3932339	5154	g_42910	g_188
Super-Scaffold_100019	3933415	3937359	3944	g_188	g_189
Super-Scaffold_100019	3939824	3951371	11547	g_189	g_190
Super-Scaffold_100019	3985286	3993088	7802	g_190	g_191
Super-Scaffold_100019	3994725	4000918	6193	g_191	g_42911
Super-Scaffold_100019	4002552	4004995	2443	g_42911	g_42912
Super-Scaffold_100019	4006650	4016156	9506	g_42912	g_192
Super-Scaffold_100019	4034612	4067825	33213	g_192	g_193
Super-Scaffold_100019	4069462	4075647	6185	g_193	g_194
Super-Scaffold_100019	4083839	4105241	21402	g_194	g_195
Super-Scaffold_100019	4132731	4139294	6563	g_195	g_196
Super-Scaffold_100019	4140907	4316074	175167	g_196	g_199
Super-Scaffold_100019	4318017	4431356	113339	g_199	g_203
Super-Scaffold_100019	4467643	4476149	8506	g_203	g_204
Super-Scaffold_100019	4485118	4534992	49874	g_204	g_205
Super-Scaffold_100019	4536668	4537974	1306	g_205	g_206
Super-Scaffold_100019	4538750	4541128	2378	g_206	g_207
Super-Scaffold_100019	4542876	4545362	2486	g_207	g_42913
Super-Scaffold_100019	4546836	4570234	23398	g_42913	g_208
Super-Scaffold_100019	4571940	4579255	7315	g_208	g_42914
Super-Scaffold_100019	4580964	4591930	10966	g_42914	g_209
Super-Scaffold_100019	4602408	4606867	4459	g_209	g_210
Super-Scaffold_100019	4610379	4611382	1003	g_210	g_211
Super-Scaffold_100019	4624679	4626072	1393	g_211	g_212
Super-Scaffold_100019	4634275	4636730	2455	g_212	g_213
Super-Scaffold_100019	4644675	4647761	3086	g_213	g_214
Super-Scaffold_100019	4683477	4698218	14741	g_214	g_215
Super-Scaffold_100019	4706600	4766441	59841	g_215	g_216
Super-Scaffold_100019	4769774	4777257	7483	g_216	g_217
Super-Scaffold_100019	4779473	4796091	16618	g_217	g_218
Super-Scaffold_100019	4803844	4839643	35799	g_218	g_219
Super-Scaffold_100019	4840137	4840764	627	g_219	g_220
Super-Scaffold_100019	4841955	4848895	6940	g_220	g_221
Super-Scaffold_100019	4850410	4861381	10971	g_221	g_222
Super-Scaffold_100019	4862634	4865092	2458	g_222	g_223
Super-Scaffold_100019	4874489	4876809	2320	g_223	g_224
Super-Scaffold_100019	4880871	4887163	6292	g_224	g_225
Super-Scaffold_100019	4899577	4900969	1392	g_225	g_226
Super-Scaffold_100019	4909706	4920344	10638	g_226	g_227
Super-Scaffold_100019	4940010	4942108	2098	g_227	g_228
Super-Scaffold_100019	4948096	4951231	3135	g_228	g_229
Super-Scaffold_100019	4953988	4954772	784	g_229	g_230
Super-Scaffold_100019	4955038	4956029	991	g_230	g_231
Super-Scaffold_100019	4956713	4961425	4712	g_231	g_232
Super-Scaffold_100019	4962067	4962154	87	g_232	g_233
Super-Scaffold_100019	4962450	5001278	38828	g_233	g_236
Super-Scaffold_100019	5001508	5007864	6356	g_236	g_237
Super-Scaffold_100019	5008088	5150757	142669	g_237	g_242
Super-Scaffold_100019	5160532	5223216	62684	g_242	g_243
Super-Scaffold_100019	5227341	5238013	10672	g_243	g_245
Super-Scaffold_100019	5240729	5248985	8256	g_245	g_42915
Super-Scaffold_100019	5257945	5303610	45665	g_42915	g_246
Super-Scaffold_100019	5305065	5308122	3057	g_246	g_42916
Super-Scaffold_100019	5309248	5571732	262484	g_42916	g_39174
Super-Scaffold_100019	5572070	5607281	35211	g_39174	g_248
Super-Scaffold_100019	5608583	5707337	98754	g_248	g_251
Super-Scaffold_100019	5728871	5728919	48	g_251	g_42917
Super-Scaffold_100019	5735349	5738723	3374	g_42917	g_252
Super-Scaffold_100019	5750600	5760755	10155	g_252	g_254
Super-Scaffold_100019	5777797	5779194	1397	g_254	g_255
Super-Scaffold_100019	5792407	5794094	1687	g_255	g_42918
Super-Scaffold_100019	5799782	5801658	1876	g_42918	g_39175
Super-Scaffold_100019	5812816	5817339	4523	g_256	g_257
Super-Scaffold_100019	5819199	5823404	4205	g_257	g_258
Super-Scaffold_100019	5826491	5847798	21307	g_258	g_259
Super-Scaffold_100019	5848178	5863913	15735	g_259	g_260
Super-Scaffold_100019	5867369	5874729	7360	g_260	g_261
Super-Scaffold_100019	5906211	5906283	72	g_261	g_39176
Super-Scaffold_100019	5907704	5911542	3838	g_39176	g_263
Super-Scaffold_100019	5912141	5938869	26728	g_263	g_264
Super-Scaffold_100019	5939618	5942612	2994	g_264	g_265
Super-Scaffold_100019	5947353	5949204	1851	g_265	g_266
Super-Scaffold_100019	5949620	5952450	2830	g_266	g_268
Super-Scaffold_100019	5979819	5983308	3489	g_268	g_269
Super-Scaffold_100019	5985507	5992258	6751	g_269	g_270
Super-Scaffold_100019	6011685	6015642	3957	g_270	g_271
Super-Scaffold_100019	6022664	6024439	1775	g_271	g_272
Super-Scaffold_100019	6027373	6057069	29696	g_272	g_275
Super-Scaffold_100019	6057278	6095237	37959	g_275	g_277
Super-Scaffold_100019	6171347	6268695	97348	g_277	g_279
Super-Scaffold_100019	6285498	6305534	20036	g_279	g_280
Super-Scaffold_100019	6306289	6432229	125940	g_280	g_283
Super-Scaffold_100019	6453646	6467009	13363	g_283	g_284
Super-Scaffold_100019	6480397	6487033	6636	g_284	g_285
Super-Scaffold_100019	6505197	6513298	8101	g_285	g_286
Super-Scaffold_100019	6540255	6543195	2940	g_286	g_287
Super-Scaffold_100019	6548073	6551562	3489	g_287	g_289
Super-Scaffold_100019	6564540	6583420	18880	g_289	g_290
Super-Scaffold_100019	6587212	6591689	4477	g_290	g_291
Super-Scaffold_100019	6591898	6593194	1296	g_291	g_292
Super-Scaffold_100019	6617508	6618683	1175	g_292	g_293
Super-Scaffold_100019	6620746	6623214	2468	g_293	g_294
Super-Scaffold_100019	6642337	6685324	42987	g_294	g_297
Super-Scaffold_100019	6686070	6688340	2270	g_297	g_298
Super-Scaffold_100019	6700774	6702709	1935	g_298	g_299
Super-Scaffold_100019	6706972	6710196	3224	g_299	g_300
Super-Scaffold_100019	6710720	6714746	4026	g_300	g_42919
Super-Scaffold_100019	6719026	6721836	2810	g_42919	g_42920
Super-Scaffold_100019	6727523	6739859	12336	g_42920	g_301
Super-Scaffold_100019	6751610	6758446	6836	g_301	g_302
Super-Scaffold_100019	6767862	6769749	1887	g_302	g_42921
Super-Scaffold_100019	6776355	6784930	8575	g_42921	g_304
Super-Scaffold_100019	6791198	6801638	10440	g_304	g_305
Super-Scaffold_100019	6821132	6827939	6807	g_305	g_306
Super-Scaffold_100019	6828259	6828803	544	g_306	g_42922
Super-Scaffold_100019	6829027	6838827	9800	g_42922	g_307
Super-Scaffold_100019	6839135	6864127	24992	g_307	g_310
Super-Scaffold_100019	6872754	6880029	7275	g_310	g_311
Super-Scaffold_100019	6880247	6893664	13417	g_311	g_314
Super-Scaffold_100019	6893954	6904325	10371	g_314	g_315
Super-Scaffold_100019	6908911	6924501	15590	g_315	g_318
Super-Scaffold_100019	6924797	6941492	16695	g_318	g_320
Super-Scaffold_100019	6949818	6952045	2227	g_320	g_321
Super-Scaffold_100019	6965192	6981906	16714	g_321	g_322
Super-Scaffold_100019	6998969	7001078	2109	g_322	g_323
Super-Scaffold_100019	7011877	7016883	5006	g_323	g_324
Super-Scaffold_100019	7017197	7032557	15360	g_324	g_326
Super-Scaffold_100019	7032778	7032884	106	g_326	g_327
Super-Scaffold_100019	7050383	7063225	12842	g_327	g_328
Super-Scaffold_100019	7069462	7093836	24374	g_328	g_329
Super-Scaffold_100019	7097947	7107902	9955	g_329	g_330
Super-Scaffold_100019	7108330	7119770	11440	g_330	g_42923
Super-Scaffold_100019	7161299	7226795	65496	g_42923	g_332
Super-Scaffold_100019	7228386	7286800	58414	g_332	g_333
Super-Scaffold_100019	7287087	7289958	2871	g_333	g_334
Super-Scaffold_100019	7290326	7398829	108503	g_334	g_336
Super-Scaffold_100019	7402505	7408032	5527	g_336	g_337
Super-Scaffold_100019	7419902	7422677	2775	g_337	g_338
Super-Scaffold_100019	7446960	7563373	116413	g_338	g_339
Super-Scaffold_100019	7563621	7634305	70684	g_339	g_341
Super-Scaffold_100019	7634532	7643986	9454	g_341	g_342
Super-Scaffold_100019	7644291	7646250	1959	g_342	g_343
Super-Scaffold_100019	7653267	7656170	2903	g_343	g_344
Super-Scaffold_100019	7660464	7665193	4729	g_344	g_345
Super-Scaffold_100019	7690120	7713412	23292	g_345	g_347
Super-Scaffold_100019	7713756	7724540	10784	g_347	g_348
Super-Scaffold_100019	7724863	7805085	80222	g_348	g_39187
Super-Scaffold_100019	7805372	7863475	58103	g_39187	g_39188
Super-Scaffold_100019	7863678	7930154	66476	g_39188	g_354
Super-Scaffold_100019	7930879	7931073	194	g_354	g_355
Super-Scaffold_100019	7933028	7933619	591	g_355	g_356
Super-Scaffold_100019	7935208	7935530	322	g_356	g_357
Super-Scaffold_100019	7935973	7936413	440	g_357	g_358
Super-Scaffold_100019	7937633	7999351	61718	g_358	g_359
Super-Scaffold_100019	8000568	8082815	82247	g_359	g_39192
Super-Scaffold_100019	8083033	8189911	106878	g_39192	g_362
Super-Scaffold_100019	8190303	8405398	215095	g_362	g_368
Super-Scaffold_100019	8406144	8414259	8115	g_368	g_369
Super-Scaffold_100019	8415422	8419499	4077	g_369	g_370
Super-Scaffold_100019	8420243	8428380	8137	g_370	g_42924
Super-Scaffold_100019	8429265	8434034	4769	g_42924	g_371
Super-Scaffold_100019	8434766	8443043	8277	g_371	g_372
Super-Scaffold_100019	8443923	8448547	4624	g_372	g_373
Super-Scaffold_100019	8452149	8463781	11632	g_373	g_42925
Super-Scaffold_100019	8483542	8493001	9459	g_42925	g_374
Super-Scaffold_100019	8493234	8547095	53861	g_374	g_377
Super-Scaffold_100019	8556197	8558399	2202	g_377	g_378
Super-Scaffold_100019	8562544	8583993	21449	g_378	g_379
Super-Scaffold_100019	8594385	8609890	15505	g_379	g_382
Super-Scaffold_100019	8631027	8634110	3083	g_382	g_383
Super-Scaffold_100019	8634472	8636165	1693	g_383	g_384
Super-Scaffold_100019	8648390	8654942	6552	g_384	g_385
Super-Scaffold_100019	8659937	8722861	62924	g_385	g_387
Super-Scaffold_100019	8723244	8733191	9947	g_387	g_386
Super-Scaffold_100019	8733406	8773871	40465	g_386	g_389
Super-Scaffold_100019	8778492	8783037	4545	g_389	g_390
Super-Scaffold_100019	8783992	8785576	1584	g_390	g_391
Super-Scaffold_100019	8788428	8825939	37511	g_391	g_392
Super-Scaffold_100019	8837630	9032296	194666	g_392	g_395
Super-Scaffold_100019	9032526	9112203	79677	g_395	g_396
Super-Scaffold_100019	9115310	9119759	4449	g_396	g_398
Super-Scaffold_100019	9121338	9179561	58223	g_398	g_399
Super-Scaffold_100019	9180898	9220092	39194	g_399	g_400
Super-Scaffold_100019	9220346	9239144	18798	g_400	g_401
Super-Scaffold_100019	9239868	9239990	122	g_401	g_402
Super-Scaffold_100019	9247032	9401209	154177	g_402	g_404
Super-Scaffold_100019	9402865	9405918	3053	g_404	g_42926
Super-Scaffold_100019	9413521	9415965	2444	g_42926	g_405
Super-Scaffold_100019	9420904	9424249	3345	g_405	g_406
Super-Scaffold_100019	9428387	9433270	4883	g_406	g_42927
Super-Scaffold_100019	9434689	9437238	2549	g_42927	g_42928
Super-Scaffold_100019	9445190	9540602	95412	g_42928	g_408
Super-Scaffold_100019	9551463	9558758	7295	g_408	g_409
Super-Scaffold_100019	9560089	9562057	1968	g_409	g_410
Super-Scaffold_100019	9562434	9624596	62162	g_410	g_413
Super-Scaffold_100019	9625981	9823105	197124	g_413	g_417
Super-Scaffold_100019	9832779	9846518	13739	g_417	g_42929
Super-Scaffold_100019	9869250	9874398	5148	g_42929	g_418
Super-Scaffold_100019	9900011	9988763	88752	g_418	g_423
Super-Scaffold_100019	10014054	10017802	3748	g_423	g_424
Super-Scaffold_100019	10023500	10028888	5388	g_424	g_425
Super-Scaffold_100019	10039489	10040496	1007	g_425	g_426
Super-Scaffold_100019	10041608	10047496	5888	g_426	g_427
Super-Scaffold_100019	10049666	10057363	7697	g_427	g_42930
Super-Scaffold_100019	10059256	10066572	7316	g_42930	g_428
Super-Scaffold_100019	10073889	10077305	3416	g_428	g_429
Super-Scaffold_100019	10093047	10101135	8088	g_429	g_430
Super-Scaffold_100019	10101515	10118348	16833	g_430	g_431
Super-Scaffold_100019	10125504	10126931	1427	g_431	g_432
Super-Scaffold_100019	10138232	10142332	4100	g_432	g_433
Super-Scaffold_100019	10147004	10161772	14768	g_433	g_434
Super-Scaffold_100019	10166962	10167020	58	g_434	g_435
Super-Scaffold_100019	10172611	10197621	25010	g_435	g_436
Super-Scaffold_100019	10201323	10222211	20888	g_436	g_437
Super-Scaffold_100019	10241648	10258419	16771	g_437	g_438
Super-Scaffold_100019	10265232	10265834	602	g_438	g_39198
Super-Scaffold_100019	10266154	10341667	75513	g_39198	g_440
Super-Scaffold_100019	10355409	10359285	3876	g_440	g_441
Super-Scaffold_100019	10360112	10370684	10572	g_441	g_442
Super-Scaffold_100019	10370974	10375605	4631	g_442	g_443
Super-Scaffold_100019	10396787	10399525	2738	g_443	g_444
Super-Scaffold_100019	10401209	10408959	7750	g_444	g_445
Super-Scaffold_100019	10410228	10412400	2172	g_445	g_446
Super-Scaffold_100019	10418136	10494574	76438	g_446	g_448
Super-Scaffold_100019	10494870	10524002	29132	g_448	g_450
Super-Scaffold_100019	10527964	10541248	13284	g_450	g_451
Super-Scaffold_100019	10543820	10545135	1315	g_451	g_42931
Super-Scaffold_100019	10545389	10547751	2362	g_42931	g_452
Super-Scaffold_100019	10552075	10566556	14481	g_452	g_453
Super-Scaffold_100019	10569130	10571234	2104	g_453	g_454
Super-Scaffold_100019	10571551	10575558	4007	g_454	g_456
Super-Scaffold_100019	10575812	10578214	2402	g_456	g_457
Super-Scaffold_100019	10587180	10595558	8378	g_457	g_458
Super-Scaffold_100019	10598040	10604452	6412	g_458	g_460
Super-Scaffold_100019	10611986	10618461	6475	g_460	g_461
Super-Scaffold_100019	10620967	10623193	2226	g_461	g_462
Super-Scaffold_100019	10623393	10626430	3037	g_462	g_464
Super-Scaffold_100019	10635509	10645192	9683	g_464	g_465
Super-Scaffold_100019	10647672	10653777	6105	g_465	g_467
Super-Scaffold_100019	10657583	10662601	5018	g_467	g_468
Super-Scaffold_100019	10665196	10668097	2901	g_468	g_469
Super-Scaffold_100019	10669913	10671565	1652	g_469	g_470
Super-Scaffold_100019	10674132	10820111	145979	g_470	g_471
Super-Scaffold_100019	10885164	10895587	10423	g_471	g_473
Super-Scaffold_100019	10900775	10908893	8118	g_473	g_474
Super-Scaffold_100019	10915053	10918776	3723	g_474	g_475
Super-Scaffold_100019	10923129	10927186	4057	g_475	g_476
Super-Scaffold_100019	10946736	10957108	10372	g_476	g_477
Super-Scaffold_100019	10996827	11315844	319017	g_477	g_481
Super-Scaffold_100019	11317785	11343870	26085	g_481	g_482
Super-Scaffold_100019	11362874	11365242	2368	g_482	g_483
Super-Scaffold_100019	11367580	11369046	1466	g_483	g_484
Super-Scaffold_100019	11371435	11376340	4905	g_484	g_485
Super-Scaffold_100019	11378589	11460136	81547	g_485	g_487
Super-Scaffold_100019	11460411	11560735	100324	g_487	g_490
Super-Scaffold_100019	11577728	11697122	119394	g_490	g_493
Super-Scaffold_100019	11704373	11707795	3422	g_493	g_42932
Super-Scaffold_100019	11711716	11712712	996	g_42932	g_494
Super-Scaffold_100019	11714896	11719416	4520	g_494	g_495
Super-Scaffold_100019	11742815	11747965	5150	g_495	g_496
Super-Scaffold_100019	11749713	11835697	85984	g_496	g_498
Super-Scaffold_100019	11839315	11845307	5992	g_498	g_499
Super-Scaffold_100019	11846936	11852325	5389	g_499	g_500
Super-Scaffold_100019	11865104	11875936	10832	g_500	g_501
Super-Scaffold_100019	11900321	11909001	8680	g_501	g_42933
Super-Scaffold_100019	11910943	11952598	41655	g_42933	g_502
Super-Scaffold_100019	11974719	11977011	2292	g_502	g_42934
Super-Scaffold_100019	11980467	11986651	6184	g_42934	g_503
Super-Scaffold_100019	11987679	11989750	2071	g_503	g_504
Super-Scaffold_100019	11992061	11997389	5328	g_504	g_505
Super-Scaffold_100019	12019379	12023372	3993	g_505	g_506
Super-Scaffold_100019	12031294	12036542	5248	g_506	g_507
Super-Scaffold_100019	12039912	12040355	443	g_507	g_508
Super-Scaffold_100019	12048725	12050341	1616	g_508	g_509
Super-Scaffold_100019	12055188	12059395	4207	g_509	g_510
Super-Scaffold_100019	12064911	12082354	17443	g_510	g_511
Super-Scaffold_100019	12082692	12083017	325	g_511	g_512
Super-Scaffold_100019	12083280	12113892	30612	g_512	g_514
Super-Scaffold_100019	12135054	12139329	4275	g_514	g_515
Super-Scaffold_100019	12139892	12140847	955	g_515	g_516
Super-Scaffold_100019	12142023	12152792	10769	g_516	g_518
Super-Scaffold_100019	12153538	12160930	7392	g_518	g_519
Super-Scaffold_100019	12162135	12163383	1248	g_519	g_520
Super-Scaffold_100019	12164171	12165484	1313	g_520	g_521
Super-Scaffold_100019	12171041	12172926	1885	g_521	g_42935
Super-Scaffold_100019	12174654	12176175	1521	g_42935	g_522
Super-Scaffold_100019	12179774	12185846	6072	g_522	g_42936
Super-Scaffold_100019	12196736	12214253	17517	g_42936	g_42937
Super-Scaffold_100019	12216967	12239891	22924	g_42937	g_525
Super-Scaffold_100019	12259787	12273912	14125	g_525	g_527
Super-Scaffold_100019	12275501	12275823	322	g_527	g_528
Super-Scaffold_100019	12278953	12310571	31618	g_528	g_529
Super-Scaffold_100019	12320813	12328450	7637	g_529	g_530
Super-Scaffold_100019	12328692	12333569	4877	g_530	g_531
Super-Scaffold_100019	12344028	12349679	5651	g_531	g_532
Super-Scaffold_100019	12359209	12394994	35785	g_532	g_535
Super-Scaffold_100019	12397203	12403012	5809	g_535	g_42938
Super-Scaffold_100019	12405228	12475001	69773	g_42938	g_537
Super-Scaffold_100019	12500149	12557372	57223	g_537	g_538
Super-Scaffold_100019	12572265	12594342	22077	g_538	g_540
Super-Scaffold_100019	12607528	12618230	10702	g_540	g_541
Super-Scaffold_100019	12619835	12634766	14931	g_541	g_542
Super-Scaffold_100019	12651017	12653015	1998	g_542	g_543
Super-Scaffold_100019	12654176	12656551	2375	g_543	g_544
Super-Scaffold_100019	12665393	12669699	4306	g_544	g_545
Super-Scaffold_100019	12676002	12685818	9816	g_545	g_546
Super-Scaffold_100019	12697606	12702035	4429	g_546	g_547
Super-Scaffold_100019	12711572	12714538	2966	g_547	g_548
Super-Scaffold_100019	12726465	12732219	5754	g_548	g_550
Super-Scaffold_100019	12737273	12737712	439	g_550	g_551
Super-Scaffold_100019	12741857	12769780	27923	g_551	g_553
Super-Scaffold_100019	12776459	12782799	6340	g_553	g_554
Super-Scaffold_100019	12784083	12787680	3597	g_554	g_555
Super-Scaffold_100019	12792008	12794722	2714	g_555	g_556
Super-Scaffold_100019	12801653	12813545	11892	g_556	g_557
Super-Scaffold_100019	12824830	12827208	2378	g_557	g_558
Super-Scaffold_100019	12832811	12838105	5294	g_558	g_559
Super-Scaffold_100019	12865404	12910034	44630	g_559	g_560
Super-Scaffold_100019	12912339	12963162	50823	g_560	g_562
Super-Scaffold_100019	12981993	12997092	15099	g_562	g_563
Super-Scaffold_100019	13005381	13008196	2815	g_563	g_564
Super-Scaffold_100019	13008861	13013475	4614	g_564	g_565
Super-Scaffold_100019	13019301	13020481	1180	g_565	g_566
Super-Scaffold_100019	13023359	13026222	2863	g_566	g_567
Super-Scaffold_100019	13029641	13030830	1189	g_567	g_568
Super-Scaffold_100019	13031618	13042306	10688	g_568	g_569
Super-Scaffold_100019	13049331	13065819	16488	g_569	g_570
Super-Scaffold_100019	13075882	13101253	25371	g_570	g_571
Super-Scaffold_100019	13117658	13122407	4749	g_571	g_39211
Super-Scaffold_100019	13122643	13135644	13001	g_39211	g_572
Super-Scaffold_100019	13140448	13158288	17840	g_572	g_573
Super-Scaffold_100019	13178577	13181186	2609	g_573	g_574
Super-Scaffold_100019	13187025	13189376	2351	g_574	g_575
Super-Scaffold_100019	13189657	13195156	5499	g_575	g_576
Super-Scaffold_100019	13198941	13204395	5454	g_576	g_577
Super-Scaffold_100019	13214223	13216788	2565	g_577	g_578
Super-Scaffold_100019	13219547	13221997	2450	g_578	g_579
Super-Scaffold_100019	13224742	13225778	1036	g_579	g_580
Super-Scaffold_100019	13226830	13229193	2363	g_580	g_581
Super-Scaffold_100019	13232774	13236290	3516	g_581	g_582
Super-Scaffold_100019	13243041	13244865	1824	g_582	g_42939
Super-Scaffold_100019	13249533	13250954	1421	g_42939	g_583
Super-Scaffold_100019	13255913	13256967	1054	g_583	g_584
Super-Scaffold_100019	13260687	13261704	1017	g_584	g_585
Super-Scaffold_100019	13263548	13265064	1516	g_585	g_586
Super-Scaffold_100019	13265762	13267837	2075	g_586	g_587
Super-Scaffold_100019	13278293	13279598	1305	g_587	g_588
Super-Scaffold_100019	13281247	13304479	23232	g_588	g_589
Super-Scaffold_100019	13318545	13336710	18165	g_589	g_591
Super-Scaffold_100019	13337018	13384223	47205	g_591	g_594
Super-Scaffold_100019	13384588	13385017	429	g_594	g_595
Super-Scaffold_100019	13400714	13415571	14857	g_595	g_42940
Super-Scaffold_100019	13422487	13474992	52505	g_42940	g_597
Super-Scaffold_100019	13475321	13478554	3233	g_597	g_598
Super-Scaffold_100019	13481076	13503421	22345	g_598	g_599
Super-Scaffold_100019	13504560	13509541	4981	g_599	g_600
Super-Scaffold_100019	13521127	13529253	8126	g_600	g_601
Super-Scaffold_100019	13533884	13534381	497	g_601	g_602
Super-Scaffold_100019	13542662	13559142	16480	g_602	g_39215
Super-Scaffold_100019	13559366	13577084	17718	g_39215	g_605
Super-Scaffold_100019	13591001	13594491	3490	g_605	g_606
Super-Scaffold_100019	13604313	13688993	84680	g_606	g_609
Super-Scaffold_100019	13692792	13695095	2303	g_609	g_610
Super-Scaffold_100019	13700103	13708198	8095	g_610	g_611
Super-Scaffold_100019	13725858	13744143	18285	g_611	g_612
Super-Scaffold_100019	13744397	13783721	39324	g_612	g_614
Super-Scaffold_100019	13792062	13835645	43583	g_614	g_615
Super-Scaffold_100019	13835854	13839607	3753	g_615	g_616
Super-Scaffold_100019	13853208	13858325	5117	g_616	g_617
Super-Scaffold_100019	13864467	13865062	595	g_617	g_618
Super-Scaffold_100019	13867528	13871636	4108	g_618	g_619
Super-Scaffold_100019	13884850	13892530	7680	g_619	g_42941
Super-Scaffold_100019	13897527	13900520	2993	g_42941	g_620
Super-Scaffold_100019	13906234	13922565	16331	g_620	g_621
Super-Scaffold_100019	13952848	13958419	5571	g_621	g_622
Super-Scaffold_100019	13963891	13987212	23321	g_622	g_623
Super-Scaffold_100019	13987631	14020467	32836	g_623	g_624
Super-Scaffold_100019	14026908	14056040	29132	g_624	g_625
Super-Scaffold_100019	14069141	14075123	5982	g_625	g_626
Super-Scaffold_100019	14076368	14095649	19281	g_626	g_42942
Super-Scaffold_100019	14115794	14329990	214196	g_42942	g_630
Super-Scaffold_100019	14330382	14414629	84247	g_630	g_631
Super-Scaffold_100019	14415237	14422655	7418	g_631	g_39228
Super-Scaffold_100019	14422864	14711754	288890	g_39228	g_637
Super-Scaffold_100019	14713811	14718947	5136	g_637	g_638
Super-Scaffold_100019	14729517	14754270	24753	g_638	g_639
Super-Scaffold_100019	14766731	14775612	8881	g_639	g_640
Super-Scaffold_100019	14859647	14878677	19030	g_640	g_641
Super-Scaffold_100019	14899552	14935699	36147	g_641	g_642
Super-Scaffold_100019	14947914	14964347	16433	g_642	g_42943
Super-Scaffold_100019	14965381	15003211	37830	g_42943	g_643
Super-Scaffold_100019	15026162	15045492	19330	g_643	g_42944
Super-Scaffold_100019	15053646	15079151	25505	g_42944	g_645
Super-Scaffold_100019	15081518	15082666	1148	g_645	g_646
Super-Scaffold_100019	15085371	15088350	2979	g_646	g_647
Super-Scaffold_100019	15103204	15109967	6763	g_647	g_648
Super-Scaffold_100019	15117098	15118509	1411	g_648	g_649
Super-Scaffold_100019	15119678	15161692	42014	g_649	g_652
Super-Scaffold_100019	15168694	15171494	2800	g_652	g_653
Super-Scaffold_100019	15172705	15173559	854	g_653	g_654
Super-Scaffold_100019	15175705	15177517	1812	g_654	g_655
Super-Scaffold_100019	15183329	15187203	3874	g_655	g_42945
Super-Scaffold_100019	15193076	15193147	71	g_42945	g_39231
Super-Scaffold_100019	15193365	15221360	27995	g_39231	g_657
Super-Scaffold_100019	15241009	15243938	2929	g_657	g_39233
Super-Scaffold_100019	15244141	15247553	3412	g_39233	g_658
Super-Scaffold_100019	15251151	15256243	5092	g_658	g_42946
Super-Scaffold_100019	15261781	15267483	5702	g_42946	g_659
Super-Scaffold_100019	15274369	15289866	15497	g_659	g_660
Super-Scaffold_100019	15292127	15295155	3028	g_660	g_661
Super-Scaffold_100019	15303496	15312318	8822	g_663	g_665
Super-Scaffold_100019	15317174	15320953	3779	g_665	g_666
Super-Scaffold_100019	15322773	15326917	4144	g_666	g_667
Super-Scaffold_100019	15337763	15347390	9627	g_667	g_669
Super-Scaffold_100019	15348265	15353155	4890	g_669	g_670
Super-Scaffold_100019	15355741	15359860	4119	g_670	g_671
Super-Scaffold_100019	15369905	15377653	7748	g_671	g_672
Super-Scaffold_100019	15386478	15404279	17801	g_672	g_674
Super-Scaffold_100019	15407783	15407955	172	g_674	g_675
Super-Scaffold_100019	15411128	15418021	6893	g_675	g_676
Super-Scaffold_100019	15422518	15436991	14473	g_676	g_678
Super-Scaffold_100019	15437606	15458044	20438	g_678	g_39237
Super-Scaffold_100019	15458349	15493190	34841	g_39237	g_682
Super-Scaffold_100019	15523778	15683490	159712	g_682	g_687
Super-Scaffold_100019	15690168	15711217	21049	g_687	g_689
Super-Scaffold_100019	15726265	15755901	29636	g_689	g_691
Super-Scaffold_100019	15762335	15769824	7489	g_691	g_692
Super-Scaffold_100019	15774740	15782461	7721	g_692	g_42947
Super-Scaffold_100019	15788720	15792535	3815	g_42947	g_693
Super-Scaffold_100019	15806324	15821574	15250	g_693	g_694
Super-Scaffold_100019	15824455	15867277	42822	g_694	g_696
Super-Scaffold_100019	15888509	15891497	2988	g_696	g_697
Super-Scaffold_100019	15894754	15901228	6474	g_697	g_698
Super-Scaffold_100019	15916964	15927253	10289	g_698	g_699
Super-Scaffold_100019	15935920	15936912	992	g_699	g_700
Super-Scaffold_100019	15938291	15944557	6266	g_700	g_701
Super-Scaffold_100019	15965695	15967685	1990	g_701	g_702
Super-Scaffold_100019	15977721	15979285	1564	g_702	g_703
Super-Scaffold_100019	15980412	15981549	1137	g_703	g_39243
Super-Scaffold_100019	15992471	16003579	11108	g_704	g_705
Super-Scaffold_100019	16028196	16030975	2779	g_705	g_706
Super-Scaffold_100019	16031217	16031258	41	g_706	g_42948
Super-Scaffold_100019	16032972	16039970	6998	g_42948	g_707
Super-Scaffold_100019	16044783	16051464	6681	g_707	g_708
Super-Scaffold_100019	16059780	16068088	8308	g_708	g_42949
Super-Scaffold_100019	16081348	16155910	74562	g_42949	g_711
Super-Scaffold_100019	16156158	16164281	8123	g_711	g_39244
Super-Scaffold_100019	16164541	16194577	30036	g_39244	g_713
Super-Scaffold_100019	16216729	16228730	12001	g_713	g_714
Super-Scaffold_100019	16250613	16334163	83550	g_714	g_715
Super-Scaffold_100019	16343407	16354175	10768	g_715	g_716
Super-Scaffold_100019	16354636	16355645	1009	g_716	g_717
Super-Scaffold_100019	16356001	16404778	48777	g_717	g_718
Super-Scaffold_100019	16415978	16427358	11380	g_718	g_719
Super-Scaffold_100019	16436471	16459509	23038	g_719	g_720
Super-Scaffold_100019	16463109	16505630	42521	g_720	g_722
Super-Scaffold_100019	16522662	16534799	12137	g_722	g_723
Super-Scaffold_100019	16543564	16547017	3453	g_723	g_724
Super-Scaffold_100019	16548502	16551011	2509	g_724	g_42950
Super-Scaffold_100019	16565129	16567521	2392	g_42950	g_725
Super-Scaffold_100019	16577461	16584987	7526	g_725	g_42951
Super-Scaffold_100019	16585994	16589268	3274	g_42951	g_726
Super-Scaffold_100019	16591467	16596068	4601	g_726	g_727
Super-Scaffold_100019	16605092	16608534	3442	g_727	g_728
Super-Scaffold_100019	16609885	16613015	3130	g_39248	g_729
Super-Scaffold_100019	16614656	16618643	3987	g_729	g_730
Super-Scaffold_100019	16632979	16635593	2614	g_730	g_731
Super-Scaffold_100019	16635799	16684365	48566	g_731	g_732
Super-Scaffold_100019	16686773	16689985	3212	g_732	g_733
Super-Scaffold_100019	16691198	16695344	4146	g_733	g_734
Super-Scaffold_100019	16698858	16703438	4580	g_734	g_42952
Super-Scaffold_100019	16715405	16717017	1612	g_42952	g_735
Super-Scaffold_100019	16725815	16736538	10723	g_735	g_737
Super-Scaffold_100019	16741405	16742709	1304	g_737	g_738
Super-Scaffold_100019	16756088	16762078	5990	g_738	g_739
Super-Scaffold_100019	16775540	16778195	2655	g_739	g_740
Super-Scaffold_100019	16779745	16783142	3397	g_740	g_741
Super-Scaffold_100019	16783999	16784844	845	g_741	g_742
Super-Scaffold_100019	16787093	16792135	5042	g_742	g_743
Super-Scaffold_100019	16793145	16794388	1243	g_743	g_42953
Super-Scaffold_100019	16796530	16797843	1313	g_42953	g_39251
Super-Scaffold_100019	16800313	16802649	2336	g_744	g_745
Super-Scaffold_100019	16803861	16805484	1623	g_745	g_42954
Super-Scaffold_100019	16808900	16814969	6069	g_42954	g_746
Super-Scaffold_100019	16828546	16832101	3555	g_746	g_747
Super-Scaffold_100019	16834783	16848900	14117	g_747	g_749
Super-Scaffold_100019	16849748	16859690	9942	g_749	g_751
Super-Scaffold_100019	16860538	16866249	5711	g_751	g_752
Super-Scaffold_100019	16867097	16867171	74	g_752	g_753
Super-Scaffold_100019	16868019	16874064	6045	g_753	g_754
Super-Scaffold_100019	16887674	16894427	6753	g_754	g_755
Super-Scaffold_100019	16897112	16899447	2335	g_755	g_756
Super-Scaffold_100019	16905439	16908129	2690	g_756	g_757
Super-Scaffold_100019	16909332	16910733	1401	g_757	g_758
Super-Scaffold_100019	16914307	16915108	801	g_758	g_759
Super-Scaffold_100019	16921796	16926880	5084	g_759	g_760
Super-Scaffold_100019	16939046	16943454	4408	g_760	g_761
Super-Scaffold_100019	16960597	16993651	33054	g_761	g_762
Super-Scaffold_100019	17001612	17014850	13238	g_762	g_763
Super-Scaffold_100019	17039408	17077443	38035	g_763	g_768
Super-Scaffold_100019	17085576	17089634	4058	g_768	g_769
Super-Scaffold_100019	17096702	17107528	10826	g_769	g_770
Super-Scaffold_100019	17120827	17121211	384	g_770	g_771
Super-Scaffold_100019	17121648	17125662	4014	g_771	g_772
Super-Scaffold_100019	17131136	17132645	1509	g_772	g_773
Super-Scaffold_100019	17146879	17148833	1954	g_773	g_774
Super-Scaffold_100019	17153407	17157260	3853	g_774	g_775
Super-Scaffold_100019	17163908	17178636	14728	g_775	g_776
Super-Scaffold_100019	17185298	17189617	4319	g_776	g_777
Super-Scaffold_100019	17206635	17211291	4656	g_777	g_778
Super-Scaffold_100019	17224337	17226011	1674	g_778	g_779
Super-Scaffold_100019	17239030	17240787	1757	g_779	g_780
Super-Scaffold_100019	17245011	17251806	6795	g_780	g_781
Super-Scaffold_100019	17267604	17270295	2691	g_781	g_782
Super-Scaffold_100019	17270747	17273600	2853	g_782	g_783
Super-Scaffold_100019	17274106	17279319	5213	g_783	g_785
Super-Scaffold_100019	17285121	17288881	3760	g_785	g_786
Super-Scaffold_100019	17293754	17310312	16558	g_786	g_787
Super-Scaffold_100019	17311382	17315157	3775	g_787	g_788
Super-Scaffold_100019	17315405	17317511	2106	g_788	g_789
Super-Scaffold_100019	17322271	17324763	2492	g_789	g_790
Super-Scaffold_100019	17335107	17337109	2002	g_790	g_791
Super-Scaffold_100019	17348109	17352712	4603	g_791	g_792
Super-Scaffold_100019	17357345	17360439	3094	g_792	g_39254
Super-Scaffold_100019	17360651	17361215	564	g_39254	g_793
Super-Scaffold_100019	17363406	17368250	4844	g_793	g_795
Super-Scaffold_100019	17383060	17387388	4328	g_795	g_796
Super-Scaffold_100019	17393684	17397855	4171	g_796	g_797
Super-Scaffold_100019	17404070	17418317	14247	g_797	g_798
Super-Scaffold_100019	17424938	17431045	6107	g_798	g_799
Super-Scaffold_100019	17435872	17447137	11265	g_799	g_800
Super-Scaffold_100019	17457680	17514136	56456	g_800	g_801
Super-Scaffold_100019	17530963	17534106	3143	g_801	g_42955
Super-Scaffold_100019	17542557	17544197	1640	g_42955	g_802
Super-Scaffold_100019	17556183	17559489	3306	g_802	g_803
Super-Scaffold_100019	17562086	17563664	1578	g_803	g_42956
Super-Scaffold_100019	17564394	17568707	4313	g_42956	g_804
Super-Scaffold_100019	17583124	17585339	2215	g_804	g_805
Super-Scaffold_100019	17607406	17610158	2752	g_805	g_806
Super-Scaffold_100019	17617340	17621490	4150	g_806	g_42957
Super-Scaffold_100019	17627660	17628870	1210	g_42957	g_807
Super-Scaffold_100019	17666361	17686899	20538	g_807	g_809
Super-Scaffold_100019	17708876	17715308	6432	g_809	g_810
Super-Scaffold_100019	17767189	17786104	18915	g_810	g_811
Super-Scaffold_100019	17787303	17838269	50966	g_811	g_813
Super-Scaffold_100019	17838490	17863977	25487	g_813	g_814
Super-Scaffold_100019	17877655	18004326	126671	g_814	g_817
Super-Scaffold_100019	18015190	18019613	4423	g_817	g_818
Super-Scaffold_100019	18024873	18028286	3413	g_818	g_819
Super-Scaffold_100019	18030307	18033008	2701	g_819	g_820
Super-Scaffold_100019	18034001	18039674	5673	g_820	g_821
Super-Scaffold_100019	18039970	18048181	8211	g_821	g_822
Super-Scaffold_100019	18055060	18058233	3173	g_822	g_823
Super-Scaffold_100019	18065504	18079010	13506	g_823	g_824
Super-Scaffold_100019	18079642	18092109	12467	g_824	g_826
Super-Scaffold_100019	18100702	18173825	73123	g_826	g_829
Super-Scaffold_100019	18178817	18182371	3554	g_829	g_830
Super-Scaffold_100019	18182628	18182811	183	g_830	g_831
Super-Scaffold_100019	18197087	18199261	2174	g_831	g_832
Super-Scaffold_100019	18205674	18206902	1228	g_832	g_833
Super-Scaffold_100019	18209575	18213495	3920	g_833	g_834
Super-Scaffold_100019	18216033	18235865	19832	g_834	g_836
Super-Scaffold_100019	18238404	18241212	2808	g_836	g_837
Super-Scaffold_100019	18256570	18266485	9915	g_837	g_838
Super-Scaffold_100019	18273218	18277585	4367	g_838	g_839
Super-Scaffold_100019	18298630	18346105	47475	g_839	g_840
Super-Scaffold_100019	18349408	18350001	593	g_840	g_841
Super-Scaffold_100019	18351599	18354208	2609	g_841	g_842
Super-Scaffold_100019	18365309	18367485	2176	g_842	g_843
Super-Scaffold_100019	18371563	18380653	9090	g_843	g_42958
Super-Scaffold_100019	18382498	18386583	4085	g_42958	g_844
Super-Scaffold_100019	18387611	18397097	9486	g_844	g_845
Super-Scaffold_100019	18401028	18413555	12527	g_845	g_846
Super-Scaffold_100019	18428662	18434787	6125	g_846	g_42959
Super-Scaffold_100019	18451806	18454519	2713	g_42959	g_42960
Super-Scaffold_100019	18461830	18466507	4677	g_42960	g_847
Super-Scaffold_100019	18486258	18490803	4545	g_847	g_848
Super-Scaffold_100019	18493928	18495551	1623	g_848	g_849
Super-Scaffold_100019	18502254	18507467	5213	g_849	g_850
Super-Scaffold_100019	18523757	18540220	16463	g_850	g_851
Super-Scaffold_100019	18540555	18552351	11796	g_851	g_852
Super-Scaffold_100019	18553958	18555470	1512	g_852	g_853
Super-Scaffold_100019	18565217	18568218	3001	g_853	g_854
Super-Scaffold_100019	18575061	18581808	6747	g_854	g_855
Super-Scaffold_100019	18604036	18606429	2393	g_855	g_42961
Super-Scaffold_100019	18613215	18616845	3630	g_42961	g_856
Super-Scaffold_100019	18622594	18624934	2340	g_856	g_857
Super-Scaffold_100019	18627691	18637354	9663	g_857	g_858
Super-Scaffold_100019	18646831	18649349	2518	g_858	g_859
Super-Scaffold_100019	18661308	18689229	27921	g_859	g_861
Super-Scaffold_100019	18713915	18722253	8338	g_861	g_42962
Super-Scaffold_100019	18725276	18801272	75996	g_42962	g_862
Super-Scaffold_100019	18809245	18811677	2432	g_862	g_42963
Super-Scaffold_100019	18816837	18819330	2493	g_42963	g_863
Super-Scaffold_100019	18829346	18862315	32969	g_863	g_864
Super-Scaffold_100019	18871176	18874089	2913	g_864	g_865
Super-Scaffold_100019	18875858	18878195	2337	g_865	g_42964
Super-Scaffold_100019	18885036	18885122	86	g_42964	g_866
Super-Scaffold_100019	18888543	18890286	1743	g_866	g_867
Super-Scaffold_100019	18894095	18899684	5589	g_867	g_868
Super-Scaffold_100019	18921514	18925213	3699	g_868	g_869
Super-Scaffold_100019	18926208	18926886	678	g_869	g_870
Super-Scaffold_100019	18931682	18933589	1907	g_870	g_871
Super-Scaffold_100019	18943473	18944243	770	g_871	g_872
Super-Scaffold_100019	18956725	18958491	1766	g_872	g_42965
Super-Scaffold_100019	18968720	18974547	5827	g_42965	g_873
Super-Scaffold_100019	18980392	18984265	3873	g_873	g_874
Super-Scaffold_100019	18993854	18997593	3739	g_874	g_875
Super-Scaffold_100019	19000247	19002956	2709	g_875	g_876
Super-Scaffold_100019	19023055	19024456	1401	g_876	g_877
Super-Scaffold_100019	19024869	19043662	18793	g_877	g_879
Super-Scaffold_100019	19071903	19084715	12812	g_879	g_880
Super-Scaffold_100019	19094927	19130600	35673	g_880	g_881
Super-Scaffold_100019	19145530	19167242	21712	g_881	g_42966
Super-Scaffold_100019	19167676	19186280	18604	g_42966	g_882
Super-Scaffold_100019	19190561	19198221	7660	g_882	g_884
Super-Scaffold_100019	19201772	19202384	612	g_884	g_885
Super-Scaffold_100019	19205433	19207508	2075	g_885	g_886
Super-Scaffold_100019	19209300	19214571	5271	g_886	g_42967
Super-Scaffold_100019	19230754	19232044	1290	g_42967	g_39261
Super-Scaffold_100019	19232247	19235415	3168	g_39261	g_887
Super-Scaffold_100019	19244179	19247163	2984	g_887	g_888
Super-Scaffold_100019	19251432	19252982	1550	g_888	g_889
Super-Scaffold_100019	19254849	19349789	94940	g_889	g_892
Super-Scaffold_100019	19352473	19353289	816	g_892	g_893
Super-Scaffold_100019	19358306	19359806	1500	g_893	g_894
Super-Scaffold_100019	19362397	19362433	36	g_894	g_42968
Super-Scaffold_100019	19364527	19365464	937	g_42968	g_895
Super-Scaffold_100019	19369923	19427997	58074	g_895	g_897
Super-Scaffold_100019	19440069	19452819	12750	g_897	g_898
Super-Scaffold_100019	19454087	19458352	4265	g_898	g_899
Super-Scaffold_100019	19464030	19467415	3385	g_899	g_900
Super-Scaffold_100019	19484859	19517865	33006	g_900	g_901
Super-Scaffold_100019	19530303	19539224	8921	g_901	g_42969
Super-Scaffold_100019	19546790	19553060	6270	g_42969	g_902
Super-Scaffold_100019	19555173	19564258	9085	g_902	g_903
Super-Scaffold_100019	19566542	19568742	2200	g_903	g_42970
Super-Scaffold_100019	19570896	19574400	3504	g_42970	g_904
Super-Scaffold_100019	19576301	19580499	4198	g_39265	g_905
Super-Scaffold_100019	19581401	19589712	8311	g_905	g_906
Super-Scaffold_100019	19592504	19602298	9794	g_906	g_907
Super-Scaffold_100019	19606301	19623278	16977	g_907	g_42971
Super-Scaffold_100019	19623707	19635410	11703	g_42971	g_908
Super-Scaffold_100019	19635757	19676012	40255	g_908	g_909
Super-Scaffold_100019	19683971	19686430	2459	g_909	g_39266
Super-Scaffold_100019	19686666	19691723	5057	g_39266	g_910
Super-Scaffold_100019	19695521	19701313	5792	g_910	g_911
Super-Scaffold_100019	19712995	19732229	19234	g_911	g_912
Super-Scaffold_100019	19732480	19734679	2199	g_912	g_39267
Super-Scaffold_100019	19734882	19758945	24063	g_39267	g_914
Super-Scaffold_100019	19759259	19760623	1364	g_914	g_39270
Super-Scaffold_100019	19760949	19808634	47685	g_39270	g_916
Super-Scaffold_100019	19824897	19839592	14695	g_916	g_917
Super-Scaffold_100019	19841155	19886457	45302	g_917	g_921
Super-Scaffold_100019	19901546	19902916	1370	g_921	g_922
Super-Scaffold_100019	19918071	19922749	4678	g_922	g_923
Super-Scaffold_100019	19928508	19933165	4657	g_923	g_924
Super-Scaffold_100019	19956954	19982737	25783	g_924	g_926
Super-Scaffold_100019	19985859	19988046	2187	g_926	g_42972
Super-Scaffold_100019	19990707	19992438	1731	g_42972	g_927
Super-Scaffold_100019	20000344	20004279	3935	g_927	g_928
Super-Scaffold_100019	20008579	20069959	61380	g_928	g_931
Super-Scaffold_100019	20070315	20114597	44282	g_931	g_932
Super-Scaffold_100019	20117217	20129214	11997	g_932	g_933
Super-Scaffold_100019	20136661	20139530	2869	g_933	g_934
Super-Scaffold_100019	20144913	20187411	42498	g_934	g_935
Super-Scaffold_100019	20209266	20228391	19125	g_935	g_936
Super-Scaffold_100019	20238435	20275043	36608	g_936	g_938
Super-Scaffold_100019	20301813	20337010	35197	g_938	g_940
Super-Scaffold_100019	20354881	20377626	22745	g_940	g_941
Super-Scaffold_100019	20384466	20387868	3402	g_941	g_942
Super-Scaffold_100019	20395195	20406768	11573	g_942	g_943
Super-Scaffold_100019	20408888	20421296	12408	g_943	g_945
Super-Scaffold_100019	20425221	20425629	408	g_945	g_946
Super-Scaffold_100019	20441079	20467265	26186	g_946	g_948
Super-Scaffold_100019	20469181	20475870	6689	g_948	g_949
Super-Scaffold_100019	20499782	20500047	265	g_949	g_950
Super-Scaffold_100019	20500511	20500576	65	g_950	g_951
Super-Scaffold_100019	20501064	20501761	697	g_951	g_952
Super-Scaffold_100019	20502024	20504240	2216	g_952	g_953
Super-Scaffold_100019	20519348	20584265	64917	g_953	g_955
Super-Scaffold_100019	20584750	20644940	60190	g_955	g_957
Super-Scaffold_100019	20645326	20647282	1956	g_957	g_39276
Super-Scaffold_100019	20647668	20663898	16230	g_39276	g_958
Super-Scaffold_100019	20667775	20669193	1418	g_958	g_959
Super-Scaffold_100019	20672531	20719843	47312	g_959	g_960
Super-Scaffold_100019	20721009	20730022	9013	g_960	g_961
Super-Scaffold_100019	20747489	20794656	47167	g_961	g_962
Super-Scaffold_100019	20797828	20803592	5764	g_962	g_963
Super-Scaffold_100019	20816637	20820526	3889	g_963	g_42973
Super-Scaffold_100019	20831833	20838400	6567	g_42973	g_964
Super-Scaffold_100019	20852112	20883126	31014	g_964	g_965
Super-Scaffold_100019	20919617	21012990	93373	g_965	g_42974
Super-Scaffold_100019	21013406	21179772	166366	g_42974	g_967
Super-Scaffold_100019	21180173	21180235	62	g_967	g_968
Super-Scaffold_100019	21181650	21181860	210	g_968	g_969
Super-Scaffold_100019	21184059	21216566	32507	g_969	g_39279
Super-Scaffold_100019	21216823	21298194	81371	g_39279	g_973
Super-Scaffold_100019	21298859	21353955	55096	g_973	g_39281
Super-Scaffold_100019	21354188	21407489	53301	g_39281	g_976
Super-Scaffold_100019	21414084	21446734	32650	g_976	g_977
Super-Scaffold_100019	21451769	21609889	158120	g_977	g_984
Super-Scaffold_100019	21632543	21636732	4189	g_984	g_985
Super-Scaffold_100019	21640618	21642956	2338	g_985	g_986
Super-Scaffold_100019	21646146	21646834	688	g_986	g_42975
Super-Scaffold_100019	21652286	21657443	5157	g_42975	g_987
Super-Scaffold_100019	21658282	21751394	93112	g_987	g_39283
Super-Scaffold_100019	21751657	21772587	20930	g_39283	g_39284
Super-Scaffold_100019	21772811	21853186	80375	g_39284	g_989
Super-Scaffold_100019	21868458	21976678	108220	g_989	g_39287
Super-Scaffold_100019	21976905	22040212	63307	g_39287	g_991
Super-Scaffold_100019	22040535	22146800	106265	g_991	g_994
Super-Scaffold_100019	22164205	22169423	5218	g_994	g_995
Super-Scaffold_100019	22176501	22205117	28616	g_995	g_996
Super-Scaffold_100019	22206922	22217399	10477	g_996	g_998
Super-Scaffold_100019	22220688	22226842	6154	g_998	g_999
Super-Scaffold_100019	22229314	22231033	1719	g_999	g_1000
Super-Scaffold_100019	22238472	22238943	471	g_1000	g_1001
Super-Scaffold_100019	22249744	22264195	14451	g_1001	g_1002
Super-Scaffold_100019	22265970	22405877	139907	g_1002	g_1005
Super-Scaffold_100019	22446924	22460399	13475	g_1005	g_1006
Super-Scaffold_100019	22463050	22465166	2116	g_1006	g_1007
Super-Scaffold_100019	22468693	22473666	4973	g_1007	g_1008
Super-Scaffold_100019	22474682	22529318	54636	g_1008	g_39291
Super-Scaffold_100019	22529611	22546319	16708	g_39291	g_1011
Super-Scaffold_100019	22548590	22560504	11914	g_1011	g_1012
Super-Scaffold_100019	22601698	22619311	17613	g_1012	g_1013
Super-Scaffold_100019	22638423	22639982	1559	g_1013	g_1014
Super-Scaffold_100019	22646787	22653246	6459	g_1014	g_1015
Super-Scaffold_100019	22658161	22699522	41361	g_1015	g_1017
Super-Scaffold_100019	22701611	22716121	14510	g_1017	g_1018
Super-Scaffold_100019	22720354	22728287	7933	g_1018	g_1019
Super-Scaffold_100019	22737705	22747526	9821	g_1019	g_1020
Super-Scaffold_100019	22749898	22759922	10024	g_1020	g_1021
Super-Scaffold_100019	22760698	22768077	7379	g_1021	g_1022
Super-Scaffold_100019	22773038	22781839	8801	g_1022	g_1023
Super-Scaffold_100019	22786800	22795602	8802	g_1023	g_1024
Super-Scaffold_100019	22800563	22811200	10637	g_1024	g_1025
Super-Scaffold_100019	22816083	22818423	2340	g_1025	g_42976
Super-Scaffold_100019	22826220	22829745	3525	g_42976	g_42977
Super-Scaffold_100019	22833017	22834306	1289	g_42977	g_42978
Super-Scaffold_100019	22855463	22858929	3466	g_42978	g_1026
Super-Scaffold_100019	22863218	22872071	8853	g_1026	g_1027
Super-Scaffold_100019	22881463	22885065	3602	g_1027	g_1028
Super-Scaffold_100019	22885274	22919726	34452	g_1028	g_1030
Super-Scaffold_100019	22920619	22964884	44265	g_1030	g_1031
Super-Scaffold_100019	22965108	23171297	206189	g_1031	g_1034
Super-Scaffold_100019	23183401	23192748	9347	g_1034	g_1035
Super-Scaffold_100019	23193182	23194912	1730	g_1035	g_1036
Super-Scaffold_100019	23204649	23207335	2686	g_1036	g_1037
Super-Scaffold_100019	23214154	23216072	1918	g_1037	g_1038
Super-Scaffold_100019	23222504	23266020	43516	g_1038	g_1039
Super-Scaffold_100019	23292912	23301729	8817	g_1039	g_39295
Super-Scaffold_100019	23301944	23311808	9864	g_39295	g_1042
Super-Scaffold_100019	23315470	23315710	240	g_1042	g_1043
Super-Scaffold_100019	23318481	23319367	886	g_1043	g_1044
Super-Scaffold_100019	23324743	23326011	1268	g_1044	g_42979
Super-Scaffold_100019	23332380	23334650	2270	g_42979	g_1045
Super-Scaffold_100019	23338237	23346028	7791	g_1045	g_1046
Super-Scaffold_100019	23348476	23350787	2311	g_1046	g_1047
Super-Scaffold_100019	23357023	23360953	3930	g_1047	g_42980
Super-Scaffold_100019	23365488	23426574	61086	g_42980	g_39296
Super-Scaffold_100019	23426819	23426923	104	g_39296	g_39297
Super-Scaffold_100019	23427126	23483770	56644	g_39297	g_1049
Super-Scaffold_100019	23484126	23577228	93102	g_1049	g_1053
Super-Scaffold_100019	23578700	23671481	92781	g_1053	g_1057
Super-Scaffold_100019	23671792	23680354	8562	g_1057	g_1058
Super-Scaffold_100019	23680728	23792094	111366	g_1058	g_39306
Super-Scaffold_100019	23792312	23793858	1546	g_39306	g_1062
Super-Scaffold_100019	23796401	23796983	582	g_1062	g_1063
Super-Scaffold_100019	23799184	23818542	19358	g_1063	g_1064
Super-Scaffold_100019	23824531	23830393	5862	g_1064	g_1065
Super-Scaffold_100019	23838630	23840618	1988	g_1065	g_1066
Super-Scaffold_100019	23842315	23844729	2414	g_1066	g_1067
Super-Scaffold_100019	23866928	23867751	823	g_1067	g_1068
Super-Scaffold_100019	23908864	23913000	4136	g_1068	g_1069
Super-Scaffold_100019	23937479	24012099	74620	g_1069	g_39307
Super-Scaffold_100019	24012365	24017213	4848	g_39307	g_1071
Super-Scaffold_100019	24024678	24024742	64	g_1071	g_42981
Super-Scaffold_100019	24029647	24030126	479	g_42981	g_1072
Super-Scaffold_100019	24030961	24063698	32737	g_1072	g_1073
Super-Scaffold_100019	24064767	24064900	133	g_1073	g_1074
Super-Scaffold_100019	24065322	24104392	39070	g_1074	g_1076
Super-Scaffold_100019	24108296	24109720	1424	g_1076	g_1077
Super-Scaffold_100019	24111516	24115392	3876	g_1077	g_1078
Super-Scaffold_100019	24127073	24145940	18867	g_1078	g_1080
Super-Scaffold_100019	24153256	24169045	15789	g_1080	g_1081
Super-Scaffold_100019	24184434	24186620	2186	g_1081	g_1082
Super-Scaffold_100019	24188017	24202359	14342	g_1082	g_1083
Super-Scaffold_100019	24209033	24220027	10994	g_1083	g_1084
Super-Scaffold_100019	24220287	24263134	42847	g_1084	g_1085
Super-Scaffold_100019	24284504	24348208	63704	g_1085	g_1086
Super-Scaffold_100019	24382212	24389534	7322	g_1086	g_1087
Super-Scaffold_100019	24397357	24398411	1054	g_1087	g_1088
Super-Scaffold_100019	24400059	24413020	12961	g_1088	g_1090
Super-Scaffold_100019	24416583	24424504	7921	g_1090	g_1091
Super-Scaffold_100019	24436115	24473360	37245	g_1091	g_1093
Super-Scaffold_100019	24498362	24525034	26672	g_1093	g_1094
Super-Scaffold_100019	24536547	24551623	15076	g_1094	g_1096
Super-Scaffold_100019	24553059	24553687	628	g_1096	g_1097
Super-Scaffold_100019	24554706	24580645	25939	g_1097	g_1098
Super-Scaffold_100019	24599261	24624548	25287	g_1098	g_1099
Super-Scaffold_100019	24638149	24659079	20930	g_1099	g_1101
Super-Scaffold_100019	24666770	24668625	1855	g_1101	g_1102
Super-Scaffold_100019	24682100	24694593	12493	g_1102	g_1103
Super-Scaffold_100019	24705953	24707124	1171	g_1103	g_1104
Super-Scaffold_100019	24712256	24714541	2285	g_1104	g_1105
Super-Scaffold_100019	24717461	24724955	7494	g_1105	g_42982
Super-Scaffold_100019	24749703	24794234	44531	g_42982	g_1106
Super-Scaffold_100019	24798081	24802899	4818	g_1106	g_42983
Super-Scaffold_100019	24810873	24815018	4145	g_42983	g_1108
Super-Scaffold_100019	24849676	24861842	12166	g_1108	g_1109
Super-Scaffold_100019	24878536	24902557	24021	g_1109	g_1110
Super-Scaffold_100019	24915059	24921922	6863	g_1110	g_42984
Super-Scaffold_100019	24924422	24925881	1459	g_42984	g_39315
Super-Scaffold_100019	24926081	24928167	2086	g_39315	g_1111
Super-Scaffold_100019	24934051	24957303	23252	g_1111	g_1112
Super-Scaffold_100019	24979353	24990406	11053	g_1112	g_1113
Super-Scaffold_100019	24999842	25001553	1711	g_1113	g_1114
Super-Scaffold_100019	25006270	25019810	13540	g_1114	g_1115
Super-Scaffold_100019	25021078	25038016	16938	g_1115	g_1116
Super-Scaffold_100019	25044546	25050337	5791	g_1116	g_42985
Super-Scaffold_100019	25064420	25115428	51008	g_42985	g_1119
Super-Scaffold_100019	25129154	25163197	34043	g_1119	g_1120
Super-Scaffold_100019	25166794	25168667	1873	g_1120	g_1121
Super-Scaffold_100019	25172205	25176741	4536	g_1121	g_1122
Super-Scaffold_100019	25176977	25177800	823	g_1122	g_1123
Super-Scaffold_100019	25190758	25208706	17948	g_1124	g_42986
Super-Scaffold_100019	25209528	25254798	45270	g_42986	g_1126
Super-Scaffold_100019	25265944	25284340	18396	g_1126	g_1127
Super-Scaffold_100019	25296717	25346197	49480	g_1127	g_1128
Super-Scaffold_100019	25350632	25395827	45195	g_1128	g_1129
Super-Scaffold_100019	25396861	25421591	24730	g_1129	g_1130
Super-Scaffold_100019	25425428	25438399	12971	g_1130	g_1131
Super-Scaffold_100019	25444290	25449907	5617	g_1131	g_1132
Super-Scaffold_100019	25454160	25498127	43967	g_1132	g_1134
Super-Scaffold_100019	25499200	25558214	59014	g_1134	g_1138
Super-Scaffold_100019	25558669	25641008	82339	g_1138	g_1140
Super-Scaffold_100019	25641304	25699401	58097	g_1140	g_1143
Super-Scaffold_100019	25701897	25782566	80669	g_1143	g_1144
Super-Scaffold_100019	25788451	25803101	14650	g_1144	g_1145
Super-Scaffold_100019	25803346	25839212	35866	g_1145	g_1147
Super-Scaffold_100019	25852585	25864925	12340	g_1147	g_1148
Super-Scaffold_100019	25866724	25933428	66704	g_1148	g_1149
Super-Scaffold_100019	25948853	25961983	13130	g_1149	g_1151
Super-Scaffold_100019	25962234	25987528	25294	g_1151	g_1154
Super-Scaffold_100019	25989074	25989820	746	g_1154	g_1155
Super-Scaffold_100019	25990665	26103144	112479	g_1155	g_1157
Super-Scaffold_100019	26103353	26282400	179047	g_1157	g_1158
Super-Scaffold_100019	26283413	26283569	156	g_1158	g_1159
Super-Scaffold_100019	26283922	26362819	78897	g_1159	g_1161
Super-Scaffold_100019	26377388	26377846	458	g_1161	g_1162
Super-Scaffold_100019	26378262	26404823	26561	g_1162	g_1163
Super-Scaffold_100019	26407158	26431173	24015	g_1163	g_1165
Super-Scaffold_100019	26435154	26437485	2331	g_1165	g_42987
Super-Scaffold_100019	26439084	26475792	36708	g_42987	g_39321
Super-Scaffold_100019	26476100	26535876	59776	g_39321	g_1168
Super-Scaffold_100019	26553436	26571129	17693	g_1168	g_1169
Super-Scaffold_100019	26571740	26575264	3524	g_1169	g_1170
Super-Scaffold_100019	26575473	26579639	4166	g_1170	g_1171
Super-Scaffold_100019	26581253	26629122	47869	g_1171	g_1172
Super-Scaffold_100019	26646767	26654571	7804	g_1172	g_1173
Super-Scaffold_100019	26654975	26663396	8421	g_1173	g_42988
Super-Scaffold_100019	26666190	26702622	36432	g_42988	g_1174
Super-Scaffold_100019	26717075	26722174	5099	g_1174	g_1175
Super-Scaffold_100019	26742282	26749919	7637	g_1175	g_42989
Super-Scaffold_100019	26752834	26780039	27205	g_42989	g_1176
Super-Scaffold_100019	26782714	26785879	3165	g_1176	g_1179
Super-Scaffold_100019	26786955	26816498	29543	g_1179	g_1182
Super-Scaffold_100019	26816842	26838236	21394	g_1182	g_1183
Super-Scaffold_100019	26839489	26858675	19186	g_1183	g_1184
Super-Scaffold_100019	26859064	26881715	22651	g_1184	g_1185
Super-Scaffold_100019	26886684	26900895	14211	g_1185	g_1187
Super-Scaffold_100019	26901536	26907752	6216	g_1187	g_1188
Super-Scaffold_100019	26910299	26918120	7821	g_1188	g_1189
Super-Scaffold_100019	26925212	26954771	29559	g_1189	g_1190
Super-Scaffold_100019	26955964	27006783	50819	g_1190	g_1191
Super-Scaffold_100019	27021938	27051329	29391	g_1191	g_1192
Super-Scaffold_100022	6733	6930	197	g_4767	g_4768
Super-Scaffold_100022	8024	8071	47	g_4768	g_4769
Super-Scaffold_100022	9864	9901	37	g_4769	g_4770
Super-Scaffold_100022	10167	55293	45126	g_4770	g_4772
Super-Scaffold_100022	63269	97465	34196	g_40694	g_4773
Super-Scaffold_100022	106188	108038	1850	g_4773	g_4774
Super-Scaffold_100022	124680	130429	5749	g_40695	g_4775
Super-Scaffold_100022	131037	134470	3433	g_4775	g_4776
Super-Scaffold_100022	135150	145298	10148	g_4776	g_4777
Super-Scaffold_100022	145669	152515	6846	g_4777	g_4779
Super-Scaffold_100022	165464	165603	139	g_4779	g_4780
Super-Scaffold_100022	165812	167324	1512	g_4780	g_4781
Super-Scaffold_100022	167704	168281	577	g_4781	g_4782
Super-Scaffold_100022	168859	199145	30286	g_4782	g_4783
Super-Scaffold_100022	224012	227074	3062	g_4783	g_4784
Super-Scaffold_100022	233298	262275	28977	g_4784	g_4786
Super-Scaffold_100022	263972	277977	14005	g_4786	g_4787
Super-Scaffold_100022	297531	354868	57337	g_4787	g_4788
Super-Scaffold_100022	355227	369335	14108	g_4788	g_4789
Super-Scaffold_100022	370331	374325	3994	g_40698	g_4790
Super-Scaffold_100022	374849	397316	22467	g_4790	g_4792
Super-Scaffold_100022	404978	1072568	667590	g_4792	g_4793
Super-Scaffold_100022	1076575	1080888	4313	g_4793	g_4794
Super-Scaffold_100022	1095976	1097170	1194	g_4794	g_4795
Super-Scaffold_100022	1113159	1169253	56094	g_4795	g_4796
Super-Scaffold_100022	1177718	1209465	31747	g_40700	g_4798
Super-Scaffold_100022	1210730	1217574	6844	g_4798	g_4800
Super-Scaffold_100022	1217789	1247501	29712	g_4800	g_4803
Super-Scaffold_100022	1278740	1333201	54461	g_4803	g_4805
Super-Scaffold_100022	1371129	1388227	17098	g_4805	g_4806
Super-Scaffold_100022	1418723	1480179	61456	g_4806	g_4809
Super-Scaffold_100022	1483811	1488201	4390	g_4809	g_4810
Super-Scaffold_100022	1504178	1504919	741	g_4810	g_4811
Super-Scaffold_100022	1514513	1552489	37976	g_4811	g_4813
Super-Scaffold_100022	1572395	1624345	51950	g_4813	g_4814
Super-Scaffold_100022	1631715	1640576	8861	g_4814	g_4815
Super-Scaffold_100022	1682707	1713204	30497	g_4815	g_4816
Super-Scaffold_100022	1716441	1730114	13673	g_4816	g_4817
Super-Scaffold_100022	1736941	1783935	46994	g_4817	g_4818
Super-Scaffold_100022	1790410	1821585	31175	g_4818	g_4819
Super-Scaffold_100022	1825710	1826498	788	g_4819	g_43239
Super-Scaffold_100022	1832206	1897859	65653	g_43239	g_4820
Super-Scaffold_100022	1911491	1929628	18137	g_4820	g_4822
Super-Scaffold_100022	1942833	1947695	4862	g_4822	g_40704
Super-Scaffold_100022	1947898	1950254	2356	g_40704	g_4823
Super-Scaffold_100022	1953597	1954836	1239	g_4823	g_40705
Super-Scaffold_100022	1955060	1957130	2070	g_40705	g_4824
Super-Scaffold_100022	1958422	1989724	31302	g_4824	g_4825
Super-Scaffold_100022	1990059	2049321	59262	g_4825	g_4827
Super-Scaffold_100022	2080694	2085349	4655	g_4827	g_4828
Super-Scaffold_100022	2086311	2088282	1971	g_4828	g_4829
Super-Scaffold_100022	2097816	2099332	1516	g_4829	g_4830
Super-Scaffold_100022	2102601	2103047	446	g_4830	g_4831
Super-Scaffold_100022	2112104	2114748	2644	g_4831	g_4832
Super-Scaffold_100022	2115851	2119574	3723	g_4832	g_4833
Super-Scaffold_100022	2129869	2130827	958	g_4833	g_4834
Super-Scaffold_100022	2149790	2152179	2389	g_4834	g_4835
Super-Scaffold_100022	2161197	2162550	1353	g_4835	g_4836
Super-Scaffold_100022	2179718	2182143	2425	g_4836	g_4837
Super-Scaffold_100022	2182487	2182926	439	g_4837	g_4838
Super-Scaffold_100022	2184323	2187365	3042	g_4838	g_4839
Super-Scaffold_100022	2196469	2262164	65695	g_4839	g_4841
Super-Scaffold_100022	2281061	2315632	34571	g_4841	g_4842
Super-Scaffold_100022	2315913	2366312	50399	g_4842	g_4843
Super-Scaffold_100022	2367892	2456439	88547	g_4843	g_4845
Super-Scaffold_100022	2477730	2494627	16897	g_4845	g_4846
Super-Scaffold_100022	2500000	2507641	7641	g_4846	g_40710
Super-Scaffold_100022	2507877	2591375	83498	g_40710	g_4853
Super-Scaffold_100022	2595863	2599798	3935	g_4853	g_4854
Super-Scaffold_100022	2601994	2713206	111212	g_4854	g_4856
Super-Scaffold_100022	2714279	2715272	993	g_4856	g_4857
Super-Scaffold_100022	2723857	2725280	1423	g_4857	g_4858
Super-Scaffold_100022	2737101	2751325	14224	g_4858	g_4859
Super-Scaffold_100022	2765727	2766887	1160	g_4859	g_4860
Super-Scaffold_100022	2767138	2785156	18018	g_4860	g_4861
Super-Scaffold_100022	2786406	2807411	21005	g_4861	g_4862
Super-Scaffold_100022	2807794	2827001	19207	g_4862	g_4863
Super-Scaffold_100022	2830685	2832843	2158	g_4863	g_4864
Super-Scaffold_100022	2835999	2836712	713	g_4864	g_43240
Super-Scaffold_100022	2839421	2842782	3361	g_43240	g_4865
Super-Scaffold_100022	2846856	2938599	91743	g_4865	g_4870
Super-Scaffold_100022	2947800	2950100	2300	g_4870	g_4871
Super-Scaffold_100022	2956926	2959547	2621	g_4871	g_4872
Super-Scaffold_100022	2963975	3024606	60631	g_4872	g_4873
Super-Scaffold_100022	3031641	3032894	1253	g_4873	g_4874
Super-Scaffold_100022	3039134	3042304	3170	g_4874	g_43241
Super-Scaffold_100022	3062689	3082532	19843	g_43241	g_4875
Super-Scaffold_100022	3098476	3101504	3028	g_4875	g_4876
Super-Scaffold_100022	3116198	3117209	1011	g_4876	g_4877
Super-Scaffold_100022	3135354	3173360	38006	g_4877	g_4878
Super-Scaffold_100022	3182445	3185430	2985	g_4878	g_4879
Super-Scaffold_100022	3190411	3192701	2290	g_4879	g_43242
Super-Scaffold_100022	3199255	3200578	1323	g_43242	g_4880
Super-Scaffold_100022	3203550	3208776	5226	g_4880	g_4881
Super-Scaffold_100022	3217824	3228190	10366	g_4881	g_4882
Super-Scaffold_100022	3242506	3245174	2668	g_4882	g_4883
Super-Scaffold_100022	3248189	3328040	79851	g_4883	g_4885
Super-Scaffold_100022	3341812	3343044	1232	g_4885	g_4886
Super-Scaffold_100022	3345126	3350031	4905	g_4886	g_4887
Super-Scaffold_100022	3353304	3357192	3888	g_4887	g_4888
Super-Scaffold_100022	3357686	3359668	1982	g_4888	g_4889
Super-Scaffold_100022	3367055	3370153	3098	g_4889	g_4890
Super-Scaffold_100022	3372335	3373395	1060	g_4890	g_4891
Super-Scaffold_100022	3375769	3380861	5092	g_4891	g_4892
Super-Scaffold_100022	3382049	3394540	12491	g_4892	g_4893
Super-Scaffold_100022	3395303	3403463	8160	g_4893	g_4894
Super-Scaffold_100022	3404602	3423770	19168	g_4894	g_4895
Super-Scaffold_100022	3424920	3429808	4888	g_4895	g_4896
Super-Scaffold_100022	3434269	3445511	11242	g_4896	g_4897
Super-Scaffold_100022	3445979	3446959	980	g_4897	g_4898
Super-Scaffold_100022	3449625	3452447	2822	g_4898	g_4899
Super-Scaffold_100022	3453607	3454862	1255	g_4899	g_4900
Super-Scaffold_100022	3456238	3459727	3489	g_4900	g_40723
Super-Scaffold_100022	3459927	3461048	1121	g_40723	g_4901
Super-Scaffold_100022	3481379	3494940	13561	g_4901	g_4902
Super-Scaffold_100022	3496149	3500803	4654	g_4902	g_4904
Super-Scaffold_100022	3501807	3503091	1284	g_4904	g_4905
Super-Scaffold_100022	3503591	3520297	16706	g_4905	g_40724
Super-Scaffold_100022	3520518	3536219	15701	g_40724	g_4906
Super-Scaffold_100022	3551168	3551934	766	g_4906	g_4907
Super-Scaffold_100022	3564160	3564670	510	g_4907	g_4908
Super-Scaffold_100022	3568250	3571937	3687	g_4908	g_4909
Super-Scaffold_100022	3580965	3583733	2768	g_4909	g_4910
Super-Scaffold_100022	3588982	3592134	3152	g_4910	g_4911
Super-Scaffold_100022	3594406	3596620	2214	g_4911	g_4912
Super-Scaffold_100022	3604947	3607364	2417	g_4912	g_4913
Super-Scaffold_100022	3621804	3661650	39846	g_4913	g_4916
Super-Scaffold_100022	3666818	3669438	2620	g_4916	g_4917
Super-Scaffold_100022	3676472	3680075	3603	g_4917	g_4919
Super-Scaffold_100022	3690396	3690511	115	g_4919	g_40726
Super-Scaffold_100022	3690711	3691547	836	g_40726	g_4920
Super-Scaffold_100022	3729064	3738240	9176	g_4920	g_4922
Super-Scaffold_100022	3741856	3745028	3172	g_4922	g_4923
Super-Scaffold_100022	3747678	3749399	1721	g_4923	g_4924
Super-Scaffold_100022	3758385	3764947	6562	g_4924	g_4926
Super-Scaffold_100022	3771170	3775419	4249	g_4926	g_4927
Super-Scaffold_100022	3776444	3777368	924	g_4927	g_4928
Super-Scaffold_100022	3777649	3779153	1504	g_4928	g_4929
Super-Scaffold_100022	3783326	3787401	4075	g_4929	g_4930
Super-Scaffold_100022	3792665	3799834	7169	g_4930	g_4932
Super-Scaffold_100022	3801628	3806616	4988	g_4932	g_4933
Super-Scaffold_100022	3808877	3809612	735	g_4933	g_4934
Super-Scaffold_100022	3819775	3823413	3638	g_4934	g_4935
Super-Scaffold_100022	3825665	3829234	3569	g_4935	g_4936
Super-Scaffold_100022	3832156	3832886	730	g_4936	g_4937
Super-Scaffold_100022	3834032	3838274	4242	g_4937	g_4938
Super-Scaffold_100022	3847034	3848088	1054	g_4938	g_4939
Super-Scaffold_100022	3867105	3871645	4540	g_4939	g_4940
Super-Scaffold_100022	3902043	3904089	2046	g_4940	g_43243
Super-Scaffold_100022	3921547	3922942	1395	g_43243	g_4941
Super-Scaffold_100022	3931048	3937699	6651	g_4941	g_4942
Super-Scaffold_100022	3939028	3940973	1945	g_4942	g_43244
Super-Scaffold_100022	3942445	3946672	4227	g_43244	g_4943
Super-Scaffold_100022	3951124	3952345	1221	g_4943	g_4944
Super-Scaffold_100022	3955346	3991504	36158	g_4944	g_4945
Super-Scaffold_100022	3991818	4020158	28340	g_4945	g_4948
Super-Scaffold_100022	4020952	4096008	75056	g_4948	g_4953
Super-Scaffold_100022	4102394	4104530	2136	g_4953	g_4954
Super-Scaffold_100022	4106843	4109774	2931	g_4954	g_4955
Super-Scaffold_100022	4124392	4129886	5494	g_4955	g_4956
Super-Scaffold_100022	4133495	4134442	947	g_4956	g_4957
Super-Scaffold_100022	4143895	4159168	15273	g_4957	g_4959
Super-Scaffold_100022	4165641	4182985	17344	g_4959	g_4960
Super-Scaffold_100022	4184235	4196680	12445	g_4960	g_4961
Super-Scaffold_100022	4199455	4201331	1876	g_4961	g_4963
Super-Scaffold_100022	4209081	4210610	1529	g_4963	g_4964
Super-Scaffold_100022	4211222	4213677	2455	g_4964	g_4965
Super-Scaffold_100022	4228296	4232785	4489	g_4965	g_4966
Super-Scaffold_100022	4233687	4245200	11513	g_4966	g_4967
Super-Scaffold_100022	4274304	4286561	12257	g_4967	g_4968
Super-Scaffold_100022	4298081	4300188	2107	g_4968	g_4969
Super-Scaffold_100022	4309811	4313016	3205	g_4969	g_4970
Super-Scaffold_100022	4326547	4327911	1364	g_4970	g_4971
Super-Scaffold_100022	4330138	4332823	2685	g_4971	g_4972
Super-Scaffold_100022	4340829	4367863	27034	g_4972	g_4975
Super-Scaffold_100022	4368162	4398055	29893	g_4975	g_4977
Super-Scaffold_100022	4400806	4401957	1151	g_4977	g_43245
Super-Scaffold_100022	4402836	4406219	3383	g_43245	g_4978
Super-Scaffold_100022	4407262	4412760	5498	g_4978	g_4979
Super-Scaffold_100022	4414359	4421039	6680	g_4979	g_4980
Super-Scaffold_100022	4422049	4423646	1597	g_4980	g_4981
Super-Scaffold_100022	4426978	4428948	1970	g_4981	g_4982
Super-Scaffold_100022	4447215	4458170	10955	g_4982	g_4983
Super-Scaffold_100022	4462741	4476140	13399	g_4983	g_40739
Super-Scaffold_100022	4476385	4486316	9931	g_40739	g_4984
Super-Scaffold_100022	4491691	4493079	1388	g_4984	g_4985
Super-Scaffold_100022	4495825	4513805	17980	g_4985	g_4986
Super-Scaffold_100022	4525632	4528799	3167	g_4986	g_4987
Super-Scaffold_100022	4533479	4554268	20789	g_4987	g_4988
Super-Scaffold_100022	4556217	4557819	1602	g_4988	g_4989
Super-Scaffold_100022	4563798	4566454	2656	g_4989	g_4990
Super-Scaffold_100022	4567874	4567912	38	g_4990	g_43246
Super-Scaffold_100022	4576013	4626109	50096	g_43246	g_4993
Super-Scaffold_100022	4651383	4653835	2452	g_4993	g_4994
Super-Scaffold_100022	4654704	4658341	3637	g_4994	g_4995
Super-Scaffold_100022	4659208	4684907	25699	g_4995	g_4996
Super-Scaffold_100022	4689345	4693863	4518	g_4996	g_4997
Super-Scaffold_100022	4699440	4712210	12770	g_4997	g_4998
Super-Scaffold_100022	4715435	4716315	880	g_4998	g_4999
Super-Scaffold_100022	4721857	4723121	1264	g_4999	g_5000
Super-Scaffold_100022	4725582	4727399	1817	g_5000	g_5001
Super-Scaffold_100022	4735448	4739370	3922	g_5001	g_5002
Super-Scaffold_100022	4750900	4752738	1838	g_5002	g_5003
Super-Scaffold_100022	4755286	4755781	495	g_5003	g_40742
Super-Scaffold_100022	4757135	4757811	676	g_40742	g_5004
Super-Scaffold_100022	4775943	4781272	5329	g_5004	g_5006
Super-Scaffold_100022	4785172	4788417	3245	g_5006	g_5007
Super-Scaffold_100022	4791408	4793348	1940	g_5007	g_43247
Super-Scaffold_100022	4796809	4814150	17341	g_43247	g_5009
Super-Scaffold_100022	4814578	4845639	31061	g_5009	g_5011
Super-Scaffold_100022	4846283	4867526	21243	g_5011	g_5012
Super-Scaffold_100022	4884162	4892838	8676	g_5012	g_5013
Super-Scaffold_100022	4893077	5031107	138030	g_5013	g_5017
Super-Scaffold_100022	5032090	5064254	32164	g_5017	g_5018
Super-Scaffold_100022	5086643	5089004	2361	g_5018	g_43248
Super-Scaffold_100022	5093458	5275279	181821	g_43248	g_5025
Super-Scaffold_100022	5275485	5540364	264879	g_5025	g_5026
Super-Scaffold_100022	5558710	5708872	150162	g_5026	g_5027
Super-Scaffold_100022	5719508	5725874	6366	g_5027	g_40747
Super-Scaffold_100022	5726140	5729112	2972	g_40747	g_5028
Super-Scaffold_100022	5754258	5885619	131361	g_5028	g_5030
Super-Scaffold_100022	5885963	5886027	64	g_5030	g_5031
Super-Scaffold_100022	5887228	5988665	101437	g_5032	g_5034
Super-Scaffold_100022	5994819	6090295	95476	g_5034	g_5036
Super-Scaffold_100022	6093778	6096939	3161	g_5036	g_5037
Super-Scaffold_100022	6098555	6164374	65819	g_5037	g_5038
Super-Scaffold_100022	6174525	6198190	23665	g_5038	g_5039
Super-Scaffold_100022	6198567	6198644	77	g_5039	g_5040
Super-Scaffold_100022	6222936	6309854	86918	g_5040	g_5041
Super-Scaffold_100022	6317720	6319572	1852	g_5041	g_5042
Super-Scaffold_100022	6325758	6348509	22751	g_5042	g_5043
Super-Scaffold_100022	6357495	6366500	9005	g_5043	g_43249
Super-Scaffold_100022	6390838	6393531	2693	g_43249	g_43250
Super-Scaffold_100022	6396472	6402432	5960	g_43250	g_5045
Super-Scaffold_100022	6416479	6421189	4710	g_5047	g_5048
Super-Scaffold_100022	6430509	6436248	5739	g_5048	g_5049
Super-Scaffold_100022	6436520	6440065	3545	g_5049	g_5050
Super-Scaffold_100022	6459175	6463048	3873	g_5050	g_5051
Super-Scaffold_100022	6467115	6468437	1322	g_5051	g_5052
Super-Scaffold_100022	6471178	6475882	4704	g_5052	g_5053
Super-Scaffold_100022	6487820	6513387	25567	g_5053	g_5055
Super-Scaffold_100022	6520002	6521075	1073	g_5055	g_43251
Super-Scaffold_100022	6529180	6530784	1604	g_43251	g_5056
Super-Scaffold_100022	6533969	6541798	7829	g_5056	g_5057
Super-Scaffold_100022	6549907	6554628	4721	g_5057	g_43252
Super-Scaffold_100022	6561161	6562078	917	g_43252	g_5058
Super-Scaffold_100022	6563551	6564597	1046	g_5058	g_5059
Super-Scaffold_100022	6569075	6570287	1212	g_5059	g_5060
Super-Scaffold_100022	6576031	6576698	667	g_5060	g_5061
Super-Scaffold_100022	6580327	6582185	1858	g_5061	g_43253
Super-Scaffold_100022	6585915	6606525	20610	g_43253	g_5062
Super-Scaffold_100022	6622625	6634229	11604	g_5062	g_5063
Super-Scaffold_100022	6668093	6673296	5203	g_5063	g_5064
Super-Scaffold_100022	6675988	6678455	2467	g_5064	g_43254
Super-Scaffold_100022	6680318	6684844	4526	g_43254	g_5065
Super-Scaffold_100022	6690908	6692895	1987	g_5065	g_5066
Super-Scaffold_100022	6694690	6695991	1301	g_5066	g_5067
Super-Scaffold_100022	6705606	6709049	3443	g_5067	g_5068
Super-Scaffold_100022	6711425	6722037	10612	g_5068	g_5069
Super-Scaffold_100022	6735463	6740627	5164	g_5069	g_5070
Super-Scaffold_100022	6751534	6756888	5354	g_5070	g_40750
Super-Scaffold_100022	6758399	6805120	46721	g_40750	g_5073
Super-Scaffold_100022	6849174	6851952	2778	g_5073	g_5074
Super-Scaffold_100022	6858078	6907093	49015	g_5074	g_5076
Super-Scaffold_100022	6908598	6914921	6323	g_5076	g_5077
Super-Scaffold_100022	6934510	6955218	20708	g_5077	g_5078
Super-Scaffold_100022	6977395	7042051	64656	g_5078	g_5079
Super-Scaffold_100022	7049723	7053018	3295	g_5079	g_5080
Super-Scaffold_100022	7066246	7068960	2714	g_5080	g_5081
Super-Scaffold_100022	7072695	7076323	3628	g_5081	g_5082
Super-Scaffold_100022	7084165	7085311	1146	g_5082	g_5083
Super-Scaffold_100022	7094842	7097737	2895	g_5083	g_43255
Super-Scaffold_100022	7101050	7103849	2799	g_43255	g_5084
Super-Scaffold_100022	7108975	7110734	1759	g_5084	g_5085
Super-Scaffold_100022	7116244	7119267	3023	g_5085	g_5086
Super-Scaffold_100022	7136464	7171997	35533	g_5086	g_5090
Super-Scaffold_100022	7178879	7180929	2050	g_5090	g_5091
Super-Scaffold_100022	7191115	7193034	1919	g_5091	g_5092
Super-Scaffold_100022	7193450	7197604	4154	g_5092	g_43256
Super-Scaffold_100022	7199783	7201181	1398	g_43256	g_5093
Super-Scaffold_100022	7216701	7216929	228	g_5093	g_5094
Super-Scaffold_100022	7232789	7237769	4980	g_5094	g_5095
Super-Scaffold_100022	7238038	7252926	14888	g_5095	g_5096
Super-Scaffold_100022	7256568	7262328	5760	g_5096	g_5097
Super-Scaffold_100022	7267233	7267588	355	g_5097	g_5098
Super-Scaffold_100022	7273609	7274965	1356	g_5098	g_5099
Super-Scaffold_100022	7286178	7299331	13153	g_5099	g_5100
Super-Scaffold_100022	7306078	7330292	24214	g_5100	g_5102
Super-Scaffold_100022	7331548	7374180	42632	g_5102	g_5104
Super-Scaffold_100022	7376741	7380566	3825	g_5104	g_5106
Super-Scaffold_100022	7380886	7381182	296	g_5106	g_5107
Super-Scaffold_100022	7409701	7410351	650	g_5107	g_43257
Super-Scaffold_100022	7419700	7421043	1343	g_43257	g_5108
Super-Scaffold_100022	7431132	7436627	5495	g_5108	g_43258
Super-Scaffold_100022	7467064	7472470	5406	g_43258	g_5109
Super-Scaffold_100022	7473482	7475660	2178	g_5109	g_5110
Super-Scaffold_100022	7478500	7478913	413	g_5110	g_5111
Super-Scaffold_100022	7482323	7484938	2615	g_5111	g_5112
Super-Scaffold_100022	7488186	7536353	48167	g_5112	g_5113
Super-Scaffold_100022	7540253	7541669	1416	g_5113	g_5114
Super-Scaffold_100022	7544193	7545008	815	g_5114	g_5115
Super-Scaffold_100022	7547256	7553331	6075	g_5115	g_5116
Super-Scaffold_100022	7554612	7574625	20013	g_5116	g_5119
Super-Scaffold_100022	7576153	7590207	14054	g_5119	g_5121
Super-Scaffold_100022	7598619	7601220	2601	g_5121	g_5122
Super-Scaffold_100022	7611721	7613468	1747	g_5122	g_5123
Super-Scaffold_100022	7627836	7629165	1329	g_5123	g_5124
Super-Scaffold_100022	7635316	7668264	32948	g_5124	g_5127
Super-Scaffold_100022	7668647	7684126	15479	g_5127	g_5130
Super-Scaffold_100022	7684530	7684644	114	g_5130	g_5131
Super-Scaffold_100022	7685270	7690209	4939	g_5131	g_5129
Super-Scaffold_100022	7701144	7713694	12550	g_5129	g_5133
Super-Scaffold_100022	7715292	7717098	1806	g_5133	g_43259
Super-Scaffold_100022	7724330	7726808	2478	g_43259	g_5134
Super-Scaffold_100022	7734563	7734645	82	g_5134	g_43260
Super-Scaffold_100022	7735046	7743447	8401	g_43260	g_5135
Super-Scaffold_100022	7745018	7756313	11295	g_5135	g_5136
Super-Scaffold_100022	7756522	7841172	84650	g_5136	g_5138
Super-Scaffold_100022	7855462	7873113	17651	g_5138	g_5140
Super-Scaffold_100022	7875081	7876809	1728	g_5140	g_5141
Super-Scaffold_100022	7910621	7926969	16348	g_5141	g_5142
Super-Scaffold_100022	7937419	7948086	10667	g_5142	g_5143
Super-Scaffold_100022	7954525	7957393	2868	g_5143	g_43261
Super-Scaffold_100022	7969967	7974937	4970	g_43261	g_5146
Super-Scaffold_100022	7978808	7981136	2328	g_5146	g_5147
Super-Scaffold_100022	7985665	7987685	2020	g_5147	g_5148
Super-Scaffold_100022	7993716	8008671	14955	g_5148	g_5149
Super-Scaffold_100022	8032485	8034891	2406	g_5149	g_43262
Super-Scaffold_100022	8035774	8038033	2259	g_43262	g_5150
Super-Scaffold_100022	8039933	8051902	11969	g_5150	g_5151
Super-Scaffold_100022	8052361	8057028	4667	g_5151	g_43263
Super-Scaffold_100022	8057501	8071456	13955	g_43263	g_5152
Super-Scaffold_100022	8071939	8073677	1738	g_5152	g_43264
Super-Scaffold_100022	8073886	8094719	20833	g_43264	g_5153
Super-Scaffold_100022	8102685	8105490	2805	g_5153	g_5154
Super-Scaffold_100022	8113757	8138346	24589	g_5154	g_5155
Super-Scaffold_100022	8160425	8176768	16343	g_5155	g_5156
Super-Scaffold_100022	8187559	8195362	7803	g_5156	g_5157
Super-Scaffold_100022	8197517	8242550	45033	g_5157	g_5158
Super-Scaffold_100022	8260248	8262582	2334	g_5158	g_43265
Super-Scaffold_100022	8264393	8267277	2884	g_43265	g_5160
Super-Scaffold_100022	8295765	8298793	3028	g_5160	g_5161
Super-Scaffold_100022	8307310	8313819	6509	g_5161	g_43266
Super-Scaffold_100022	8316029	8320734	4705	g_43266	g_5162
Super-Scaffold_100022	8322692	8336305	13613	g_5162	g_5163
Super-Scaffold_100022	8336559	8338830	2271	g_5163	g_5164
Super-Scaffold_100022	8339267	8355985	16718	g_5164	g_40769
Super-Scaffold_100022	8356200	8364208	8008	g_40769	g_5167
Super-Scaffold_100022	8364630	8399566	34936	g_5167	g_5171
Super-Scaffold_100022	8413562	8414724	1162	g_5171	g_43267
Super-Scaffold_100022	8421549	8425438	3889	g_43267	g_5172
Super-Scaffold_100022	8434393	8440912	6519	g_5172	g_5173
Super-Scaffold_100022	8449671	8452761	3090	g_5173	g_5174
Super-Scaffold_100022	8462278	8462605	327	g_5174	g_5175
Super-Scaffold_100022	8462979	8465508	2529	g_5175	g_5176
Super-Scaffold_100022	8483458	8599117	115659	g_5176	g_5177
Super-Scaffold_100022	8602773	8687305	84532	g_5177	g_5179
Super-Scaffold_100022	8699948	8748900	48952	g_5179	g_5181
Super-Scaffold_100022	8768079	8812479	44400	g_5181	g_5183
Super-Scaffold_100022	8812679	8878116	65437	g_5183	g_5185
Super-Scaffold_100022	8880804	8886393	5589	g_5185	g_5186
Super-Scaffold_100022	8898030	8910176	12146	g_5186	g_5188
Super-Scaffold_100022	8912838	8915599	2761	g_5188	g_43268
Super-Scaffold_100022	8923609	8935855	12246	g_43268	g_43269
Super-Scaffold_100022	8939837	8939858	21	g_43269	g_5189
Super-Scaffold_100022	8944450	8970037	25587	g_5189	g_5191
Super-Scaffold_100022	8975612	8976190	578	g_5192	g_5193
Super-Scaffold_100022	8977308	8977481	173	g_5193	g_5194
Super-Scaffold_100022	8978823	8978988	165	g_5194	g_5195
Super-Scaffold_100022	8982327	8985440	3113	g_5195	g_5196
Super-Scaffold_100022	8986474	8991830	5356	g_5196	g_43270
Super-Scaffold_100022	8998942	9026045	27103	g_43270	g_40773
Super-Scaffold_100022	9026272	9316468	290196	g_40773	g_5200
Super-Scaffold_100022	9331200	9384368	53168	g_5200	g_40775
Super-Scaffold_100022	9387283	9401002	13719	g_5202	g_5204
Super-Scaffold_100022	9403082	9407377	4295	g_5204	g_5205
Super-Scaffold_100022	9411119	9443477	32358	g_5205	g_5206
Super-Scaffold_100022	9445858	9513965	68107	g_5206	g_5207
Super-Scaffold_100022	9514442	9516708	2266	g_5207	g_5208
Super-Scaffold_100022	9517772	9519757	1985	g_5208	g_5209
Super-Scaffold_100022	9524025	9566270	42245	g_5209	g_5210
Super-Scaffold_100022	9570291	9572971	2680	g_5210	g_5211
Super-Scaffold_100022	9581979	9613443	31464	g_5211	g_43271
Super-Scaffold_100022	9613760	9619538	5778	g_43271	g_5213
Super-Scaffold_100022	9619804	9620624	820	g_5213	g_5214
Super-Scaffold_100022	9620995	9621001	6	g_5214	g_5215
Super-Scaffold_100022	9621327	9621393	66	g_5215	g_5216
Super-Scaffold_100022	9621869	9628382	6513	g_5216	g_5212
Super-Scaffold_100022	9634348	9636615	2267	g_5212	g_5217
Super-Scaffold_100022	9636908	9637011	103	g_5217	g_5218
Super-Scaffold_100022	9637274	9637373	99	g_5218	g_5219
Super-Scaffold_100022	9637981	9638142	161	g_5219	g_5220
Super-Scaffold_100022	9638618	9643396	4778	g_5220	g_5222
Super-Scaffold_100022	9643740	9649998	6258	g_5222	g_43272
Super-Scaffold_100022	9655829	9662770	6941	g_43272	g_5223
Super-Scaffold_100022	9663837	9664207	370	g_5223	g_5224
Super-Scaffold_100022	9665796	9671524	5728	g_5224	g_5226
Super-Scaffold_100022	9672102	9675152	3050	g_5226	g_5227
Super-Scaffold_100022	9681816	9684506	2690	g_5227	g_5228
Super-Scaffold_100022	9691344	9692065	721	g_5228	g_5229
Super-Scaffold_100022	9697214	9700175	2961	g_5229	g_5230
Super-Scaffold_100022	9705085	9732141	27056	g_5230	g_5232
Super-Scaffold_100022	9737954	9741888	3934	g_5232	g_43273
Super-Scaffold_100022	9752897	9755059	2162	g_43273	g_5233
Super-Scaffold_100022	9759309	9760279	970	g_5233	g_5234
Super-Scaffold_100022	9766826	9768272	1446	g_5234	g_5235
Super-Scaffold_100022	9785670	9794817	9147	g_5235	g_5236
Super-Scaffold_100022	9799714	9817096	17382	g_5236	g_5237
Super-Scaffold_100022	9828680	9904208	75528	g_5237	g_5239
Super-Scaffold_100022	9907170	9911508	4338	g_5239	g_5240
Super-Scaffold_100022	9917518	9935719	18201	g_5240	g_43274
Super-Scaffold_100022	9947860	10019471	71611	g_43274	g_5243
Super-Scaffold_100022	10023088	10023984	896	g_5243	g_5244
Super-Scaffold_100022	10025836	10026944	1108	g_5244	g_43275
Super-Scaffold_100022	10037671	10126525	88854	g_43275	g_5248
Super-Scaffold_100022	10128647	10130252	1605	g_5248	g_5249
Super-Scaffold_100022	10132035	10139374	7339	g_5249	g_5250
Super-Scaffold_100022	10145392	10241366	95974	g_5250	g_5252
Super-Scaffold_100022	10258241	10268032	9791	g_5252	g_5253
Super-Scaffold_100022	10277618	10285091	7473	g_5253	g_5254
Super-Scaffold_100022	10285477	10288461	2984	g_5254	g_5255
Super-Scaffold_100022	10313299	10386700	73401	g_5255	g_5257
Super-Scaffold_100022	10388373	10416908	28535	g_5257	g_5258
Super-Scaffold_100022	10418560	10428524	9964	g_5258	g_5260
Super-Scaffold_100022	10431585	10480019	48434	g_5260	g_5261
Super-Scaffold_100022	10480531	10482283	1752	g_5261	g_5262
Super-Scaffold_100022	10484864	10494097	9233	g_5262	g_5263
Super-Scaffold_100022	10495554	10509132	13578	g_5263	g_5264
Super-Scaffold_100022	10510710	10512493	1783	g_5264	g_5265
Super-Scaffold_100022	10514344	10541496	27152	g_5265	g_5266
Super-Scaffold_100022	10543260	10592058	48798	g_5266	g_5268
Super-Scaffold_100022	10593909	10658790	64881	g_5268	g_5270
Super-Scaffold_100022	10660589	10666845	6256	g_5270	g_5271
Super-Scaffold_100022	10670670	10675536	4866	g_5271	g_5272
Super-Scaffold_100022	10691051	10694597	3546	g_5272	g_5273
Super-Scaffold_100022	10724078	10740658	16580	g_5273	g_5276
Super-Scaffold_100022	10742128	10743484	1356	g_5276	g_5277
Super-Scaffold_100022	10743828	10758317	14489	g_5277	g_5280
Super-Scaffold_100022	10758787	10797693	38906	g_5280	g_5282
Super-Scaffold_100022	10810219	10825147	14928	g_5282	g_5283
Super-Scaffold_100022	10842828	10871140	28312	g_5283	g_5284
Super-Scaffold_100022	10872729	10873117	388	g_5284	g_5285
Super-Scaffold_100022	10875153	10905072	29919	g_5285	g_5286
Super-Scaffold_100022	10910562	10921221	10659	g_5286	g_5287
Super-Scaffold_100022	10921715	11017923	96208	g_5287	g_5289
Super-Scaffold_100022	11019239	11020205	966	g_5289	g_5290
Super-Scaffold_100022	11020720	11021013	293	g_5290	g_40785
Super-Scaffold_100022	11022480	11040342	17862	g_5291	g_40786
Super-Scaffold_100022	11042216	11085747	43531	g_5292	g_5293
Super-Scaffold_100022	11088139	11088731	592	g_5293	g_5294
Super-Scaffold_100022	11089192	11098830	9638	g_5294	g_43276
Super-Scaffold_100022	11100448	11220973	120525	g_43276	g_5295
Super-Scaffold_100022	11221749	11221860	111	g_5295	g_5296
Super-Scaffold_100022	11222546	11293348	70802	g_5296	g_5299
Super-Scaffold_100022	11296048	11338144	42096	g_5299	g_5300
Super-Scaffold_100022	11338692	11339601	909	g_5300	g_5301
Super-Scaffold_100022	11340344	11419818	79474	g_5301	g_5302
Super-Scaffold_100022	11422261	11428326	6065	g_5302	g_5303
Super-Scaffold_100022	11429482	11468577	39095	g_5303	g_43277
Super-Scaffold_100022	11481667	11573914	92247	g_43277	g_5305
Super-Scaffold_100022	11577271	11689684	112413	g_5305	g_5308
Super-Scaffold_100022	11705711	11719949	14238	g_5308	g_43278
Super-Scaffold_100022	11727135	11782570	55435	g_43278	g_5309
Super-Scaffold_100022	11792064	11807628	15564	g_5309	g_5310
Super-Scaffold_100022	11808152	11858882	50730	g_5310	g_5312
Super-Scaffold_100022	11859712	11862485	2773	g_5312	g_5313
Super-Scaffold_100022	11865282	11918962	53680	g_5313	g_5315
Super-Scaffold_100022	11925926	11926656	730	g_5315	g_5316
Super-Scaffold_100022	11927210	11927577	367	g_5316	g_5317
Super-Scaffold_100022	11928485	11955343	26858	g_5317	g_5318
Super-Scaffold_100022	11955966	11956007	41	g_5318	g_43279
Super-Scaffold_100022	11956246	11973590	17344	g_43279	g_40788
Super-Scaffold_100022	11974417	11986208	11791	g_5320	g_5321
Super-Scaffold_100022	11992975	12114902	121927	g_5321	g_5322
Super-Scaffold_100022	12115120	12437337	322217	g_5322	g_5324
Super-Scaffold_100022	12438164	12464153	25989	g_5324	g_5325
Super-Scaffold_100022	12465755	12465829	74	g_5325	g_5326
Super-Scaffold_100022	12466332	12568476	102144	g_5326	g_5327
Super-Scaffold_100022	12570455	12640809	70354	g_5327	g_5328
Super-Scaffold_100022	12641627	12641956	329	g_5328	g_5329
Super-Scaffold_100022	12642264	12642760	496	g_5329	g_5331
Super-Scaffold_100022	12643227	12643378	151	g_5331	g_5330
Super-Scaffold_100022	12644175	12914733	270558	g_5330	g_5332
Super-Scaffold_100022	12915935	13109950	194015	g_5332	g_5334
Super-Scaffold_100022	13110987	13164291	53304	g_5334	g_5336
Super-Scaffold_100022	13164668	13245180	80512	g_5336	g_5338
Super-Scaffold_100022	13255702	13271646	15944	g_5338	g_5339
Super-Scaffold_100022	13290261	13293440	3179	g_5339	g_5340
Super-Scaffold_100022	13299707	13300879	1172	g_5340	g_5341
Super-Scaffold_100022	13302835	13303733	898	g_5341	g_5342
Super-Scaffold_100022	13306063	13324095	18032	g_5342	g_5343
Super-Scaffold_100022	13324298	13325665	1367	g_5343	g_5344
Super-Scaffold_100022	13338220	13345102	6882	g_5344	g_43280
Super-Scaffold_100022	13346619	13361552	14933	g_43280	g_43281
Super-Scaffold_100022	13370644	13371307	663	g_43281	g_40791
Super-Scaffold_100022	13371576	13422855	51279	g_40791	g_5345
Super-Scaffold_100022	13445763	13515723	69960	g_5345	g_5349
Super-Scaffold_100022	13520992	13654063	133071	g_5349	g_5351
Super-Scaffold_100022	13711721	13713493	1772	g_5351	g_5352
Super-Scaffold_100022	13714095	13714257	162	g_5352	g_5353
Super-Scaffold_100022	13715270	13722501	7231	g_5353	g_5354
Super-Scaffold_100022	13737838	13743496	5658	g_5354	g_5356
Super-Scaffold_100022	13747111	13758689	11578	g_5356	g_5357
Super-Scaffold_100022	13758940	13775062	16122	g_5357	g_40794
Super-Scaffold_100022	13775271	13785682	10411	g_40794	g_5358
Super-Scaffold_100022	13816860	13868523	51663	g_5358	g_5360
Super-Scaffold_100022	13884355	13891409	7054	g_5360	g_5361
Super-Scaffold_100022	13893354	13906338	12984	g_5361	g_40797
Super-Scaffold_100022	13906583	13924247	17664	g_40797	g_5364
Super-Scaffold_100022	13942213	13971942	29729	g_5364	g_5365
Super-Scaffold_100022	13984324	14038866	54542	g_5365	g_5368
Super-Scaffold_100022	14039132	14066630	27498	g_5368	g_5369
Super-Scaffold_100022	14069124	14096999	27875	g_5369	g_5370
Super-Scaffold_100022	14097277	14119646	22369	g_5370	g_5371
Super-Scaffold_100022	14161051	14203729	42678	g_5371	g_5372
Super-Scaffold_100022	14205070	14244476	39406	g_5372	g_5373
Super-Scaffold_100022	14250157	14250628	471	g_5373	g_5374
Super-Scaffold_100022	14259485	14298733	39248	g_5374	g_5376
Super-Scaffold_100022	14299011	14299126	115	g_5376	g_5377
Super-Scaffold_100022	14307785	14490683	182898	g_5377	g_5378
Super-Scaffold_100022	14490970	14534817	43847	g_5378	g_40809
Super-Scaffold_100022	14535068	14600034	64966	g_40809	g_5380
Super-Scaffold_100022	14600282	14611966	11684	g_5380	g_5382
Super-Scaffold_100022	14641221	14732696	91475	g_5382	g_5385
Super-Scaffold_100022	14737100	14748681	11581	g_5385	g_43282
Super-Scaffold_100022	14770169	14823103	52934	g_43282	g_5386
Super-Scaffold_100022	14830479	14842324	11845	g_5386	g_5388
Super-Scaffold_100022	14863416	14886210	22794	g_5388	g_5390
Super-Scaffold_100022	14895001	14898394	3393	g_5390	g_5391
Super-Scaffold_100022	14906083	14978054	71971	g_5391	g_5394
Super-Scaffold_100022	14979663	15016851	37188	g_5394	g_5396
Super-Scaffold_100022	15017102	15100647	83545	g_5396	g_40821
Super-Scaffold_100022	15100910	15118827	17917	g_40821	g_5399
Super-Scaffold_100022	15132099	15210993	78894	g_5399	g_5400
Super-Scaffold_100022	15222467	15230898	8431	g_5400	g_43283
Super-Scaffold_100022	15255437	15345572	90135	g_43283	g_5403
Super-Scaffold_100022	15345799	15419771	73972	g_5403	g_5404
Super-Scaffold_100022	15428157	15432813	4656	g_5404	g_5405
Super-Scaffold_100022	15436445	15458570	22125	g_5405	g_5406
Super-Scaffold_100022	15469922	15476525	6603	g_5406	g_5407
Super-Scaffold_100022	15477888	15483027	5139	g_5407	g_43284
Super-Scaffold_100022	15485217	15490164	4947	g_43284	g_5408
Super-Scaffold_100022	15491909	15503138	11229	g_5408	g_5411
Super-Scaffold_100022	15504028	15595068	91040	g_5411	g_5413
Super-Scaffold_100022	15595319	15595680	361	g_5413	g_40829
Super-Scaffold_100022	15595883	15617169	21286	g_40829	g_40831
Super-Scaffold_100022	15617432	15752332	134900	g_40831	g_5415
Super-Scaffold_100022	15756047	15779659	23612	g_5415	g_5417
Super-Scaffold_100022	15780024	15821978	41954	g_5417	g_5420
Super-Scaffold_100022	15830681	15930559	99878	g_40836	g_5424
Super-Scaffold_100022	15930861	15972209	41348	g_5424	g_5427
Super-Scaffold_100022	15972439	16028749	56310	g_5427	g_5428
Super-Scaffold_100022	16030806	16087886	57080	g_5428	g_5430
Super-Scaffold_100022	16102637	16104539	1902	g_5430	g_5431
Super-Scaffold_100022	16106702	16108545	1843	g_5431	g_5432
Super-Scaffold_100022	16116001	16118287	2286	g_5432	g_5433
Super-Scaffold_100022	16125019	16128096	3077	g_5433	g_43285
Super-Scaffold_100022	16132592	16134009	1417	g_43285	g_5434
Super-Scaffold_100022	16136837	16140154	3317	g_5434	g_5435
Super-Scaffold_100022	16153837	16160499	6662	g_5435	g_43286
Super-Scaffold_100022	16163725	16180173	16448	g_43286	g_5436
Super-Scaffold_100022	16181087	16195970	14883	g_5436	g_5437
Super-Scaffold_100022	16204885	16207575	2690	g_5437	g_5438
Super-Scaffold_100022	16211965	16213917	1952	g_5438	g_5439
Super-Scaffold_100022	16218367	16222405	4038	g_5439	g_43287
Super-Scaffold_100022	16227602	16229081	1479	g_43287	g_5440
Super-Scaffold_100022	16231968	16240360	8392	g_5440	g_5441
Super-Scaffold_100022	16253783	16302028	48245	g_5441	g_5442
Super-Scaffold_100022	16308590	16309818	1228	g_5442	g_5443
Super-Scaffold_100022	16310674	16314689	4015	g_5443	g_43288
Super-Scaffold_100022	16315611	16319635	4024	g_43288	g_43289
Super-Scaffold_100022	16320527	16330427	9900	g_43289	g_5444
Super-Scaffold_100022	16331319	16335346	4027	g_40841	g_5445
Super-Scaffold_100022	16336238	16340456	4218	g_40842	g_5446
Super-Scaffold_100022	16341348	16345644	4296	g_5446	g_5447
Super-Scaffold_100022	16347009	16349211	2202	g_5447	g_5448
Super-Scaffold_100022	16354616	16355716	1100	g_5448	g_5449
Super-Scaffold_100022	16358174	16363650	5476	g_5449	g_43290
Super-Scaffold_100022	16365830	16366170	340	g_43290	g_5450
Super-Scaffold_100022	16369853	16370796	943	g_5450	g_5451
Super-Scaffold_100022	16375380	16382453	7073	g_5451	g_5452
Super-Scaffold_100022	16385525	16385909	384	g_5452	g_43291
Super-Scaffold_100022	16396000	16486069	90069	g_43291	g_5454
Super-Scaffold_100022	16493156	16531894	38738	g_5454	g_5455
Super-Scaffold_100022	16537953	16571590	33637	g_5455	g_5457
Super-Scaffold_100022	16638451	16645459	7008	g_5457	g_5458
Super-Scaffold_100022	16645836	16646023	187	g_5458	g_5459
Super-Scaffold_100022	16646898	16647231	333	g_5459	g_5460
Super-Scaffold_100022	16648262	16649848	1586	g_5460	g_5463
Super-Scaffold_100022	16650600	16660741	10141	g_5463	g_5464
Super-Scaffold_100022	16669825	16793742	123917	g_5464	g_5465
Super-Scaffold_100022	16793963	16827976	34013	g_5465	g_5466
Super-Scaffold_100022	16829031	16876885	47854	g_5466	g_5469
Super-Scaffold_100022	16877520	16940392	62872	g_5469	g_5474
Super-Scaffold_100022	16947934	17018528	70594	g_5474	g_5475
Super-Scaffold_100022	17022218	17026117	3899	g_5475	g_5476
Super-Scaffold_100022	17033789	17039333	5544	g_5476	g_5477
Super-Scaffold_100022	17042276	17048777	6501	g_5477	g_5478
Super-Scaffold_100022	17050612	17053044	2432	g_5478	g_5479
Super-Scaffold_100022	17054471	17057146	2675	g_5479	g_43292
Super-Scaffold_100022	17061873	17066925	5052	g_43292	g_5480
Super-Scaffold_100022	17080558	17081762	1204	g_5480	g_5481
Super-Scaffold_100022	17088715	17090069	1354	g_5481	g_43293
Super-Scaffold_100022	17102304	17133850	31546	g_43293	g_40849
Super-Scaffold_100022	17134092	17198618	64526	g_40849	g_5484
Super-Scaffold_100022	17207904	17304211	96307	g_5484	g_5486
Super-Scaffold_100022	17305980	17307152	1172	g_5486	g_43294
Super-Scaffold_100022	17311159	17360967	49808	g_43294	g_5487
Super-Scaffold_100022	17366795	17383024	16229	g_5487	g_5488
Super-Scaffold_100022	17390903	17393302	2399	g_5488	g_5489
Super-Scaffold_100022	17394765	17397727	2962	g_5489	g_5490
Super-Scaffold_100022	17407731	17414038	6307	g_5490	g_5491
Super-Scaffold_100022	17427752	17434058	6306	g_5491	g_5492
Super-Scaffold_100022	17435040	17436304	1264	g_5492	g_5493
Super-Scaffold_100022	17440008	17441352	1344	g_5493	g_5494
Super-Scaffold_100022	17441558	17441710	152	g_5494	g_5495
Super-Scaffold_100022	17452083	17455473	3390	g_5495	g_5496
Super-Scaffold_100022	17464868	17466922	2054	g_5496	g_5497
Super-Scaffold_100022	17467972	17471632	3660	g_5497	g_5498
Super-Scaffold_100022	17483145	17485497	2352	g_5498	g_5499
Super-Scaffold_100022	17487321	17488031	710	g_5499	g_5500
Super-Scaffold_100022	17492288	17496599	4311	g_5500	g_5501
Super-Scaffold_100022	17505972	17627066	121094	g_5501	g_5502
Super-Scaffold_100022	17627458	17632551	5093	g_5502	g_5503
Super-Scaffold_100022	17634528	17636076	1548	g_5503	g_5504
Super-Scaffold_100022	17637444	17641195	3751	g_5504	g_5505
Super-Scaffold_100022	17644731	17647499	2768	g_5505	g_5506
Super-Scaffold_100022	17652944	17654207	1263	g_5506	g_5507
Super-Scaffold_100022	17656524	17661034	4510	g_5507	g_5508
Super-Scaffold_100022	17669975	17670813	838	g_5508	g_5509
Super-Scaffold_100022	17672244	17674801	2557	g_5509	g_5510
Super-Scaffold_100022	17688871	17699464	10593	g_5510	g_5512
Super-Scaffold_100022	17705885	17706983	1098	g_5512	g_43295
Super-Scaffold_100022	17722304	17747622	25318	g_43295	g_5514
Super-Scaffold_100022	17763413	17765842	2429	g_5514	g_5515
Super-Scaffold_100022	17771242	17785162	13920	g_5515	g_5517
Super-Scaffold_100022	17791223	17814822	23599	g_5517	g_5521
Super-Scaffold_100022	17820112	17844127	24015	g_5521	g_5523
Super-Scaffold_100022	17844399	17866397	21998	g_5523	g_5524
Super-Scaffold_100022	17871761	17940111	68350	g_5524	g_5526
Super-Scaffold_100022	17940350	17951560	11210	g_5526	g_5528
Super-Scaffold_100022	17951760	18124989	173229	g_5528	g_5536
Super-Scaffold_100022	18125366	18184788	59422	g_5536	g_5539
Super-Scaffold_100022	18185042	18194100	9058	g_5539	g_5540
Super-Scaffold_100022	18203519	18209348	5829	g_5540	g_5541
Super-Scaffold_100022	18210364	18211188	824	g_5541	g_5542
Super-Scaffold_100022	18219074	18222743	3669	g_5542	g_5543
Super-Scaffold_100022	18226689	18274311	47622	g_5543	g_5544
Super-Scaffold_100022	18286761	18292861	6100	g_5544	g_5545
Super-Scaffold_100022	18298605	18300412	1807	g_5545	g_5546
Super-Scaffold_100022	18301367	18307740	6373	g_5546	g_5547
Super-Scaffold_100022	18314861	18328708	13847	g_5547	g_5548
Super-Scaffold_100022	18329157	18535918	206761	g_5548	g_5551
Super-Scaffold_100022	18552899	18562205	9306	g_5551	g_40862
Super-Scaffold_100022	18572938	18592696	19758	g_40862	g_5553
Super-Scaffold_100022	18593208	18600084	6876	g_5553	g_5554
Super-Scaffold_100022	18603531	18606004	2473	g_5554	g_43296
Super-Scaffold_100022	18616570	18617593	1023	g_43296	g_5555
Super-Scaffold_100022	18626942	18638637	11695	g_5555	g_5556
Super-Scaffold_100022	18640682	18650432	9750	g_5556	g_5557
Super-Scaffold_100022	18652908	18695286	42378	g_5557	g_5558
Super-Scaffold_100022	18696278	18847504	151226	g_5558	g_5561
Super-Scaffold_100022	18847956	18869446	21490	g_5561	g_5562
Super-Scaffold_100022	18875263	18905160	29897	g_5562	g_43297
Super-Scaffold_100022	18924820	18941678	16858	g_43297	g_40870
Super-Scaffold_100022	18941968	18988972	47004	g_40870	g_5565
Super-Scaffold_100022	19039987	19087322	47335	g_5565	g_5567
Super-Scaffold_100022	19094911	19099485	4574	g_5567	g_5568
Super-Scaffold_100022	19100432	19103112	2680	g_5568	g_5569
Super-Scaffold_100022	19113438	19114569	1131	g_5569	g_5570
Super-Scaffold_100022	19127734	19131000	3266	g_5570	g_5571
Super-Scaffold_100022	19144989	19149061	4072	g_5571	g_5572
Super-Scaffold_100022	19161185	19165124	3939	g_5572	g_43298
Super-Scaffold_100022	19175961	19178470	2509	g_43298	g_5573
Super-Scaffold_100022	19179693	19218859	39166	g_5573	g_5575
Super-Scaffold_100022	19220052	19221924	1872	g_5575	g_5577
Super-Scaffold_100022	19222502	19222762	260	g_5577	g_5578
Super-Scaffold_100022	19223523	19295855	72332	g_5578	g_5580
Super-Scaffold_100022	19296061	19474514	178453	g_5580	g_5583
Super-Scaffold_100022	19475864	19478778	2914	g_5583	g_5584
Super-Scaffold_100022	19497949	19595843	97894	g_5584	g_5587
Super-Scaffold_100022	19607941	19613948	6007	g_5587	g_5588
Super-Scaffold_100022	19615232	19640661	25429	g_5588	g_5590
Super-Scaffold_100022	19641940	19647469	5529	g_5590	g_5591
Super-Scaffold_100022	19649303	19650372	1069	g_5591	g_5592
Super-Scaffold_100022	19657313	19659321	2008	g_5592	g_5593
Super-Scaffold_100022	19659524	19673297	13773	g_5593	g_43299
Super-Scaffold_100022	19684751	19694486	9735	g_43299	g_5594
Super-Scaffold_100022	19702449	19704835	2386	g_5594	g_5595
Super-Scaffold_100022	19710417	19715338	4921	g_5595	g_43300
Super-Scaffold_100022	19719151	19732789	13638	g_43300	g_40876
Super-Scaffold_100022	19733001	19795300	62299	g_40876	g_5599
Super-Scaffold_100022	19795506	19799312	3806	g_5599	g_5600
Super-Scaffold_100022	19801591	19814897	13306	g_5600	g_5602
Super-Scaffold_100022	19838092	19841009	2917	g_5602	g_5603
Super-Scaffold_100022	19841296	19841648	352	g_5603	g_5604
Super-Scaffold_100022	19869344	19871737	2393	g_5604	g_5605
Super-Scaffold_100022	19872834	19886062	13228	g_5605	g_43301
Super-Scaffold_100022	19887370	19902113	14743	g_43301	g_5606
Super-Scaffold_100022	19903169	19918909	15740	g_5606	g_5607
Super-Scaffold_100022	19920036	19920946	910	g_5607	g_5608
Super-Scaffold_100022	19928091	19938533	10442	g_5608	g_5609
Super-Scaffold_100022	19939966	19940876	910	g_5609	g_5610
Super-Scaffold_100022	19948039	19958379	10340	g_5610	g_40878
Super-Scaffold_100022	19958882	19960161	1279	g_40878	g_5611
Super-Scaffold_100022	19967243	19977481	10238	g_5611	g_5612
Super-Scaffold_100022	19978251	19979147	896	g_5612	g_5613
Super-Scaffold_100022	19991531	19991810	279	g_5613	g_43302
Super-Scaffold_100022	19995876	19996221	345	g_43302	g_5614
Super-Scaffold_100022	19997155	20041367	44212	g_5614	g_43303
Super-Scaffold_100022	20055123	20062396	7273	g_43303	g_5615
Super-Scaffold_100022	20064032	20076331	12299	g_5615	g_5619
Super-Scaffold_100022	20078029	20082486	4457	g_5619	g_5620
Super-Scaffold_100022	20084802	20089872	5070	g_5620	g_5623
Super-Scaffold_100022	20091854	20097012	5158	g_5623	g_5625
Super-Scaffold_100022	20097636	20099734	2098	g_5625	g_5626
Super-Scaffold_100022	20105804	20106583	779	g_5626	g_5627
Super-Scaffold_100022	20117484	20121400	3916	g_5627	g_43304
Super-Scaffold_100022	20127277	20143876	16599	g_43304	g_5628
Super-Scaffold_100022	20146917	20150585	3668	g_5628	g_5629
Super-Scaffold_100022	20169110	20194980	25870	g_5629	g_5630
Super-Scaffold_100022	20207619	20214880	7261	g_5630	g_5631
Super-Scaffold_100022	20216906	20310569	93663	g_5631	g_5636
Super-Scaffold_100022	20310805	20334788	23983	g_5636	g_40882
Super-Scaffold_100022	20335030	20349778	14748	g_40882	g_5637
Super-Scaffold_100022	20355371	20365117	9746	g_5637	g_5638
Super-Scaffold_100022	20365836	20366422	586	g_5638	g_5639
Super-Scaffold_100022	20369129	20369743	614	g_5639	g_5640
Super-Scaffold_100022	20377970	20389340	11370	g_5640	g_5642
Super-Scaffold_100022	20396776	20404379	7603	g_5642	g_5643
Super-Scaffold_100022	20480851	20482802	1951	g_5643	g_5644
Super-Scaffold_100022	20497362	20501260	3898	g_5644	g_5645
Super-Scaffold_100022	20511636	20513999	2363	g_5645	g_5646
Super-Scaffold_100022	20527995	20536662	8667	g_5646	g_5647
Super-Scaffold_100022	20548133	20548991	858	g_5647	g_5648
Super-Scaffold_100022	20552107	20555125	3018	g_5648	g_5650
Super-Scaffold_100022	20579940	20587972	8032	g_5650	g_5651
Super-Scaffold_100022	20591834	20592954	1120	g_5651	g_5652
Super-Scaffold_100022	20597542	20599145	1603	g_5652	g_5653
Super-Scaffold_100022	20634016	20659311	25295	g_5653	g_5656
Super-Scaffold_100022	20659517	20682890	23373	g_5656	g_5658
Super-Scaffold_100022	20769218	20771656	2438	g_5658	g_5659
Super-Scaffold_100022	20772033	20855431	83398	g_5659	g_5666
Super-Scaffold_100022	20857951	20862508	4557	g_5666	g_43305
Super-Scaffold_100022	20886259	20932348	46089	g_43305	g_5668
Super-Scaffold_100022	20936556	21009841	73285	g_5668	g_5669
Super-Scaffold_100022	21022463	21026040	3577	g_5669	g_5670
Super-Scaffold_100022	21027315	21043320	16005	g_5670	g_5671
Super-Scaffold_100022	21045302	21112606	67304	g_5671	g_5672
Super-Scaffold_100022	21113019	21117345	4326	g_5672	g_5673
Super-Scaffold_100022	21117665	21209407	91742	g_5673	g_5675
Super-Scaffold_100022	21211017	21222252	11235	g_5675	g_5676
Super-Scaffold_100022	21278692	21280920	2228	g_5676	g_43306
Super-Scaffold_100022	21286583	21290672	4089	g_43306	g_5677
Super-Scaffold_100022	21315574	21350127	34553	g_5677	g_40888
Super-Scaffold_100022	21350351	21358434	8083	g_40888	g_5679
Super-Scaffold_100022	21376737	21393864	17127	g_5679	g_5680
Super-Scaffold_100022	21400642	21438610	37968	g_5680	g_40891
Super-Scaffold_100022	21439569	21453602	14033	g_40891	g_5682
Super-Scaffold_100022	21459328	21461054	1726	g_5682	g_5683
Super-Scaffold_100022	21465498	21486752	21254	g_5683	g_5684
Super-Scaffold_100022	21499620	21510928	11308	g_5684	g_5685
Super-Scaffold_100022	21513803	21515741	1938	g_5685	g_5686
Super-Scaffold_100022	21523434	21529587	6153	g_5686	g_5687
Super-Scaffold_100022	21533930	21581755	47825	g_5687	g_43307
Super-Scaffold_100022	21596122	21644803	48681	g_43307	g_5689
Super-Scaffold_100022	21645027	21663471	18444	g_5689	g_5690
Super-Scaffold_100022	21673523	21682401	8878	g_5690	g_5691
Super-Scaffold_100022	21686945	21688797	1852	g_5691	g_5692
Super-Scaffold_100022	21699584	21714310	14726	g_5692	g_5694
Super-Scaffold_100022	21720808	21721779	971	g_5694	g_5695
Super-Scaffold_100022	21728416	21733413	4997	g_5695	g_5696
Super-Scaffold_100022	21736401	21852485	116084	g_5696	g_5697
Super-Scaffold_100022	21853159	21929715	76556	g_5697	g_5699
Super-Scaffold_100022	21932271	21947605	15334	g_5699	g_5701
Super-Scaffold_100022	21947811	21992376	44565	g_5701	g_5702
Super-Scaffold_100022	21992807	22146839	154032	g_5702	g_5706
Super-Scaffold_100022	22147090	22150430	3340	g_5706	g_5707
Super-Scaffold_100022	22155506	22158649	3143	g_5707	g_5708
Super-Scaffold_100022	22165933	22168149	2216	g_5708	g_5709
Super-Scaffold_100022	22168511	22210291	41780	g_5709	g_5712
Super-Scaffold_100022	22248907	22259490	10583	g_5712	g_43308
Super-Scaffold_100022	22267821	22326065	58244	g_43308	g_5714
Super-Scaffold_100022	22345032	22348790	3758	g_5714	g_5715
Super-Scaffold_100022	22378180	22438289	60109	g_5715	g_5717
Super-Scaffold_100022	22438708	22446685	7977	g_5717	g_5719
Super-Scaffold_100022	22446990	22463832	16842	g_5719	g_5720
Super-Scaffold_100022	22473579	22474891	1312	g_5720	g_5721
Super-Scaffold_100022	22475226	22528585	53359	g_5721	g_5722
Super-Scaffold_100022	22543189	22597190	54001	g_5722	g_40904
Super-Scaffold_100022	22597495	22597519	24	g_40904	g_5724
Super-Scaffold_100022	22598517	22598550	33	g_5724	g_5725
Super-Scaffold_100022	22599152	22599467	315	g_5725	g_40905
Super-Scaffold_100022	22599817	22601630	1813	g_40905	g_5726
Super-Scaffold_100022	22618926	22639422	20496	g_5726	g_5729
Super-Scaffold_100022	22639712	22672528	32816	g_5729	g_5731
Super-Scaffold_100022	22677730	22741190	63460	g_5731	g_5734
Super-Scaffold_100022	22744611	22751775	7164	g_5734	g_40907
Super-Scaffold_100022	22751975	22773175	21200	g_40907	g_5739
Super-Scaffold_100022	22774989	22778432	3443	g_5739	g_5740
Super-Scaffold_100022	22780699	22788536	7837	g_5740	g_5741
Super-Scaffold_100022	22795019	22802983	7964	g_5741	g_5742
Super-Scaffold_100022	22803411	22815473	12062	g_5742	g_5743
Super-Scaffold_100022	22836071	22842318	6247	g_40910	g_40912
Super-Scaffold_100022	22842605	22842634	29	g_40912	g_5744
Super-Scaffold_100022	22843680	22856887	13207	g_5744	g_5746
Super-Scaffold_100022	22865478	22917352	51874	g_5746	g_5751
Super-Scaffold_100022	22917582	22953339	35757	g_5751	g_5753
Super-Scaffold_100022	22956485	22988120	31635	g_5753	g_5756
Super-Scaffold_100022	22989379	23012968	23589	g_5756	g_5758
Super-Scaffold_100022	23013606	23029953	16347	g_5758	g_5760
Super-Scaffold_100022	23030864	23040625	9761	g_5760	g_5762
Super-Scaffold_100022	23042454	23122297	79843	g_5762	g_5769
Super-Scaffold_100022	23137328	23163284	25956	g_5769	g_5771
Super-Scaffold_100022	23164027	23285702	121675	g_5771	g_5774
Super-Scaffold_100022	23285923	23286275	352	g_5774	g_5775
Super-Scaffold_100022	23286664	23286690	26	g_5775	g_5776
Super-Scaffold_100022	23286977	23287232	255	g_5776	g_5777
Super-Scaffold_100022	23287930	23291116	3186	g_5777	g_5778
Super-Scaffold_100022	23291799	23292954	1155	g_5778	g_5779
Super-Scaffold_100022	23296504	23304686	8182	g_5779	g_5780
Super-Scaffold_100022	23305319	23317256	11937	g_5780	g_5781
Super-Scaffold_100022	23318272	23379752	61480	g_5781	g_5783
Super-Scaffold_100022	23380102	23448060	67958	g_5783	g_5789
Super-Scaffold_100022	23449268	23450868	1600	g_5789	g_5790
Super-Scaffold_100022	23453476	23462800	9324	g_5790	g_5791
Super-Scaffold_100022	23464137	23482972	18835	g_5791	g_5792
Super-Scaffold_100022	23483328	23483987	659	g_5792	g_5793
Super-Scaffold_100022	23497490	23504770	7280	g_5793	g_5795
Super-Scaffold_100022	23521814	23524954	3140	g_5795	g_5796
Super-Scaffold_100022	23538599	23539731	1132	g_5796	g_5797
Super-Scaffold_100022	23540174	23597164	56990	g_5797	g_5799
Super-Scaffold_100022	23599300	23604929	5629	g_5799	g_5801
Super-Scaffold_100022	23607649	23608701	1052	g_5801	g_5802
Super-Scaffold_100022	23609768	23627778	18010	g_5802	g_5804
Super-Scaffold_100022	23636222	23650487	14265	g_5804	g_40925
Super-Scaffold_100022	23651293	23702501	51208	g_40925	g_5806
Super-Scaffold_100022	23717967	23732294	14327	g_5806	g_5808
Super-Scaffold_100022	23740479	23743006	2527	g_5808	g_5809
Super-Scaffold_100022	23744948	23758034	13086	g_5809	g_5811
Super-Scaffold_100022	23767060	23782248	15188	g_5811	g_5813
Super-Scaffold_100022	23793731	23796156	2425	g_5813	g_5814
Super-Scaffold_100022	23804722	23825136	20414	g_5814	g_5816
Super-Scaffold_100022	23841898	23954460	112562	g_5816	g_5817
Super-Scaffold_100022	23955014	23992690	37676	g_5817	g_5818
Super-Scaffold_100022	23993631	24008696	15065	g_5818	g_5819
Super-Scaffold_100023	27538	32272	4734	g_20116	g_20117
Super-Scaffold_100023	32979	39684	6705	g_20117	g_20118
Super-Scaffold_100023	40190	40212	22	g_20118	g_20119
Super-Scaffold_100023	40910	98686	57776	g_20119	g_20121
Super-Scaffold_100023	101053	135165	34112	g_20121	g_20122
Super-Scaffold_100023	138045	450326	312281	g_20122	g_20123
Super-Scaffold_100023	452476	555154	102678	g_20123	g_39495
Super-Scaffold_100023	555957	760133	204176	g_39495	g_20126
Super-Scaffold_100023	760381	897923	137542	g_20126	g_20128
Super-Scaffold_100023	907261	968232	60971	g_20128	g_20130
Super-Scaffold_100023	968588	998278	29690	g_20130	g_20132
Super-Scaffold_100023	1000633	1001224	591	g_20132	g_20133
Super-Scaffold_100023	1002738	1028429	25691	g_20133	g_20134
Super-Scaffold_100023	1036263	1041690	5427	g_20134	g_20135
Super-Scaffold_100023	1046485	1053673	7188	g_20135	g_20136
Super-Scaffold_100023	1078372	1084913	6541	g_20136	g_44576
Super-Scaffold_100023	1092115	1107350	15235	g_44576	g_20137
Super-Scaffold_100023	1108165	1108237	72	g_20137	g_39498
Super-Scaffold_100023	1133845	1137380	3535	g_20138	g_20139
Super-Scaffold_100023	1161837	1163561	1724	g_20139	g_20140
Super-Scaffold_100023	1166686	1171398	4712	g_20140	g_20141
Super-Scaffold_100023	1181451	1332136	150685	g_20141	g_20142
Super-Scaffold_100023	1352013	1356577	4564	g_20142	g_20143
Super-Scaffold_100023	1359021	1402844	43823	g_20143	g_20144
Super-Scaffold_100023	1408170	1425911	17741	g_20144	g_20145
Super-Scaffold_100023	1441899	1445523	3624	g_20145	g_44577
Super-Scaffold_100023	1451655	1456866	5211	g_44577	g_44578
Super-Scaffold_100023	1461052	1469886	8834	g_44578	g_20146
Super-Scaffold_100023	1472359	1483164	10805	g_20146	g_20148
Super-Scaffold_100023	1521910	1530306	8396	g_20148	g_44579
Super-Scaffold_100023	1533197	1579529	46332	g_44579	g_20149
Super-Scaffold_100023	1583723	1584586	863	g_20149	g_20150
Super-Scaffold_100023	1605666	1614788	9122	g_20150	g_20152
Super-Scaffold_100023	1616091	1617518	1427	g_20152	g_20153
Super-Scaffold_100023	1630354	1632976	2622	g_20153	g_20154
Super-Scaffold_100023	1647356	1657443	10087	g_20154	g_20155
Super-Scaffold_100023	1679252	1686399	7147	g_20155	g_20156
Super-Scaffold_100023	1686653	1687347	694	g_20156	g_20157
Super-Scaffold_100023	1687685	1753146	65461	g_20157	g_20159
Super-Scaffold_100023	1754144	1823215	69071	g_20159	g_20160
Super-Scaffold_100023	1825199	1835490	10291	g_20160	g_20161
Super-Scaffold_100023	1875779	1913425	37646	g_20161	g_20163
Super-Scaffold_100023	1913982	1962565	48583	g_20163	g_20166
Super-Scaffold_100023	1985182	2011554	26372	g_20166	g_20167
Super-Scaffold_100023	2022437	2037527	15090	g_20167	g_20168
Super-Scaffold_100023	2046696	2050649	3953	g_20168	g_20169
Super-Scaffold_100023	2058878	2104699	45821	g_20169	g_20171
Super-Scaffold_100023	2108949	2116351	7402	g_20171	g_20173
Super-Scaffold_100023	2122403	2124807	2404	g_20173	g_20174
Super-Scaffold_100023	2126715	2126984	269	g_20174	g_20175
Super-Scaffold_100023	2127349	2127757	408	g_20175	g_20176
Super-Scaffold_100023	2128425	2129945	1520	g_20176	g_20177
Super-Scaffold_100023	2135991	2141565	5574	g_20177	g_39502
Super-Scaffold_100023	2143475	2151293	7818	g_39502	g_20178
Super-Scaffold_100023	2151637	2173921	22284	g_20178	g_20182
Super-Scaffold_100023	2180288	2197641	17353	g_20182	g_20185
Super-Scaffold_100023	2197937	2276671	78734	g_20185	g_20188
Super-Scaffold_100023	2302281	2362305	60024	g_20188	g_20191
Super-Scaffold_100023	2373096	2377647	4551	g_20191	g_20192
Super-Scaffold_100023	2396256	2398873	2617	g_20192	g_20193
Super-Scaffold_100023	2437682	2442608	4926	g_20193	g_20194
Super-Scaffold_100023	2484220	2488094	3874	g_20194	g_20195
Super-Scaffold_100023	2490750	2513238	22488	g_20195	g_20197
Super-Scaffold_100023	2514812	2532284	17472	g_20197	g_20198
Super-Scaffold_100023	2538867	2552846	13979	g_20198	g_20199
Super-Scaffold_100023	2555863	2561162	5299	g_20199	g_44580
Super-Scaffold_100023	2571331	2571588	257	g_44580	g_20200
Super-Scaffold_100023	2573407	2577734	4327	g_20200	g_20201
Super-Scaffold_100023	2582113	2584451	2338	g_20201	g_20202
Super-Scaffold_100023	2584840	2591871	7031	g_20202	g_20203
Super-Scaffold_100023	2611482	2676070	64588	g_20203	g_20205
Super-Scaffold_100023	2677353	2684837	7484	g_20205	g_44581
Super-Scaffold_100023	2686114	2779780	93666	g_44581	g_20208
Super-Scaffold_100023	2780426	2783600	3174	g_20208	g_20209
Super-Scaffold_100023	2785440	2794126	8686	g_20209	g_20210
Super-Scaffold_100023	2815820	2817555	1735	g_20210	g_20211
Super-Scaffold_100023	2821073	2822240	1167	g_20211	g_20212
Super-Scaffold_100023	2830021	2838919	8898	g_20212	g_20213
Super-Scaffold_100023	2851984	2864076	12092	g_20213	g_20214
Super-Scaffold_100023	2878318	2879928	1610	g_20214	g_20215
Super-Scaffold_100023	2884857	2886388	1531	g_20215	g_20216
Super-Scaffold_100023	2906068	2910257	4189	g_20216	g_20217
Super-Scaffold_100023	2915720	2927178	11458	g_20217	g_20218
Super-Scaffold_100023	2928776	2942017	13241	g_20218	g_44582
Super-Scaffold_100023	2943492	2945081	1589	g_44582	g_20219
Super-Scaffold_100023	2945799	2947063	1264	g_20219	g_20220
Super-Scaffold_100023	2949055	2951447	2392	g_20220	g_20221
Super-Scaffold_100023	2953051	2953965	914	g_20221	g_20222
Super-Scaffold_100023	2959672	2968542	8870	g_20222	g_20223
Super-Scaffold_100023	2973725	2990878	17153	g_20223	g_20224
Super-Scaffold_100023	2992029	3004838	12809	g_20224	g_39507
Super-Scaffold_100023	3005074	3005553	479	g_20226	g_20227
Super-Scaffold_100023	3046815	3065985	19170	g_20227	g_20228
Super-Scaffold_100023	3084912	3123305	38393	g_20228	g_20229
Super-Scaffold_100023	3123757	3163230	39473	g_20229	g_20231
Super-Scaffold_100023	3163451	3163907	456	g_20231	g_20232
Super-Scaffold_100023	3165256	3217641	52385	g_20232	g_20233
Super-Scaffold_100023	3235866	3239862	3996	g_20233	g_20234
Super-Scaffold_100023	3242868	3247848	4980	g_20234	g_44583
Super-Scaffold_100023	3260055	3269664	9609	g_44583	g_20235
Super-Scaffold_100023	3284569	3291058	6489	g_20235	g_20236
Super-Scaffold_100023	3301265	3356969	55704	g_20236	g_20238
Super-Scaffold_100023	3368054	3466813	98759	g_20238	g_20240
Super-Scaffold_100023	3468219	3497828	29609	g_20240	g_20241
Super-Scaffold_100023	3517739	3531722	13983	g_20241	g_20242
Super-Scaffold_100023	3532027	3540211	8184	g_20242	g_20243
Super-Scaffold_100023	3546705	3550112	3407	g_20243	g_44584
Super-Scaffold_100023	3558077	3561907	3830	g_44584	g_20244
Super-Scaffold_100023	3585044	3595434	10390	g_20244	g_20245
Super-Scaffold_100023	3607645	3656830	49185	g_20245	g_20246
Super-Scaffold_100023	3662637	3677077	14440	g_20246	g_44585
Super-Scaffold_100023	3690108	3704524	14416	g_44585	g_20247
Super-Scaffold_100023	3704856	3705946	1090	g_20247	g_20248
Super-Scaffold_100023	3731783	3742501	10718	g_20248	g_20250
Super-Scaffold_100023	3754601	3762303	7702	g_20250	g_20251
Super-Scaffold_100023	3776531	3777490	959	g_20251	g_20252
Super-Scaffold_100023	3788662	3789728	1066	g_20252	g_20253
Super-Scaffold_100023	3792926	3800837	7911	g_20253	g_20255
Super-Scaffold_100023	3801037	3804904	3867	g_20255	g_20256
Super-Scaffold_100023	3819981	3825972	5991	g_20256	g_20257
Super-Scaffold_100023	3835714	3841736	6022	g_20257	g_20258
Super-Scaffold_100023	3858484	3859551	1067	g_20258	g_20259
Super-Scaffold_100023	3863570	3865039	1469	g_20259	g_20260
Super-Scaffold_100023	3871792	3878596	6804	g_20260	g_20261
Super-Scaffold_100023	3880472	3884457	3985	g_20261	g_20263
Super-Scaffold_100023	3898281	3901542	3261	g_20263	g_20264
Super-Scaffold_100023	3909313	3915778	6465	g_20264	g_20265
Super-Scaffold_100023	3932498	3992031	59533	g_20265	g_20266
Super-Scaffold_100023	3996938	3999718	2780	g_20266	g_20267
Super-Scaffold_100023	4002198	4037872	35674	g_20267	g_20268
Super-Scaffold_100023	4053747	4056671	2924	g_20268	g_39513
Super-Scaffold_100023	4058972	4060665	1693	g_20269	g_20270
Super-Scaffold_100023	4062583	4065474	2891	g_20270	g_20271
Super-Scaffold_100023	4070870	4075926	5056	g_20271	g_20272
Super-Scaffold_100023	4080110	4081293	1183	g_20272	g_20273
Super-Scaffold_100023	4088507	4095238	6731	g_20273	g_20274
Super-Scaffold_100023	4104886	4109960	5074	g_20274	g_20275
Super-Scaffold_100023	4111778	4112965	1187	g_20275	g_20276
Super-Scaffold_100023	4114158	4124354	10196	g_20276	g_20277
Super-Scaffold_100023	4126443	4127862	1419	g_20277	g_20278
Super-Scaffold_100023	4128985	4138265	9280	g_20278	g_20280
Super-Scaffold_100023	4142994	4150423	7429	g_20280	g_20281
Super-Scaffold_100023	4166143	4175041	8898	g_20281	g_20283
Super-Scaffold_100023	4181631	4185687	4056	g_20283	g_20284
Super-Scaffold_100023	4190709	4193379	2670	g_20284	g_20285
Super-Scaffold_100023	4198525	4200911	2386	g_20285	g_44586
Super-Scaffold_100023	4207914	4216514	8600	g_44586	g_20286
Super-Scaffold_100023	4216849	4218632	1783	g_20286	g_20287
Super-Scaffold_100023	4221571	4222014	443	g_20287	g_20288
Super-Scaffold_100023	4227576	4232072	4496	g_20288	g_20289
Super-Scaffold_100023	4243572	4249612	6040	g_20289	g_20290
Super-Scaffold_100023	4266149	4297795	31646	g_20290	g_20291
Super-Scaffold_100023	4298028	4375636	77608	g_20291	g_20294
Super-Scaffold_100023	4376223	4408641	32418	g_20294	g_20295
Super-Scaffold_100023	4414857	4442123	27266	g_20295	g_20296
Super-Scaffold_100023	4472032	4483812	11780	g_20296	g_44587
Super-Scaffold_100023	4495320	4542465	47145	g_44587	g_20298
Super-Scaffold_100023	4543373	4544925	1552	g_20298	g_20300
Super-Scaffold_100023	4545143	4546351	1208	g_20300	g_20301
Super-Scaffold_100023	4554899	4562306	7407	g_20301	g_20302
Super-Scaffold_100023	4577457	4612681	35224	g_39517	g_20305
Super-Scaffold_100023	4612920	4626834	13914	g_20305	g_20308
Super-Scaffold_100023	4629553	4730716	101163	g_20308	g_20309
Super-Scaffold_100023	4731465	4732328	863	g_20309	g_20310
Super-Scaffold_100023	4733503	4772485	38982	g_20310	g_39520
Super-Scaffold_100023	4772784	4789091	16307	g_39520	g_39521
Super-Scaffold_100023	4789318	4844614	55296	g_39521	g_20312
Super-Scaffold_100023	4865973	4868477	2504	g_20312	g_20313
Super-Scaffold_100023	4868752	4869269	517	g_20313	g_44588
Super-Scaffold_100023	4869502	4882174	12672	g_44588	g_39523
Super-Scaffold_100023	4882386	4910604	28218	g_39523	g_20314
Super-Scaffold_100023	4924253	4926020	1767	g_20314	g_20315
Super-Scaffold_100023	4936692	4938729	2037	g_20315	g_20316
Super-Scaffold_100023	4950265	5021383	71118	g_20316	g_20317
Super-Scaffold_100023	5030631	5098500	67869	g_20317	g_20318
Super-Scaffold_100023	5098874	5126017	27143	g_20318	g_20319
Super-Scaffold_100023	5129487	5158096	28609	g_20319	g_20320
Super-Scaffold_100023	5169396	5204500	35104	g_20320	g_20321
Super-Scaffold_100023	5205105	5207431	2326	g_20321	g_20322
Super-Scaffold_100023	5221565	5232804	11239	g_20322	g_20323
Super-Scaffold_100023	5247062	5247360	298	g_20323	g_20324
Super-Scaffold_100023	5250911	5253538	2627	g_20324	g_20325
Super-Scaffold_100023	5258136	5259234	1098	g_20325	g_20326
Super-Scaffold_100023	5262031	5264057	2026	g_20326	g_44589
Super-Scaffold_100023	5267478	5285602	18124	g_44589	g_20327
Super-Scaffold_100023	5297047	5378462	81415	g_20327	g_20329
Super-Scaffold_100023	5378665	5443195	64530	g_20329	g_20331
Super-Scaffold_100023	5457576	5461802	4226	g_20331	g_20332
Super-Scaffold_100023	5471568	5473053	1485	g_20332	g_20333
Super-Scaffold_100023	5477151	5480330	3179	g_20333	g_44590
Super-Scaffold_100023	5482126	5490857	8731	g_44590	g_20334
Super-Scaffold_100023	5491354	5501435	10081	g_20334	g_44591
Super-Scaffold_100023	5515886	5519804	3918	g_44591	g_20335
Super-Scaffold_100023	5528210	5529259	1049	g_20335	g_20336
Super-Scaffold_100023	5538473	5538862	389	g_20337	g_20338
Super-Scaffold_100023	5540451	5548690	8239	g_20338	g_20339
Super-Scaffold_100023	5565426	5569476	4050	g_20339	g_20340
Super-Scaffold_100023	5570582	5572319	1737	g_20340	g_20341
Super-Scaffold_100023	5573293	5575935	2642	g_20341	g_20342
Super-Scaffold_100023	5576907	5577592	685	g_20342	g_20343
Super-Scaffold_100023	5581897	5588610	6713	g_20343	g_44592
Super-Scaffold_100023	5606934	5615665	8731	g_44592	g_20344
Super-Scaffold_100023	5619203	5623949	4746	g_20344	g_44593
Super-Scaffold_100023	5631330	5634027	2697	g_44593	g_20345
Super-Scaffold_100023	5637612	5678864	41252	g_20345	g_20346
Super-Scaffold_100023	5683429	5684108	679	g_20346	g_20347
Super-Scaffold_100023	5685400	5691842	6442	g_20347	g_20348
Super-Scaffold_100023	5706296	5729183	22887	g_20348	g_20349
Super-Scaffold_100023	5734978	5758625	23647	g_20349	g_20351
Super-Scaffold_100023	5771454	5773108	1654	g_20351	g_44594
Super-Scaffold_100023	5777924	5780412	2488	g_44594	g_20352
Super-Scaffold_100023	5822983	5826477	3494	g_20352	g_20353
Super-Scaffold_100023	5830804	5831550	746	g_20353	g_20354
Super-Scaffold_100023	5834669	5914229	79560	g_20354	g_20355
Super-Scaffold_100023	5918708	5992737	74029	g_20355	g_20359
Super-Scaffold_100023	5995313	6001735	6422	g_20359	g_20360
Super-Scaffold_100023	6007552	6009260	1708	g_20360	g_44595
Super-Scaffold_100023	6011148	6014606	3458	g_44595	g_20361
Super-Scaffold_100023	6017859	6024721	6862	g_20361	g_20362
Super-Scaffold_100023	6031269	6069389	38120	g_20362	g_20363
Super-Scaffold_100023	6086059	6088558	2499	g_20363	g_20364
Super-Scaffold_100023	6093969	6097537	3568	g_20364	g_20365
Super-Scaffold_100023	6119801	6121688	1887	g_20365	g_20366
Super-Scaffold_100023	6125420	6127290	1870	g_20366	g_20367
Super-Scaffold_100023	6133639	6202688	69049	g_20367	g_20369
Super-Scaffold_100023	6203014	6213266	10252	g_20369	g_20370
Super-Scaffold_100023	6242448	6287300	44852	g_20373	g_20374
Super-Scaffold_100023	6288058	6316271	28213	g_20374	g_20376
Super-Scaffold_100023	6323528	6328019	4491	g_20376	g_20377
Super-Scaffold_100023	6334343	6357104	22761	g_20378	g_20379
Super-Scaffold_100023	6357388	6384727	27339	g_20379	g_20381
Super-Scaffold_100023	6384954	6476721	91767	g_20381	g_20383
Super-Scaffold_100023	6481512	6489894	8382	g_20383	g_20384
Super-Scaffold_100023	6496781	6534974	38193	g_20384	g_20386
Super-Scaffold_100023	6535960	6664483	128523	g_20386	g_20389
Super-Scaffold_100023	6667103	6813786	146683	g_20389	g_39543
Super-Scaffold_100023	6814019	6869492	55473	g_39543	g_20392
Super-Scaffold_100023	6871862	6995989	124127	g_20392	g_20395
Super-Scaffold_100023	6996333	7089837	93504	g_20395	g_20397
Super-Scaffold_100023	7092460	7104529	12069	g_20397	g_20398
Super-Scaffold_100023	7149456	7173744	24288	g_20398	g_20400
Super-Scaffold_100023	7173998	7175332	1334	g_20400	g_20399
Super-Scaffold_100023	7188817	7192302	3485	g_20399	g_20401
Super-Scaffold_100023	7193813	7196019	2206	g_20401	g_20402
Super-Scaffold_100023	7199564	7208851	9287	g_20402	g_20403
Super-Scaffold_100023	7209108	7265936	56828	g_20403	g_20404
Super-Scaffold_100023	7274891	7277037	2146	g_20404	g_20406
Super-Scaffold_100023	7277528	7348134	70606	g_20406	g_20409
Super-Scaffold_100023	7366597	7367496	899	g_20409	g_20410
Super-Scaffold_100023	7374860	7378230	3370	g_20410	g_20411
Super-Scaffold_100023	7381830	7385658	3828	g_20411	g_20412
Super-Scaffold_100023	7391445	7394863	3418	g_20412	g_20413
Super-Scaffold_100023	7395891	7398938	3047	g_20413	g_20414
Super-Scaffold_100023	7404135	7411539	7404	g_20414	g_20415
Super-Scaffold_100023	7425942	7443257	17315	g_20415	g_20416
Super-Scaffold_100023	7449409	7450380	971	g_20416	g_20417
Super-Scaffold_100023	7454407	7456870	2463	g_20417	g_20418
Super-Scaffold_100023	7458843	7461753	2910	g_20418	g_20419
Super-Scaffold_100023	7465582	7467381	1799	g_20419	g_44596
Super-Scaffold_100023	7469651	7478436	8785	g_44596	g_20420
Super-Scaffold_100023	7480501	7488652	8151	g_20420	g_44597
Super-Scaffold_100023	7494922	7505647	10725	g_44597	g_20421
Super-Scaffold_100023	7506823	7518218	11395	g_20421	g_44598
Super-Scaffold_100023	7523568	7528639	5071	g_44598	g_44599
Super-Scaffold_100023	7530171	7530826	655	g_44599	g_44600
Super-Scaffold_100023	7533047	7537133	4086	g_44600	g_44601
Super-Scaffold_100023	7561083	7562252	1169	g_44601	g_20422
Super-Scaffold_100023	7563413	7565912	2499	g_20422	g_20424
Super-Scaffold_100023	7566205	7566369	164	g_20424	g_20425
Super-Scaffold_100023	7570968	7572899	1931	g_20425	g_20426
Super-Scaffold_100023	7582500	7633175	50675	g_20426	g_20427
Super-Scaffold_100023	7642020	7648594	6574	g_20427	g_20428
Super-Scaffold_100023	7652028	7653290	1262	g_20428	g_20429
Super-Scaffold_100023	7659698	7661544	1846	g_20429	g_20430
Super-Scaffold_100023	7670095	7678215	8120	g_20430	g_20431
Super-Scaffold_100023	7692257	7697037	4780	g_20431	g_20432
Super-Scaffold_100023	7714528	7720746	6218	g_20432	g_20433
Super-Scaffold_100023	7721606	7734156	12550	g_20433	g_20434
Super-Scaffold_100023	7736647	7740926	4279	g_20434	g_44602
Super-Scaffold_100023	7757867	7762363	4496	g_44602	g_20435
Super-Scaffold_100023	7775021	7780274	5253	g_20435	g_20436
Super-Scaffold_100023	7788027	7808054	20027	g_20436	g_20438
Super-Scaffold_100023	7823083	7832383	9300	g_20438	g_20439
Super-Scaffold_100023	7870311	7878504	8193	g_20439	g_20440
Super-Scaffold_100023	7882913	7893182	10269	g_20440	g_20441
Super-Scaffold_100023	7912065	7917743	5678	g_20441	g_20442
Super-Scaffold_100023	7929387	7936613	7226	g_20442	g_44603
Super-Scaffold_100023	7941657	8026737	85080	g_44603	g_20444
Super-Scaffold_100023	8045125	8051293	6168	g_20444	g_20445
Super-Scaffold_100023	8063171	8065295	2124	g_20445	g_20446
Super-Scaffold_100023	8071096	8071977	881	g_20446	g_44604
Super-Scaffold_100023	8073094	8088484	15390	g_44604	g_20448
Super-Scaffold_100023	8103068	8105927	2859	g_20448	g_20449
Super-Scaffold_100023	8106460	8113651	7191	g_20449	g_20450
Super-Scaffold_100023	8122311	8124363	2052	g_20450	g_20451
Super-Scaffold_100023	8139563	8169396	29833	g_20451	g_20453
Super-Scaffold_100023	8170765	8183080	12315	g_20453	g_20454
Super-Scaffold_100023	8189198	8207809	18611	g_20454	g_20455
Super-Scaffold_100023	8232731	8233956	1225	g_20455	g_20456
Super-Scaffold_100023	8237354	8242718	5364	g_20456	g_20457
Super-Scaffold_100023	8249571	8255573	6002	g_20457	g_20458
Super-Scaffold_100023	8259111	8260215	1104	g_20458	g_20459
Super-Scaffold_100023	8262883	8266168	3285	g_20459	g_20460
Super-Scaffold_100023	8268634	8272431	3797	g_20460	g_20461
Super-Scaffold_100023	8284408	8285884	1476	g_20461	g_20463
Super-Scaffold_100023	8298092	8302959	4867	g_20463	g_20464
Super-Scaffold_100023	8315675	8365679	50004	g_20464	g_20466
Super-Scaffold_100023	8365921	8368037	2116	g_20466	g_20467
Super-Scaffold_100023	8374944	8391651	16707	g_20467	g_20469
Super-Scaffold_100023	8393235	8393605	370	g_20469	g_20470
Super-Scaffold_100023	8396673	8400978	4305	g_20470	g_20471
Super-Scaffold_100023	8403620	8405614	1994	g_20471	g_20472
Super-Scaffold_100023	8442677	8445036	2359	g_20472	g_20473
Super-Scaffold_100023	8460131	8461622	1491	g_20473	g_44605
Super-Scaffold_100023	8464624	8466231	1607	g_44605	g_20474
Super-Scaffold_100023	8480799	8480987	188	g_20474	g_44606
Super-Scaffold_100023	8481304	8501633	20329	g_44606	g_20475
Super-Scaffold_100023	8512750	8553254	40504	g_20475	g_20478
Super-Scaffold_100023	8555033	8571926	16893	g_20478	g_39553
Super-Scaffold_100023	8572171	8580392	8221	g_39553	g_20479
Super-Scaffold_100023	8581776	8674962	93186	g_20479	g_20482
Super-Scaffold_100023	8676191	8764529	88338	g_20482	g_20485
Super-Scaffold_100023	8779452	8858077	78625	g_20485	g_20487
Super-Scaffold_100023	8865179	8866166	987	g_20487	g_20488
Super-Scaffold_100023	8868398	8869276	878	g_20488	g_20489
Super-Scaffold_100023	8871232	8871890	658	g_20489	g_44607
Super-Scaffold_100023	8875669	8951498	75829	g_44607	g_20491
Super-Scaffold_100023	8953453	8961230	7777	g_20491	g_20492
Super-Scaffold_100023	8961448	8972654	11206	g_20492	g_20493
Super-Scaffold_100023	8972854	8985218	12364	g_20493	g_20497
Super-Scaffold_100023	8985499	8987083	1584	g_20497	g_20498
Super-Scaffold_100023	8993905	8996753	2848	g_20498	g_20499
Super-Scaffold_100023	9005001	9014811	9810	g_39558	g_20500
Super-Scaffold_100023	9017503	9027132	9629	g_20500	g_20501
Super-Scaffold_100023	9033862	9035158	1296	g_20501	g_20502
Super-Scaffold_100023	9035364	9057336	21972	g_20502	g_20503
Super-Scaffold_100023	9061091	9062924	1833	g_20503	g_20504
Super-Scaffold_100023	9067561	9104044	36483	g_20504	g_20505
Super-Scaffold_100023	9104385	9132740	28355	g_20505	g_20506
Super-Scaffold_100023	9146543	9160188	13645	g_20506	g_20507
Super-Scaffold_100023	9184087	9197877	13790	g_20507	g_20509
Super-Scaffold_100023	9199723	9213479	13756	g_20509	g_20511
Super-Scaffold_100023	9220189	9240092	19903	g_39561	g_20513
Super-Scaffold_100023	9241868	9244869	3001	g_20513	g_20514
Super-Scaffold_100023	9246058	9249697	3639	g_20514	g_20515
Super-Scaffold_100023	9253749	9254534	785	g_20515	g_20516
Super-Scaffold_100023	9255932	9257401	1469	g_20516	g_20517
Super-Scaffold_100023	9260031	9260591	560	g_20517	g_20518
Super-Scaffold_100023	9268973	9269930	957	g_20518	g_20519
Super-Scaffold_100023	9290690	9298385	7695	g_20519	g_20520
Super-Scaffold_100023	9298603	9299437	834	g_20520	g_20521
Super-Scaffold_100023	9299745	9305663	5918	g_20521	g_20522
Super-Scaffold_100023	9314171	9316401	2230	g_20522	g_20523
Super-Scaffold_100023	9317969	9323951	5982	g_20523	g_20524
Super-Scaffold_100023	9327117	9332446	5329	g_20524	g_20525
Super-Scaffold_100023	9335202	9336880	1678	g_20525	g_20526
Super-Scaffold_100023	9338939	9342031	3092	g_20526	g_20527
Super-Scaffold_100023	9352347	9352376	29	g_20527	g_20528
Super-Scaffold_100023	9352597	9356043	3446	g_20528	g_20529
Super-Scaffold_100023	9359179	9364072	4893	g_20529	g_20530
Super-Scaffold_100023	9365696	9533047	167351	g_20530	g_20534
Super-Scaffold_100023	9534893	9537680	2787	g_20534	g_20535
Super-Scaffold_100023	9540498	9541696	1198	g_20535	g_44608
Super-Scaffold_100023	9552036	9558318	6282	g_44608	g_20536
Super-Scaffold_100023	9561425	9567315	5890	g_20536	g_20537
Super-Scaffold_100023	9572385	9575254	2869	g_20537	g_20538
Super-Scaffold_100023	9576039	9578391	2352	g_20538	g_20539
Super-Scaffold_100023	9579905	9580671	766	g_20539	g_20540
Super-Scaffold_100023	9587128	9613134	26006	g_20540	g_20542
Super-Scaffold_100023	9633739	9639071	5332	g_20542	g_20543
Super-Scaffold_100023	9641019	9643567	2548	g_20543	g_44609
Super-Scaffold_100023	9646457	9648802	2345	g_44609	g_20544
Super-Scaffold_100023	9650143	9653289	3146	g_20544	g_44610
Super-Scaffold_100023	9656548	9665441	8893	g_44610	g_20545
Super-Scaffold_100023	9681285	9710762	29477	g_20545	g_39570
Super-Scaffold_100023	9710971	9718460	7489	g_39570	g_20547
Super-Scaffold_100023	9757700	9759940	2240	g_20547	g_20548
Super-Scaffold_100023	9766920	9776260	9340	g_20548	g_20549
Super-Scaffold_100023	9776526	9779170	2644	g_20549	g_44611
Super-Scaffold_100023	9783994	9789243	5249	g_44611	g_20550
Super-Scaffold_100023	9797853	9800243	2390	g_20550	g_20551
Super-Scaffold_100023	9824179	9882966	58787	g_20551	g_20553
Super-Scaffold_100023	9883268	9927531	44263	g_20553	g_20554
Super-Scaffold_100023	9927980	9933413	5433	g_20554	g_20555
Super-Scaffold_100023	9942952	9956270	13318	g_20555	g_20556
Super-Scaffold_100023	9968676	9972491	3815	g_20556	g_20557
Super-Scaffold_100023	9975603	10002228	26625	g_20557	g_20560
Super-Scaffold_100023	10006864	10040616	33752	g_20560	g_39574
Super-Scaffold_100023	10040951	10083860	42909	g_39574	g_20564
Super-Scaffold_100023	10117081	10126774	9693	g_20564	g_20565
Super-Scaffold_100023	10127130	10223634	96504	g_20565	g_20566
Super-Scaffold_100023	10225874	10249364	23490	g_20566	g_20567
Super-Scaffold_100023	10256925	10258009	1084	g_20567	g_20568
Super-Scaffold_100023	10260031	10263543	3512	g_20568	g_44612
Super-Scaffold_100023	10266057	10267529	1472	g_44612	g_20569
Super-Scaffold_100023	10268306	10269762	1456	g_20569	g_44613
Super-Scaffold_100023	10271034	10274355	3321	g_44613	g_20570
Super-Scaffold_100023	10276406	10277820	1414	g_20570	g_20571
Super-Scaffold_100023	10281823	10283767	1944	g_20571	g_20572
Super-Scaffold_100023	10304421	10310375	5954	g_20572	g_20573
Super-Scaffold_100023	10322265	10366565	44300	g_20573	g_20577
Super-Scaffold_100023	10366819	10368346	1527	g_20577	g_20578
Super-Scaffold_100023	10368594	10414727	46133	g_20578	g_20580
Super-Scaffold_100023	10439030	10443136	4106	g_20580	g_20581
Super-Scaffold_100023	10446567	10457962	11395	g_20581	g_20582
Super-Scaffold_100023	10460161	10461624	1463	g_20582	g_44614
Super-Scaffold_100023	10464419	10467510	3091	g_44614	g_20583
Super-Scaffold_100023	10469916	10470797	881	g_20583	g_20584
Super-Scaffold_100023	10471096	10474281	3185	g_20584	g_20585
Super-Scaffold_100023	10485629	10487246	1617	g_20585	g_20586
Super-Scaffold_100023	10491510	10494205	2695	g_20586	g_20587
Super-Scaffold_100023	10497694	10578874	81180	g_20587	g_20591
Super-Scaffold_100023	10579212	10612348	33136	g_20591	g_39585
Super-Scaffold_100023	10612584	10699977	87393	g_39585	g_20596
Super-Scaffold_100023	10720210	10776458	56248	g_20596	g_20600
Super-Scaffold_100023	10786412	10788785	2373	g_20600	g_20601
Super-Scaffold_100023	10789185	10791109	1924	g_20601	g_20602
Super-Scaffold_100023	10793233	10795544	2311	g_20602	g_20603
Super-Scaffold_100023	10803370	10807069	3699	g_20603	g_20604
Super-Scaffold_100023	10810280	10824720	14440	g_39595	g_20605
Super-Scaffold_100023	10825064	10833124	8060	g_20605	g_20607
Super-Scaffold_100023	10842862	10897559	54697	g_20607	g_20609
Super-Scaffold_100023	10899894	10905131	5237	g_20609	g_20610
Super-Scaffold_100023	10917834	10921581	3747	g_20610	g_20611
Super-Scaffold_100023	10926470	10926906	436	g_20611	g_44615
Super-Scaffold_100023	10932232	10938615	6383	g_44615	g_20612
Super-Scaffold_100023	10948910	10960176	11266	g_20612	g_44616
Super-Scaffold_100023	10974602	10977103	2501	g_44616	g_20613
Super-Scaffold_100023	10977567	10979378	1811	g_20613	g_20614
Super-Scaffold_100023	10980615	10985659	5044	g_20614	g_20615
Super-Scaffold_100023	10988162	10996250	8088	g_20615	g_20616
Super-Scaffold_100023	10996967	11022108	25141	g_20616	g_20618
Super-Scaffold_100023	11022825	11030287	7462	g_20618	g_20619
Super-Scaffold_100023	11032457	11071647	39190	g_20619	g_20621
Super-Scaffold_100023	11071937	11095356	23419	g_20621	g_20622
Super-Scaffold_100023	11106750	11121456	14706	g_20622	g_20623
Super-Scaffold_100023	11136905	11139496	2591	g_20623	g_20624
Super-Scaffold_100023	11142404	11144584	2180	g_20624	g_20625
Super-Scaffold_100023	11148627	11149719	1092	g_20625	g_20626
Super-Scaffold_100023	11155307	11156520	1213	g_20626	g_20627
Super-Scaffold_100023	11159517	11162008	2491	g_20627	g_20628
Super-Scaffold_100023	11185326	11187200	1874	g_20628	g_44617
Super-Scaffold_100023	11193304	11195505	2201	g_44617	g_20629
Super-Scaffold_100023	11196866	11209594	12728	g_20629	g_20630
Super-Scaffold_100023	11210373	11216616	6243	g_20630	g_20631
Super-Scaffold_100023	11230194	11274466	44272	g_20631	g_20634
Super-Scaffold_100023	11294661	11296898	2237	g_20634	g_20635
Super-Scaffold_100023	11300052	11301758	1706	g_20635	g_20636
Super-Scaffold_100023	11310266	11314143	3877	g_20636	g_44618
Super-Scaffold_100023	11329962	11338984	9022	g_44618	g_20638
Super-Scaffold_100023	11352206	11369989	17783	g_20638	g_20639
Super-Scaffold_100023	11376040	11381827	5787	g_20639	g_20641
Super-Scaffold_100023	11383584	11394281	10697	g_20641	g_20642
Super-Scaffold_100023	11402840	11404476	1636	g_20642	g_44619
Super-Scaffold_100023	11407754	11410913	3159	g_44619	g_44620
Super-Scaffold_100023	11417278	11418142	864	g_44620	g_20643
Super-Scaffold_100023	11435957	11439679	3722	g_20643	g_20644
Super-Scaffold_100023	11443319	11446408	3089	g_20644	g_20645
Super-Scaffold_100023	11449367	11453887	4520	g_20645	g_20646
Super-Scaffold_100023	11461421	11464161	2740	g_20646	g_20647
Super-Scaffold_100023	11474448	11474991	543	g_20647	g_20648
Super-Scaffold_100023	11493443	11499714	6271	g_20648	g_20649
Super-Scaffold_100023	11500892	11510565	9673	g_20649	g_20650
Super-Scaffold_100023	11533246	11536108	2862	g_20650	g_20651
Super-Scaffold_100023	11548635	11554464	5829	g_20651	g_44621
Super-Scaffold_100023	11565821	11567169	1348	g_44621	g_20652
Super-Scaffold_100023	11578576	11581622	3046	g_20652	g_20653
Super-Scaffold_100023	11583130	11584052	922	g_20653	g_20654
Super-Scaffold_100023	11605006	11613093	8087	g_20654	g_20655
Super-Scaffold_100023	11679850	11697655	17805	g_20655	g_20656
Super-Scaffold_100023	11716223	11800877	84654	g_20656	g_20657
Super-Scaffold_100023	11801164	11804860	3696	g_20657	g_20658
Super-Scaffold_100023	11805723	12014695	208972	g_20658	g_20663
Super-Scaffold_100023	12021693	12025281	3588	g_20663	g_20664
Super-Scaffold_100023	12027276	12031585	4309	g_20664	g_20665
Super-Scaffold_100023	12040343	12045584	5241	g_20665	g_20666
Super-Scaffold_100023	12060444	12062495	2051	g_20666	g_20667
Super-Scaffold_100023	12072128	12075265	3137	g_20667	g_20668
Super-Scaffold_100023	12089595	12107264	17669	g_20668	g_20669
Super-Scaffold_100023	12109368	12111679	2311	g_20669	g_20670
Super-Scaffold_100023	12111990	12174315	62325	g_20670	g_39600
Super-Scaffold_100023	12174560	12181689	7129	g_39600	g_20673
Super-Scaffold_100023	12190066	12231713	41647	g_20673	g_20674
Super-Scaffold_100023	12310299	12344254	33955	g_20674	g_20675
Super-Scaffold_100023	12346681	12471475	124794	g_20675	g_20677
Super-Scaffold_100023	12478601	12492105	13504	g_20677	g_20679
Super-Scaffold_100023	12527959	12568199	40240	g_20679	g_20680
Super-Scaffold_100023	12581228	12586831	5603	g_20680	g_20681
Super-Scaffold_100023	12590850	12675196	84346	g_20681	g_20683
Super-Scaffold_100023	12679483	12681345	1862	g_20683	g_20684
Super-Scaffold_100023	12689598	12691479	1881	g_20684	g_20685
Super-Scaffold_100023	12694124	12695629	1505	g_20685	g_20686
Super-Scaffold_100023	12699848	12702621	2773	g_20686	g_44622
Super-Scaffold_100023	12711101	12742330	31229	g_44622	g_20687
Super-Scaffold_100023	12755746	12774027	18281	g_20687	g_20688
Super-Scaffold_100023	12785329	12802406	17077	g_20688	g_20690
Super-Scaffold_100023	12803673	12811106	7433	g_20690	g_20691
Super-Scaffold_100023	12812803	12813705	902	g_20691	g_20692
Super-Scaffold_100023	12815128	12819593	4465	g_20692	g_20693
Super-Scaffold_100023	12831945	12861632	29687	g_20693	g_20694
Super-Scaffold_100023	12862791	12864128	1337	g_20694	g_20695
Super-Scaffold_100023	12866045	12870509	4464	g_20695	g_20696
Super-Scaffold_100023	12890623	12943055	52432	g_20696	g_20697
Super-Scaffold_100023	12944299	12947334	3035	g_20697	g_20698
Super-Scaffold_100023	12953054	12962944	9890	g_20698	g_20699
Super-Scaffold_100023	12973950	12983618	9668	g_20699	g_20700
Super-Scaffold_100023	12985188	12987759	2571	g_20700	g_20701
Super-Scaffold_100023	12997702	13001233	3531	g_20701	g_20702
Super-Scaffold_100023	13006452	13019690	13238	g_20702	g_20704
Super-Scaffold_100023	13029186	13031395	2209	g_20704	g_20705
Super-Scaffold_100023	13033537	13035461	1924	g_20705	g_20706
Super-Scaffold_100023	13041421	13043667	2246	g_20706	g_20707
Super-Scaffold_100023	13047845	13057307	9462	g_20707	g_20708
Super-Scaffold_100023	13082948	13087631	4683	g_20708	g_20709
Super-Scaffold_100023	13091374	13096117	4743	g_20709	g_20710
Super-Scaffold_100023	13098523	13101173	2650	g_20710	g_20711
Super-Scaffold_100023	13103133	13110169	7036	g_20711	g_44623
Super-Scaffold_100023	13113253	13114686	1433	g_44623	g_20712
Super-Scaffold_100023	13116941	13122057	5116	g_20712	g_20713
Super-Scaffold_100023	13128122	13129648	1526	g_20713	g_44624
Super-Scaffold_100023	13135902	13140775	4873	g_44624	g_20714
Super-Scaffold_100023	13147551	13147641	90	g_20714	g_20715
Super-Scaffold_100023	13162513	13162562	49	g_20715	g_20716
Super-Scaffold_100023	13165130	13165879	749	g_39603	g_20717
Super-Scaffold_100023	13173518	13174387	869	g_20717	g_20718
Super-Scaffold_100023	13180098	13187121	7023	g_20718	g_20719
Super-Scaffold_100023	13187561	13187686	125	g_20719	g_20720
Super-Scaffold_100023	13198063	13199745	1682	g_20720	g_20721
Super-Scaffold_100023	13205038	13207520	2482	g_20721	g_20722
Super-Scaffold_100023	13212238	13212435	197	g_20722	g_20723
Super-Scaffold_100023	13217042	13219167	2125	g_20723	g_20724
Super-Scaffold_100023	13230741	13230940	199	g_20724	g_39605
Super-Scaffold_100023	13231182	13231912	730	g_39605	g_20725
Super-Scaffold_100023	13238013	13260810	22797	g_20725	g_20727
Super-Scaffold_100023	13276319	13286710	10391	g_20727	g_20728
Super-Scaffold_100023	13288216	13290609	2393	g_20728	g_20729
Super-Scaffold_100023	13297362	13298679	1317	g_20729	g_20730
Super-Scaffold_100023	13300252	13303129	2877	g_20730	g_20731
Super-Scaffold_100023	13306637	13312287	5650	g_20731	g_20732
Super-Scaffold_100023	13316590	13328522	11932	g_20732	g_20733
Super-Scaffold_100023	13341421	13347902	6481	g_20733	g_20734
Super-Scaffold_100023	13349126	13355412	6286	g_20734	g_20735
Super-Scaffold_100023	13359034	13362487	3453	g_20735	g_44625
Super-Scaffold_100023	13366224	13367978	1754	g_44625	g_20736
Super-Scaffold_100023	13372179	13373600	1421	g_20736	g_20737
Super-Scaffold_100023	13382843	13391140	8297	g_20737	g_20738
Super-Scaffold_100023	13397457	13399256	1799	g_20738	g_20739
Super-Scaffold_100023	13408713	13414411	5698	g_20739	g_20740
Super-Scaffold_100023	13416574	13418146	1572	g_20740	g_20741
Super-Scaffold_100023	13420577	13423757	3180	g_20741	g_20742
Super-Scaffold_100023	13437395	13438453	1058	g_20742	g_20743
Super-Scaffold_100023	13442684	13447454	4770	g_20743	g_44626
Super-Scaffold_100023	13448497	13450902	2405	g_44626	g_20744
Super-Scaffold_100023	13455548	13456320	772	g_20744	g_20745
Super-Scaffold_100023	13459902	13465750	5848	g_20745	g_20746
Super-Scaffold_100023	13471008	13475710	4702	g_20746	g_44627
Super-Scaffold_100023	13484512	13487150	2638	g_44627	g_20747
Super-Scaffold_100023	13490295	13501828	11533	g_20747	g_20748
Super-Scaffold_100023	13517154	13532088	14934	g_20748	g_44628
Super-Scaffold_100023	13535507	13537907	2400	g_44628	g_20749
Super-Scaffold_100023	13557165	13558946	1781	g_20749	g_20750
Super-Scaffold_100023	13560084	13563562	3478	g_20750	g_20751
Super-Scaffold_100023	13570150	13570914	764	g_20751	g_20752
Super-Scaffold_100023	13575285	13579007	3722	g_20752	g_20753
Super-Scaffold_100023	13593698	13600921	7223	g_20753	g_20755
Super-Scaffold_100023	13613183	13623883	10700	g_20755	g_44629
Super-Scaffold_100023	13633268	13638444	5176	g_44629	g_20756
Super-Scaffold_100023	13649330	13655507	6177	g_20756	g_20759
Super-Scaffold_100023	13657229	13661717	4488	g_20759	g_20758
Super-Scaffold_100023	13664261	13664574	313	g_20758	g_20760
Super-Scaffold_100023	13667736	13669068	1332	g_20760	g_20761
Super-Scaffold_100023	13672274	13675142	2868	g_20761	g_44630
Super-Scaffold_100023	13677396	13685440	8044	g_44630	g_20762
Super-Scaffold_100023	13691078	13691553	475	g_20762	g_20763
Super-Scaffold_100023	13693574	13696425	2851	g_20763	g_20764
Super-Scaffold_100023	13697606	13698428	822	g_20764	g_20765
Super-Scaffold_100023	13700982	13712118	11136	g_20765	g_39608
Super-Scaffold_100023	13712408	13712465	57	g_39608	g_39609
Super-Scaffold_100023	13712920	13760469	47549	g_39609	g_20769
Super-Scaffold_100023	13764195	13766222	2027	g_20769	g_20770
Super-Scaffold_100023	13767147	13771091	3944	g_20770	g_20771
Super-Scaffold_100023	13785892	13791954	6062	g_20771	g_39610
Super-Scaffold_100023	13801475	13810764	9289	g_20772	g_44631
Super-Scaffold_100023	13812355	13813260	905	g_44631	g_20773
Super-Scaffold_100023	13816771	13819619	2848	g_20773	g_20774
Super-Scaffold_100023	13820782	13833436	12654	g_20774	g_20775
Super-Scaffold_100023	13854653	13854958	305	g_20775	g_20776
Super-Scaffold_100023	13863626	13877264	13638	g_20776	g_20777
Super-Scaffold_100023	13879620	13897180	17560	g_20777	g_20778
Super-Scaffold_100023	13900831	13913077	12246	g_20778	g_20779
Super-Scaffold_100023	13924794	13927249	2455	g_20779	g_20781
Super-Scaffold_100023	13935413	13937089	1676	g_20781	g_20782
Super-Scaffold_100023	13937982	13938914	932	g_20782	g_20783
Super-Scaffold_100023	13941918	13943889	1971	g_20783	g_44632
Super-Scaffold_100023	13951026	13956589	5563	g_44632	g_44633
Super-Scaffold_100023	13978535	13983089	4554	g_44633	g_44634
Super-Scaffold_100023	13983319	14025841	42522	g_44634	g_20785
Super-Scaffold_100023	14039818	14067742	27924	g_20785	g_20786
Super-Scaffold_100023	14068029	14072503	4474	g_20786	g_20787
Super-Scaffold_100023	14072787	14106744	33957	g_20787	g_20788
Super-Scaffold_100023	14106968	14120981	14013	g_20788	g_20790
Super-Scaffold_100023	14141040	14161166	20126	g_20790	g_20791
Super-Scaffold_100023	14161798	14197081	35283	g_20791	g_20794
Super-Scaffold_100023	14197422	14243435	46013	g_20794	g_20796
Super-Scaffold_100023	14243770	14250717	6947	g_20796	g_20797
Super-Scaffold_100023	14264515	14270951	6436	g_20797	g_20798
Super-Scaffold_100023	14275846	14280384	4538	g_20798	g_20799
Super-Scaffold_100023	14287178	14288848	1670	g_20799	g_20800
Super-Scaffold_100023	14291437	14294291	2854	g_20800	g_20801
Super-Scaffold_100023	14297256	14298151	895	g_20801	g_20802
Super-Scaffold_100023	14301237	14303736	2499	g_20802	g_20803
Super-Scaffold_100023	14307690	14309588	1898	g_20803	g_44635
Super-Scaffold_100023	14324511	14348479	23968	g_44635	g_20804
Super-Scaffold_100023	14373279	14375273	1994	g_20804	g_20805
Super-Scaffold_100023	14378797	14381305	2508	g_20805	g_20806
Super-Scaffold_100023	14383627	14410976	27349	g_20806	g_20811
Super-Scaffold_100023	14414704	14433675	18971	g_20811	g_20812
Super-Scaffold_100023	14437667	14454804	17137	g_20812	g_20813
Super-Scaffold_100023	14459396	14461734	2338	g_20813	g_44636
Super-Scaffold_100023	14467164	14468933	1769	g_44636	g_20814
Super-Scaffold_100023	14474538	14478479	3941	g_20814	g_20815
Super-Scaffold_100023	14485602	14487480	1878	g_20815	g_44637
Super-Scaffold_100023	14495622	14500710	5088	g_44637	g_20816
Super-Scaffold_100023	14528043	14530797	2754	g_20816	g_44638
Super-Scaffold_100023	14533884	14537351	3467	g_44638	g_20817
Super-Scaffold_100023	14540764	14591933	51169	g_20817	g_20820
Super-Scaffold_100023	14602860	14610983	8123	g_20820	g_44639
Super-Scaffold_100023	14623077	14629780	6703	g_44639	g_20821
Super-Scaffold_100023	14635225	14639137	3912	g_20821	g_44640
Super-Scaffold_100023	14670047	14671700	1653	g_44640	g_20822
Super-Scaffold_100023	14673948	14674920	972	g_20822	g_20823
Super-Scaffold_100023	14675816	14677149	1333	g_20823	g_20824
Super-Scaffold_100023	14686554	14689618	3064	g_20824	g_20825
Super-Scaffold_100023	14690205	14750244	60039	g_20825	g_20827
Super-Scaffold_100023	14752204	14754008	1804	g_20827	g_20828
Super-Scaffold_100023	14757854	14763141	5287	g_20828	g_20830
Super-Scaffold_100023	14767680	14768853	1173	g_20830	g_20831
Super-Scaffold_100023	14772746	14781974	9228	g_20831	g_20832
Super-Scaffold_100023	14782583	14783527	944	g_20832	g_39622
Super-Scaffold_100023	14785315	14785382	67	g_20833	g_39623
Super-Scaffold_100023	14787409	14788757	1348	g_39623	g_20834
Super-Scaffold_100023	14789773	14792191	2418	g_20834	g_20835
Super-Scaffold_100023	14793279	14801040	7761	g_20835	g_20837
Super-Scaffold_100023	14803560	14804696	1136	g_20837	g_20838
Super-Scaffold_100023	14810430	14813555	3125	g_20838	g_44641
Super-Scaffold_100023	14827689	14839299	11610	g_44641	g_20839
Super-Scaffold_100023	14843647	14845667	2020	g_20839	g_44642
Super-Scaffold_100023	14850425	14851588	1163	g_44642	g_20840
Super-Scaffold_100023	14853360	14854144	784	g_20840	g_20841
Super-Scaffold_100023	14856288	14857539	1251	g_20841	g_20842
Super-Scaffold_100023	14870912	14873500	2588	g_20842	g_20843
Super-Scaffold_100023	14878175	14883046	4871	g_20843	g_20844
Super-Scaffold_100023	14888347	14891424	3077	g_20844	g_20845
Super-Scaffold_100023	14893388	14895404	2016	g_20845	g_20846
Super-Scaffold_100023	14904128	14906206	2078	g_20846	g_44643
Super-Scaffold_100023	14911142	14916463	5321	g_44643	g_44644
Super-Scaffold_100023	14942824	14968196	25372	g_44644	g_20847
Super-Scaffold_100023	14972218	14979404	7186	g_20847	g_20848
Super-Scaffold_100023	14987249	14997735	10486	g_20848	g_20849
Super-Scaffold_100023	15000976	15002673	1697	g_20849	g_44645
Super-Scaffold_100023	15007355	15014152	6797	g_44645	g_44646
Super-Scaffold_100023	15021509	15027283	5774	g_44646	g_20850
Super-Scaffold_100023	15037129	15038593	1464	g_20850	g_20851
Super-Scaffold_100023	15044910	15046713	1803	g_20851	g_20852
Super-Scaffold_100023	15051292	15054417	3125	g_20852	g_20853
Super-Scaffold_100023	15056530	15058806	2276	g_20853	g_20854
Super-Scaffold_100023	15074118	15076415	2297	g_20854	g_20855
Super-Scaffold_100023	15079062	15083102	4040	g_20855	g_20856
Super-Scaffold_100023	15084312	15124776	40464	g_20856	g_20858
Super-Scaffold_100023	15126077	15136440	10363	g_20858	g_20859
Super-Scaffold_100023	15150203	15151841	1638	g_20859	g_20860
Super-Scaffold_100023	15155049	15162473	7424	g_20860	g_20861
Super-Scaffold_100023	15163267	15175811	12544	g_20861	g_20862
Super-Scaffold_100023	15199448	15205679	6231	g_20862	g_20863
Super-Scaffold_100023	15206494	15369199	162705	g_20863	g_20869
Super-Scaffold_100023	15369495	15371246	1751	g_20869	g_20868
Super-Scaffold_100023	15386013	15392591	6578	g_20868	g_20870
Super-Scaffold_100023	15403996	15405111	1115	g_20870	g_44647
Super-Scaffold_100023	15410861	15416779	5918	g_44647	g_20871
Super-Scaffold_100023	15419669	15435258	15589	g_20871	g_20872
Super-Scaffold_100023	15435494	15447515	12021	g_20872	g_44648
Super-Scaffold_100023	15463049	15464443	1394	g_44648	g_20874
Super-Scaffold_100023	15466408	15468908	2500	g_20874	g_20875
Super-Scaffold_100023	15469461	15471087	1626	g_20875	g_39636
Super-Scaffold_100023	15474469	15482172	7703	g_20876	g_44649
Super-Scaffold_100023	15485139	15498128	12989	g_44649	g_20877
Super-Scaffold_100023	15517627	15520216	2589	g_20877	g_20879
Super-Scaffold_100023	15534755	15547378	12623	g_20879	g_44650
Super-Scaffold_100023	15547848	15565198	17350	g_44650	g_20881
Super-Scaffold_100023	15567221	15574170	6949	g_20881	g_20882
Super-Scaffold_100023	15577941	15646556	68615	g_20882	g_20885
Super-Scaffold_100023	15648016	15648512	496	g_20885	g_20886
Super-Scaffold_100023	15654879	15656097	1218	g_20886	g_20887
Super-Scaffold_100023	15662428	15663393	965	g_20887	g_20888
Super-Scaffold_100023	15692011	15694642	2631	g_20888	g_20889
Super-Scaffold_100023	15711042	15715552	4510	g_20889	g_20890
Super-Scaffold_100023	15729073	15734474	5401	g_20890	g_20891
Super-Scaffold_100023	15740115	15743524	3409	g_20891	g_20893
Super-Scaffold_100023	15751368	15755997	4629	g_20893	g_20894
Super-Scaffold_100023	15770746	15774503	3757	g_20894	g_20895
Super-Scaffold_100023	15774727	15780813	6086	g_20895	g_20896
Super-Scaffold_100023	15784730	15793112	8382	g_20896	g_20898
Super-Scaffold_100023	15794954	15795602	648	g_20898	g_20899
Super-Scaffold_100023	15796602	15799187	2585	g_20899	g_20900
Super-Scaffold_100023	15803848	15806408	2560	g_20900	g_20901
Super-Scaffold_100023	15827847	15840263	12416	g_20901	g_20903
Super-Scaffold_100023	15840484	15848347	7863	g_20903	g_20904
Super-Scaffold_100023	15848928	15878043	29115	g_20904	g_20908
Super-Scaffold_100023	15878345	15909488	31143	g_20908	g_20909
Super-Scaffold_100023	15927141	15950906	23765	g_20909	g_20910
Super-Scaffold_100023	15952014	15958312	6298	g_20910	g_20911
Super-Scaffold_100023	15958749	15967450	8701	g_20911	g_20912
Super-Scaffold_100023	15980576	15982963	2387	g_20912	g_20913
Super-Scaffold_100023	15988677	15993694	5017	g_20913	g_20914
Super-Scaffold_100023	15994239	15995635	1396	g_20914	g_20915
Super-Scaffold_100023	16006780	16010658	3878	g_20915	g_20916
Super-Scaffold_100023	16018712	16019900	1188	g_20916	g_20917
Super-Scaffold_100023	16026851	16029821	2970	g_20917	g_20919
Super-Scaffold_100023	16040350	16042867	2517	g_20919	g_20920
Super-Scaffold_100023	16048706	16072421	23715	g_20920	g_20921
Super-Scaffold_100023	16091204	16095233	4029	g_20921	g_20922
Super-Scaffold_100023	16109955	16113025	3070	g_20922	g_20923
Super-Scaffold_100023	16116145	16116425	280	g_20923	g_20924
Super-Scaffold_100023	16119649	16119703	54	g_20924	g_20925
Super-Scaffold_100023	16126388	16127257	869	g_20925	g_20926
Super-Scaffold_100023	16133278	16133871	593	g_20926	g_20927
Super-Scaffold_100023	16140224	16141834	1610	g_20927	g_20928
Super-Scaffold_100023	16148268	16150469	2201	g_20928	g_44651
Super-Scaffold_100023	16164284	16172860	8576	g_44651	g_20929
Super-Scaffold_100023	16174429	16179572	5143	g_20929	g_20930
Super-Scaffold_100023	16181049	16183995	2946	g_20930	g_20931
Super-Scaffold_100023	16184216	16198795	14579	g_20931	g_20932
Super-Scaffold_100023	16202371	16206756	4385	g_20932	g_20933
Super-Scaffold_100023	16207298	16209443	2145	g_20933	g_20934
Super-Scaffold_100023	16219232	16219718	486	g_20934	g_20935
Super-Scaffold_100023	16221313	16260382	39069	g_20935	g_20937
Super-Scaffold_100023	16265127	16275524	10397	g_20937	g_20938
Super-Scaffold_100023	16282717	16289459	6742	g_20938	g_20939
Super-Scaffold_100023	16341718	16344953	3235	g_20939	g_20941
Super-Scaffold_100023	16389996	16466243	76247	g_20941	g_20942
Super-Scaffold_100023	16471077	16504251	33174	g_20942	g_20943
Super-Scaffold_100023	16504622	16511798	7176	g_20943	g_20944
Super-Scaffold_100023	16522757	16527295	4538	g_20944	g_20946
Super-Scaffold_100023	16530070	16539719	9649	g_20946	g_20947
Super-Scaffold_100023	16553913	16554922	1009	g_20947	g_44652
Super-Scaffold_100023	16557884	16558513	629	g_44652	g_20948
Super-Scaffold_100023	16561799	16561869	70	g_20948	g_20949
Super-Scaffold_100023	16562084	16582090	20006	g_20949	g_20950
Super-Scaffold_100023	16585301	16596583	11282	g_20950	g_20951
Super-Scaffold_100023	16611081	16628067	16986	g_20951	g_20953
Super-Scaffold_100023	16629872	16651077	21205	g_20953	g_20954
Super-Scaffold_100023	16651589	16670871	19282	g_20954	g_20955
Super-Scaffold_100023	16671482	16694072	22590	g_20955	g_20957
Super-Scaffold_100023	16704157	16708435	4278	g_20957	g_20958
Super-Scaffold_100023	16711439	16712417	978	g_20958	g_20959
Super-Scaffold_100023	16717709	16718777	1068	g_20959	g_20960
Super-Scaffold_100023	16720446	16721549	1103	g_20960	g_20961
Super-Scaffold_100023	16724466	16727849	3383	g_20961	g_20962
Super-Scaffold_100023	16731009	16781490	50481	g_20962	g_20963
Super-Scaffold_100023	16781696	16782561	865	g_20963	g_20964
Super-Scaffold_100023	16801231	16812840	11609	g_20964	g_20965
Super-Scaffold_100023	16813085	16822325	9240	g_20965	g_20967
Super-Scaffold_100023	16830332	16833519	3187	g_20967	g_44653
Super-Scaffold_100023	16840827	16843019	2192	g_44653	g_44654
Super-Scaffold_100023	16846157	16846456	299	g_44654	g_20968
Super-Scaffold_100023	16847610	16853350	5740	g_20968	g_20969
Super-Scaffold_100023	16853971	16856419	2448	g_20969	g_20970
Super-Scaffold_100023	16857035	16862321	5286	g_20970	g_20971
Super-Scaffold_100023	16865091	16949687	84596	g_20971	g_20972
Super-Scaffold_100023	16954029	17017177	63148	g_20972	g_20974
Super-Scaffold_100023	17023423	17075750	52327	g_20974	g_20975
Super-Scaffold_100023	17079424	17191273	111849	g_20975	g_20976
Super-Scaffold_100023	17217125	17260791	43666	g_20976	g_20977
Super-Scaffold_100023	17263795	17293129	29334	g_20977	g_20978
Super-Scaffold_100023	17293431	17313899	20468	g_20978	g_20979
Super-Scaffold_100023	17317414	17323099	5685	g_20979	g_20980
Super-Scaffold_100023	17338317	17357049	18732	g_20980	g_39651
Super-Scaffold_100023	17365818	17407282	41464	g_20981	g_20982
Super-Scaffold_100023	17432261	17455837	23576	g_20982	g_20985
Super-Scaffold_100023	17456154	17537790	81636	g_20985	g_20988
Super-Scaffold_100023	17538023	17726013	187990	g_20988	g_20994
Super-Scaffold_100023	17745045	17747175	2130	g_20994	g_20995
Super-Scaffold_100023	17747639	17762576	14937	g_20995	g_20998
Super-Scaffold_100023	17769225	17770553	1328	g_20998	g_20999
Super-Scaffold_100023	17782220	17783528	1308	g_20999	g_21000
Super-Scaffold_100023	17794017	17795794	1777	g_21000	g_21001
Super-Scaffold_100023	17798137	17807090	8953	g_21001	g_21002
Super-Scaffold_100023	17809377	17815293	5916	g_21002	g_21003
Super-Scaffold_100023	17830610	17838144	7534	g_21003	g_44655
Super-Scaffold_100023	17854694	17861840	7146	g_44655	g_21004
Super-Scaffold_100023	17891804	17931438	39634	g_21004	g_21005
Super-Scaffold_100023	17936855	17939403	2548	g_21005	g_21006
Super-Scaffold_100023	17962503	17977433	14930	g_21006	g_21008
Super-Scaffold_100023	17987892	17989898	2006	g_21008	g_21009
Super-Scaffold_100023	17990320	18022657	32337	g_21009	g_21010
Super-Scaffold_100023	18045443	18049367	3924	g_21010	g_21011
Super-Scaffold_100023	18049720	18103800	54080	g_21011	g_21013
Super-Scaffold_100023	18106228	18116661	10433	g_21013	g_44656
Super-Scaffold_100023	18130948	18131481	533	g_44656	g_21014
Super-Scaffold_100023	18133660	18136631	2971	g_21014	g_21015
Super-Scaffold_100023	18142667	18149005	6338	g_21015	g_21016
Super-Scaffold_100023	18149781	18165489	15708	g_21016	g_21018
Super-Scaffold_100023	18185765	18189950	4185	g_21018	g_21019
Super-Scaffold_100023	18200449	18208071	7622	g_21019	g_21020
Super-Scaffold_100023	18216693	18216855	162	g_39657	g_39658
Super-Scaffold_100023	18217187	18225906	8719	g_39658	g_21021
Super-Scaffold_100023	18246651	18252361	5710	g_21021	g_21022
Super-Scaffold_100023	18273135	18292764	19629	g_21022	g_44657
Super-Scaffold_100023	18317455	18325659	8204	g_44657	g_21023
Super-Scaffold_100023	18333050	18335587	2537	g_21023	g_21024
Super-Scaffold_100023	18343777	18348413	4636	g_21024	g_44658
Super-Scaffold_100023	18352008	18356066	4058	g_44658	g_21025
Super-Scaffold_100023	18368780	18370026	1246	g_21025	g_21026
Super-Scaffold_100023	18373405	18417370	43965	g_21026	g_21028
Super-Scaffold_100023	18418029	18439069	21040	g_21028	g_21029
Super-Scaffold_100023	18473998	18504235	30237	g_21029	g_21030
Super-Scaffold_100023	18507146	18510093	2947	g_21030	g_44659
Super-Scaffold_100023	18519782	18522340	2558	g_44659	g_21031
Super-Scaffold_100023	18543791	18548056	4265	g_21031	g_21032
Super-Scaffold_100023	18556030	18560346	4316	g_21032	g_21033
Super-Scaffold_100023	18584137	18670156	86019	g_21033	g_21036
Super-Scaffold_100023	18693194	18695067	1873	g_21036	g_21037
Super-Scaffold_100023	18702810	18706697	3887	g_21037	g_21038
Super-Scaffold_100023	18708725	18711848	3123	g_21038	g_21039
Super-Scaffold_100023	18715611	18778648	63037	g_21039	g_21041
Super-Scaffold_100023	18802505	18818790	16285	g_21041	g_21042
Super-Scaffold_100023	18842921	18851115	8194	g_21042	g_21043
Super-Scaffold_100023	18857967	18870958	12991	g_21043	g_21045
Super-Scaffold_100023	18877443	18901721	24278	g_21045	g_21046
Super-Scaffold_100023	18903460	18917564	14104	g_21046	g_21047
Super-Scaffold_100023	18931257	18943730	12473	g_21047	g_21049
Super-Scaffold_100023	18945160	18945210	50	g_21049	g_21050
Super-Scaffold_100023	18951389	18953372	1983	g_21050	g_21051
Super-Scaffold_100023	18956210	18961594	5384	g_21051	g_21052
Super-Scaffold_100023	18962232	19090415	128183	g_21052	g_21055
Super-Scaffold_100023	19090696	19114812	24116	g_21055	g_21056
Super-Scaffold_100023	19116134	19223619	107485	g_21056	g_21061
Super-Scaffold_100023	19223858	19264661	40803	g_21061	g_39665
Super-Scaffold_100023	19264903	19276297	11394	g_39665	g_21062
Super-Scaffold_100023	19278319	19421216	142897	g_21062	g_21065
Super-Scaffold_100023	19421698	19450218	28520	g_21065	g_21066
Super-Scaffold_100023	19450661	19504255	53594	g_21066	g_21067
Super-Scaffold_100023	19505904	19508283	2379	g_21067	g_21068
Super-Scaffold_100023	19511654	19514433	2779	g_21068	g_21069
Super-Scaffold_100023	19514681	19525567	10886	g_21069	g_21070
Super-Scaffold_100023	19544317	19572314	27997	g_21070	g_21071
Super-Scaffold_100023	19575376	19576601	1225	g_21071	g_21072
Super-Scaffold_100023	19594187	19671011	76824	g_21072	g_21074
Super-Scaffold_100023	19672991	19676725	3734	g_21074	g_21075
Super-Scaffold_100023	19686992	19718679	31687	g_21075	g_21077
Super-Scaffold_100023	19719035	19768944	49909	g_21077	g_21078
Super-Scaffold_100023	19787577	19798286	10709	g_21078	g_21079
Super-Scaffold_100023	19799512	19843950	44438	g_21079	g_21080
Super-Scaffold_100023	19850586	19852913	2327	g_21080	g_21081
Super-Scaffold_100023	19863108	19864466	1358	g_21081	g_21082
Super-Scaffold_100023	19884367	19887945	3578	g_21082	g_21083
Super-Scaffold_100023	19893712	19915440	21728	g_21083	g_21085
Super-Scaffold_100023	19918092	19950176	32084	g_21085	g_21086
Super-Scaffold_100023	19951180	19961631	10451	g_21086	g_21087
Super-Scaffold_100023	19962275	19998092	35817	g_21087	g_39669
Super-Scaffold_100023	19998688	20084403	85715	g_39669	g_21091
Super-Scaffold_100023	20087393	20095832	8439	g_21091	g_21093
Super-Scaffold_100023	20102955	20106774	3819	g_21093	g_21094
Super-Scaffold_100023	20110039	20111736	1697	g_21094	g_21095
Super-Scaffold_100023	20112896	20118597	5701	g_21095	g_21096
Super-Scaffold_100023	20155996	20159737	3741	g_21096	g_21097
Super-Scaffold_100023	20167640	20180339	12699	g_21097	g_21098
Super-Scaffold_100023	20182614	20186446	3832	g_21098	g_21100
Super-Scaffold_100023	20190430	20195346	4916	g_21100	g_21101
Super-Scaffold_100023	20205552	20211099	5547	g_21101	g_21102
Super-Scaffold_100023	20241840	20292912	51072	g_21102	g_21105
Super-Scaffold_100023	20293193	20421031	127838	g_21105	g_21109
Super-Scaffold_100023	20421303	20456308	35005	g_21109	g_21110
Super-Scaffold_100023	20467166	20480589	13423	g_21110	g_44660
Super-Scaffold_100023	20513304	20520201	6897	g_44660	g_44661
Super-Scaffold_100023	20540223	20559554	19331	g_44661	g_21111
Super-Scaffold_100023	20575904	20642307	66403	g_21111	g_21113
Super-Scaffold_100023	20646196	20735144	88948	g_21113	g_21114
Super-Scaffold_100023	20736061	20836115	100054	g_21114	g_21115
Super-Scaffold_100023	20841181	20866793	25612	g_21115	g_21117
Super-Scaffold_100023	20881065	20881495	430	g_21117	g_21118
Super-Scaffold_100023	20888588	20891408	2820	g_21118	g_21119
Super-Scaffold_100023	20894881	20901038	6157	g_21119	g_21120
Super-Scaffold_100023	20909701	20916931	7230	g_21120	g_44662
Super-Scaffold_100023	20917861	20933035	15174	g_44662	g_21121
Super-Scaffold_100023	20954506	20955394	888	g_21121	g_21122
Super-Scaffold_100023	20957982	20960623	2641	g_21122	g_21123
Super-Scaffold_100023	20962709	20966866	4157	g_21123	g_21124
Super-Scaffold_100023	20967930	20972283	4353	g_21124	g_21126
Super-Scaffold_100023	20972585	20976312	3727	g_21126	g_21127
Super-Scaffold_100023	20978014	20981316	3302	g_21127	g_21128
Super-Scaffold_100023	20982553	20988509	5956	g_21128	g_44663
Super-Scaffold_100023	20990803	20993649	2846	g_44663	g_21129
Super-Scaffold_100023	20995546	20996425	879	g_21129	g_21130
Super-Scaffold_100023	20997894	20998725	831	g_21130	g_21131
Super-Scaffold_100023	21001325	21003982	2657	g_21131	g_21132
Super-Scaffold_100023	21005942	21006821	879	g_21132	g_21133
Super-Scaffold_100023	21008001	21008832	831	g_21133	g_21134
Super-Scaffold_100023	21010040	21015962	5922	g_21134	g_44664
Super-Scaffold_100023	21018861	21021104	2243	g_44664	g_21135
Super-Scaffold_100023	21023769	21029743	5974	g_21135	g_21136
Super-Scaffold_100023	21032896	21035125	2229	g_21136	g_21137
Super-Scaffold_100023	21037656	21040380	2724	g_21137	g_44665
Super-Scaffold_100023	21041593	21049555	7962	g_44665	g_21138
Super-Scaffold_100023	21051930	21054557	2627	g_21138	g_21139
Super-Scaffold_100023	21056552	21057439	887	g_21139	g_21140
Super-Scaffold_100023	21058869	21059622	753	g_21140	g_21141
Super-Scaffold_100023	21060779	21063329	2550	g_21141	g_44666
Super-Scaffold_100023	21065109	21065163	54	g_44666	g_21142
Super-Scaffold_100023	21065525	21068036	2511	g_21142	g_44667
Super-Scaffold_100023	21069874	21070756	882	g_44667	g_21143
Super-Scaffold_100023	21072278	21073108	830	g_21143	g_21144
Super-Scaffold_100023	21075701	21078353	2652	g_21144	g_21145
Super-Scaffold_100023	21080115	21080995	880	g_21145	g_21146
Super-Scaffold_100023	21082963	21083793	830	g_21146	g_21147
Super-Scaffold_100023	21084972	21087562	2590	g_21147	g_44668
Super-Scaffold_100023	21088475	21102724	14249	g_44668	g_21149
Super-Scaffold_100023	21105377	21108029	2652	g_21149	g_21150
Super-Scaffold_100023	21109822	21113501	3679	g_21150	g_21151
Super-Scaffold_100023	21114710	21117295	2585	g_21151	g_44669
Super-Scaffold_100023	21120314	21122556	2242	g_44669	g_21152
Super-Scaffold_100023	21125311	21127966	2655	g_21152	g_21153
Super-Scaffold_100023	21130412	21131615	1203	g_21153	g_21154
Super-Scaffold_100023	21144285	21145886	1601	g_21154	g_21155
Super-Scaffold_100023	21154083	21155191	1108	g_21155	g_21156
Super-Scaffold_100023	21155670	21157791	2121	g_21156	g_21157
Super-Scaffold_100023	21173969	21176259	2290	g_21157	g_21158
Super-Scaffold_100023	21208327	21210810	2483	g_21158	g_21159
Super-Scaffold_100023	21228847	21230875	2028	g_21159	g_21160
Super-Scaffold_100023	21233445	21234449	1004	g_21160	g_21161
Super-Scaffold_100023	21246956	21251768	4812	g_21161	g_21162
Super-Scaffold_100023	21254738	21276449	21711	g_21162	g_21163
Super-Scaffold_100023	21276897	21291566	14669	g_21163	g_21164
Super-Scaffold_100023	21302497	21305845	3348	g_21164	g_21165
Super-Scaffold_100023	21341734	21348900	7166	g_21165	g_39680
Super-Scaffold_100023	21349118	21349161	43	g_39680	g_21166
Super-Scaffold_100023	21349733	21356073	6340	g_21166	g_21167
Super-Scaffold_100023	21356276	21358608	2332	g_21167	g_39681
Super-Scaffold_100023	21359486	21362171	2685	g_39681	g_21168
Super-Scaffold_100023	21384282	21389895	5613	g_21168	g_21169
Super-Scaffold_100023	21390922	21394540	3618	g_21169	g_21170
Super-Scaffold_100023	21397035	21400829	3794	g_21170	g_21171
Super-Scaffold_100023	21410280	21421925	11645	g_21171	g_21172
Super-Scaffold_100023	21452973	21459078	6105	g_21172	g_21174
Super-Scaffold_100023	21459605	21462757	3152	g_21174	g_21175
Super-Scaffold_100023	21463134	21526301	63167	g_21175	g_21176
Super-Scaffold_100023	21527173	21540488	13315	g_21176	g_21177
Super-Scaffold_100023	21541360	21547393	6033	g_21177	g_21178
Super-Scaffold_100023	21548772	21559216	10444	g_21178	g_21179
Super-Scaffold_100023	21560475	21582216	21741	g_21179	g_21180
Super-Scaffold_100023	21589968	21594684	4716	g_21180	g_21181
Super-Scaffold_100023	21595532	21595599	67	g_21181	g_39683
Super-Scaffold_100023	21598203	21598497	294	g_21182	g_21183
Super-Scaffold_100023	21616666	21622848	6182	g_21183	g_21184
Super-Scaffold_100023	21623375	21628894	5519	g_21184	g_21185
Super-Scaffold_100023	21629289	21651318	22029	g_21185	g_21186
Super-Scaffold_100023	21654175	21660210	6035	g_21186	g_21187
Super-Scaffold_100023	21667084	21675859	8775	g_21187	g_21188
Super-Scaffold_100023	21682620	21758885	76265	g_21188	g_21190
Super-Scaffold_100023	21759133	21764815	5682	g_21190	g_21191
Super-Scaffold_100023	21765636	21860004	94368	g_21191	g_21192
Super-Scaffold_100023	21860438	21866308	5870	g_21192	g_39690
Super-Scaffold_100023	21866508	21997638	131130	g_39690	g_21195
Super-Scaffold_100023	21997937	21998100	163	g_21195	g_21196
Super-Scaffold_100023	21998342	22019205	20863	g_21196	g_21198
Super-Scaffold_100023	22019486	22072527	53041	g_21198	g_21200
Super-Scaffold_100023	22076434	22211363	134929	g_21200	g_21204
Super-Scaffold_100023	22212151	22225129	12978	g_21204	g_21205
Super-Scaffold_100023	22244090	22287305	43215	g_21205	g_21208
Super-Scaffold_100023	22287647	22325230	37583	g_21208	g_21210
Super-Scaffold_100023	22328153	22371484	43331	g_39699	g_21213
Super-Scaffold_100023	22372854	22380023	7169	g_21213	g_21214
Super-Scaffold_100023	22399877	22436523	36646	g_21214	g_21216
Super-Scaffold_100023	22437728	22442152	4424	g_21216	g_21217
Super-Scaffold_100023	22449151	22453398	4247	g_21217	g_21218
Super-Scaffold_100023	22456035	22464559	8524	g_21218	g_21219
Super-Scaffold_100023	22464900	22465694	794	g_21219	g_21220
Super-Scaffold_100023	22467124	22468153	1029	g_21220	g_21221
Super-Scaffold_100023	22470339	22480118	9779	g_21221	g_21223
Super-Scaffold_100023	22496778	22511391	14613	g_21223	g_21224
Super-Scaffold_100023	22511771	22529336	17565	g_21224	g_21226
Super-Scaffold_100023	22529662	22538475	8813	g_21226	g_21227
Super-Scaffold_100023	22538912	22544449	5537	g_21227	g_39702
Super-Scaffold_100023	22544787	22546775	1988	g_39702	g_21228
Super-Scaffold_100023	22547062	22549192	2130	g_21228	g_21229
Super-Scaffold_100023	22565463	22571291	5828	g_21229	g_21230
Super-Scaffold_100023	22591396	22617331	25935	g_21230	g_21231
Super-Scaffold_100023	22617705	22652679	34974	g_21231	g_21234
Super-Scaffold_100023	22653161	22655853	2692	g_21234	g_21236
Super-Scaffold_100023	22656383	22712655	56272	g_21236	g_21238
Super-Scaffold_100023	22727472	22737520	10048	g_21238	g_21239
Super-Scaffold_100023	22738125	22744625	6500	g_21239	g_21240
Super-Scaffold_100023	22753816	22760527	6711	g_21240	g_21241
Super-Scaffold_100023	22764578	22768035	3457	g_21241	g_21242
Super-Scaffold_100023	22778583	22782546	3963	g_21242	g_21243
Super-Scaffold_100023	22783031	22787666	4635	g_21243	g_21244
Super-Scaffold_100023	22793568	22799250	5682	g_21244	g_21245
Super-Scaffold_100023	22799519	22807942	8423	g_21245	g_21247
Super-Scaffold_100023	22821298	22827255	5957	g_39707	g_39708
Super-Scaffold_100023	22828202	22850505	22303	g_39708	g_21248
Super-Scaffold_100023	22858270	22860409	2139	g_39710	g_21249
Super-Scaffold_100023	22878305	22884302	5997	g_21249	g_21251
Super-Scaffold_100023	22884622	22886003	1381	g_21251	g_21252
Super-Scaffold_100023	22886890	22930226	43336	g_21252	g_21256
Super-Scaffold_100023	22935775	22944006	8231	g_21256	g_21258
Super-Scaffold_100023	22951301	22958335	7034	g_21258	g_21259
Super-Scaffold_100023	22977541	23746019	768478	g_21259	g_21260
Super-Scaffold_100023	23750567	23773185	22618	g_39712	g_44670
Super-Scaffold_100023	23774576	23782837	8261	g_44670	g_21263
Super-Scaffold_100023	23783238	23783351	113	g_21263	g_21264
Super-Scaffold_100023	23783593	23790441	6848	g_21264	g_21262
Super-Scaffold_100023	23791091	23810311	19220	g_21262	g_21265
Super-Scaffold_100023	23810643	23810829	186	g_21265	g_21266
Super-Scaffold_100023	23811065	23841580	30515	g_21266	g_39714
Super-Scaffold_100023	23842272	23855942	13670	g_39714	g_21268
Super-Scaffold_100023	23874725	23891259	16534	g_21268	g_21270
Super-Scaffold_100023	23891923	23898880	6957	g_21270	g_44671
Super-Scaffold_100023	23905127	23932338	27211	g_44671	g_21274
Super-Scaffold_100026	132977	150051	17074	g_34103	g_34105
Super-Scaffold_100026	169306	187411	18105	g_34105	g_34107
Super-Scaffold_100026	189606	202735	13129	g_34107	g_34109
Super-Scaffold_100026	202998	207377	4379	g_34109	g_34110
Super-Scaffold_100026	229092	231365	2273	g_34110	g_34111
Super-Scaffold_100026	237806	243638	5832	g_34111	g_34113
Super-Scaffold_100026	256609	271171	14562	g_34113	g_45622
Super-Scaffold_100026	282046	284947	2901	g_45622	g_34114
Super-Scaffold_100026	297416	306245	8829	g_34114	g_34116
Super-Scaffold_100026	316871	324254	7383	g_34116	g_34117
Super-Scaffold_100026	324544	325242	698	g_34117	g_34118
Super-Scaffold_100026	325472	337422	11950	g_34118	g_34119
Super-Scaffold_100026	337892	352753	14861	g_34119	g_34120
Super-Scaffold_100026	353010	359112	6102	g_34120	g_34121
Super-Scaffold_100026	370735	374905	4170	g_34121	g_34122
Super-Scaffold_100026	375111	400705	25594	g_34122	g_34123
Super-Scaffold_100026	401218	401369	151	g_34123	g_34124
Super-Scaffold_100026	403036	403351	315	g_34124	g_34125
Super-Scaffold_100026	403920	404029	109	g_34125	g_37175
Super-Scaffold_100026	404928	436437	31509	g_37175	g_34127
Super-Scaffold_100026	437738	493748	56010	g_34127	g_37176
Super-Scaffold_100026	495073	497122	2049	g_37176	g_34131
Super-Scaffold_100026	497541	521568	24027	g_34131	g_37178
Super-Scaffold_100026	522170	522455	285	g_37178	g_34132
Super-Scaffold_100026	524836	527377	2541	g_34132	g_34133
Super-Scaffold_100026	541465	544412	2947	g_34133	g_34134
Super-Scaffold_100026	545308	568875	23567	g_34134	g_34135
Super-Scaffold_100026	590153	593834	3681	g_34135	g_34136
Super-Scaffold_100026	594103	601224	7121	g_34136	g_34137
Super-Scaffold_100026	602534	603242	708	g_34137	g_34138
Super-Scaffold_100026	623433	632990	9557	g_34138	g_34141
Super-Scaffold_100026	647770	654991	7221	g_34141	g_34142
Super-Scaffold_100026	662794	682928	20134	g_34142	g_37184
Super-Scaffold_100026	683236	745339	62103	g_37184	g_34144
Super-Scaffold_100026	748669	759617	10948	g_34144	g_34147
Super-Scaffold_100026	760288	794276	33988	g_34147	g_34151
Super-Scaffold_100026	794851	795285	434	g_34151	g_34152
Super-Scaffold_100026	795653	796545	892	g_34152	g_34153
Super-Scaffold_100026	796973	797327	354	g_34153	g_34154
Super-Scaffold_100026	805228	825573	20345	g_34154	g_34156
Super-Scaffold_100026	828197	855390	27193	g_34156	g_34157
Super-Scaffold_100026	855719	860980	5261	g_34157	g_34158
Super-Scaffold_100026	861183	888475	27292	g_34158	g_34161
Super-Scaffold_100026	888924	931848	42924	g_34161	g_34165
Super-Scaffold_100026	944816	987818	43002	g_34165	g_34167
Super-Scaffold_100026	988402	988449	47	g_34167	g_34168
Super-Scaffold_100026	988940	989172	232	g_34168	g_34169
Super-Scaffold_100026	989891	989938	47	g_34169	g_34170
Super-Scaffold_100026	990792	1019726	28934	g_34170	g_34172
Super-Scaffold_100026	1021030	1032898	11868	g_34172	g_37191
Super-Scaffold_100026	1033116	1082888	49772	g_37191	g_34173
Super-Scaffold_100026	1084907	1101208	16301	g_34173	g_34174
Super-Scaffold_100026	1101774	1104815	3041	g_34174	g_34175
Super-Scaffold_100026	1105288	1122530	17242	g_34175	g_34176
Super-Scaffold_100026	1122778	1124032	1254	g_34176	g_34177
Super-Scaffold_100026	1125620	1159941	34321	g_34177	g_34178
Super-Scaffold_100026	1162057	1186057	24000	g_34178	g_34180
Super-Scaffold_100026	1188600	1189855	1255	g_34180	g_34181
Super-Scaffold_100026	1191165	1195752	4587	g_34181	g_34182
Super-Scaffold_100026	1203520	1203540	20	g_34182	g_34183
Super-Scaffold_100026	1206884	1207228	344	g_34183	g_34184
Super-Scaffold_100026	1208688	1226901	18213	g_34184	g_34185
Super-Scaffold_100026	1252500	1333157	80657	g_34185	g_34188
Super-Scaffold_100026	1333390	1359287	25897	g_34188	g_34189
Super-Scaffold_100026	1361581	1361599	18	g_34189	g_34190
Super-Scaffold_100026	1362177	1362590	413	g_34191	g_34192
Super-Scaffold_100026	1362958	1363019	61	g_34192	g_34193
Super-Scaffold_100026	1364824	1371034	6210	g_34193	g_34194
Super-Scaffold_100026	1371273	1418800	47527	g_34194	g_34197
Super-Scaffold_100026	1419336	1453553	34217	g_34197	g_34199
Super-Scaffold_100026	1455682	1455727	45	g_34199	g_34200
Super-Scaffold_100026	1457427	1710164	252737	g_34200	g_34210
Super-Scaffold_100026	1710379	1737386	27007	g_34210	g_34211
Super-Scaffold_100026	1737688	1740588	2900	g_34211	g_34212
Super-Scaffold_100026	1741457	1761630	20173	g_34212	g_34213
Super-Scaffold_100026	1762025	1768937	6912	g_34213	g_45623
Super-Scaffold_100026	1777047	1810716	33669	g_45623	g_37205
Super-Scaffold_100026	1811450	1869885	58435	g_37205	g_34217
Super-Scaffold_100026	1875198	1875243	45	g_34217	g_37207
Super-Scaffold_100026	1875848	1898989	23141	g_37207	g_34218
Super-Scaffold_100026	1899204	1921350	22146	g_34218	g_34220
Super-Scaffold_100026	1921790	1934342	12552	g_34220	g_34221
Super-Scaffold_100026	1935679	1998745	63066	g_34221	g_34223
Super-Scaffold_100026	1999383	2011029	11646	g_34223	g_34224
Super-Scaffold_100026	2027673	2035415	7742	g_34224	g_34225
Super-Scaffold_100026	2035858	2043450	7592	g_34225	g_34226
Super-Scaffold_100026	2043848	2079457	35609	g_34226	g_34228
Super-Scaffold_100026	2091254	2133572	42318	g_34228	g_34230
Super-Scaffold_100026	2135589	2168971	33382	g_34230	g_34232
Super-Scaffold_100026	2170549	2245292	74743	g_34232	g_34235
Super-Scaffold_100026	2248844	2281681	32837	g_34235	g_34237
Super-Scaffold_100026	2282526	2282593	67	g_34237	g_34238
Super-Scaffold_100026	2283711	2284266	555	g_34238	g_34239
Super-Scaffold_100026	2284954	2286066	1112	g_34239	g_34240
Super-Scaffold_100026	2286533	2354315	67782	g_34240	g_34243
Super-Scaffold_100026	2355081	2423284	68203	g_34243	g_34245
Super-Scaffold_100026	2426910	2500746	73836	g_34245	g_34248
Super-Scaffold_100026	2503672	2516166	12494	g_34248	g_34249
Super-Scaffold_100026	2519207	2530862	11655	g_34249	g_34251
Super-Scaffold_100026	2531077	2570475	39398	g_34251	g_34253
Super-Scaffold_100026	2583240	2619842	36602	g_34253	g_37213
Super-Scaffold_100026	2620327	2620389	62	g_37213	g_34254
Super-Scaffold_100026	2624755	2626778	2023	g_34254	g_34255
Super-Scaffold_100026	2661026	2675945	14919	g_34255	g_34256
Super-Scaffold_100026	2712075	2821667	109592	g_34256	g_34257
Super-Scaffold_100026	2821879	2868161	46282	g_34257	g_34258
Super-Scaffold_100026	2868415	2881170	12755	g_34258	g_34259
Super-Scaffold_100026	2914214	3001979	87765	g_34259	g_34263
Super-Scaffold_100026	3016211	3158203	141992	g_34263	g_34267
Super-Scaffold_100026	3164904	3277299	112395	g_34267	g_34268
Super-Scaffold_100026	3277595	3378607	101012	g_34268	g_34272
Super-Scaffold_100026	3380859	3397703	16844	g_34272	g_34273
Super-Scaffold_100026	3398587	3428390	29803	g_34273	g_37215
Super-Scaffold_100026	3428620	3437231	8611	g_37215	g_34274
Super-Scaffold_100026	3437557	3473321	35764	g_34274	g_34275
Super-Scaffold_100026	3478972	3527083	48111	g_34275	g_45624
Super-Scaffold_100026	3557938	3557980	42	g_45624	g_34276
Super-Scaffold_100026	3558957	3574139	15182	g_34276	g_34277
Super-Scaffold_100026	3583591	3715178	131587	g_34277	g_34281
Super-Scaffold_100026	3737922	3780673	42751	g_34281	g_34284
Super-Scaffold_100026	3793853	3824342	30489	g_34284	g_34285
Super-Scaffold_100026	3826230	3835897	9667	g_34285	g_34286
Super-Scaffold_100026	3838007	3861942	23935	g_34286	g_34287
Super-Scaffold_100026	3871788	3876378	4590	g_34287	g_34288
Super-Scaffold_100026	3876677	3979944	103267	g_34288	g_34291
Super-Scaffold_100026	3981347	3988334	6987	g_34291	g_34292
Super-Scaffold_100026	3988573	4055046	66473	g_34292	g_34294
Super-Scaffold_100026	4055303	4331456	276153	g_34294	g_34300
Super-Scaffold_100026	4347452	4434618	87166	g_34300	g_34302
Super-Scaffold_100026	4441954	4464916	22962	g_34302	g_34304
Super-Scaffold_100026	4467272	4467863	591	g_34304	g_34305
Super-Scaffold_100026	4469372	4582748	113376	g_34305	g_34310
Super-Scaffold_100026	4585103	4585694	591	g_34310	g_34311
Super-Scaffold_100026	4587208	4672421	85213	g_34311	g_34315
Super-Scaffold_100026	4672744	4772868	100124	g_34315	g_34317
Super-Scaffold_100026	4779940	4780517	577	g_34317	g_34318
Super-Scaffold_100026	4784538	4785502	964	g_34318	g_34319
Super-Scaffold_100026	4794164	4797548	3384	g_34319	g_34320
Super-Scaffold_100026	4799242	4810704	11462	g_34320	g_34321
Super-Scaffold_100026	4816056	4857030	40974	g_34321	g_34322
Super-Scaffold_100026	4858718	4959799	101081	g_34322	g_34325
Super-Scaffold_100026	4962875	4997253	34378	g_34325	g_34329
Super-Scaffold_100026	4998116	5065215	67099	g_34329	g_34330
Super-Scaffold_100026	5065562	5095526	29964	g_34330	g_34331
Super-Scaffold_100026	5095753	5157274	61521	g_34331	g_37232
Super-Scaffold_100026	5157495	5173875	16380	g_37232	g_34334
Super-Scaffold_100026	5174102	5233632	59530	g_34334	g_34337
Super-Scaffold_100026	5233877	5267640	33763	g_34337	g_37235
Super-Scaffold_100026	5267894	5316660	48766	g_37235	g_34339
Super-Scaffold_100026	5316869	5682707	365838	g_34339	g_34347
Super-Scaffold_100026	5691478	5886299	194821	g_34347	g_37243
Super-Scaffold_100026	5886580	5955592	69012	g_37243	g_34350
Super-Scaffold_100026	5955813	6100811	144998	g_34350	g_34352
Super-Scaffold_100026	6101282	6129108	27826	g_37248	g_34353
Super-Scaffold_100027	20250	70819	50569	g_7580	g_7581
Super-Scaffold_100027	72724	76903	4179	g_7581	g_7582
Super-Scaffold_100027	77265	82187	4922	g_7582	g_43434
Super-Scaffold_100027	107928	127269	19341	g_43434	g_7583
Super-Scaffold_100027	129177	161797	32620	g_7583	g_7586
Super-Scaffold_100027	165898	196960	31062	g_7586	g_7587
Super-Scaffold_100027	247236	256465	9229	g_7587	g_43435
Super-Scaffold_100027	270523	276142	5619	g_43435	g_7589
Super-Scaffold_100027	295247	436152	140905	g_7589	g_7595
Super-Scaffold_100027	442137	454886	12749	g_7595	g_7596
Super-Scaffold_100027	496328	515824	19496	g_7596	g_7597
Super-Scaffold_100027	517995	525802	7807	g_7597	g_7598
Super-Scaffold_100027	557781	559360	1579	g_7598	g_7599
Super-Scaffold_100027	572428	576929	4501	g_7599	g_7600
Super-Scaffold_100027	610537	716607	106070	g_7600	g_7604
Super-Scaffold_100027	732292	733126	834	g_7604	g_7605
Super-Scaffold_100027	733803	738538	4735	g_7605	g_7606
Super-Scaffold_100027	744522	748089	3567	g_7606	g_7608
Super-Scaffold_100027	750860	757371	6511	g_7608	g_7609
Super-Scaffold_100027	762597	771663	9066	g_7609	g_7610
Super-Scaffold_100027	775451	779578	4127	g_7610	g_7612
Super-Scaffold_100027	780708	781561	853	g_7612	g_7613
Super-Scaffold_100027	782088	782449	361	g_7613	g_7614
Super-Scaffold_100027	783111	783641	530	g_7614	g_7615
Super-Scaffold_100027	784459	784633	174	g_7615	g_7616
Super-Scaffold_100027	786084	786185	101	g_7616	g_7617
Super-Scaffold_100027	786706	786755	49	g_7617	g_7618
Super-Scaffold_100027	787762	788735	973	g_7618	g_7619
Super-Scaffold_100027	789943	790115	172	g_7619	g_7620
Super-Scaffold_100027	790702	795979	5277	g_7620	g_7621
Super-Scaffold_100027	819103	867195	48092	g_7621	g_7623
Super-Scaffold_100027	868004	894683	26679	g_7623	g_36062
Super-Scaffold_100027	895054	902418	7364	g_36062	g_7625
Super-Scaffold_100027	902834	930883	28049	g_7625	g_36063
Super-Scaffold_100027	931299	939368	8069	g_36063	g_7627
Super-Scaffold_100027	945803	982141	36338	g_7627	g_36064
Super-Scaffold_100027	982431	991102	8671	g_36064	g_7629
Super-Scaffold_100027	996439	1030471	34032	g_7629	g_36065
Super-Scaffold_100027	1030842	1039594	8752	g_36065	g_7631
Super-Scaffold_100027	1044777	1070473	25696	g_7631	g_7632
Super-Scaffold_100027	1074062	1079982	5920	g_7632	g_7633
Super-Scaffold_100027	1080824	1087418	6594	g_7633	g_7636
Super-Scaffold_100027	1097009	1100722	3713	g_7636	g_43436
Super-Scaffold_100027	1103649	1116784	13135	g_43436	g_7637
Super-Scaffold_100027	1124374	1128147	3773	g_7637	g_7638
Super-Scaffold_100027	1128512	1129410	898	g_7638	g_7639
Super-Scaffold_100027	1145176	1146891	1715	g_7639	g_7640
Super-Scaffold_100027	1152855	1153315	460	g_7640	g_7641
Super-Scaffold_100027	1160781	1163570	2789	g_7641	g_7642
Super-Scaffold_100027	1175565	1193930	18365	g_7642	g_7644
Super-Scaffold_100027	1200470	1211749	11279	g_7644	g_7646
Super-Scaffold_100027	1213443	1233947	20504	g_7646	g_7647
Super-Scaffold_100027	1234162	1252567	18405	g_7647	g_7648
Super-Scaffold_100027	1255006	1266678	11672	g_7648	g_7650
Super-Scaffold_100027	1270641	1281814	11173	g_7650	g_7651
Super-Scaffold_100027	1284655	1285358	703	g_7651	g_7652
Super-Scaffold_100027	1289618	1306713	17095	g_7652	g_7653
Super-Scaffold_100027	1306946	1310373	3427	g_7653	g_36070
Super-Scaffold_100027	1310615	1317028	6413	g_36070	g_7655
Super-Scaffold_100027	1337278	1362808	25530	g_7655	g_7657
Super-Scaffold_100027	1366722	1370155	3433	g_7657	g_7658
Super-Scaffold_100027	1374296	1377530	3234	g_7658	g_7659
Super-Scaffold_100027	1381713	1390797	9084	g_7659	g_7660
Super-Scaffold_100027	1392098	1392612	514	g_7660	g_7661
Super-Scaffold_100027	1393838	1421630	27792	g_7661	g_7662
Super-Scaffold_100027	1422151	1432338	10187	g_7662	g_7663
Super-Scaffold_100027	1435618	1479652	44034	g_7663	g_7666
Super-Scaffold_100027	1482949	1490767	7818	g_7666	g_36072
Super-Scaffold_100027	1491015	1502885	11870	g_36072	g_7667
Super-Scaffold_100027	1505932	1571441	65509	g_7667	g_7669
Super-Scaffold_100027	1590531	1615600	25069	g_7669	g_36073
Super-Scaffold_100027	1616523	1647935	31412	g_36073	g_7670
Super-Scaffold_100027	1662592	1686607	24015	g_7670	g_36074
Super-Scaffold_100027	1686927	1688627	1700	g_36074	g_7672
Super-Scaffold_100027	1700387	1719421	19034	g_7672	g_7674
Super-Scaffold_100027	1726732	1734857	8125	g_36076	g_36077
Super-Scaffold_100027	1735258	1775288	40030	g_36077	g_7675
Super-Scaffold_100029	52499	210530	158031	g_30643	g_30646
Super-Scaffold_100029	211309	265313	54004	g_30646	g_30648
Super-Scaffold_100029	265726	271008	5282	g_30648	g_30649
Super-Scaffold_100031	3081	18333	15252	g_6510	g_6511
Super-Scaffold_100031	31938	37542	5604	g_6511	g_6512
Super-Scaffold_100031	40850	54891	14041	g_6512	g_36332
Super-Scaffold_100031	55163	123444	68281	g_36332	g_6517
Super-Scaffold_100031	124514	124609	95	g_6517	g_6518
Super-Scaffold_100031	125505	175319	49814	g_6518	g_6519
Super-Scaffold_100031	191590	192304	714	g_6519	g_6520
Super-Scaffold_100031	194751	231534	36783	g_6520	g_6521
Super-Scaffold_100031	243206	277959	34753	g_6521	g_6522
Super-Scaffold_100031	294771	295620	849	g_6522	g_6523
Super-Scaffold_100031	297676	358765	61089	g_6523	g_6525
Super-Scaffold_100031	375597	379845	4248	g_6525	g_6526
Super-Scaffold_100031	393288	461632	68344	g_6526	g_6527
Super-Scaffold_100031	462057	469472	7415	g_6527	g_6528
Super-Scaffold_100031	470187	492565	22378	g_36334	g_43363
Super-Scaffold_100031	498993	511795	12802	g_43363	g_6529
Super-Scaffold_100031	512244	517095	4851	g_6529	g_6530
Super-Scaffold_100031	517544	518344	800	g_6530	g_6531
Super-Scaffold_100031	518727	531214	12487	g_6531	g_6532
Super-Scaffold_100031	536134	539113	2979	g_6532	g_6533
Super-Scaffold_100031	543867	566479	22612	g_6533	g_6535
Super-Scaffold_100031	573531	612398	38867	g_36335	g_6536
Super-Scaffold_100031	623389	623900	511	g_6536	g_43364
Super-Scaffold_100031	650735	683713	32978	g_43364	g_6537
Super-Scaffold_100031	686420	724534	38114	g_6537	g_6539
Super-Scaffold_100031	727236	733863	6627	g_6539	g_6540
Super-Scaffold_100031	736415	791658	55243	g_6540	g_6543
Super-Scaffold_100031	794207	812673	18466	g_6543	g_43365
Super-Scaffold_100031	857740	862038	4298	g_43365	g_6544
Super-Scaffold_100031	865082	870222	5140	g_6544	g_6545
Super-Scaffold_100031	871808	872014	206	g_6545	g_6546
Super-Scaffold_100031	872484	881349	8865	g_6546	g_6547
Super-Scaffold_100031	882524	896129	13605	g_6547	g_6550
Super-Scaffold_100031	921043	1058511	137468	g_6550	g_6551
Super-Scaffold_100031	1063220	1064905	1685	g_6551	g_6555
Super-Scaffold_100033	212795	213404	609	g_4512	g_4513
Super-Scaffold_100033	221132	221765	633	g_4513	g_4514
Super-Scaffold_100033	229710	230433	723	g_4514	g_4515
Super-Scaffold_100033	231281	256682	25401	g_4515	g_4518
Super-Scaffold_100033	267883	279548	11665	g_4518	g_4519
Super-Scaffold_100033	280596	288136	7540	g_4519	g_4520
Super-Scaffold_100033	294671	304837	10166	g_4520	g_4521
Super-Scaffold_100033	319480	328296	8816	g_4521	g_4522
Super-Scaffold_100033	329636	364824	35188	g_4522	g_4523
Super-Scaffold_100033	379121	539328	160207	g_4523	g_4529
Super-Scaffold_100033	541412	553809	12397	g_4529	g_4530
Super-Scaffold_100033	555152	575716	20564	g_4530	g_4531
Super-Scaffold_100033	576117	586317	10200	g_4531	g_43224
Super-Scaffold_100033	605288	650995	45707	g_43224	g_4532
Super-Scaffold_100033	658214	667315	9101	g_4532	g_4533
Super-Scaffold_100033	678906	697085	18179	g_4533	g_4534
Super-Scaffold_100033	704592	709735	5143	g_4534	g_4535
Super-Scaffold_100033	710193	712156	1963	g_4535	g_4536
Super-Scaffold_100033	731811	786210	54399	g_4536	g_4537
Super-Scaffold_100033	800942	878014	77072	g_4537	g_4538
Super-Scaffold_100033	896667	898326	1659	g_4538	g_4539
Super-Scaffold_100033	905425	909347	3922	g_4539	g_4540
Super-Scaffold_100033	912706	926894	14188	g_4540	g_4542
Super-Scaffold_100033	951916	967188	15272	g_4542	g_4543
Super-Scaffold_100033	972332	978237	5905	g_4543	g_4544
Super-Scaffold_100033	986052	1005170	19118	g_4544	g_4545
Super-Scaffold_100033	1011403	1014838	3435	g_4545	g_4547
Super-Scaffold_100033	1017448	1029000	11552	g_4547	g_4548
Super-Scaffold_100033	1040004	1041579	1575	g_4548	g_4549
Super-Scaffold_100033	1049108	1077049	27941	g_4549	g_4551
Super-Scaffold_100033	1078440	1087564	9124	g_4551	g_4553
Super-Scaffold_100033	1089409	1093027	3618	g_4553	g_43225
Super-Scaffold_100033	1114169	1141954	27785	g_43225	g_4557
Super-Scaffold_100033	1143009	1143516	507	g_4557	g_4558
Super-Scaffold_100033	1149038	1150428	1390	g_4558	g_4559
Super-Scaffold_100033	1152247	1169181	16934	g_4559	g_4560
Super-Scaffold_100033	1171331	1176288	4957	g_4560	g_4561
Super-Scaffold_100033	1179713	1181643	1930	g_4561	g_4562
Super-Scaffold_100033	1182293	1221729	39436	g_4562	g_4565
Super-Scaffold_100033	1235924	1242961	7037	g_4565	g_39488
Super-Scaffold_100033	1243488	1245046	1558	g_39488	g_4566
Super-Scaffold_100033	1246011	1299854	53843	g_4566	g_4568
Super-Scaffold_100033	1305139	1350200	45061	g_4568	g_4571
Super-Scaffold_100033	1350718	1361473	10755	g_4571	g_4573
Super-Scaffold_100033	1364174	1365179	1005	g_4573	g_4574
Super-Scaffold_100033	1387065	1389419	2354	g_4574	g_4575
Super-Scaffold_100033	1391665	1396210	4545	g_4575	g_4576
Super-Scaffold_100033	1396821	1404322	7501	g_4576	g_4577
Super-Scaffold_100033	1404573	1407529	2956	g_4577	g_4578
Super-Scaffold_100033	1424747	1438998	14251	g_4578	g_4579
Super-Scaffold_100033	1492267	1492753	486	g_4579	g_4580
Super-Scaffold_100033	1493307	1494387	1080	g_4580	g_4581
Super-Scaffold_100033	1494830	1494916	86	g_4581	g_43226
Super-Scaffold_100033	1499952	1523662	23710	g_43226	g_4583
Super-Scaffold_100033	1526079	1526201	122	g_4583	g_4584
Super-Scaffold_100034	20645	53563	32918	g_40442	g_34099
Super-Scaffold_100034	54183	96866	42683	g_34099	g_34101
Super-Scaffold_100040	9497	110481	100984	g_27469	g_27470
Super-Scaffold_100040	110864	112159	1295	g_27470	g_27471
Super-Scaffold_100040	131197	164636	33439	g_27471	g_27473
Super-Scaffold_100040	179477	193306	13829	g_27473	g_27474
Super-Scaffold_100040	201248	230873	29625	g_27474	g_27475
Super-Scaffold_100040	252754	267695	14941	g_27475	g_27477
Super-Scaffold_100040	270141	275282	5141	g_27477	g_27479
Super-Scaffold_100040	294029	302086	8057	g_27479	g_27480
Super-Scaffold_100040	305140	317406	12266	g_27480	g_45157
Super-Scaffold_100040	335975	336388	413	g_45157	g_27481
Super-Scaffold_100040	393729	399133	5404	g_27481	g_45158
Super-Scaffold_100040	426785	427869	1084	g_45158	g_45159
Super-Scaffold_100040	429381	431805	2424	g_45159	g_27482
Super-Scaffold_100040	432947	440033	7086	g_27482	g_45160
Super-Scaffold_100040	456815	480390	23575	g_45160	g_41529
Super-Scaffold_100040	481880	492203	10323	g_41529	g_27485
Super-Scaffold_100040	507599	517480	9881	g_27485	g_27486
Super-Scaffold_100040	518084	519811	1727	g_27486	g_27487
Super-Scaffold_100040	521126	532918	11792	g_27487	g_41530
Super-Scaffold_100040	533301	533585	284	g_41530	g_27488
Super-Scaffold_100040	564728	651309	86581	g_27488	g_27491
Super-Scaffold_100040	651632	698941	47309	g_27491	g_27493
Super-Scaffold_100040	699225	705836	6611	g_27493	g_27494
Super-Scaffold_100040	708209	735677	27468	g_27494	g_27495
Super-Scaffold_100040	750171	761496	11325	g_27495	g_27497
Super-Scaffold_100040	762257	764388	2131	g_27498	g_27499
Super-Scaffold_100040	777154	784505	7351	g_27499	g_27500
Super-Scaffold_100040	785563	800092	14529	g_27500	g_27501
Super-Scaffold_100040	805705	812835	7130	g_27501	g_27502
Super-Scaffold_100040	814019	815480	1461	g_27502	g_27503
Super-Scaffold_100040	818781	829809	11028	g_27503	g_45161
Super-Scaffold_100040	833108	836209	3101	g_45161	g_27505
Super-Scaffold_100040	839681	839738	57	g_27505	g_27506
Super-Scaffold_100040	842783	843262	479	g_27506	g_27507
Super-Scaffold_100040	843682	860542	16860	g_27507	g_45162
Super-Scaffold_100040	877410	887196	9786	g_45162	g_27508
Super-Scaffold_100040	893715	897429	3714	g_27508	g_27509
Super-Scaffold_100040	899538	911051	11513	g_27509	g_27511
Super-Scaffold_100040	911386	917349	5963	g_27511	g_27512
Super-Scaffold_100040	920994	928701	7707	g_27512	g_27513
Super-Scaffold_100040	934147	945116	10969	g_27513	g_27515
Super-Scaffold_100040	949946	996137	46191	g_27515	g_27516
Super-Scaffold_100040	996340	1001637	5297	g_27516	g_27517
Super-Scaffold_100040	1028044	1084980	56936	g_27517	g_41534
Super-Scaffold_100040	1085213	1105168	19955	g_41534	g_27520
Super-Scaffold_100040	1111635	1143827	32192	g_27520	g_27521
Super-Scaffold_100040	1150736	1174779	24043	g_27521	g_27522
Super-Scaffold_100040	1199429	1204252	4823	g_27522	g_27523
Super-Scaffold_100040	1211670	1238648	26978	g_27523	g_27524
Super-Scaffold_100040	1249487	1282515	33028	g_27524	g_27525
Super-Scaffold_100040	1288447	1340174	51727	g_27525	g_27528
Super-Scaffold_100040	1355760	1358631	2871	g_27528	g_27529
Super-Scaffold_100040	1361291	1361636	345	g_27529	g_27530
Super-Scaffold_100040	1364456	1374529	10073	g_27530	g_27531
Super-Scaffold_100040	1379719	1472800	93081	g_27531	g_27533
Super-Scaffold_100040	1478066	1482976	4910	g_27533	g_27534
Super-Scaffold_100040	1486015	1498255	12240	g_27534	g_27535
Super-Scaffold_100040	1498701	1499040	339	g_27535	g_27536
Super-Scaffold_100040	1503335	1513632	10297	g_27536	g_27537
Super-Scaffold_100040	1514069	1524027	9958	g_27537	g_27540
Super-Scaffold_100040	1526738	1533286	6548	g_27540	g_27541
Super-Scaffold_100040	1535100	1541042	5942	g_27541	g_27542
Super-Scaffold_100040	1554540	1563055	8515	g_27542	g_27543
Super-Scaffold_100040	1579312	1582580	3268	g_27543	g_27544
Super-Scaffold_100040	1595340	1599177	3837	g_27544	g_45163
Super-Scaffold_100040	1607187	1727197	120010	g_45163	g_27546
Super-Scaffold_100040	1737172	1767850	30678	g_27546	g_45164
Super-Scaffold_100040	1896481	1943695	47214	g_45164	g_27547
Super-Scaffold_100040	1950726	1957766	7040	g_27547	g_45165
Super-Scaffold_100040	1963585	1980339	16754	g_45165	g_27548
Super-Scaffold_100040	2007488	2009800	2312	g_27548	g_27549
Super-Scaffold_100040	2010873	2018739	7866	g_27549	g_27550
Super-Scaffold_100040	2022902	2031345	8443	g_27550	g_27551
Super-Scaffold_100040	2049190	2050572	1382	g_27551	g_27552
Super-Scaffold_100040	2054378	2061782	7404	g_27552	g_27553
Super-Scaffold_100040	2062738	2064808	2070	g_27553	g_27554
Super-Scaffold_100040	2073117	2078708	5591	g_27554	g_27555
Super-Scaffold_100040	2085165	2095996	10831	g_27555	g_27556
Super-Scaffold_100040	2096382	2152322	55940	g_27556	g_27558
Super-Scaffold_100041	13722	17645	3923	g_14934	g_44145
Super-Scaffold_100041	21540	21777	237	g_44145	g_14935
Super-Scaffold_100041	22472	26950	4478	g_14935	g_14937
Super-Scaffold_100041	27480	28372	892	g_14937	g_14938
Super-Scaffold_100041	51032	52677	1645	g_14938	g_44146
Super-Scaffold_100041	52877	138833	85956	g_44146	g_14939
Super-Scaffold_100041	139303	140448	1145	g_14939	g_14940
Super-Scaffold_100041	161139	163621	2482	g_14940	g_14941
Super-Scaffold_100041	168408	169614	1206	g_14941	g_14942
Super-Scaffold_100041	171028	184623	13595	g_14942	g_14943
Super-Scaffold_100041	199789	208011	8222	g_14943	g_14945
Super-Scaffold_100041	208517	208609	92	g_14945	g_14946
Super-Scaffold_100041	209463	209607	144	g_14946	g_14947
Super-Scaffold_100041	210173	216842	6669	g_14947	g_14948
Super-Scaffold_100041	217318	219989	2671	g_14948	g_14949
Super-Scaffold_100041	225499	238898	13399	g_14949	g_14952
Super-Scaffold_100041	239919	317031	77112	g_14952	g_14960
Super-Scaffold_100041	318150	318234	84	g_41545	g_41546
Super-Scaffold_100041	318452	318567	115	g_41546	g_41547
Super-Scaffold_100041	319385	352551	33166	g_41547	g_14962
Super-Scaffold_100041	352976	353757	781	g_14962	g_14964
Super-Scaffold_100041	354035	354053	18	g_14964	g_14965
Super-Scaffold_100041	354343	354427	84	g_14965	g_14966
Super-Scaffold_100041	354639	354777	138	g_14966	g_14967
Super-Scaffold_100041	355073	355235	162	g_14967	g_14968
Super-Scaffold_100041	378834	386970	8136	g_14968	g_14969
Super-Scaffold_100041	387560	395267	7707	g_14969	g_14971
Super-Scaffold_100041	395470	431920	36450	g_14971	g_14972
Super-Scaffold_100041	434022	434101	79	g_14972	g_14973
Super-Scaffold_100041	438602	443675	5073	g_14973	g_14974
Super-Scaffold_100041	444589	447820	3231	g_14974	g_14975
Super-Scaffold_100041	448092	448660	568	g_14975	g_14976
Super-Scaffold_100041	473764	480546	6782	g_14976	g_14977
Super-Scaffold_100041	490600	490813	213	g_14977	g_14978
Super-Scaffold_100041	492330	500424	8094	g_14978	g_14979
Super-Scaffold_100041	518863	525034	6171	g_14979	g_14980
Super-Scaffold_100041	529028	532383	3355	g_14980	g_44147
Super-Scaffold_100041	539333	555602	16269	g_44147	g_14981
Super-Scaffold_100041	557558	573289	15731	g_14981	g_14984
Super-Scaffold_100041	573936	588748	14812	g_14984	g_14985
Super-Scaffold_100041	589354	619150	29796	g_14985	g_14988
Super-Scaffold_100041	631322	633839	2517	g_14988	g_14989
Super-Scaffold_100041	639082	650159	11077	g_14989	g_41552
Super-Scaffold_100041	660050	699404	39354	g_41552	g_14991
Super-Scaffold_100041	699667	743775	44108	g_14991	g_14996
Super-Scaffold_100041	756493	762172	5679	g_14996	g_14997
Super-Scaffold_100041	771295	775948	4653	g_14997	g_14998
Super-Scaffold_100041	776214	782771	6557	g_14998	g_14999
Super-Scaffold_100041	792219	815215	22996	g_14999	g_15001
Super-Scaffold_100041	845660	849813	4153	g_15001	g_15002
Super-Scaffold_100041	861046	903859	42813	g_15002	g_15006
Super-Scaffold_100041	931540	938892	7352	g_15006	g_15007
Super-Scaffold_100041	947707	950102	2395	g_15007	g_15008
Super-Scaffold_100041	960479	964884	4405	g_15008	g_15009
Super-Scaffold_100041	970791	975868	5077	g_15009	g_15010
Super-Scaffold_100041	981430	1034876	53446	g_15010	g_15012
Super-Scaffold_100041	1035265	1035322	57	g_15012	g_15013
Super-Scaffold_100041	1055035	1060259	5224	g_15013	g_44148
Super-Scaffold_100041	1060781	1061831	1050	g_44148	g_44149
Super-Scaffold_100041	1076616	1083294	6678	g_44149	g_15014
Super-Scaffold_100041	1089482	1099027	9545	g_15014	g_15016
Super-Scaffold_100041	1101045	1108999	7954	g_15016	g_15017
Super-Scaffold_100041	1129128	1133995	4867	g_15017	g_15018
Super-Scaffold_100041	1143128	1145885	2757	g_15018	g_15019
Super-Scaffold_100041	1148371	1150740	2369	g_15019	g_15020
Super-Scaffold_100041	1162831	1272116	109285	g_15020	g_15024
Super-Scaffold_100041	1272466	1284642	12176	g_15024	g_15026
Super-Scaffold_100041	1308368	1329247	20879	g_15026	g_15027
Super-Scaffold_100041	1343262	1357559	14297	g_15027	g_41560
Super-Scaffold_100041	1357807	1360195	2388	g_41560	g_15028
Super-Scaffold_100041	1360767	1360800	33	g_15028	g_15029
Super-Scaffold_100041	1361078	1371301	10223	g_15029	g_15031
Super-Scaffold_100041	1373489	1443916	70427	g_15031	g_15033
Super-Scaffold_100041	1444152	1520653	76501	g_15033	g_15034
Super-Scaffold_100041	1523643	1557303	33660	g_15034	g_15035
Super-Scaffold_100041	1578946	1592535	13589	g_15035	g_44150
Super-Scaffold_100041	1596405	1620555	24150	g_44150	g_15036
Super-Scaffold_100041	1627657	1630636	2979	g_15036	g_15037
Super-Scaffold_100041	1641053	1685707	44654	g_15037	g_15038
Super-Scaffold_100041	1697214	1704320	7106	g_15038	g_15039
Super-Scaffold_100041	1705300	1705501	201	g_15039	g_15040
Super-Scaffold_100041	1705749	1706148	399	g_15040	g_15041
Super-Scaffold_100041	1706399	1706613	214	g_15041	g_15042
Super-Scaffold_100041	1707317	1714425	7108	g_15042	g_15043
Super-Scaffold_100041	1719298	1750716	31418	g_15043	g_15045
Super-Scaffold_100041	1751009	1817745	66736	g_15045	g_15047
Super-Scaffold_100041	1831477	1863857	32380	g_41561	g_15050
Super-Scaffold_100041	1885551	1894009	8458	g_15050	g_15051
Super-Scaffold_100041	1894608	1894666	58	g_15051	g_15052
Super-Scaffold_100041	1895169	1910800	15631	g_15052	g_15055
Super-Scaffold_100041	1911108	1911443	335	g_15055	g_15056
Super-Scaffold_100041	1911814	1913691	1877	g_15056	g_44151
Super-Scaffold_100049	16216	17284	1068	g_13751	g_13752
Super-Scaffold_100052	29114	121818	92704	g_7496	g_7497
Super-Scaffold_100052	122423	133418	10995	g_7497	g_7498
Super-Scaffold_100052	140481	143584	3103	g_7498	g_43428
Super-Scaffold_100052	169002	173321	4319	g_43428	g_7499
Super-Scaffold_100052	174768	179485	4717	g_7499	g_43429
Super-Scaffold_100052	189080	192190	3110	g_43429	g_7500
Super-Scaffold_100052	196332	216053	19721	g_42871	g_7502
Super-Scaffold_100052	222459	226803	4344	g_7502	g_43430
Super-Scaffold_100052	232243	289973	57730	g_43430	g_7506
Super-Scaffold_100052	299951	318093	18142	g_7506	g_7507
Super-Scaffold_100052	326589	333397	6808	g_7507	g_7509
Super-Scaffold_100052	336882	339063	2181	g_7509	g_7510
Super-Scaffold_100052	339440	341952	2512	g_7510	g_7511
Super-Scaffold_100052	342329	361466	19137	g_7511	g_7512
Super-Scaffold_100052	364080	400994	36914	g_7512	g_7513
Super-Scaffold_100052	405967	419926	13959	g_7513	g_7514
Super-Scaffold_100052	423279	475044	51765	g_7514	g_7516
Super-Scaffold_100052	476240	502860	26620	g_7516	g_7517
Super-Scaffold_100052	503228	548826	45598	g_7517	g_7518
Super-Scaffold_100052	552312	587297	34985	g_7518	g_43431
Super-Scaffold_100052	587701	597161	9460	g_43431	g_7519
Super-Scaffold_100052	602507	617516	15009	g_7519	g_7520
Super-Scaffold_100052	633952	731110	97158	g_7520	g_42876
Super-Scaffold_100052	731454	760278	28824	g_42876	g_7523
Super-Scaffold_100052	760811	767864	7053	g_7523	g_7524
Super-Scaffold_100052	768112	815494	47382	g_7524	g_7526
Super-Scaffold_100052	823592	846181	22589	g_7526	g_7528
Super-Scaffold_100052	859183	872969	13786	g_7528	g_7529
Super-Scaffold_100052	873685	888403	14718	g_7529	g_7531
Super-Scaffold_100052	892907	897060	4153	g_7531	g_7533
Super-Scaffold_100052	904080	905649	1569	g_7533	g_7534
Super-Scaffold_100052	910534	939744	29210	g_7534	g_42879
Super-Scaffold_100052	941812	969666	27854	g_7536	g_7537
Super-Scaffold_100052	974828	975254	426	g_7537	g_7538
Super-Scaffold_100052	976894	977160	266	g_7538	g_7539
Super-Scaffold_100052	977489	1019236	41747	g_7539	g_7542
Super-Scaffold_100052	1026294	1030928	4634	g_7542	g_7544
Super-Scaffold_100052	1032737	1058780	26043	g_7544	g_7546
Super-Scaffold_100052	1065928	1079854	13926	g_7546	g_7547
Super-Scaffold_100052	1086117	1090495	4378	g_7547	g_7548
Super-Scaffold_100052	1091982	1092234	252	g_7548	g_7549
Super-Scaffold_100052	1092914	1093127	213	g_7549	g_7550
Super-Scaffold_100052	1093354	1099477	6123	g_7550	g_7551
Super-Scaffold_100052	1099749	1115051	15302	g_7551	g_42883
Super-Scaffold_100052	1116680	1121378	4698	g_7554	g_7555
Super-Scaffold_100052	1141674	1156076	14402	g_7555	g_7557
Super-Scaffold_100052	1169754	1194894	25140	g_42885	g_7558
Super-Scaffold_100052	1201232	1203983	2751	g_7558	g_43432
Super-Scaffold_100052	1228813	1235626	6813	g_43432	g_42886
Super-Scaffold_100052	1236213	1236291	78	g_42886	g_7560
Super-Scaffold_100052	1239333	1239473	140	g_7560	g_42887
Super-Scaffold_100052	1240003	1263211	23208	g_42887	g_7561
Super-Scaffold_100052	1263429	1278416	14987	g_7561	g_7563
Super-Scaffold_100052	1294255	1344418	50163	g_7563	g_7566
Super-Scaffold_100052	1347906	1357929	10023	g_7566	g_7568
Super-Scaffold_100052	1358204	1366917	8713	g_7568	g_7570
Super-Scaffold_100052	1367702	1367810	108	g_7570	g_42889
Super-Scaffold_100052	1369345	1390344	20999	g_42889	g_42890
Super-Scaffold_100052	1390898	1390980	82	g_42890	g_7572
Super-Scaffold_100052	1391717	1393966	2249	g_7572	g_42892
Super-Scaffold_100052	1394604	1415995	21391	g_42892	g_43433
Super-Scaffold_100052	1420145	1430693	10548	g_43433	g_7573
Super-Scaffold_100052	1435212	1436350	1138	g_7573	g_7574
Super-Scaffold_100052	1436811	1436943	132	g_7574	g_7575
Super-Scaffold_100052	1438310	1438334	24	g_7575	g_7576
Super-Scaffold_100052	1439470	1439494	24	g_7576	g_7577
Super-Scaffold_100052	1440822	1440858	36	g_7577	g_7578
Super-Scaffold_100057	47818	81942	34124	g_28892	g_28893
Super-Scaffold_100057	91022	108117	17095	g_28893	g_28894
Super-Scaffold_100057	119160	119483	323	g_28894	g_28895
Super-Scaffold_100057	133484	157288	23804	g_41828	g_28896
Super-Scaffold_100057	177140	183031	5891	g_28896	g_28897
Super-Scaffold_100057	188106	328718	140612	g_28897	g_28900
Super-Scaffold_100057	330500	347276	16776	g_28900	g_28901
Super-Scaffold_100057	347751	368465	20714	g_28901	g_28902
Super-Scaffold_100057	370302	371323	1021	g_28902	g_28903
Super-Scaffold_100057	371784	372898	1114	g_28903	g_28904
Super-Scaffold_100057	373599	382691	9092	g_28904	g_28905
Super-Scaffold_100057	393885	423211	29326	g_28905	g_28906
Super-Scaffold_100057	434648	460631	25983	g_41830	g_28908
Super-Scaffold_100057	461302	473719	12417	g_28908	g_28909
Super-Scaffold_100057	488001	494872	6871	g_28909	g_28910
Super-Scaffold_100057	495171	499848	4677	g_28910	g_41833
Super-Scaffold_100057	503855	557513	53658	g_28911	g_28912
Super-Scaffold_100057	559075	569198	10123	g_28912	g_28913
Super-Scaffold_100057	577451	577492	41	g_28913	g_28914
Super-Scaffold_100057	578103	607668	29565	g_28914	g_28915
Super-Scaffold_100057	608642	609311	669	g_28915	g_28916
Super-Scaffold_100057	709187	716089	6902	g_28916	g_45262
Super-Scaffold_100057	734655	738983	4328	g_45262	g_28917
Super-Scaffold_100057	739755	835893	96138	g_28917	g_28920
Super-Scaffold_100057	853139	879757	26618	g_28920	g_28922
Super-Scaffold_100057	884865	890708	5843	g_28922	g_28923
Super-Scaffold_100057	892331	915070	22739	g_28923	g_41836
Super-Scaffold_100057	915837	945176	29339	g_41836	g_28924
Super-Scaffold_100057	945379	953703	8324	g_28924	g_28925
Super-Scaffold_100057	959571	981703	22132	g_28925	g_28927
Super-Scaffold_100057	985563	985916	353	g_28927	g_28926
Super-Scaffold_100057	986599	991695	5096	g_28926	g_28928
Super-Scaffold_100057	1012896	1111320	98424	g_28928	g_28931
Super-Scaffold_100057	1142217	1214006	71789	g_28931	g_28932
Super-Scaffold_100057	1217747	1243404	25657	g_28932	g_28933
Super-Scaffold_100057	1251143	1259611	8468	g_28933	g_45263
Super-Scaffold_100057	1278353	1283056	4703	g_45263	g_28934
Super-Scaffold_100057	1283553	1283635	82	g_28934	g_28935
Super-Scaffold_100057	1284018	1284075	57	g_28935	g_28936
Super-Scaffold_100057	1285071	1292552	7481	g_28936	g_45264
Super-Scaffold_100057	1296438	1336181	39743	g_28937	g_28938
Super-Scaffold_100057	1343725	1355503	11778	g_28938	g_28939
Super-Scaffold_100057	1363445	1365956	2511	g_28939	g_28940
Super-Scaffold_100057	1381614	1383562	1948	g_28940	g_28941
Super-Scaffold_100057	1384221	1386667	2446	g_28941	g_28942
Super-Scaffold_100057	1391450	1395913	4463	g_28942	g_28943
Super-Scaffold_100057	1404243	1413590	9347	g_28943	g_28944
Super-Scaffold_100057	1424142	1469220	45078	g_28944	g_28946
Super-Scaffold_100057	1489924	1496243	6319	g_28946	g_28947
Super-Scaffold_100057	1509065	1514683	5618	g_28947	g_45265
Super-Scaffold_100057	1522420	1532684	10264	g_45265	g_28948
Super-Scaffold_100057	1553517	1559613	6096	g_28948	g_28949
Super-Scaffold_100057	1568979	1571782	2803	g_28949	g_28950
Super-Scaffold_100057	1579341	1582003	2662	g_28950	g_28951
Super-Scaffold_100057	1586665	1685043	98378	g_28951	g_28953
Super-Scaffold_100057	1685258	1686826	1568	g_28953	g_28954
Super-Scaffold_100057	1687041	1691108	4067	g_28954	g_41841
Super-Scaffold_100057	1692547	1696161	3614	g_41841	g_41842
Super-Scaffold_100074	9125	9846	721	g_12145	g_40106
Super-Scaffold_100074	10286	13760	3474	g_40106	g_40107
Super-Scaffold_100074	15010	16918	1908	g_40107	g_12146
Super-Scaffold_100074	19220	36917	17697	g_12146	g_12148
Super-Scaffold_100074	39654	47997	8343	g_12148	g_12150
Super-Scaffold_100074	55445	59964	4519	g_12150	g_12151
Super-Scaffold_100074	62589	64994	2405	g_12151	g_12153
Super-Scaffold_100074	68817	90965	22148	g_12153	g_12155
Super-Scaffold_100074	103686	133644	29958	g_12155	g_12157
Super-Scaffold_100074	134165	134376	211	g_12157	g_40110
Super-Scaffold_100074	135506	138625	3119	g_40110	g_12158
Super-Scaffold_100074	139347	139843	496	g_12158	g_12159
Super-Scaffold_100074	153882	154159	277	g_12159	g_12160
Super-Scaffold_100074	157461	159007	1546	g_12160	g_12161
Super-Scaffold_100074	174494	176843	2349	g_12161	g_12162
Super-Scaffold_100074	177106	181405	4299	g_12162	g_12163
Super-Scaffold_100074	182980	185690	2710	g_12164	g_12165
Super-Scaffold_100074	198669	199997	1328	g_12165	g_12166
Super-Scaffold_100074	203722	207847	4125	g_12166	g_12168
Super-Scaffold_100074	213344	214102	758	g_12168	g_12169
Super-Scaffold_100074	217995	224115	6120	g_12169	g_12170
Super-Scaffold_100074	244165	245140	975	g_12170	g_12171
Super-Scaffold_100074	271170	273701	2531	g_12171	g_12172
Super-Scaffold_100074	273958	275942	1984	g_12172	g_12173
Super-Scaffold_100074	281026	296022	14996	g_12173	g_12177
Super-Scaffold_100074	297689	297951	262	g_12177	g_12178
Super-Scaffold_100074	298211	302857	4646	g_12178	g_12180
Super-Scaffold_100074	310789	318061	7272	g_12180	g_12181
Super-Scaffold_100074	318708	338255	19547	g_12181	g_12182
Super-Scaffold_100074	350971	393776	42805	g_12182	g_43944
Super-Scaffold_100074	401848	402689	841	g_43944	g_12183
Super-Scaffold_100074	405625	420210	14585	g_12183	g_12184
Super-Scaffold_100074	420668	425186	4518	g_12184	g_12185
Super-Scaffold_100074	425572	428645	3073	g_12185	g_40114
Super-Scaffold_100074	429595	435895	6300	g_40114	g_12186
Super-Scaffold_100074	436746	438598	1852	g_12186	g_12187
Super-Scaffold_100074	456477	477377	20900	g_12187	g_43945
Super-Scaffold_100079	5294	20645	15351	g_23753	g_23754
Super-Scaffold_100079	21253	24931	3678	g_23754	g_23755
Super-Scaffold_100079	25527	50061	24534	g_23755	g_23758
Super-Scaffold_100079	61308	66518	5210	g_23758	g_23761
Super-Scaffold_100079	69754	72249	2495	g_23761	g_23762
Super-Scaffold_100079	74091	75609	1518	g_23762	g_36340
Super-Scaffold_100079	77891	78057	166	g_36340	g_23764
Super-Scaffold_100079	88123	98418	10295	g_23764	g_23766
Super-Scaffold_100079	109432	132111	22679	g_23766	g_23767
Super-Scaffold_100079	155902	165083	9181	g_23767	g_23769
Super-Scaffold_100079	179293	182892	3599	g_23769	g_23770
Super-Scaffold_100079	196670	211259	14589	g_23770	g_23772
Super-Scaffold_100079	217592	221641	4049	g_23772	g_23774
Super-Scaffold_100079	309310	313985	4675	g_23774	g_44851
Super-Scaffold_100079	321728	351612	29884	g_44851	g_23777
Super-Scaffold_100079	425035	426579	1544	g_23777	g_44852
Super-Scaffold_100079	447264	454620	7356	g_44852	g_44853
Super-Scaffold_100079	457297	471865	14568	g_44853	g_23779
Super-Scaffold_100079	478803	479680	877	g_23779	g_23780
Super-Scaffold_100079	485300	487248	1948	g_23780	g_23781
Super-Scaffold_100079	489794	591271	101477	g_23781	g_23784
Super-Scaffold_100090	98392	104413	6021	g_34394	g_36349
Super-Scaffold_100090	105279	167366	62087	g_36349	g_34397
Super-Scaffold_100090	193071	195548	2477	g_34397	g_34398
Super-Scaffold_100090	203737	238043	34306	g_34398	g_34399
Super-Scaffold_100090	245356	246841	1485	g_34399	g_34400
Super-Scaffold_100090	270444	290094	19650	g_34400	g_34401
Super-Scaffold_100090	292148	294575	2427	g_34401	g_34402
Super-Scaffold_100090	305135	319401	14266	g_34402	g_36353
Super-Scaffold_100090	320033	321228	1195	g_36353	g_34405
Super-Scaffold_100090	340762	461230	120468	g_34405	g_34408
Super-Scaffold_100090	462792	465504	2712	g_34408	g_34410
Super-Scaffold_100090	466244	467519	1275	g_34410	g_34411
Super-Scaffold_100090	472297	473487	1190	g_34411	g_34412
Super-Scaffold_100090	474581	534708	60127	g_34412	g_34415
Super-Scaffold_100090	543550	598218	54668	g_34415	g_34417
Super-Scaffold_100104	22445	50578	28133	g_13687	g_13691
Super-Scaffold_100104	51627	51775	148	g_13691	g_13692
Super-Scaffold_100104	53121	80750	27629	g_13692	g_13694
Super-Scaffold_100104	81478	81547	69	g_13694	g_13695
Super-Scaffold_100104	82554	107682	25128	g_13695	g_13698
Super-Scaffold_100104	108464	125245	16781	g_13698	g_13700
Super-Scaffold_100104	125532	227338	101806	g_13700	g_13703
Super-Scaffold_100104	227895	230641	2746	g_13703	g_13704
Super-Scaffold_100104	231369	258785	27416	g_13704	g_13706
Super-Scaffold_100104	281818	284147	2329	g_13706	g_13707
Super-Scaffold_100104	285304	288563	3259	g_13707	g_13708
Super-Scaffold_100104	288799	324670	35871	g_13708	g_13709
Super-Scaffold_100104	325080	325321	241	g_13709	g_13710
Super-Scaffold_100104	325581	325989	408	g_13710	g_13711
Super-Scaffold_100104	326491	326529	38	g_13711	g_13712
Super-Scaffold_100104	326915	334585	7670	g_13712	g_37753
Super-Scaffold_100104	335040	438402	103362	g_37753	g_13716
Super-Scaffold_100104	468125	496503	28378	g_13716	g_13720
Super-Scaffold_100104	497222	497285	63	g_13720	g_13721
Super-Scaffold_100104	498166	498195	29	g_13721	g_13722
Super-Scaffold_100104	498761	498784	23	g_13722	g_13723
Super-Scaffold_100104	499212	536741	37529	g_13723	g_37757
Super-Scaffold_100104	537049	541078	4029	g_37757	g_13725
Super-Scaffold_100104	544405	602091	57686	g_13725	g_13726
Super-Scaffold_100104	611784	632299	20515	g_13726	g_13727
Super-Scaffold_100104	640374	654762	14388	g_13727	g_13728
Super-Scaffold_100104	666410	681508	15098	g_13728	g_13729
Super-Scaffold_100109	48702	50199	1497	g_3	g_4
Super-Scaffold_100109	50680	54766	4086	g_4	g_6
Super-Scaffold_100109	58796	61671	2875	g_6	g_7
Super-Scaffold_100109	79294	133988	54694	g_7	g_10
Super-Scaffold_100109	148136	159932	11796	g_10	g_11
Super-Scaffold_100109	160525	161737	1212	g_11	g_12
Super-Scaffold_100109	161994	178177	16183	g_12	g_38080
Super-Scaffold_100109	178383	178775	392	g_38080	g_14
Super-Scaffold_100109	179029	179055	26	g_14	g_15
Super-Scaffold_100109	179441	180750	1309	g_15	g_16
Super-Scaffold_100109	190142	190215	73	g_16	g_17
Super-Scaffold_100109	192656	193126	470	g_17	g_18
Super-Scaffold_100109	201293	237302	36009	g_18	g_19
Super-Scaffold_100109	237936	238075	139	g_19	g_20
Super-Scaffold_100109	248608	255846	7238	g_20	g_21
Super-Scaffold_100109	265361	274718	9357	g_21	g_23
Super-Scaffold_100109	295095	298870	3775	g_23	g_24
Super-Scaffold_100109	299409	308069	8660	g_24	g_42896
Super-Scaffold_100109	312227	337331	25104	g_42896	g_26
Super-Scaffold_100109	374561	374835	274	g_26	g_27
Super-Scaffold_100109	375191	376594	1403	g_27	g_28
Super-Scaffold_100109	380644	381565	921	g_28	g_38083
Super-Scaffold_100109	382227	387281	5054	g_38083	g_30
Super-Scaffold_100109	390610	410764	20154	g_30	g_31
Super-Scaffold_100109	459734	461894	2160	g_31	g_42897
Super-Scaffold_100109	465009	467358	2349	g_42897	g_32
Super-Scaffold_100109	482026	482990	964	g_32	g_33
Super-Scaffold_100109	483952	485275	1323	g_33	g_34
Super-Scaffold_100111	37213	47473	10260	g_5821	g_5824
Super-Scaffold_100111	48333	49447	1114	g_5824	g_5825
Super-Scaffold_100111	65558	68566	3008	g_5825	g_5826
Super-Scaffold_100111	71735	72370	635	g_5826	g_5827
Super-Scaffold_100111	73203	75341	2138	g_5827	g_5828
Super-Scaffold_100111	77669	102214	24545	g_5828	g_5830
Super-Scaffold_100112	26483	28488	2005	g_18485	g_18486
Super-Scaffold_100112	31734	33766	2032	g_18486	g_18487
Super-Scaffold_100112	61726	69564	7838	g_18487	g_18488
Super-Scaffold_100112	86989	149096	62107	g_18488	g_18489
Super-Scaffold_100112	150553	150837	284	g_18489	g_18490
Super-Scaffold_100112	151154	151662	508	g_18490	g_18491
Super-Scaffold_100112	151979	152037	58	g_18491	g_18492
Super-Scaffold_100121	16132	21863	5731	g_27462	g_27464
Super-Scaffold_100121	22132	22283	151	g_27464	g_27463
Super-Scaffold_100121	22966	26853	3887	g_27463	g_27465
Super-Scaffold_100121	42742	46372	3630	g_27465	g_27466
Super-Scaffold_100121	49177	74949	25772	g_27466	g_27468
Super-Scaffold_100123	2615	172426	169811	g_36026	g_36028
Super-Scaffold_100123	173280	177306	4026	g_36028	g_1363
Super-Scaffold_100123	208042	242514	34472	g_1363	g_36030
Super-Scaffold_100123	244021	258515	14494	g_36031	g_1367
Super-Scaffold_100123	266259	274886	8627	g_1367	g_42997
Super-Scaffold_100123	288093	299938	11845	g_42997	g_1369
Super-Scaffold_100123	317818	336210	18392	g_1369	g_1371
Super-Scaffold_100123	337770	344339	6569	g_1371	g_1372
Super-Scaffold_100123	344692	360978	16286	g_1372	g_1375
Super-Scaffold_100123	385538	403026	17488	g_1375	g_1376
Super-Scaffold_100123	409519	416287	6768	g_1376	g_1377
Super-Scaffold_100123	444012	445114	1102	g_1377	g_1378
Super-Scaffold_100123	448107	449180	1073	g_1378	g_1379
Super-Scaffold_100123	472683	488823	16140	g_1379	g_1381
Super-Scaffold_100123	492017	493577	1560	g_1381	g_1382
Super-Scaffold_100126	31601	39024	7423	g_30634	g_30635
Super-Scaffold_100126	40654	59150	18496	g_30635	g_30637
Super-Scaffold_100126	68079	71476	3397	g_30637	g_30638
Super-Scaffold_100126	72210	90915	18705	g_30638	g_30639
Super-Scaffold_100126	91514	104849	13335	g_30639	g_30640
Super-Scaffold_100126	117850	118075	225	g_30640	g_40692
Super-Scaffold_100126	118497	133198	14701	g_40692	g_30642
Super-Scaffold_100128	29744	44963	15219	g_6594	g_6595
Super-Scaffold_100128	62017	68749	6732	g_6595	g_6598
Super-Scaffold_100128	69066	69236	170	g_6598	g_6599
Super-Scaffold_100128	69961	74556	4595	g_6599	g_6600
Super-Scaffold_100128	78415	79253	838	g_6600	g_6601
Super-Scaffold_100128	92470	143065	50595	g_6601	g_6603
Super-Scaffold_100128	143313	164454	21141	g_6603	g_6604
Super-Scaffold_100128	165206	172486	7280	g_6604	g_6605
Super-Scaffold_100136	6908	6937	29	g_13734	g_13735
Super-Scaffold_100136	16832	38191	21359	g_13735	g_13737
Super-Scaffold_100136	46986	122620	75634	g_13737	g_13740
Super-Scaffold_100136	125877	134578	8701	g_13740	g_44069
Super-Scaffold_100136	136459	155359	18900	g_44069	g_42895
Super-Scaffold_100136	155574	175656	20082	g_42895	g_13749
Super-Scaffold_100136	191521	194339	2818	g_13749	g_13750
Super-Scaffold_100139	45748	45815	67	g_4612	g_4613
Super-Scaffold_100139	47332	47857	525	g_4613	g_4614
Super-Scaffold_100139	50113	56238	6125	g_4614	g_4615
Super-Scaffold_100139	59384	99121	39737	g_4615	g_4617
Super-Scaffold_100139	100770	101917	1147	g_4617	g_4618
Super-Scaffold_100139	102747	102938	191	g_4618	g_4619
Super-Scaffold_100139	105899	111540	5641	g_4619	g_4620
Super-Scaffold_100139	113138	118748	5610	g_4620	g_4621
Super-Scaffold_100139	119059	122420	3361	g_4621	g_4622
Super-Scaffold_100139	131902	149100	17198	g_37745	g_4623
Super-Scaffold_100139	149498	156369	6871	g_4623	g_4625
Super-Scaffold_100139	157868	193122	35254	g_4625	g_4626
Super-Scaffold_100139	203133	215906	12773	g_4626	g_43228
Super-Scaffold_100139	238421	251099	12678	g_43228	g_43229
Super-Scaffold_100139	279252	282529	3277	g_43229	g_4627
Super-Scaffold_100139	284047	290888	6841	g_4627	g_4629
Super-Scaffold_100139	291592	291861	269	g_4629	g_4630
Super-Scaffold_100139	311399	311597	198	g_4630	g_4631
Super-Scaffold_100139	315790	335540	19750	g_4631	g_4633
Super-Scaffold_174	336592	516333	179741	g_4633	g_12190
Super-Scaffold_174	519831	543768	23937	g_12190	g_12192
Super-Scaffold_174	547308	556770	9462	g_12192	g_12193
Super-Scaffold_174	579910	601232	21322	g_12193	g_12194
Super-Scaffold_174	605526	663169	57643	g_12194	g_12195
Super-Scaffold_174	669234	671305	2071	g_12195	g_12196
Super-Scaffold_174	684838	684905	67	g_12196	g_12197
Super-Scaffold_174	693378	781762	88384	g_12197	g_12200
Super-Scaffold_174	790606	809903	19297	g_12200	g_43946
Super-Scaffold_174	810826	814294	3468	g_43946	g_12201
Super-Scaffold_174	814515	817429	2914	g_12201	g_43947
Super-Scaffold_174	818257	888279	70022	g_43947	g_40928
Super-Scaffold_174	888521	895077	6556	g_40928	g_12202
Super-Scaffold_174	895790	921152	25362	g_12202	g_12203
Super-Scaffold_174	921829	921924	95	g_12203	g_12204
Super-Scaffold_174	922304	1006140	83836	g_12204	g_12205
Super-Scaffold_174	1041387	1085546	44159	g_12205	g_12208
Super-Scaffold_174	1102152	1106368	4216	g_12208	g_40931
Super-Scaffold_174	1106601	1125711	19110	g_40931	g_12210
Super-Scaffold_174	1130512	1235162	104650	g_12210	g_12213
Super-Scaffold_174	1246499	1339256	92757	g_12213	g_12218
Super-Scaffold_174	1340518	1351531	11013	g_12218	g_12219
Super-Scaffold_174	1353582	1421958	68376	g_12219	g_40932
Super-Scaffold_174	1422173	1643722	221549	g_40932	g_12221
Super-Scaffold_174	1643967	1686099	42132	g_12221	g_12222
Super-Scaffold_174	1686617	1753288	66671	g_12222	g_12224
Super-Scaffold_174	1753677	1753774	97	g_12224	g_12225
Super-Scaffold_174	1754049	1755445	1396	g_12225	g_12226
Super-Scaffold_174	1755669	1774759	19090	g_12226	g_12227
Super-Scaffold_174	1775880	1834088	58208	g_12227	g_12228
Super-Scaffold_174	1834399	1872523	38124	g_12228	g_12230
Super-Scaffold_174	1872882	1907448	34566	g_12230	g_12232
Super-Scaffold_174	1908074	1950253	42179	g_12232	g_12233
Super-Scaffold_174	1950474	2112017	161543	g_12233	g_12240
Super-Scaffold_174	2112301	2143069	30768	g_12240	g_12241
Super-Scaffold_174	2143284	2188476	45192	g_12241	g_12244
Super-Scaffold_174	2201907	2206945	5038	g_12244	g_12247
Super-Scaffold_174	2207145	2220880	13735	g_12247	g_12248
Super-Scaffold_174	2222219	2222293	74	g_12248	g_12249
Super-Scaffold_174	2222799	2231405	8606	g_12249	g_12245
Super-Scaffold_174	2246823	2251903	5080	g_12245	g_12251
Super-Scaffold_174	2252130	2295653	43523	g_12251	g_40946
Super-Scaffold_174	2299118	2319488	20370	g_40946	g_12253
Super-Scaffold_174	2332379	2342284	9905	g_12253	g_12254
Super-Scaffold_174	2343327	2345875	2548	g_12254	g_12255
Super-Scaffold_174	2346528	2365455	18927	g_12255	g_12257
Super-Scaffold_174	2366243	2426273	60030	g_12257	g_12259
Super-Scaffold_174	2426899	2428200	1301	g_12259	g_12260
Super-Scaffold_174	2428583	2514280	85697	g_12260	g_12262
Super-Scaffold_174	2514885	2515104	219	g_12262	g_43948
Super-Scaffold_174	2517873	2952746	434873	g_43948	g_12266
Super-Scaffold_174	2952985	3021899	68914	g_12266	g_12268
Super-Scaffold_174	3022240	3045019	22779	g_12268	g_12269
Super-Scaffold_174	3047013	3161271	114258	g_12269	g_12272
Super-Scaffold_174	3164547	3165914	1367	g_12272	g_12273
Super-Scaffold_174	3167313	3191642	24329	g_12273	g_12274
Super-Scaffold_174	3192765	3415934	223169	g_12274	g_12279
Super-Scaffold_174	3417496	3434174	16678	g_40951	g_12280
Super-Scaffold_174	3434980	3435039	59	g_12280	g_12281
Super-Scaffold_174	3436604	3436655	51	g_12281	g_43949
Super-Scaffold_174	3438414	3464373	25959	g_43949	g_12282
Super-Scaffold_174	3466523	3472544	6021	g_12282	g_12283
Super-Scaffold_174	3473017	3482200	9183	g_12283	g_12285
Super-Scaffold_174	3482442	3482490	48	g_12285	g_12286
Super-Scaffold_174	3483032	3483132	100	g_12286	g_12287
Super-Scaffold_174	3483482	3606706	123224	g_12287	g_12288
Super-Scaffold_174	3609304	3679543	70239	g_12288	g_12290
Super-Scaffold_174	3717486	3743945	26459	g_12290	g_12291
Super-Scaffold_174	3763835	3790681	26846	g_12291	g_40955
Super-Scaffold_174	3790998	3830636	39638	g_40955	g_12295
Super-Scaffold_174	3853290	3865800	12510	g_12295	g_12297
Super-Scaffold_174	3879756	3904330	24574	g_12297	g_12298
Super-Scaffold_174	3908346	3922261	13915	g_12298	g_43950
Super-Scaffold_174	3931475	4061649	130174	g_43950	g_12301
Super-Scaffold_174	4062492	4145638	83146	g_12301	g_12304
Super-Scaffold_174	4146033	4162812	16779	g_12304	g_12306
Super-Scaffold_174	4164790	4164878	88	g_12306	g_12307
Super-Scaffold_174	4165078	4197104	32026	g_12307	g_12310
Super-Scaffold_174	4208413	4224412	15999	g_12310	g_12312
Super-Scaffold_174	4226250	4237002	10752	g_12312	g_12313
Super-Scaffold_174	4244334	4250979	6645	g_12313	g_12314
Super-Scaffold_174	4266826	4304284	37458	g_12314	g_12316
Super-Scaffold_174	4304601	4306141	1540	g_12316	g_12317
Super-Scaffold_174	4308657	4314352	5695	g_12317	g_12318
Super-Scaffold_174	4334312	4376206	41894	g_12318	g_12320
Super-Scaffold_174	4395538	4401589	6051	g_12320	g_43951
Super-Scaffold_174	4415525	4442654	27129	g_43951	g_12321
Super-Scaffold_174	4446069	4454722	8653	g_12321	g_12322
Super-Scaffold_174	4459489	4492620	33131	g_12322	g_12325
Super-Scaffold_174	4493018	4500947	7929	g_12325	g_12326
Super-Scaffold_174	4501345	4511403	10058	g_12326	g_12327
Super-Scaffold_174	4511891	4514756	2865	g_12327	g_12328
Super-Scaffold_174	4518256	4521359	3103	g_12328	g_12329
Super-Scaffold_174	4523405	4531617	8212	g_12329	g_12330
Super-Scaffold_174	4532057	4538254	6197	g_12330	g_12331
Super-Scaffold_174	4540699	4545706	5007	g_12331	g_12332
Super-Scaffold_174	4546672	4555074	8402	g_12332	g_12333
Super-Scaffold_174	4569358	4571112	1754	g_12333	g_12334
Super-Scaffold_174	4591008	4592540	1532	g_12334	g_12335
Super-Scaffold_174	4595978	4598341	2363	g_12335	g_12336
Super-Scaffold_174	4604534	4689306	84772	g_12336	g_12337
Super-Scaffold_174	4702858	4809898	107040	g_12337	g_12339
Super-Scaffold_174	4810349	4833024	22675	g_12339	g_12340
Super-Scaffold_174	4833233	4860929	27696	g_12340	g_43952
Super-Scaffold_174	4865979	4890643	24664	g_43952	g_12341
Super-Scaffold_174	4897928	4908168	10240	g_12341	g_12342
Super-Scaffold_174	4911120	4912579	1459	g_12342	g_43953
Super-Scaffold_174	4912965	4919946	6981	g_43953	g_43954
Super-Scaffold_174	4959672	4970260	10588	g_43954	g_12343
Super-Scaffold_174	4984130	4985548	1418	g_12343	g_12344
Super-Scaffold_174	4989166	4991110	1944	g_12344	g_12345
Super-Scaffold_174	4993943	5007843	13900	g_12345	g_12346
Super-Scaffold_174	5009998	5072796	62798	g_12346	g_12347
Super-Scaffold_174	5073768	5149110	75342	g_12347	g_12348
Super-Scaffold_174	5149376	5157073	7697	g_12348	g_12349
Super-Scaffold_174	5157354	5175260	17906	g_12349	g_12351
Super-Scaffold_174	5178549	5236311	57762	g_12351	g_12353
Super-Scaffold_174	5236577	5239321	2744	g_12353	g_12354
Super-Scaffold_174	5241979	5249665	7686	g_12354	g_12355
Super-Scaffold_174	5249982	5303899	53917	g_12355	g_12356
Super-Scaffold_174	5304204	5313380	9176	g_12356	g_12357
Super-Scaffold_174	5313583	5318474	4891	g_12357	g_12359
Super-Scaffold_174	5325326	5327119	1793	g_12359	g_12360
Super-Scaffold_174	5335819	5398670	62851	g_12360	g_12361
Super-Scaffold_174	5415825	5427034	11209	g_12361	g_12363
Super-Scaffold_174	5430425	5453454	23029	g_12363	g_12364
Super-Scaffold_174	5484100	5500336	16236	g_12364	g_43955
Super-Scaffold_174	5510465	5515275	4810	g_43955	g_12365
Super-Scaffold_174	5535927	5597494	61567	g_12365	g_12367
Super-Scaffold_174	5597778	5604404	6626	g_12367	g_12368
Super-Scaffold_174	5609955	5611635	1680	g_12368	g_12369
Super-Scaffold_174	5623048	5625065	2017	g_12369	g_12370
Super-Scaffold_174	5626647	5632808	6161	g_12370	g_12371
Super-Scaffold_174	5647014	5655686	8672	g_12371	g_12372
Super-Scaffold_174	5656270	5683147	26877	g_12372	g_12373
Super-Scaffold_174	5692300	5727465	35165	g_12373	g_12374
Super-Scaffold_174	5729656	5742642	12986	g_12374	g_12376
Super-Scaffold_174	5747961	5787373	39412	g_12376	g_12378
Super-Scaffold_174	5821095	5824998	3903	g_12378	g_43956
Super-Scaffold_174	5829044	5880304	51260	g_43956	g_12379
Super-Scaffold_174	5880717	5889509	8792	g_12379	g_12380
Super-Scaffold_174	5916285	5934362	18077	g_12380	g_12381
Super-Scaffold_174	5934676	5939560	4884	g_12381	g_12383
Super-Scaffold_174	5942676	5972268	29592	g_12383	g_12384
Super-Scaffold_174	5972576	5976692	4116	g_12384	g_12385
Super-Scaffold_174	5984218	6026250	42032	g_12385	g_12386
Super-Scaffold_174	6027968	6057840	29872	g_12386	g_12388
Super-Scaffold_174	6076134	6090284	14150	g_12388	g_43957
Super-Scaffold_174	6092930	6095753	2823	g_43957	g_43958
Super-Scaffold_174	6096749	6114325	17576	g_43958	g_12389
Super-Scaffold_174	6114591	6130189	15598	g_12389	g_12390
Super-Scaffold_174	6132121	6145616	13495	g_12390	g_12391
Super-Scaffold_174	6164764	6192353	27589	g_12391	g_12392
Super-Scaffold_174	6203052	6219381	16329	g_12392	g_12393
Super-Scaffold_174	6221324	6225407	4083	g_12393	g_12394
Super-Scaffold_174	6232256	6254062	21806	g_12394	g_12395
Super-Scaffold_174	6323322	6325207	1885	g_12395	g_12396
Super-Scaffold_174	6327356	6332369	5013	g_12396	g_40965
Super-Scaffold_174	6363082	6363640	558	g_12397	g_12398
Super-Scaffold_174	6368234	6369991	1757	g_12398	g_12399
Super-Scaffold_174	6377896	6392928	15032	g_12399	g_12400
Super-Scaffold_174	6400700	6470187	69487	g_12400	g_12401
Super-Scaffold_174	6470471	6530592	60121	g_12401	g_12402
Super-Scaffold_174	6534774	6566289	31515	g_12402	g_12403
Super-Scaffold_174	6567134	6597406	30272	g_12403	g_12404
Super-Scaffold_174	6597642	6691147	93505	g_12404	g_12407
Super-Scaffold_174	6691401	6691719	318	g_12407	g_12408
Super-Scaffold_174	6692537	6696762	4225	g_12408	g_12409
Super-Scaffold_174	6698253	6698305	52	g_12409	g_12410
Super-Scaffold_174	6700237	6743014	42777	g_12410	g_12411
Super-Scaffold_174	6743721	6786808	43087	g_12411	g_12414
Super-Scaffold_174	6787194	6937982	150788	g_12414	g_12415
Super-Scaffold_174	6940381	6973147	32766	g_12415	g_12417
Super-Scaffold_174	6973603	7005422	31819	g_12417	g_12419
Super-Scaffold_174	7008892	7059127	50235	g_12419	g_12421
Super-Scaffold_174	7061669	7089627	27958	g_12421	g_12422
Super-Scaffold_174	7090150	7094070	3920	g_12422	g_12423
Super-Scaffold_174	7094888	7094946	58	g_12423	g_12424
Super-Scaffold_174	7097363	7121879	24516	g_12424	g_40967
Super-Scaffold_174	7122346	7139686	17340	g_40967	g_40968
Super-Scaffold_174	7139889	7170464	30575	g_40968	g_12426
Super-Scaffold_174	7171551	7172786	1235	g_12426	g_12427
Super-Scaffold_174	7173417	7241559	68142	g_12427	g_12428
Super-Scaffold_174	7244107	7254705	10598	g_12428	g_12429
Super-Scaffold_174	7255283	7385458	130175	g_12429	g_12432
Super-Scaffold_174	7386003	7463380	77377	g_12432	g_12433
Super-Scaffold_174	7465116	7522105	56989	g_12433	g_40970
Super-Scaffold_174	7522359	7570614	48255	g_40970	g_12434
Super-Scaffold_174	7571654	7690454	118800	g_12434	g_12435
Super-Scaffold_174	7690990	7772607	81617	g_12435	g_12437
Super-Scaffold_174	7773700	7794251	20551	g_12437	g_12438
Super-Scaffold_174	7795220	7931327	136107	g_40971	g_12440
Super-Scaffold_174	7931941	7932076	135	g_12440	g_40974
Super-Scaffold_174	7932729	8001192	68463	g_40974	g_12442
Super-Scaffold_174	8001546	8225172	223626	g_12442	g_12443
Super-Scaffold_174	8239395	8255236	15841	g_12443	g_43959
Super-Scaffold_174	8257327	8349824	92497	g_43959	g_12444
Super-Scaffold_174	8350957	8440980	90023	g_12444	g_12446
Super-Scaffold_174	8441537	8482910	41373	g_12446	g_12448
Super-Scaffold_174	8483200	8551031	67831	g_12448	g_12449
Super-Scaffold_174	8551768	8754948	203180	g_12449	g_12450
Super-Scaffold_174	8760336	8765856	5520	g_12450	g_12451
Super-Scaffold_174	8788482	8798400	9918	g_12451	g_12452
Super-Scaffold_174	8804860	8826429	21569	g_12452	g_43960
Super-Scaffold_174	8827205	8831427	4222	g_43960	g_43961
Super-Scaffold_174	8847460	8852186	4726	g_43961	g_43962
Super-Scaffold_174	8852790	8857873	5083	g_43962	g_12453
Super-Scaffold_174	8862197	8882191	19994	g_12453	g_12455
Super-Scaffold_174	8891772	8894806	3034	g_12455	g_12456
Super-Scaffold_174	8911033	8911171	138	g_12456	g_12457
Super-Scaffold_174	8914822	8925115	10293	g_12457	g_43963
Super-Scaffold_174	8927620	8990259	62639	g_43963	g_12459
Super-Scaffold_174	8991920	9003218	11298	g_12459	g_12460
Super-Scaffold_174	9005083	9019125	14042	g_12460	g_12461
Super-Scaffold_174	9020111	9032415	12304	g_12461	g_12462
Super-Scaffold_174	9049217	9058223	9006	g_12462	g_12463
Super-Scaffold_174	9062231	9128610	66379	g_12463	g_40980
Super-Scaffold_174	9129206	9129471	265	g_40980	g_12465
Super-Scaffold_174	9205953	9307150	101197	g_12465	g_12467
Super-Scaffold_174	9307617	9380250	72633	g_12467	g_12469
Super-Scaffold_174	9399007	9401973	2966	g_12469	g_12470
Super-Scaffold_174	9402293	9478428	76135	g_12470	g_12472
Super-Scaffold_174	9479168	9495350	16182	g_12472	g_12474
Super-Scaffold_174	9499599	9503574	3975	g_12474	g_12475
Super-Scaffold_174	9509764	9511023	1259	g_12475	g_12476
Super-Scaffold_174	9524484	9525266	782	g_12476	g_12477
Super-Scaffold_174	9531455	9533643	2188	g_12477	g_12478
Super-Scaffold_174	9536317	9580197	43880	g_12478	g_12480
Super-Scaffold_174	9582626	9582797	171	g_12480	g_40982
Super-Scaffold_174	9583108	9588794	5686	g_40982	g_12481
Super-Scaffold_174	9602519	9603800	1281	g_12481	g_12482
Super-Scaffold_174	9607097	9608812	1715	g_12482	g_12483
Super-Scaffold_174	9614175	9617321	3146	g_12483	g_12484
Super-Scaffold_174	9621478	9622875	1397	g_12484	g_12485
Super-Scaffold_174	9626425	9632128	5703	g_12485	g_12486
Super-Scaffold_174	9661865	9662714	849	g_12486	g_12487
Super-Scaffold_174	9668874	9670815	1941	g_12487	g_12488
Super-Scaffold_174	9677821	9680246	2425	g_12488	g_12489
Super-Scaffold_174	9682806	9683407	601	g_12489	g_43964
Super-Scaffold_174	9684054	9707595	23541	g_43964	g_12493
Super-Scaffold_174	9720339	9722000	1661	g_12493	g_12494
Super-Scaffold_174	9723447	9725677	2230	g_12494	g_43965
Super-Scaffold_174	9727654	9733263	5609	g_43965	g_43966
Super-Scaffold_174	9735671	9736681	1010	g_43966	g_12495
Super-Scaffold_174	9739530	9823145	83615	g_12495	g_12498
Super-Scaffold_174	9823387	9885354	61967	g_12498	g_12500
Super-Scaffold_174	9889631	9905868	16237	g_12500	g_12502
Super-Scaffold_174	9907765	9914730	6965	g_12502	g_12503
Super-Scaffold_174	9928920	9952879	23959	g_12503	g_12504
Super-Scaffold_174	9957103	10240687	283584	g_12504	g_12509
Super-Scaffold_174	10240890	10382111	141221	g_12509	g_12512
Super-Scaffold_174	10382887	10528552	145665	g_12512	g_12514
Super-Scaffold_174	10546531	10549557	3026	g_12514	g_12515
Super-Scaffold_174	10554796	10556432	1636	g_12515	g_12516
Super-Scaffold_174	10558916	10561445	2529	g_12516	g_12517
Super-Scaffold_174	10564512	10664001	99489	g_12517	g_12520
Super-Scaffold_174	10666453	10676057	9604	g_12520	g_12522
Super-Scaffold_174	10677519	10761635	84116	g_12522	g_40991
Super-Scaffold_174	10768059	10954999	186940	g_12523	g_12524
Super-Scaffold_174	10955637	10955794	157	g_12524	g_12525
Super-Scaffold_174	10957384	11010355	52971	g_12525	g_12526
Super-Scaffold_174	11011622	11053504	41882	g_12526	g_12527
Super-Scaffold_174	11055272	11123561	68289	g_12527	g_12528
Super-Scaffold_174	11124181	11200266	76085	g_12528	g_12530
Super-Scaffold_174	11200949	11201014	65	g_12530	g_12531
Super-Scaffold_174	11202033	11202119	86	g_12531	g_12532
Super-Scaffold_174	11202490	11211113	8623	g_12532	g_12533
Super-Scaffold_174	11211487	11220361	8874	g_12533	g_12534
Super-Scaffold_174	11221151	11350285	129134	g_12534	g_12536
Super-Scaffold_174	11352820	11412514	59694	g_12536	g_12537
Super-Scaffold_174	11413479	11467833	54354	g_12537	g_12538
Super-Scaffold_174	11474411	11475782	1371	g_12538	g_12539
Super-Scaffold_174	11484745	11488281	3536	g_12539	g_12540
Super-Scaffold_174	11512336	11598618	86282	g_12540	g_12545
Super-Scaffold_174	11603181	11657395	54214	g_12545	g_12546
Super-Scaffold_174	11661449	11677082	15633	g_12546	g_12547
Super-Scaffold_174	11683456	11691167	7711	g_12547	g_12548
Super-Scaffold_174	11695835	11701175	5340	g_12548	g_12549
Super-Scaffold_174	11702506	11705588	3082	g_12549	g_12550
Super-Scaffold_174	11726599	11739182	12583	g_12550	g_12551
Super-Scaffold_174	11744273	11746883	2610	g_12551	g_12552
Super-Scaffold_174	11748033	11761616	13583	g_12552	g_12553
Super-Scaffold_174	11764190	11790242	26052	g_12553	g_12554
Super-Scaffold_174	11808244	11809499	1255	g_12554	g_12555
Super-Scaffold_174	11828971	11831156	2185	g_12555	g_12556
Super-Scaffold_174	11832475	11868399	35924	g_12556	g_12557
Super-Scaffold_174	11869253	11900854	31601	g_12557	g_12558
Super-Scaffold_174	11915381	11997031	81650	g_41001	g_12561
Super-Scaffold_174	11997282	12050126	52844	g_12561	g_12562
Super-Scaffold_174	12085949	12100673	14724	g_12562	g_12563
Super-Scaffold_174	12121021	12124321	3300	g_12563	g_12564
Super-Scaffold_174	12126370	12127629	1259	g_12564	g_12565
Super-Scaffold_174	12135904	12165700	29796	g_12565	g_12566
Super-Scaffold_174	12175506	12184743	9237	g_12566	g_12567
Super-Scaffold_174	12206048	12207234	1186	g_12567	g_12568
Super-Scaffold_174	12218386	12219264	878	g_12568	g_12569
Super-Scaffold_174	12219965	12231824	11859	g_12569	g_12570
Super-Scaffold_174	12236702	12237123	421	g_12570	g_12571
Super-Scaffold_174	12247174	12247991	817	g_12571	g_12572
Super-Scaffold_174	12285403	12299652	14249	g_12572	g_12573
Super-Scaffold_174	12299975	12306086	6111	g_12573	g_12574
Super-Scaffold_174	12307180	12387384	80204	g_12574	g_12576
Super-Scaffold_174	12392525	12393639	1114	g_12576	g_12577
Super-Scaffold_174	12393968	12649873	255905	g_12577	g_12585
Super-Scaffold_174	12663669	12664500	831	g_12585	g_41007
Super-Scaffold_174	12665843	12680663	14820	g_41007	g_12587
Super-Scaffold_174	12696337	12698566	2229	g_12587	g_12588
Super-Scaffold_174	12701088	12705417	4329	g_12588	g_12589
Super-Scaffold_174	12707244	12758838	51594	g_12589	g_12592
Super-Scaffold_174	12759074	12802764	43690	g_12592	g_12593
Super-Scaffold_174	12803132	12833704	30572	g_12593	g_12595
Super-Scaffold_174	12834024	12845215	11191	g_12595	g_12596
Super-Scaffold_174	12853384	12854607	1223	g_12596	g_12597
Super-Scaffold_174	12855356	12860456	5100	g_12597	g_12598
Super-Scaffold_174	12860725	12897992	37267	g_12598	g_12599
Super-Scaffold_174	12898273	12901338	3065	g_12599	g_41012
Super-Scaffold_174	12901697	12948816	47119	g_41012	g_12600
Super-Scaffold_174	12949834	12972185	22351	g_12600	g_12601
Super-Scaffold_174	12983698	12994583	10885	g_12601	g_12602
Super-Scaffold_174	12995209	13006267	11058	g_12602	g_43967
Super-Scaffold_174	13008858	13014526	5668	g_43967	g_12603
Super-Scaffold_174	13030848	13049819	18971	g_12603	g_12604
Super-Scaffold_174	13060773	13062073	1300	g_12604	g_12605
Super-Scaffold_174	13065527	13066199	672	g_12605	g_12606
Super-Scaffold_174	13069951	13073523	3572	g_12606	g_12607
Super-Scaffold_174	13075185	13076779	1594	g_12607	g_12608
Super-Scaffold_174	13079089	13082845	3756	g_12608	g_12609
Super-Scaffold_174	13090113	13129925	39812	g_12609	g_12611
Super-Scaffold_174	13130248	13169055	38807	g_12611	g_12614
Super-Scaffold_174	13169330	13238923	69593	g_12614	g_12619
Super-Scaffold_174	13260102	13262182	2080	g_12619	g_12620
Super-Scaffold_174	13272275	13274621	2346	g_12620	g_43968
Super-Scaffold_174	13277513	13279930	2417	g_43968	g_43969
Super-Scaffold_174	13292020	13293855	1835	g_43969	g_12621
Super-Scaffold_174	13295604	13300929	5325	g_12621	g_12622
Super-Scaffold_174	13310507	13311514	1007	g_12622	g_12623
Super-Scaffold_174	13315948	13317064	1116	g_12623	g_12624
Super-Scaffold_174	13323192	13324484	1292	g_12624	g_12625
Super-Scaffold_174	13327031	13329662	2631	g_12625	g_12626
Super-Scaffold_174	13337502	13339518	2016	g_12626	g_12627
Super-Scaffold_174	13342407	13344317	1910	g_12627	g_12628
Super-Scaffold_174	13345090	13349856	4766	g_12628	g_12629
Super-Scaffold_174	13350719	13352915	2196	g_12629	g_12630
Super-Scaffold_174	13355700	13357455	1755	g_12630	g_12631
Super-Scaffold_174	13361615	13362399	784	g_12631	g_12632
Super-Scaffold_174	13365232	13381670	16438	g_12632	g_12633
Super-Scaffold_174	13383175	13398673	15498	g_12633	g_41019
Super-Scaffold_174	13398897	13401445	2548	g_41019	g_41020
Super-Scaffold_174	13401768	13484459	82691	g_41020	g_12636
Super-Scaffold_174	13484734	13546173	61439	g_12636	g_12640
Super-Scaffold_174	13570214	13578454	8240	g_12640	g_12641
Super-Scaffold_174	13578771	13595189	16418	g_12641	g_12642
Super-Scaffold_174	13596757	13617144	20387	g_12642	g_12644
Super-Scaffold_174	13620932	13649037	28105	g_12644	g_12645
Super-Scaffold_174	13653963	13693498	39535	g_12645	g_12646
Super-Scaffold_174	13693716	13761235	67519	g_12646	g_12649
Super-Scaffold_174	13763124	13776952	13828	g_12649	g_12650
Super-Scaffold_174	13793639	13814280	20641	g_12650	g_12652
Super-Scaffold_174	13821602	13822348	746	g_12652	g_12653
Super-Scaffold_174	13832432	13903948	71516	g_12653	g_12654
Super-Scaffold_174	13913272	13954109	40837	g_12654	g_12655
Super-Scaffold_174	13976655	13983415	6760	g_12655	g_12657
Super-Scaffold_174	13998645	14015998	17353	g_12657	g_12660
Super-Scaffold_174	14016720	14023618	6898	g_12660	g_12662
Super-Scaffold_174	14023836	14024019	183	g_12662	g_43970
Super-Scaffold_174	14029550	14073625	44075	g_43970	g_12664
Super-Scaffold_174	14076876	14146560	69684	g_12664	g_12666
Super-Scaffold_174	14147701	14170984	23283	g_12666	g_12667
Super-Scaffold_174	14174831	14255542	80711	g_12667	g_12668
Super-Scaffold_174	14270463	14272911	2448	g_12668	g_12669
Super-Scaffold_174	14283747	14288178	4431	g_12669	g_12670
Super-Scaffold_174	14289741	14292630	2889	g_12670	g_12671
Super-Scaffold_174	14299455	14372022	72567	g_12671	g_41036
Super-Scaffold_174	14372225	14446958	74733	g_41036	g_12676
Super-Scaffold_174	14465815	14469098	3283	g_12676	g_41037
Super-Scaffold_174	14469316	14473000	3684	g_41037	g_12677
Super-Scaffold_174	14474606	14534396	59790	g_12677	g_12679
Super-Scaffold_174	14536249	14555676	19427	g_12679	g_12680
Super-Scaffold_174	14555936	14570207	14271	g_12680	g_12681
Super-Scaffold_174	14571490	14572167	677	g_12681	g_12682
Super-Scaffold_174	14572373	14586021	13648	g_12682	g_12683
Super-Scaffold_174	14586323	14588362	2039	g_12683	g_43971
Super-Scaffold_174	14588772	14701670	112898	g_43971	g_12688
Super-Scaffold_174	14704725	14711324	6599	g_12688	g_12689
Super-Scaffold_174	14711530	14757850	46320	g_12689	g_12692
Super-Scaffold_174	14811063	14813903	2840	g_12692	g_12693
Super-Scaffold_174	14818102	14824658	6556	g_12693	g_12694
Super-Scaffold_174	14826065	14847845	21780	g_12694	g_12696
Super-Scaffold_174	14852704	14867673	14969	g_12696	g_12697
Super-Scaffold_174	14869509	14871756	2247	g_12697	g_12698
Super-Scaffold_174	14871992	14872039	47	g_12698	g_12699
Super-Scaffold_174	14872953	14882099	9146	g_12699	g_12700
Super-Scaffold_174	14891720	14894730	3010	g_12700	g_43972
Super-Scaffold_174	14898040	14899279	1239	g_43972	g_12701
Super-Scaffold_174	14915627	14926290	10663	g_12701	g_12703
Super-Scaffold_174	14928010	14928705	695	g_12703	g_12704
Super-Scaffold_174	14932678	14932961	283	g_12704	g_12705
Super-Scaffold_174	14934851	14936671	1820	g_12705	g_12706
Super-Scaffold_174	14939660	14943578	3918	g_12706	g_12707
Super-Scaffold_174	14947792	14952873	5081	g_12707	g_12708
Super-Scaffold_174	14955548	14957841	2293	g_12708	g_12709
Super-Scaffold_174	14969366	14972507	3141	g_12709	g_12710
Super-Scaffold_174	14976415	14981101	4686	g_12710	g_12711
Super-Scaffold_174	14984311	14984898	587	g_12711	g_12712
Super-Scaffold_174	14995611	15002042	6431	g_12712	g_12714
Super-Scaffold_174	15002391	15008399	6008	g_12714	g_12715
Super-Scaffold_174	15028657	15036062	7405	g_12715	g_12716
Super-Scaffold_174	15036703	15039528	2825	g_12716	g_12717
Super-Scaffold_174	15048155	15048286	131	g_12717	g_43973
Super-Scaffold_174	15059212	15070230	11018	g_43973	g_12718
Super-Scaffold_174	15071813	15073622	1809	g_12718	g_12719
Super-Scaffold_174	15082298	15100317	18019	g_12719	g_12720
Super-Scaffold_174	15102714	15103912	1198	g_12720	g_12721
Super-Scaffold_174	15106754	15108638	1884	g_12721	g_12722
Super-Scaffold_174	15114298	15117444	3146	g_12722	g_12723
Super-Scaffold_174	15123576	15132673	9097	g_12723	g_43974
Super-Scaffold_174	15155951	15157529	1578	g_43974	g_12724
Super-Scaffold_174	15164664	15165725	1061	g_12724	g_12725
Super-Scaffold_174	15167569	15168598	1029	g_12725	g_12726
Super-Scaffold_174	15172019	15174199	2180	g_12726	g_43975
Super-Scaffold_174	15187992	15188616	624	g_43975	g_43976
Super-Scaffold_174	15191529	15195264	3735	g_43976	g_12727
Super-Scaffold_174	15195548	15198096	2548	g_12727	g_12728
Super-Scaffold_174	15207930	15217039	9109	g_12728	g_12729
Super-Scaffold_174	15217320	15218451	1131	g_12729	g_12731
Super-Scaffold_174	15218804	15220013	1209	g_12731	g_12732
Super-Scaffold_174	15220420	15226312	5892	g_12732	g_12733
Super-Scaffold_174	15226710	15232248	5538	g_12733	g_41045
Super-Scaffold_174	15232469	15233105	636	g_41045	g_41046
Super-Scaffold_174	15233335	15235507	2172	g_41046	g_12734
Super-Scaffold_174	15237102	15241518	4416	g_12734	g_12735
Super-Scaffold_174	15241826	15244867	3041	g_12735	g_12736
Super-Scaffold_174	15247883	15248585	702	g_12736	g_12737
Super-Scaffold_174	15252676	15260921	8245	g_12737	g_12738
Super-Scaffold_174	15270479	15287073	16594	g_12738	g_12739
Super-Scaffold_174	15303612	15309371	5759	g_12739	g_12740
Super-Scaffold_174	15309994	15323871	13877	g_12740	g_12742
Super-Scaffold_174	15325234	15351129	25895	g_12742	g_12744
Super-Scaffold_174	15352223	15356507	4284	g_12744	g_12745
Super-Scaffold_174	15358084	15378342	20258	g_12745	g_12747
Super-Scaffold_174	15383277	15405137	21860	g_12747	g_12748
Super-Scaffold_174	15406171	15466350	60179	g_12748	g_12751
Super-Scaffold_174	15466808	15469188	2380	g_12751	g_12752
Super-Scaffold_174	15469493	15477169	7676	g_12752	g_12754
Super-Scaffold_174	15499170	15502342	3172	g_12754	g_12755
Super-Scaffold_174	15523604	15525169	1565	g_12755	g_41048
Super-Scaffold_174	15525411	15527162	1751	g_41048	g_12756
Super-Scaffold_174	15529208	15530717	1509	g_12756	g_12757
Super-Scaffold_174	15536733	15539667	2934	g_12757	g_12758
Super-Scaffold_174	15540215	15543466	3251	g_12758	g_12759
Super-Scaffold_174	15580446	15587237	6791	g_12759	g_12760
Super-Scaffold_174	15595659	15669236	73577	g_12760	g_12762
Super-Scaffold_174	15671499	15700649	29150	g_12762	g_12764
Super-Scaffold_174	15713991	15761092	47101	g_12764	g_12766
Super-Scaffold_174	15762654	15763705	1051	g_12766	g_41052
Super-Scaffold_174	15765568	15769858	4290	g_12767	g_12768
Super-Scaffold_174	15773482	15838576	65094	g_12768	g_12769
Super-Scaffold_174	15845290	15879800	34510	g_12769	g_12772
Super-Scaffold_174	15897851	15898912	1061	g_12772	g_12773
Super-Scaffold_174	15903976	15905546	1570	g_12773	g_12774
Super-Scaffold_174	15909865	15914548	4683	g_12774	g_12775
Super-Scaffold_174	15920670	15926730	6060	g_12775	g_12776
Super-Scaffold_174	15931861	15933058	1197	g_12776	g_12777
Super-Scaffold_174	15934201	15954391	20190	g_12777	g_12778
Super-Scaffold_174	15971583	15999557	27974	g_12778	g_12779
Super-Scaffold_174	16014629	16022402	7773	g_12779	g_12780
Super-Scaffold_174	16035035	16038021	2986	g_12780	g_12781
Super-Scaffold_174	16044662	16047198	2536	g_12781	g_43977
Super-Scaffold_174	16048022	16067138	19116	g_43977	g_12782
Super-Scaffold_174	16068208	16072069	3861	g_12782	g_43978
Super-Scaffold_174	16077722	16085776	8054	g_43978	g_43979
Super-Scaffold_174	16085991	16103595	17604	g_43979	g_12784
Super-Scaffold_174	16109268	16113980	4712	g_12784	g_12785
Super-Scaffold_174	16118980	16120826	1846	g_12785	g_12786
Super-Scaffold_174	16127591	16151221	23630	g_12786	g_12787
Super-Scaffold_174	16156655	16171243	14588	g_12787	g_12788
Super-Scaffold_174	16176258	16190777	14519	g_12788	g_12790
Super-Scaffold_174	16193856	16195308	1452	g_12790	g_12791
Super-Scaffold_174	16201844	16205426	3582	g_12791	g_12792
Super-Scaffold_174	16215618	16217501	1883	g_12792	g_12793
Super-Scaffold_174	16248001	16250078	2077	g_12793	g_43980
Super-Scaffold_174	16258749	16268315	9566	g_43980	g_41059
Super-Scaffold_174	16268566	16274012	5446	g_41059	g_12795
Super-Scaffold_174	16274486	16287184	12698	g_12795	g_43981
Super-Scaffold_174	16287630	16306968	19338	g_43981	g_12796
Super-Scaffold_174	16318112	16319962	1850	g_12796	g_12797
Super-Scaffold_174	16321929	16323355	1426	g_12797	g_12798
Super-Scaffold_174	16326863	16330338	3475	g_12798	g_12799
Super-Scaffold_174	16337734	16338407	673	g_12799	g_12800
Super-Scaffold_174	16342068	16342761	693	g_12800	g_12801
Super-Scaffold_174	16344512	16346864	2352	g_12801	g_12802
Super-Scaffold_174	16348805	16351349	2544	g_12802	g_12803
Super-Scaffold_174	16356247	16357599	1352	g_12803	g_12804
Super-Scaffold_174	16364229	16366585	2356	g_12804	g_12805
Super-Scaffold_174	16368144	16380281	12137	g_12805	g_12806
Super-Scaffold_174	16380505	16387705	7200	g_12806	g_41061
Super-Scaffold_174	16387935	16389270	1335	g_41061	g_12809
Super-Scaffold_174	16389539	16393850	4311	g_12809	g_12810
Super-Scaffold_174	16394098	16394302	204	g_12810	g_12811
Super-Scaffold_174	16394610	16408750	14140	g_12811	g_12812
Super-Scaffold_174	16409031	16412799	3768	g_12812	g_12813
Super-Scaffold_174	16416430	16423052	6622	g_12813	g_12815
Super-Scaffold_174	16438685	16497212	58527	g_12815	g_12818
Super-Scaffold_174	16504989	16505955	966	g_12818	g_12819
Super-Scaffold_174	16506281	16508035	1754	g_12819	g_12820
Super-Scaffold_174	16508700	16512501	3801	g_12820	g_12821
Super-Scaffold_174	16512704	16527337	14633	g_12821	g_12823
Super-Scaffold_174	16527711	16531853	4142	g_12823	g_12824
Super-Scaffold_174	16533763	16540940	7177	g_12824	g_12826
Super-Scaffold_174	16545468	16547221	1753	g_12826	g_12827
Super-Scaffold_174	16557174	16604631	47457	g_12827	g_12829
Super-Scaffold_174	16606287	16609323	3036	g_12829	g_12830
Super-Scaffold_174	16620901	16623104	2203	g_12830	g_12831
Super-Scaffold_174	16623694	16623971	277	g_12831	g_12832
Super-Scaffold_174	16625612	16627400	1788	g_12832	g_12833
Super-Scaffold_174	16629102	16632294	3192	g_12833	g_12834
Super-Scaffold_174	16634394	16637203	2809	g_12834	g_12835
Super-Scaffold_174	16642829	16645955	3126	g_12835	g_12836
Super-Scaffold_174	16647479	16648933	1454	g_12836	g_43982
Super-Scaffold_174	16656688	16661967	5279	g_43982	g_12838
Super-Scaffold_174	16664772	16666203	1431	g_12838	g_43983
Super-Scaffold_174	16669008	16670435	1427	g_43983	g_43984
Super-Scaffold_174	16673240	16683549	10309	g_43984	g_43985
Super-Scaffold_174	16684985	16685867	882	g_43985	g_12839
Super-Scaffold_174	16690674	16726668	35994	g_12839	g_12842
Super-Scaffold_174	16727939	16728714	775	g_12842	g_12843
Super-Scaffold_174	16729985	16731564	1579	g_12843	g_12844
Super-Scaffold_174	16732052	16736843	4791	g_12844	g_12845
Super-Scaffold_174	16750483	16751810	1327	g_12845	g_12846
Super-Scaffold_174	16753691	16754814	1123	g_12846	g_43986
Super-Scaffold_174	16756214	16758764	2550	g_43986	g_43987
Super-Scaffold_174	16766775	16767307	532	g_43987	g_12847
Super-Scaffold_174	16769346	16769883	537	g_12847	g_12848
Super-Scaffold_174	16775905	16776489	584	g_12848	g_12849
Super-Scaffold_174	16782804	16786940	4136	g_12849	g_12850
Super-Scaffold_174	16792439	16794288	1849	g_12850	g_12851
Super-Scaffold_174	16805123	16806404	1281	g_12851	g_12852
Super-Scaffold_174	16811406	16814510	3104	g_12852	g_43988
Super-Scaffold_174	16815626	16824212	8586	g_43988	g_12853
Super-Scaffold_174	16840516	16851916	11400	g_12853	g_12854
Super-Scaffold_174	16853299	16855736	2437	g_12854	g_12855
Super-Scaffold_174	16857377	16859946	2569	g_12855	g_43989
Super-Scaffold_174	16872233	16894434	22201	g_43989	g_12857
Super-Scaffold_174	16894694	16903115	8421	g_12857	g_12858
Super-Scaffold_174	16910303	16913102	2799	g_12858	g_12859
Super-Scaffold_174	16915304	16917741	2437	g_12859	g_12860
Super-Scaffold_174	16920674	16921035	361	g_12860	g_12861
Super-Scaffold_174	16928970	16948557	19587	g_12861	g_12864
Super-Scaffold_174	16948994	16969959	20965	g_12864	g_12866
Super-Scaffold_174	16970246	16982579	12333	g_12866	g_12867
Super-Scaffold_174	16984375	17004386	20011	g_12867	g_12869
Super-Scaffold_174	17016515	17036185	19670	g_12869	g_12871
Super-Scaffold_174	17047194	17051529	4335	g_12871	g_12872
Super-Scaffold_174	17064608	17069685	5077	g_12872	g_12873
Super-Scaffold_174	17076285	17076873	588	g_12873	g_12874
Super-Scaffold_174	17078093	17087761	9668	g_12874	g_12875
Super-Scaffold_174	17088288	17095239	6951	g_12875	g_12876
Super-Scaffold_174	17113404	17159214	45810	g_12876	g_12881
Super-Scaffold_174	17159486	17169280	9794	g_12881	g_12882
Super-Scaffold_174	17186138	17243252	57114	g_12882	g_12885
Super-Scaffold_174	17243515	17291630	48115	g_12885	g_12886
Super-Scaffold_174	17291830	17310215	18385	g_12886	g_12887
Super-Scaffold_174	17321271	17323725	2454	g_12887	g_12888
Super-Scaffold_174	17325138	17328274	3136	g_12888	g_12889
Super-Scaffold_174	17335221	17337166	1945	g_12889	g_12890
Super-Scaffold_174	17340028	17342430	2402	g_12890	g_12891
Super-Scaffold_174	17359233	17359760	527	g_12891	g_12892
Super-Scaffold_174	17362436	17364932	2496	g_12892	g_12893
Super-Scaffold_174	17366554	17368280	1726	g_12893	g_12894
Super-Scaffold_174	17372898	17373340	442	g_12894	g_12895
Super-Scaffold_174	17374898	17376466	1568	g_12895	g_43990
Super-Scaffold_174	17378381	17382914	4533	g_43990	g_12896
Super-Scaffold_174	17386386	17387059	673	g_12896	g_12897
Super-Scaffold_174	17387832	17394325	6493	g_12897	g_12898
Super-Scaffold_174	17403152	17434477	31325	g_12898	g_12900
Super-Scaffold_174	17434851	17453659	18808	g_12900	g_12901
Super-Scaffold_174	17464244	17467299	3055	g_12901	g_12902
Super-Scaffold_174	17472341	17478715	6374	g_12902	g_12903
Super-Scaffold_174	17495159	17497645	2486	g_12903	g_43991
Super-Scaffold_174	17502943	17505831	2888	g_43991	g_12904
Super-Scaffold_174	17511204	17512917	1713	g_12904	g_12905
Super-Scaffold_174	17521768	17523649	1881	g_12905	g_12906
Super-Scaffold_174	17525632	17529729	4097	g_12906	g_43992
Super-Scaffold_174	17534682	17536853	2171	g_43992	g_12907
Super-Scaffold_174	17538341	17540416	2075	g_12907	g_43993
Super-Scaffold_174	17547245	17548014	769	g_43993	g_12908
Super-Scaffold_174	17552800	17564708	11908	g_12908	g_12909
Super-Scaffold_174	17574929	17588062	13133	g_12909	g_12911
Super-Scaffold_174	17588505	17595774	7269	g_12911	g_12912
Super-Scaffold_174	17596193	17599726	3533	g_12912	g_12914
Super-Scaffold_174	17600100	17601227	1127	g_12914	g_12915
Super-Scaffold_174	17605464	17607390	1926	g_12915	g_12916
Super-Scaffold_174	17612824	17618874	6050	g_12916	g_12917
Super-Scaffold_174	17630480	17642034	11554	g_12917	g_12918
Super-Scaffold_174	17643619	17644061	442	g_12918	g_12919
Super-Scaffold_174	17660712	17662122	1410	g_12919	g_12920
Super-Scaffold_174	17680594	17681727	1133	g_12920	g_12921
Super-Scaffold_174	17692722	17701367	8645	g_41078	g_12922
Super-Scaffold_174	17711405	17712788	1383	g_12922	g_12923
Super-Scaffold_174	17716886	17719677	2791	g_12923	g_12924
Super-Scaffold_174	17726640	17760340	33700	g_12924	g_12925
Super-Scaffold_174	17762175	17773784	11609	g_12925	g_12926
Super-Scaffold_174	17774116	17780032	5916	g_12926	g_12927
Super-Scaffold_174	17781667	17789403	7736	g_12927	g_12929
Super-Scaffold_174	17794158	17795946	1788	g_12929	g_12930
Super-Scaffold_174	17809742	17825896	16154	g_12930	g_41080
Super-Scaffold_174	17826135	17828222	2087	g_41080	g_12932
Super-Scaffold_174	17830730	17830981	251	g_12932	g_12933
Super-Scaffold_174	17842664	17850621	7957	g_12933	g_12935
Super-Scaffold_174	17872344	17876608	4264	g_12935	g_12936
Super-Scaffold_174	17890933	17892322	1389	g_12936	g_12937
Super-Scaffold_174	17895557	17905145	9588	g_12937	g_12938
Super-Scaffold_174	17911492	17916851	5359	g_12938	g_12939
Super-Scaffold_174	17921680	17923908	2228	g_12939	g_12940
Super-Scaffold_174	17926967	17928026	1059	g_12940	g_12941
Super-Scaffold_174	17933991	17936598	2607	g_12941	g_12942
Super-Scaffold_174	17953128	17976626	23498	g_12942	g_12943
Super-Scaffold_174	17984805	17985687	882	g_12943	g_12944
Super-Scaffold_174	17986091	17988922	2831	g_12944	g_43994
Super-Scaffold_174	17993713	18037452	43739	g_43994	g_12946
Super-Scaffold_174	18045629	18051803	6174	g_12946	g_12947
Super-Scaffold_174	18063889	18070676	6787	g_12947	g_12948
Super-Scaffold_174	18072975	18073913	938	g_12948	g_12949
Super-Scaffold_174	18075458	18081784	6326	g_12949	g_12950
Super-Scaffold_174	18083449	18092596	9147	g_12950	g_12951
Super-Scaffold_174	18100492	18122445	21953	g_12951	g_43995
Super-Scaffold_174	18129296	18130338	1042	g_43995	g_43996
Super-Scaffold_174	18132285	18134382	2097	g_43996	g_12952
Super-Scaffold_174	18144356	18147227	2871	g_12952	g_12953
Super-Scaffold_174	18154756	18157224	2468	g_12953	g_12954
Super-Scaffold_174	18178506	18224000	45494	g_12954	g_12956
Super-Scaffold_174	18244030	18246157	2127	g_12956	g_12957
Super-Scaffold_174	18250017	18252936	2919	g_12957	g_12958
Super-Scaffold_174	18257528	18258140	612	g_12958	g_12959
Super-Scaffold_174	18260390	18263068	2678	g_12959	g_12960
Super-Scaffold_174	18266469	18280102	13633	g_12960	g_12961
Super-Scaffold_174	18295896	18330825	34929	g_12961	g_12962
Super-Scaffold_174	18336232	18338966	2734	g_12962	g_12963
Super-Scaffold_174	18352076	18353248	1172	g_12963	g_12964
Super-Scaffold_174	18356997	18362858	5861	g_12964	g_12965
Super-Scaffold_174	18363850	18365336	1486	g_12965	g_12966
Super-Scaffold_174	18367043	18374120	7077	g_12966	g_12967
Super-Scaffold_174	18376485	18462573	86088	g_12967	g_12969
Super-Scaffold_174	18478817	18487571	8754	g_12969	g_12970
Super-Scaffold_174	18504680	18514884	10204	g_12970	g_12971
Super-Scaffold_174	18527587	18531025	3438	g_12971	g_12972
Super-Scaffold_174	18531727	18533712	1985	g_12972	g_41084
Super-Scaffold_174	18534101	18536698	2597	g_41084	g_12974
Super-Scaffold_174	18536952	18549798	12846	g_12974	g_12975
Super-Scaffold_174	18550139	18621730	71591	g_12975	g_12979
Super-Scaffold_174	18621987	18647479	25492	g_12979	g_41089
Super-Scaffold_174	18647712	18654534	6822	g_41089	g_12981
Super-Scaffold_174	18654896	18690536	35640	g_12981	g_12985
Super-Scaffold_174	18690742	18699275	8533	g_12985	g_12986
Super-Scaffold_174	18699514	18707474	7960	g_12986	g_41091
Super-Scaffold_174	18707707	18714004	6297	g_41091	g_12987
Super-Scaffold_174	18724087	18749395	25308	g_12987	g_12989
Super-Scaffold_174	18751280	18752046	766	g_12989	g_12990
Super-Scaffold_174	18756310	18805033	48723	g_12990	g_12991
Super-Scaffold_174	18805260	18836270	31010	g_12991	g_12994
Super-Scaffold_174	18836509	18885849	49340	g_12994	g_12995
Super-Scaffold_174	18886172	18936878	50706	g_12995	g_12997
Super-Scaffold_174	18937966	19156843	218877	g_12997	g_13005
Super-Scaffold_174	19158568	19201660	43092	g_13005	g_13007
Super-Scaffold_174	19221525	19237518	15993	g_13007	g_13008
Super-Scaffold_174	19238639	19251721	13082	g_13008	g_13009
Super-Scaffold_174	19256160	19258127	1967	g_13009	g_13010
Super-Scaffold_174	19274571	19277377	2806	g_13010	g_13011
Super-Scaffold_174	19282722	19290349	7627	g_13011	g_13012
Super-Scaffold_174	19291711	19306168	14457	g_13012	g_43997
Super-Scaffold_174	19314062	19315566	1504	g_43997	g_13013
Super-Scaffold_174	19317041	19319570	2529	g_13013	g_13014
Super-Scaffold_174	19320991	19340245	19254	g_13014	g_13015
Super-Scaffold_174	19343263	19346152	2889	g_13015	g_13016
Super-Scaffold_174	19357739	19361092	3353	g_13016	g_13017
Super-Scaffold_174	19375179	19377565	2386	g_13017	g_13018
Super-Scaffold_174	19382286	19395014	12728	g_13018	g_13019
Super-Scaffold_174	19396226	19403844	7618	g_13019	g_13020
Super-Scaffold_174	19404289	19418689	14400	g_13020	g_13022
Super-Scaffold_174	19424397	19426444	2047	g_13022	g_13023
Super-Scaffold_174	19444884	19459555	14671	g_13023	g_13025
Super-Scaffold_174	19463480	19466356	2876	g_13025	g_13026
Super-Scaffold_174	19476908	19479129	2221	g_13026	g_13027
Super-Scaffold_174	19479848	19480533	685	g_13027	g_43998
Super-Scaffold_174	19484343	19486004	1661	g_43998	g_13028
Super-Scaffold_174	19487354	19488758	1404	g_13028	g_13029
Super-Scaffold_174	19501374	19503543	2169	g_13029	g_13030
Super-Scaffold_174	19506795	19510838	4043	g_13030	g_13031
Super-Scaffold_174	19511899	19516625	4726	g_13031	g_13032
Super-Scaffold_174	19519776	19621109	101333	g_13032	g_13034
Super-Scaffold_174	19622254	19645270	23016	g_13034	g_13035
Super-Scaffold_174	19650664	19650771	107	g_13035	g_13036
Super-Scaffold_174	19668832	19703217	34385	g_13036	g_13037
Super-Scaffold_174	19703618	19711680	8062	g_13037	g_13038
Super-Scaffold_174	19717728	19744497	26769	g_13038	g_13039
Super-Scaffold_174	19750482	19760725	10243	g_13039	g_13040
Super-Scaffold_174	19781723	19786433	4710	g_13040	g_13041
Super-Scaffold_174	19803247	19804605	1358	g_13041	g_13042
Super-Scaffold_174	19808074	19810732	2658	g_13042	g_43999
Super-Scaffold_174	19815515	19818246	2731	g_43999	g_13043
Super-Scaffold_174	19836563	19840366	3803	g_13043	g_44000
Super-Scaffold_174	19840584	19840818	234	g_44000	g_13044
Super-Scaffold_174	19847533	19850849	3316	g_13044	g_13045
Super-Scaffold_174	19853333	19853687	354	g_13045	g_13046
Super-Scaffold_174	19856233	19857406	1173	g_13046	g_44001
Super-Scaffold_174	19862553	19863764	1211	g_44001	g_13047
Super-Scaffold_174	19865942	19867231	1289	g_13047	g_13048
Super-Scaffold_174	19868768	19914373	45605	g_13048	g_13052
Super-Scaffold_174	19914621	19934501	19880	g_13052	g_13053
Super-Scaffold_174	19939532	19961345	21813	g_13053	g_13054
Super-Scaffold_174	19969322	19973682	4360	g_13054	g_13055
Super-Scaffold_174	19974410	19977236	2826	g_13055	g_13056
Super-Scaffold_174	19998357	20002966	4609	g_13056	g_13057
Super-Scaffold_174	20003238	20042256	39018	g_13057	g_13059
Super-Scaffold_174	20051584	20058687	7103	g_13059	g_13060
Super-Scaffold_174	20058980	20059083	103	g_13060	g_13061
Super-Scaffold_174	20059850	20067721	7871	g_13061	g_13062
Super-Scaffold_174	20088436	20095035	6599	g_13062	g_13063
Super-Scaffold_174	20103852	20110764	6912	g_13063	g_13064
Super-Scaffold_174	20111395	20173920	62525	g_13064	g_13072
Super-Scaffold_174	20174201	20174946	745	g_13072	g_13073
Super-Scaffold_174	20175233	20181912	6679	g_13073	g_13074
Super-Scaffold_174	20188043	20197181	9138	g_13074	g_13075
Super-Scaffold_174	20200990	20208339	7349	g_13075	g_44002
Super-Scaffold_174	20210446	20213247	2801	g_44002	g_13076
Super-Scaffold_174	20214340	20220725	6385	g_13076	g_44003
Super-Scaffold_174	20225067	20228701	3634	g_44003	g_44004
Super-Scaffold_174	20230961	20310593	79632	g_44004	g_41118
Super-Scaffold_174	20310850	20379932	69082	g_41118	g_13081
Super-Scaffold_174	20380243	20385209	4966	g_13081	g_13082
Super-Scaffold_174	20385565	20385714	149	g_13082	g_44005
Super-Scaffold_174	20386007	20411458	25451	g_44005	g_13084
Super-Scaffold_174	20414522	20414910	388	g_13084	g_13085
Super-Scaffold_174	20416499	20511952	95453	g_13085	g_13089
Super-Scaffold_174	20512233	20596243	84010	g_13089	g_13091
Super-Scaffold_174	20596965	20598948	1983	g_13091	g_13092
Super-Scaffold_174	20601568	20602990	1422	g_13092	g_13093
Super-Scaffold_174	20604162	20641385	37223	g_13093	g_13094
Super-Scaffold_174	20652800	20663477	10677	g_13094	g_13095
Super-Scaffold_174	20674234	20675919	1685	g_13095	g_13096
Super-Scaffold_174	20678800	20684241	5441	g_13096	g_13097
Super-Scaffold_174	20684504	20710191	25687	g_13097	g_13098
Super-Scaffold_174	20712231	20713581	1350	g_13098	g_13099
Super-Scaffold_174	20714914	20715894	980	g_13099	g_13100
Super-Scaffold_174	20721001	20723963	2962	g_13100	g_13101
Super-Scaffold_174	20728768	20729028	260	g_13101	g_13102
Super-Scaffold_174	20732662	20741966	9304	g_41123	g_13103
Super-Scaffold_174	20746191	20747087	896	g_13103	g_44006
Super-Scaffold_174	20751884	20754089	2205	g_44006	g_13104
Super-Scaffold_174	20757878	20759179	1301	g_13104	g_13105
Super-Scaffold_174	20760417	20784848	24431	g_13105	g_13106
Super-Scaffold_174	20785093	20868685	83592	g_13106	g_13109
Super-Scaffold_174	20871489	20885363	13874	g_13109	g_44007
Super-Scaffold_174	20887763	20889199	1436	g_44007	g_13110
Super-Scaffold_174	20890227	20892313	2086	g_13110	g_13111
Super-Scaffold_174	20893398	20903106	9708	g_13111	g_44008
Super-Scaffold_174	20905563	20910990	5427	g_44008	g_13112
Super-Scaffold_174	20911961	20914288	2327	g_13112	g_13113
Super-Scaffold_174	20915238	20923750	8512	g_13113	g_13114
Super-Scaffold_174	20937834	20939694	1860	g_13114	g_13115
Super-Scaffold_174	20944862	20947091	2229	g_13115	g_44009
Super-Scaffold_174	20960015	20962765	2750	g_44009	g_13116
Super-Scaffold_174	20965962	20972834	6872	g_13116	g_13117
Super-Scaffold_174	20973843	20975686	1843	g_13117	g_41125
Super-Scaffold_174	20975886	20977331	1445	g_41125	g_41126
Super-Scaffold_174	20977672	20991859	14187	g_41126	g_13119
Super-Scaffold_174	20992311	21004410	12099	g_13119	g_13120
Super-Scaffold_174	21004694	21055691	50997	g_13120	g_13122
Super-Scaffold_174	21056020	21084323	28303	g_13122	g_41131
Super-Scaffold_174	21084862	21194347	109485	g_41131	g_13129
Super-Scaffold_174	21194643	21235161	40518	g_13129	g_13132
Super-Scaffold_174	21249922	21285525	35603	g_13132	g_13134
Super-Scaffold_174	21285836	21349022	63186	g_13134	g_13139
Super-Scaffold_174	21366625	21372092	5467	g_13139	g_13140
Super-Scaffold_174	21372412	21445918	73506	g_13140	g_13142
Super-Scaffold_174	21446136	21452608	6472	g_13142	g_44010
Super-Scaffold_174	21455032	21457051	2019	g_44010	g_13143
Super-Scaffold_174	21458677	21493637	34960	g_13143	g_13144
Super-Scaffold_174	21494005	21542834	48829	g_13144	g_13146
Super-Scaffold_174	21554655	21613425	58770	g_13146	g_13148
Super-Scaffold_174	21639563	21648765	9202	g_13148	g_44011
Super-Scaffold_174	21649001	21656858	7857	g_44011	g_13149
Super-Scaffold_174	21679025	21698655	19630	g_13149	g_13150
Super-Scaffold_174	21698957	21732783	33826	g_13150	g_13152
Super-Scaffold_174	21736246	21779709	43463	g_13152	g_13155
Super-Scaffold_174	21779999	21786241	6242	g_13155	g_13156
Super-Scaffold_174	21794009	21809628	15619	g_13156	g_13157
Super-Scaffold_174	21813931	21819893	5962	g_13157	g_13158
Super-Scaffold_174	21820362	21823810	3448	g_13158	g_13159
Super-Scaffold_174	21835922	21837341	1419	g_13159	g_44012
Super-Scaffold_174	21850228	21853727	3499	g_44012	g_13161
Super-Scaffold_174	21855895	21860308	4413	g_13161	g_13162
Super-Scaffold_174	21861390	21869283	7893	g_13162	g_13163
Super-Scaffold_174	21871614	21873016	1402	g_13163	g_13164
Super-Scaffold_174	21878762	21898555	19793	g_13164	g_13165
Super-Scaffold_174	21902260	21906340	4080	g_13165	g_13166
Super-Scaffold_174	21908001	21918486	10485	g_13166	g_13167
Super-Scaffold_174	21929473	21931776	2303	g_13167	g_13168
Super-Scaffold_174	21935462	21973581	38119	g_13168	g_13169
Super-Scaffold_174	21974502	21976693	2191	g_13169	g_13170
Super-Scaffold_174	21986128	21987703	1575	g_13170	g_13171
Super-Scaffold_174	21995259	21999279	4020	g_13171	g_13172
Super-Scaffold_174	22000752	22068740	67988	g_13172	g_13175
Super-Scaffold_174	22117042	22118784	1742	g_13175	g_44013
Super-Scaffold_174	22125381	22132756	7375	g_44013	g_13176
Super-Scaffold_174	22136286	22139219	2933	g_13176	g_44014
Super-Scaffold_174	22150046	22153853	3807	g_44014	g_13177
Super-Scaffold_174	22183023	22304186	121163	g_13177	g_13180
Super-Scaffold_174	22304629	22369817	65188	g_13180	g_13182
Super-Scaffold_174	22376154	22378938	2784	g_13182	g_13183
Super-Scaffold_174	22385923	22388073	2150	g_13183	g_13184
Super-Scaffold_174	22391812	22395299	3487	g_13184	g_13185
Super-Scaffold_174	22402676	22404446	1770	g_13185	g_13186
Super-Scaffold_174	22408272	22411787	3515	g_13186	g_13187
Super-Scaffold_174	22423006	22454072	31066	g_13187	g_13188
Super-Scaffold_174	22454440	22471426	16986	g_13188	g_13190
Super-Scaffold_174	22479651	22493582	13931	g_13190	g_13191
Super-Scaffold_174	22493788	22495912	2124	g_13191	g_13192
Super-Scaffold_174	22508926	22512642	3716	g_13192	g_44015
Super-Scaffold_174	22515429	22515838	409	g_44015	g_13193
Super-Scaffold_174	22518629	22519286	657	g_13193	g_13194
Super-Scaffold_174	22523113	22526922	3809	g_13194	g_13195
Super-Scaffold_174	22527583	22535579	7996	g_13195	g_13196
Super-Scaffold_174	22535842	22545997	10155	g_13196	g_13197
Super-Scaffold_174	22565635	22571256	5621	g_13197	g_13198
Super-Scaffold_174	22571615	22574680	3065	g_13198	g_13199
Super-Scaffold_174	22586478	22643483	57005	g_13199	g_13201
Super-Scaffold_174	22647038	22669413	22375	g_13201	g_13203
Super-Scaffold_174	22669938	22685580	15642	g_13203	g_13204
Super-Scaffold_174	22690156	22698832	8676	g_13204	g_13205
Super-Scaffold_174	22705025	22708968	3943	g_13205	g_13206
Super-Scaffold_174	22710647	22711430	783	g_13206	g_13207
Super-Scaffold_174	22714449	22724307	9858	g_13207	g_13208
Super-Scaffold_174	22733888	22740140	6252	g_13208	g_13210
Super-Scaffold_174	22740352	22740666	314	g_13210	g_13211
Super-Scaffold_174	22745693	22751019	5326	g_13211	g_13212
Super-Scaffold_174	22757650	22769794	12144	g_13212	g_13213
Super-Scaffold_174	22786008	22790075	4067	g_13213	g_44016
Super-Scaffold_174	22793401	22796074	2673	g_44016	g_44017
Super-Scaffold_174	22801418	22804446	3028	g_44017	g_13214
Super-Scaffold_174	22807299	22809063	1764	g_13214	g_13215
Super-Scaffold_174	22809875	22810949	1074	g_13215	g_13216
Super-Scaffold_174	22823212	22829285	6073	g_13216	g_13218
Super-Scaffold_174	22830886	22836693	5807	g_13218	g_13219
Super-Scaffold_174	22837652	22862599	24947	g_13219	g_13220
Super-Scaffold_174	22864032	22871947	7915	g_13220	g_41158
Super-Scaffold_174	22872171	22894970	22799	g_41158	g_13222
Super-Scaffold_174	22906040	22914986	8946	g_13222	g_13223
Super-Scaffold_174	22915225	22985896	70671	g_13223	g_13225
Super-Scaffold_174	22986177	23045443	59266	g_13225	g_13227
Super-Scaffold_174	23046546	23058150	11604	g_13227	g_13228
Super-Scaffold_174	23058437	23061389	2952	g_13228	g_13229
Super-Scaffold_174	23064968	23088801	23833	g_13229	g_13231
Super-Scaffold_174	23089160	23089188	28	g_13231	g_13232
Super-Scaffold_174	23089619	23093288	3669	g_13232	g_13233
Super-Scaffold_174	23154737	23157505	2768	g_13233	g_44018
Super-Scaffold_174	23185581	23193786	8205	g_44018	g_41161
Super-Scaffold_174	23208286	23211659	3373	g_13235	g_13236
Super-Scaffold_174	23225573	23323619	98046	g_13236	g_13238
Super-Scaffold_174	23349948	23375022	25074	g_13238	g_13240
Super-Scaffold_174	23375270	23470516	95246	g_13240	g_13243
Super-Scaffold_174	23471217	23559063	87846	g_13243	g_13247
Super-Scaffold_174	23562696	23570168	7472	g_13247	g_13249
Super-Scaffold_174	23570446	23597230	26784	g_13249	g_13251
Super-Scaffold_174	23600414	23604530	4116	g_13251	g_13252
Super-Scaffold_174	23620301	23631683	11382	g_13252	g_13253
Super-Scaffold_174	23638621	23685520	46899	g_13253	g_13255
Super-Scaffold_174	23692590	23694636	2046	g_13255	g_13256
Super-Scaffold_174	23701606	23739678	38072	g_13256	g_13257
Super-Scaffold_174	23753239	23754117	878	g_13257	g_13259
Super-Scaffold_174	23758976	23760959	1983	g_13259	g_13260
Super-Scaffold_174	23774473	23787496	13023	g_13261	g_13262
Super-Scaffold_174	23814124	23823202	9078	g_13262	g_13263
Super-Scaffold_174	23833370	23839046	5676	g_13263	g_13264
Super-Scaffold_174	23843141	23845443	2302	g_13264	g_13265
Super-Scaffold_174	23853633	23855545	1912	g_13265	g_13266
Super-Scaffold_174	23862470	23871789	9319	g_13266	g_13267
Super-Scaffold_174	23877289	23880985	3696	g_13267	g_13268
Super-Scaffold_174	23888202	23897404	9202	g_13268	g_13269
Super-Scaffold_174	23911217	23952444	41227	g_13269	g_13270
Super-Scaffold_174	23955991	23962455	6464	g_13270	g_41170
Super-Scaffold_174	23985265	24001183	15918	g_13271	g_13272
Super-Scaffold_174	24003223	24010213	6990	g_13272	g_13273
Super-Scaffold_174	24011124	24019203	8079	g_13273	g_13274
Super-Scaffold_174	24025395	24026936	1541	g_13274	g_13275
Super-Scaffold_174	24030204	24031329	1125	g_13275	g_13276
Super-Scaffold_174	24038594	24039770	1176	g_13276	g_44019
Super-Scaffold_174	24071541	24074723	3182	g_44019	g_13277
Super-Scaffold_174	24083259	24086440	3181	g_13277	g_13278
Super-Scaffold_174	24090711	24094589	3878	g_13278	g_13279
Super-Scaffold_174	24102280	24107142	4862	g_13279	g_13280
Super-Scaffold_174	24124982	24133156	8174	g_13280	g_13281
Super-Scaffold_174	24152076	24203964	51888	g_13281	g_13285
Super-Scaffold_174	24221250	24323091	101841	g_13285	g_13290
Super-Scaffold_174	24324521	24324543	22	g_13290	g_13291
Super-Scaffold_174	24324908	24327787	2879	g_13291	g_13292
Super-Scaffold_174	24328131	24339902	11771	g_13292	g_13294
Super-Scaffold_174	24340228	24366347	26119	g_13294	g_13295
Super-Scaffold_174	24366745	24368730	1985	g_13295	g_13296
Super-Scaffold_174	24368948	24375096	6148	g_13296	g_13297
Super-Scaffold_174	24375437	24378811	3374	g_13297	g_44020
Super-Scaffold_174	24379200	24382461	3261	g_44020	g_13298
Super-Scaffold_174	24382718	24391872	9154	g_13298	g_44021
Super-Scaffold_174	24393611	24405257	11646	g_44021	g_13299
Super-Scaffold_174	24407326	24412355	5029	g_41176	g_13300
Super-Scaffold_174	24412567	24442039	29472	g_13300	g_13303
Super-Scaffold_174	24444824	24446492	1668	g_13303	g_13304
Super-Scaffold_174	24467011	24473493	6482	g_13304	g_13305
Super-Scaffold_174	24478752	24510638	31886	g_13305	g_41178
Super-Scaffold_174	24510850	24600516	89666	g_41178	g_13306
Super-Scaffold_174	24607032	24610814	3782	g_13306	g_13307
Super-Scaffold_174	24611131	24616570	5439	g_13307	g_13308
Super-Scaffold_174	24639643	24654862	15219	g_13308	g_13309
Super-Scaffold_174	24706187	24761949	55762	g_13309	g_13312
Super-Scaffold_174	24762299	24790302	28003	g_13312	g_13313
Super-Scaffold_174	24793914	24803756	9842	g_13313	g_13315
Super-Scaffold_174	24806208	24997943	191735	g_13315	g_13318
Super-Scaffold_174	24998158	25044219	46061	g_13318	g_13320
Super-Scaffold_174	25048758	25054908	6150	g_13320	g_44022
Super-Scaffold_174	25061773	25067548	5775	g_44022	g_13321
Super-Scaffold_174	25067901	25080891	12990	g_13321	g_13322
Super-Scaffold_174	25081874	25090755	8881	g_13322	g_13323
Super-Scaffold_174	25095501	25100195	4694	g_13323	g_13324
Super-Scaffold_174	25118579	25122430	3851	g_13324	g_44023
Super-Scaffold_174	25134845	25148884	14039	g_44023	g_13325
Super-Scaffold_174	25149267	25167222	17955	g_13325	g_13327
Super-Scaffold_174	25167569	25180033	12464	g_13327	g_13328
Super-Scaffold_174	25181166	25191990	10824	g_13328	g_13329
Super-Scaffold_174	25194572	25207454	12882	g_13329	g_13330
Super-Scaffold_174	25210651	25212599	1948	g_13330	g_13331
Super-Scaffold_174	25217097	25231062	13965	g_13331	g_13332
Super-Scaffold_174	25245713	25250375	4662	g_13332	g_13333
Super-Scaffold_174	25252489	25257482	4993	g_13333	g_13335
Super-Scaffold_174	25259209	25261579	2370	g_13335	g_13336
Super-Scaffold_174	25263558	25267648	4090	g_13336	g_13337
Super-Scaffold_174	25268325	25291531	23206	g_13337	g_13338
Super-Scaffold_174	25303405	25303523	118	g_13338	g_13339
Super-Scaffold_174	25321244	25324045	2801	g_13339	g_13340
Super-Scaffold_174	25339870	25347423	7553	g_13340	g_13341
Super-Scaffold_174	25347806	25350934	3128	g_13341	g_13342
Super-Scaffold_174	25361604	25366826	5222	g_13342	g_13343
Super-Scaffold_174	25367500	25369981	2481	g_13343	g_13344
Super-Scaffold_174	25370655	25373700	3045	g_13344	g_13345
Super-Scaffold_174	25386255	25387864	1609	g_13345	g_44024
Super-Scaffold_174	25399320	25409167	9847	g_44024	g_44025
Super-Scaffold_174	25416792	25421763	4971	g_44025	g_13346
Super-Scaffold_174	25429960	25434200	4240	g_13346	g_13347
Super-Scaffold_174	25437372	25441727	4355	g_13347	g_44026
Super-Scaffold_174	25450319	25457713	7394	g_44026	g_13349
Super-Scaffold_174	25479895	25502050	22155	g_13349	g_44027
Super-Scaffold_174	25515437	25522071	6634	g_44027	g_44028
Super-Scaffold_174	25528330	25535646	7316	g_44028	g_13352
Super-Scaffold_174	25549663	25551903	2240	g_13352	g_13353
Super-Scaffold_174	25557528	25558522	994	g_13353	g_13354
Super-Scaffold_174	25565313	25567230	1917	g_13354	g_13355
Super-Scaffold_174	25587058	25598987	11929	g_13355	g_13356
Super-Scaffold_174	25599304	25636993	37689	g_13356	g_13358
Super-Scaffold_174	25644060	25661106	17046	g_13358	g_13359
Super-Scaffold_174	25662766	25670407	7641	g_13359	g_13360
Super-Scaffold_174	25671627	25683999	12372	g_13360	g_13361
Super-Scaffold_174	25693076	25698486	5410	g_13361	g_13362
Super-Scaffold_174	25706443	25714085	7642	g_13362	g_13364
Super-Scaffold_174	25714294	25785436	71142	g_13364	g_41188
Super-Scaffold_174	25785642	25801041	15399	g_41188	g_13367
Super-Scaffold_174	25831124	25858035	26911	g_13367	g_13368
Super-Scaffold_174	25858409	25907309	48900	g_13368	g_13372
Super-Scaffold_174	25909537	25949067	39530	g_13372	g_13374
Super-Scaffold_174	25949396	25990134	40738	g_13374	g_13376
Super-Scaffold_174	25990679	26011451	20772	g_13376	g_13379
Super-Scaffold_174	26016117	26045504	29387	g_13379	g_13381
Super-Scaffold_174	26045881	26065963	20082	g_13381	g_13382
Super-Scaffold_174	26090542	26115422	24880	g_13382	g_13383
Super-Scaffold_174	26120185	26133668	13483	g_13383	g_13384
Super-Scaffold_174	26156434	26158569	2135	g_13384	g_13385
Super-Scaffold_174	26158793	26162759	3966	g_13385	g_13386
Super-Scaffold_174	26165142	26169561	4419	g_13386	g_13387
Super-Scaffold_174	26182393	26190484	8091	g_13387	g_13388
Super-Scaffold_174	26202500	26209468	6968	g_13388	g_13389
Super-Scaffold_174	26226971	26228917	1946	g_13389	g_13390
Super-Scaffold_174	26277267	26301058	23791	g_13390	g_13391
Super-Scaffold_174	26327056	26334390	7334	g_13391	g_13392
Super-Scaffold_174	26344779	26429218	84439	g_13392	g_13396
Super-Scaffold_174	26441806	26447153	5347	g_13396	g_13397
Super-Scaffold_174	26453459	26477697	24238	g_13397	g_13398
Super-Scaffold_174	26489044	26493343	4299	g_13398	g_13399
Super-Scaffold_174	26493588	26516588	23000	g_13399	g_13400
Super-Scaffold_174	26551841	26631408	79567	g_13400	g_13402
Super-Scaffold_174	26633878	26642701	8823	g_13402	g_13403
Super-Scaffold_174	26652342	26700176	47834	g_13403	g_13405
Super-Scaffold_174	26703277	26707574	4297	g_13405	g_13406
Super-Scaffold_174	26715720	26784798	69078	g_13406	g_13409
Super-Scaffold_174	26808819	26829491	20672	g_13409	g_13410
Super-Scaffold_174	26830806	26950320	119514	g_13410	g_13412
Super-Scaffold_174	26960739	26975540	14801	g_13412	g_13413
Super-Scaffold_174	26978332	27022678	44346	g_13413	g_13414
Super-Scaffold_174	27027002	27035259	8257	g_13414	g_13415
Super-Scaffold_174	27040593	27043288	2695	g_13415	g_13416
Super-Scaffold_174	27052042	27054252	2210	g_13416	g_13417
Super-Scaffold_174	27061831	27065054	3223	g_13417	g_13418
Super-Scaffold_174	27088505	27155010	66505	g_13418	g_13419
Super-Scaffold_174	27156359	27158860	2501	g_13419	g_13420
Super-Scaffold_174	27160318	27165754	5436	g_13420	g_44029
Super-Scaffold_174	27171490	27173114	1624	g_44029	g_13421
Super-Scaffold_174	27207832	27209302	1470	g_13421	g_13422
Super-Scaffold_174	27220593	27225438	4845	g_13422	g_13424
Super-Scaffold_174	27234828	27239083	4255	g_13424	g_13425
Super-Scaffold_174	27256026	27266190	10164	g_13425	g_13426
Super-Scaffold_174	27277651	27286611	8960	g_13426	g_13427
Super-Scaffold_174	27288898	27295451	6553	g_13427	g_44030
Super-Scaffold_174	27297709	27306614	8905	g_44030	g_13428
Super-Scaffold_174	27308910	27314660	5750	g_13428	g_13429
Super-Scaffold_174	27314950	27327641	12691	g_13429	g_13430
Super-Scaffold_174	27329504	27331704	2200	g_13430	g_13431
Super-Scaffold_174	27332417	27332656	239	g_13431	g_13432
Super-Scaffold_174	27333177	27334985	1808	g_13432	g_13433
Super-Scaffold_174	27337243	27340682	3439	g_13433	g_13434
Super-Scaffold_174	27356178	27359505	3327	g_13434	g_13436
Super-Scaffold_174	27371621	27379165	7544	g_13436	g_13437
Super-Scaffold_174	27383882	27387505	3623	g_13437	g_44031
Super-Scaffold_174	27390091	27415816	25725	g_44031	g_13440
Super-Scaffold_174	27418123	27430388	12265	g_13440	g_13441
Super-Scaffold_174	27430920	27434634	3714	g_13441	g_13443
Super-Scaffold_174	27436940	27441465	4525	g_13443	g_41206
Super-Scaffold_174	27442049	27444794	2745	g_41206	g_13445
Super-Scaffold_174	27445222	27446809	1587	g_13445	g_13446
Super-Scaffold_174	27449062	27469021	19959	g_13446	g_13447
Super-Scaffold_174	27469553	27486577	17024	g_13447	g_13449
Super-Scaffold_174	27488835	27510877	22042	g_13449	g_13451
Super-Scaffold_174	27513132	27534711	21579	g_13451	g_13452
Super-Scaffold_174	27536969	27553116	16147	g_13452	g_13454
Super-Scaffold_174	27555418	27568458	13040	g_13454	g_41207
Super-Scaffold_174	27569042	27573367	4325	g_41207	g_13456
Super-Scaffold_174	27575602	27606292	30690	g_13456	g_13457
Super-Scaffold_174	27618472	27634279	15807	g_13457	g_13458
Super-Scaffold_174	27635776	27644493	8717	g_13458	g_13459
Super-Scaffold_174	27644978	27650690	5712	g_13459	g_13460
Super-Scaffold_174	27652493	27659294	6801	g_13460	g_13461
Super-Scaffold_174	27683248	27684262	1014	g_13461	g_13462
Super-Scaffold_174	27685166	27689281	4115	g_13462	g_44032
Super-Scaffold_174	27689950	27722537	32587	g_44032	g_13463
Super-Scaffold_174	27737994	27794926	56932	g_13463	g_13464
Super-Scaffold_174	27805286	27856070	50784	g_13464	g_13466
Super-Scaffold_174	27859291	27864523	5232	g_13466	g_13467
Super-Scaffold_174	27883415	27884625	1210	g_13467	g_13468
Super-Scaffold_174	27889912	27930225	40313	g_13468	g_13469
Super-Scaffold_174	27936749	27941691	4942	g_13469	g_13470
Super-Scaffold_174	27954257	28001668	47411	g_13470	g_13472
Super-Scaffold_174	28004394	28004959	565	g_13472	g_13474
Super-Scaffold_174	28006065	28008502	2437	g_13474	g_13475
Super-Scaffold_174	28019487	28024950	5463	g_13475	g_13476
Super-Scaffold_174	28039866	28041640	1774	g_13476	g_13477
Super-Scaffold_174	28046155	28046543	388	g_13477	g_13478
Super-Scaffold_174	28055744	28123086	67342	g_13478	g_13480
Super-Scaffold_174	28136243	28140596	4353	g_13480	g_13481
Super-Scaffold_174	28146049	28150997	4948	g_13481	g_13482
Super-Scaffold_174	28160279	28164442	4163	g_13482	g_13483
Super-Scaffold_174	28169741	28173900	4159	g_13483	g_13484
Super-Scaffold_174	28179957	28182146	2189	g_13484	g_13485
Super-Scaffold_174	28186740	28189117	2377	g_13485	g_13486
Super-Scaffold_174	28198523	28206434	7911	g_13486	g_13487
Super-Scaffold_174	28212133	28302859	90726	g_13487	g_13490
Super-Scaffold_174	28324060	28347638	23578	g_13490	g_13493
Super-Scaffold_174	28348147	28372305	24158	g_13493	g_13496
Super-Scaffold_174	28372646	28372912	266	g_13496	g_44033
Super-Scaffold_174	28379582	28415392	35810	g_41214	g_13497
Super-Scaffold_174	28422703	28442243	19540	g_13497	g_13499
Super-Scaffold_174	28444027	28452264	8237	g_13499	g_13501
Super-Scaffold_174	28452557	28520579	68022	g_13501	g_13502
Super-Scaffold_174	28532099	28537067	4968	g_13502	g_13503
Super-Scaffold_174	28555216	28561566	6350	g_13503	g_13504
Super-Scaffold_174	28566141	28568601	2460	g_13504	g_13505
Super-Scaffold_174	28574429	28633423	58994	g_13505	g_13506
Super-Scaffold_174	28651881	28654104	2223	g_13506	g_13507
Super-Scaffold_174	28664061	28668848	4787	g_13507	g_13508
Super-Scaffold_174	28669048	28674102	5054	g_13508	g_13509
Super-Scaffold_174	28677731	28678422	691	g_13509	g_13510
Super-Scaffold_174	28685133	28686288	1155	g_13510	g_13511
Super-Scaffold_174	28689968	28692708	2740	g_13511	g_13512
Super-Scaffold_174	28710236	28715838	5602	g_13512	g_13513
Super-Scaffold_174	28730299	28733905	3606	g_13513	g_13514
Super-Scaffold_174	28764916	28766480	1564	g_13514	g_44034
Super-Scaffold_174	28781804	28785359	3555	g_44034	g_13515
Super-Scaffold_174	28806507	28814100	7593	g_13515	g_13517
Super-Scaffold_174	28821025	28824937	3912	g_13517	g_13518
Super-Scaffold_174	28829450	28889764	60314	g_13518	g_13520
Super-Scaffold_174	28900336	28903005	2669	g_13520	g_13521
Super-Scaffold_174	28907614	28916526	8912	g_13521	g_13522
Super-Scaffold_174	28927624	28930380	2756	g_13522	g_13523
Super-Scaffold_174	28954917	28958408	3491	g_13523	g_13524
Super-Scaffold_174	28973068	28983063	9995	g_13524	g_13525
Super-Scaffold_174	28997184	29001671	4487	g_13525	g_13526
Super-Scaffold_174	29004109	29006580	2471	g_13526	g_13527
Super-Scaffold_174	29006846	29031077	24231	g_13527	g_13528
Super-Scaffold_174	29054888	29060805	5917	g_13528	g_13530
Super-Scaffold_174	29061062	29071313	10251	g_13530	g_44035
Super-Scaffold_174	29080427	29088528	8101	g_44035	g_13532
Super-Scaffold_174	29094439	29096149	1710	g_13532	g_44036
Super-Scaffold_174	29096521	29097351	830	g_44036	g_44037
Super-Scaffold_174	29100246	29102687	2441	g_44037	g_13533
Super-Scaffold_174	29103223	29128577	25354	g_13533	g_13536
Super-Scaffold_174	29131622	29142267	10645	g_13536	g_13537
Super-Scaffold_174	29142774	29143438	664	g_13537	g_44038
Super-Scaffold_174	29144001	29144904	903	g_44038	g_44039
Super-Scaffold_174	29145408	29147950	2542	g_44039	g_44040
Super-Scaffold_174	29148460	29154799	6339	g_44040	g_13538
Super-Scaffold_174	29155309	29157098	1789	g_13538	g_13539
Super-Scaffold_174	29157661	29158501	840	g_13539	g_44041
Super-Scaffold_174	29159072	29161297	2225	g_44041	g_44042
Super-Scaffold_174	29161807	29163604	1797	g_44042	g_13540
Super-Scaffold_174	29164108	29166727	2619	g_13540	g_44043
Super-Scaffold_174	29167237	29169032	1795	g_44043	g_13541
Super-Scaffold_174	29169595	29170425	830	g_13541	g_44044
Super-Scaffold_174	29170995	29173561	2566	g_44044	g_44045
Super-Scaffold_174	29174071	29175869	1798	g_44045	g_13542
Super-Scaffold_174	29176373	29178867	2494	g_13542	g_13543
Super-Scaffold_174	29179377	29185748	6371	g_13543	g_44046
Super-Scaffold_174	29188027	29191984	3957	g_44046	g_44047
Super-Scaffold_174	29198324	29202463	4139	g_44047	g_13544
Super-Scaffold_174	29209380	29223837	14457	g_13544	g_13546
Super-Scaffold_174	29229754	29231463	1709	g_13546	g_44048
Super-Scaffold_174	29231835	29232665	830	g_44048	g_44049
Super-Scaffold_174	29235377	29236185	808	g_44049	g_13547
Super-Scaffold_174	29236721	29237570	849	g_13547	g_13548
Super-Scaffold_174	29239432	29246765	7333	g_13548	g_13549
Super-Scaffold_174	29247269	29251235	3966	g_13549	g_44050
Super-Scaffold_174	29251841	29258167	6326	g_44050	g_13550
Super-Scaffold_174	29260448	29265187	4739	g_13550	g_44051
Super-Scaffold_174	29271534	29275727	4193	g_44051	g_13551
Super-Scaffold_174	29282422	29295813	13391	g_13551	g_13554
Super-Scaffold_174	29300283	29301992	1709	g_13554	g_44052
Super-Scaffold_174	29302364	29303194	830	g_44052	g_13555
Super-Scaffold_174	29305961	29306769	808	g_41219	g_13556
Super-Scaffold_174	29307305	29308155	850	g_13556	g_13557
Super-Scaffold_174	29310163	29313375	3212	g_13557	g_13558
Super-Scaffold_174	29313799	29316435	2636	g_13558	g_44053
Super-Scaffold_174	29316945	29323311	6366	g_44053	g_44054
Super-Scaffold_174	29325590	29340131	14541	g_44054	g_13559
Super-Scaffold_174	29373167	29382870	9703	g_13559	g_13560
Super-Scaffold_174	29383142	29387590	4448	g_13560	g_13561
Super-Scaffold_174	29406081	29408660	2579	g_13561	g_13562
Super-Scaffold_174	29415342	29418728	3386	g_13562	g_13564
Super-Scaffold_174	29439926	29446954	7028	g_13564	g_13565
Super-Scaffold_174	29454084	29458173	4089	g_13565	g_13566
Super-Scaffold_174	29474392	29481254	6862	g_13566	g_13567
Super-Scaffold_174	29481664	29623521	141857	g_13567	g_13570
Super-Scaffold_174	29633719	29633801	82	g_13570	g_44055
Super-Scaffold_174	29646640	29682361	35721	g_44055	g_13572
Super-Scaffold_174	29700608	29703088	2480	g_13572	g_13573
Super-Scaffold_174	29725052	29734743	9691	g_13573	g_13574
Super-Scaffold_174	29742764	29743529	765	g_13574	g_13575
Super-Scaffold_174	29747948	29749955	2007	g_13575	g_13576
Super-Scaffold_174	29770687	29774891	4204	g_13576	g_13577
Super-Scaffold_174	29776999	29779675	2676	g_13577	g_13578
Super-Scaffold_174	29780220	29784087	3867	g_13578	g_13579
Super-Scaffold_174	29796822	29810783	13961	g_13579	g_13580
Super-Scaffold_174	29813317	29818362	5045	g_41222	g_44056
Super-Scaffold_174	29829888	29833507	3619	g_44056	g_13581
Super-Scaffold_174	29843547	29850161	6614	g_13581	g_13582
Super-Scaffold_174	29888490	29898107	9617	g_13582	g_13583
Super-Scaffold_174	29914313	29915186	873	g_13583	g_13584
Super-Scaffold_174	29919980	29920797	817	g_13584	g_13585
Super-Scaffold_174	29922443	29927379	4936	g_13585	g_13586
Super-Scaffold_174	29931572	29968569	36997	g_13586	g_13587
Super-Scaffold_174	29970514	29973228	2714	g_13587	g_13588
Super-Scaffold_174	29979685	29985321	5636	g_13588	g_44057
Super-Scaffold_174	30010134	30020148	10014	g_44057	g_13589
Super-Scaffold_174	30021260	30073597	52337	g_13589	g_13592
Super-Scaffold_174	30100756	30104158	3402	g_13592	g_13593
Super-Scaffold_174	30131892	30135975	4083	g_13593	g_13594
Super-Scaffold_174	30149783	30151862	2079	g_13594	g_44058
Super-Scaffold_174	30160881	30161324	443	g_44058	g_13595
Super-Scaffold_174	30164838	30166255	1417	g_13595	g_13596
Super-Scaffold_174	30179840	30185880	6040	g_13596	g_13598
Super-Scaffold_174	30186860	30188588	1728	g_13598	g_13600
Super-Scaffold_174	30190105	30190151	46	g_13600	g_13601
Super-Scaffold_174	30191434	30192223	789	g_13601	g_13602
Super-Scaffold_174	30192684	30195772	3088	g_13602	g_13603
Super-Scaffold_174	30198102	30200939	2837	g_13603	g_13604
Super-Scaffold_174	30202861	30219180	16319	g_13604	g_13605
Super-Scaffold_174	30225552	30230249	4697	g_13605	g_13606
Super-Scaffold_174	30231265	30267761	36496	g_13606	g_41224
Super-Scaffold_174	30268081	30280969	12888	g_41224	g_13609
Super-Scaffold_174	30281295	30301228	19933	g_13609	g_41225
Super-Scaffold_174	30301434	30314165	12731	g_41225	g_13610
Super-Scaffold_174	30316674	30320482	3808	g_13610	g_13611
Super-Scaffold_174	30322128	30324816	2688	g_13611	g_13612
Super-Scaffold_174	30330888	30334882	3994	g_13612	g_13613
Super-Scaffold_174	30342538	30344306	1768	g_13613	g_13614
Super-Scaffold_174	30352508	30387370	34862	g_13614	g_13617
Super-Scaffold_174	30387720	30479122	91402	g_13617	g_13619
Super-Scaffold_174	30481406	30491388	9982	g_13619	g_44059
Super-Scaffold_174	30496119	30501606	5487	g_44059	g_44060
Super-Scaffold_174	30507466	30519514	12048	g_44060	g_44061
Super-Scaffold_174	30524193	30532877	8684	g_44061	g_13623
Super-Scaffold_174	30537268	30545149	7881	g_13623	g_13625
Super-Scaffold_174	30549806	30551878	2072	g_13625	g_13626
Super-Scaffold_174	30558789	30567666	8877	g_13626	g_13627
Super-Scaffold_174	30573623	30579096	5473	g_13627	g_13629
Super-Scaffold_174	30580763	30656534	75771	g_13629	g_13628
Super-Scaffold_174	30701395	30704322	2927	g_13628	g_13630
Super-Scaffold_174	30707984	30746987	39003	g_13630	g_13632
Super-Scaffold_174	30756091	30767175	11084	g_13632	g_13633
Super-Scaffold_174	30768020	30768436	416	g_13633	g_13634
Super-Scaffold_174	30789472	30789841	369	g_13634	g_13635
Super-Scaffold_174	30790497	30793495	2998	g_13635	g_13636
Super-Scaffold_174	30795165	30797739	2574	g_13636	g_13637
Super-Scaffold_174	30798116	30800843	2727	g_13637	g_13638
Super-Scaffold_174	30801328	30821673	20345	g_13638	g_13639
Super-Scaffold_174	30822158	30844834	22676	g_13639	g_13640
Super-Scaffold_174	30845319	30856929	11610	g_13640	g_13641
Super-Scaffold_174	30858599	30861175	2576	g_13641	g_44062
Super-Scaffold_174	30861540	30865514	3974	g_44062	g_13642
Super-Scaffold_174	30865996	30880978	14982	g_13642	g_13643
Super-Scaffold_174	30881379	30884002	2623	g_13643	g_13644
Super-Scaffold_174	30884484	30903540	19056	g_13644	g_13645
Super-Scaffold_174	30904019	30945348	41329	g_13645	g_13647
Super-Scaffold_174	30954381	30958764	4383	g_13647	g_13648
Super-Scaffold_174	30967150	30980862	13712	g_13648	g_41233
Super-Scaffold_174	30981062	30982351	1289	g_41233	g_13649
Super-Scaffold_174	30994158	31003561	9403	g_13649	g_13650
Super-Scaffold_174	31011494	31015585	4091	g_13650	g_13652
Super-Scaffold_174	31017174	31018227	1053	g_13652	g_44063
Super-Scaffold_174	31030098	31108654	78556	g_41234	g_13653
Super-Scaffold_174	31109955	31139668	29713	g_13653	g_13654
Super-Scaffold_174	31139979	31148437	8458	g_13654	g_13655
Super-Scaffold_174	31148904	32583447	1434543	g_13655	g_13660
Super-Scaffold_174	32584368	32594045	9677	g_13660	g_13662
Super-Scaffold_174	32596459	32607558	11099	g_13662	g_13663
Super-Scaffold_174	32612536	32616008	3472	g_13663	g_44064
Super-Scaffold_174	32624616	32626539	1923	g_44064	g_13664
Super-Scaffold_174	32629538	32651789	22251	g_41239	g_13665
Super-Scaffold_174	32675747	32684467	8720	g_13665	g_44066
Super-Scaffold_174	32704510	32709403	4893	g_44065	g_13666
Super-Scaffold_174	32715450	32718582	3132	g_13666	g_44067
Super-Scaffold_174	32727240	32741107	13867	g_44067	g_13667
Super-Scaffold_174	32777345	32781874	4529	g_13667	g_13668
Super-Scaffold_174	32783734	32803603	19869	g_13668	g_13669
Super-Scaffold_174	32814458	32815170	712	g_13669	g_44068
Super-Scaffold_174	32815523	32817115	1592	g_44068	g_13670
Super-Scaffold_174	32833518	32837543	4025	g_13670	g_13671
Super-Scaffold_174	32847752	32853341	5589	g_13671	g_13672
Super-Scaffold_174	32857463	32864712	7249	g_13672	g_13673
Super-Scaffold_174	32867544	32872906	5362	g_13673	g_13675
Super-Scaffold_174	32873349	32877316	3967	g_13675	g_13676
Super-Scaffold_174	32892639	32893455	816	g_13676	g_13678
Super-Scaffold_174	32894570	32901788	7218	g_13678	g_41240
Super-Scaffold_174	32902066	32902107	41	g_41240	g_13679
Super-Scaffold_174	32902925	32904848	1923	g_13679	g_13680
Super-Scaffold_174	32906017	32953494	47477	g_13680	g_13681
Super-Scaffold_174	32954975	32957132	2157	g_13681	g_13683
Super-Scaffold_174	32960638	32973071	12433	g_13683	g_13684
Super-Scaffold_174	32973514	32980831	7317	g_13684	g_13686
Super-Scaffold_18	7433	16175	8742	g_25631	g_25632
Super-Scaffold_18	16510	16547	37	g_25632	g_25633
Super-Scaffold_18	21629	31124	9495	g_25633	g_44998
Super-Scaffold_18	35191	46221	11030	g_44998	g_25634
Super-Scaffold_18	47908	62926	15018	g_25634	g_25636
Super-Scaffold_18	67097	85074	17977	g_36081	g_25637
Super-Scaffold_18	102666	173207	70541	g_25637	g_25640
Super-Scaffold_18	195396	197500	2104	g_25640	g_25641
Super-Scaffold_18	217867	236631	18764	g_25641	g_25642
Super-Scaffold_18	237230	237834	604	g_25642	g_25643
Super-Scaffold_18	261670	267729	6059	g_25643	g_25646
Super-Scaffold_18	268649	272627	3978	g_25646	g_25648
Super-Scaffold_18	287285	288881	1596	g_25648	g_25650
Super-Scaffold_18	302341	343688	41347	g_25650	g_25651
Super-Scaffold_18	367942	400141	32199	g_25651	g_25652
Super-Scaffold_18	402806	412014	9208	g_25652	g_44999
Super-Scaffold_18	415169	435727	20558	g_44999	g_25653
Super-Scaffold_18	436449	455281	18832	g_25653	g_45000
Super-Scaffold_18	455526	472174	16648	g_45000	g_25656
Super-Scaffold_18	473184	473564	380	g_25656	g_25657
Super-Scaffold_18	474157	474421	264	g_25657	g_25658
Super-Scaffold_18	475458	475505	47	g_25658	g_25659
Super-Scaffold_18	476113	476164	51	g_25659	g_25655
Super-Scaffold_18	501786	547742	45956	g_25655	g_25661
Super-Scaffold_18	549471	601705	52234	g_25661	g_25667
Super-Scaffold_18	602184	602357	173	g_25667	g_25668
Super-Scaffold_18	602557	602772	215	g_25668	g_25669
Super-Scaffold_18	610135	611461	1326	g_25669	g_25670
Super-Scaffold_18	619867	627242	7375	g_36086	g_25671
Super-Scaffold_18	627610	629178	1568	g_25671	g_45002
Super-Scaffold_18	641869	666323	24454	g_45001	g_25673
Super-Scaffold_18	667692	671171	3479	g_25673	g_25674
Super-Scaffold_18	672712	720747	48035	g_25674	g_25677
Super-Scaffold_18	724209	725459	1250	g_25677	g_25678
Super-Scaffold_18	729060	731077	2017	g_25678	g_25679
Super-Scaffold_18	748006	763213	15207	g_25679	g_25680
Super-Scaffold_18	765536	794028	28492	g_36088	g_25682
Super-Scaffold_18	794987	809400	14413	g_25682	g_36089
Super-Scaffold_18	809666	816730	7064	g_36089	g_25684
Super-Scaffold_18	818085	818263	178	g_25684	g_25685
Super-Scaffold_18	823271	835414	12143	g_25685	g_45003
Super-Scaffold_18	838805	842433	3628	g_45003	g_25687
Super-Scaffold_18	845427	1290785	445358	g_25687	g_25689
Super-Scaffold_18	1314380	1326875	12495	g_25689	g_25690
Super-Scaffold_18	1327399	1327674	275	g_25690	g_25691
Super-Scaffold_18	1328123	1332704	4581	g_25691	g_25693
Super-Scaffold_18	1332988	1333926	938	g_25693	g_45004
Super-Scaffold_18	1334165	1337766	3601	g_45004	g_25694
Super-Scaffold_18	1351988	1352333	345	g_25694	g_36090
Super-Scaffold_18	1352545	1353181	636	g_36090	g_36091
Super-Scaffold_18	1353393	1355908	2515	g_36091	g_36092
Super-Scaffold_18	1356120	1361780	5660	g_36092	g_25695
Super-Scaffold_18	1384877	1385860	983	g_25695	g_36093
Super-Scaffold_18	1386186	1410878	24692	g_36093	g_25698
Super-Scaffold_18	1416674	1421358	4684	g_25698	g_45005
Super-Scaffold_18	1424423	1426490	2067	g_45005	g_25700
Super-Scaffold_18	1439397	1446725	7328	g_25700	g_25701
Super-Scaffold_18	1463197	1468325	5128	g_25701	g_25703
Super-Scaffold_18	1479107	1502724	23617	g_25703	g_25704
Super-Scaffold_18	1504793	1517653	12860	g_25704	g_25705
Super-Scaffold_18	1519723	1532781	13058	g_25705	g_25706
Super-Scaffold_18	1533062	1550772	17710	g_25706	g_25707
Super-Scaffold_18	1561663	1606871	45208	g_25707	g_25709
Super-Scaffold_18	1607137	1649149	42012	g_25709	g_25711
Super-Scaffold_18	1649445	1670357	20912	g_25711	g_45006
Super-Scaffold_18	1688400	1710105	21705	g_45006	g_25712
Super-Scaffold_18	1727945	1745425	17480	g_25712	g_25713
Super-Scaffold_18	1749826	1759360	9534	g_25713	g_45007
Super-Scaffold_18	1765196	1765913	717	g_45007	g_25714
Super-Scaffold_18	1773937	1774525	588	g_25714	g_25715
Super-Scaffold_18	1777458	1786432	8974	g_25715	g_25716
Super-Scaffold_18	1790556	1795641	5085	g_25716	g_25717
Super-Scaffold_18	1801020	1809595	8575	g_25717	g_25719
Super-Scaffold_18	1819694	1823551	3857	g_25719	g_25720
Super-Scaffold_18	1830555	1867810	37255	g_25720	g_25721
Super-Scaffold_18	1881180	1886303	5123	g_25721	g_25722
Super-Scaffold_18	1891627	1895022	3395	g_25722	g_25723
Super-Scaffold_18	1909805	1918903	9098	g_25723	g_25724
Super-Scaffold_18	1936522	1940868	4346	g_25724	g_25726
Super-Scaffold_18	1946193	1959439	13246	g_25726	g_25727
Super-Scaffold_18	1960383	1962349	1966	g_25727	g_25728
Super-Scaffold_18	1963293	1969925	6632	g_25728	g_25729
Super-Scaffold_18	1970869	1976112	5243	g_25729	g_25730
Super-Scaffold_18	1977062	1986117	9055	g_25730	g_25731
Super-Scaffold_18	1987067	1989784	2717	g_25731	g_25732
Super-Scaffold_18	1990734	1993522	2788	g_25732	g_25733
Super-Scaffold_18	1994472	1997277	2805	g_25733	g_25734
Super-Scaffold_18	1998227	2001353	3126	g_25734	g_25735
Super-Scaffold_18	2002303	2004820	2517	g_25735	g_25736
Super-Scaffold_18	2005764	2014917	9153	g_25736	g_25737
Super-Scaffold_18	2015873	2017929	2056	g_25737	g_25738
Super-Scaffold_18	2020929	2023794	2865	g_25738	g_25739
Super-Scaffold_18	2024738	2026893	2155	g_25739	g_45008
Super-Scaffold_18	2027837	2061028	33191	g_45008	g_25741
Super-Scaffold_18	2063081	2063940	859	g_25741	g_25742
Super-Scaffold_18	2066086	2067376	1290	g_25742	g_25743
Super-Scaffold_18	2069140	2070448	1308	g_25743	g_25744
Super-Scaffold_18	2072607	2076609	4002	g_25744	g_45009
Super-Scaffold_18	2078205	2085686	7481	g_45009	g_25745
Super-Scaffold_18	2102065	2113581	11516	g_25745	g_36097
Super-Scaffold_18	2114204	2120609	6405	g_36097	g_25747
Super-Scaffold_18	2136922	2143069	6147	g_25747	g_25748
Super-Scaffold_18	2148029	2158647	10618	g_36098	g_25749
Super-Scaffold_18	2174513	2175618	1105	g_25749	g_25750
Super-Scaffold_18	2198871	2205858	6987	g_25750	g_25751
Super-Scaffold_18	2212206	2213283	1077	g_25751	g_25752
Super-Scaffold_18	2214581	2218541	3960	g_25752	g_25753
Super-Scaffold_18	2228648	2248937	20289	g_25753	g_25754
Super-Scaffold_18	2249248	2251194	1946	g_25754	g_25755
Super-Scaffold_18	2251577	2252698	1121	g_25755	g_25756
Super-Scaffold_18	2253075	2254510	1435	g_25756	g_25757
Super-Scaffold_18	2254821	2262526	7705	g_25757	g_25758
Super-Scaffold_18	2262897	2263769	872	g_25758	g_25759
Super-Scaffold_18	2264149	2265213	1064	g_25759	g_25760
Super-Scaffold_18	2265623	2266143	520	g_25760	g_25761
Super-Scaffold_18	2266715	2270992	4277	g_25761	g_25763
Super-Scaffold_18	2271237	2272412	1175	g_25763	g_25764
Super-Scaffold_18	2272723	2275602	2879	g_25764	g_25765
Super-Scaffold_18	2278801	2280495	1694	g_25766	g_25767
Super-Scaffold_18	2281073	2287851	6778	g_25767	g_25768
Super-Scaffold_18	2288234	2293148	4914	g_25768	g_25769
Super-Scaffold_18	2295814	2304544	8730	g_25769	g_25770
Super-Scaffold_18	2304954	2305899	945	g_25770	g_25771
Super-Scaffold_18	2306276	2310384	4108	g_25771	g_25772
Super-Scaffold_18	2310695	2316505	5810	g_25772	g_25773
Super-Scaffold_18	2317224	2318416	1192	g_25773	g_25774
Super-Scaffold_18	2328792	2339712	10920	g_25774	g_25775
Super-Scaffold_18	2375135	2395064	19929	g_25775	g_25777
Super-Scaffold_18	2395321	2415515	20194	g_25777	g_25779
Super-Scaffold_18	2415877	2440315	24438	g_25779	g_25780
Super-Scaffold_18	2440518	2449050	8532	g_25780	g_25781
Super-Scaffold_18	2451902	2460646	8744	g_25781	g_25783
Super-Scaffold_18	2461029	2465752	4723	g_25783	g_25785
Super-Scaffold_18	2466129	2467061	932	g_25785	g_25786
Super-Scaffold_18	2467471	2469315	1844	g_25786	g_25787
Super-Scaffold_18	2469962	2471731	1769	g_25787	g_25788
Super-Scaffold_18	2472114	2473236	1122	g_25788	g_25789
Super-Scaffold_18	2473613	2476738	3125	g_25789	g_25790
Super-Scaffold_18	2477049	2489673	12624	g_25790	g_25791
Super-Scaffold_18	2492817	2498603	5786	g_25791	g_25792
Super-Scaffold_18	2506570	2513547	6977	g_25792	g_25793
Super-Scaffold_18	2513804	2517662	3858	g_25793	g_25794
Super-Scaffold_18	2518039	2519488	1449	g_25794	g_25795
Super-Scaffold_18	2519799	2524048	4249	g_25795	g_25796
Super-Scaffold_18	2525531	2526177	646	g_25796	g_25797
Super-Scaffold_18	2527339	2531025	3686	g_25797	g_25798
Super-Scaffold_18	2546114	2547862	1748	g_25799	g_25800
Super-Scaffold_18	2548272	2712227	163955	g_25800	g_25802
Super-Scaffold_18	2719010	2728134	9124	g_25802	g_25803
Super-Scaffold_18	2731209	2732877	1668	g_25803	g_25804
Super-Scaffold_18	2733830	2741273	7443	g_25804	g_25805
Super-Scaffold_18	2757473	2780956	23483	g_25805	g_36101
Super-Scaffold_18	2781294	2787222	5928	g_36101	g_25807
Super-Scaffold_18	2790025	2792233	2208	g_25807	g_25808
Super-Scaffold_18	2797281	2824389	27108	g_25808	g_25809
Super-Scaffold_18	2831416	2835549	4133	g_25809	g_25810
Super-Scaffold_18	2842335	2850365	8030	g_25810	g_25811
Super-Scaffold_18	2850841	2879329	28488	g_25811	g_25814
Super-Scaffold_18	2888163	2912934	24771	g_25814	g_25815
Super-Scaffold_18	2913848	2915875	2027	g_25815	g_25816
Super-Scaffold_18	2916174	2951780	35606	g_25816	g_25818
Super-Scaffold_18	2952103	2999691	47588	g_25818	g_25820
Super-Scaffold_18	2999906	3002683	2777	g_25820	g_25821
Super-Scaffold_18	3002994	3026370	23376	g_25821	g_25822
Super-Scaffold_18	3028702	3110246	81544	g_25822	g_25825
Super-Scaffold_18	3110491	3122412	11921	g_25825	g_25827
Super-Scaffold_18	3135394	3152205	16811	g_25827	g_25828
Super-Scaffold_18	3163722	3227686	63964	g_25828	g_25830
Super-Scaffold_18	3228015	3228686	671	g_25830	g_25831
Super-Scaffold_18	3242376	3250783	8407	g_25831	g_25832
Super-Scaffold_18	3251580	3267019	15439	g_25832	g_25833
Super-Scaffold_18	3314210	3325628	11418	g_25833	g_45010
Super-Scaffold_18	3339871	3372835	32964	g_45010	g_25835
Super-Scaffold_18	3382756	3386443	3687	g_25835	g_45011
Super-Scaffold_18	3390792	3402675	11883	g_45011	g_25836
Super-Scaffold_18	3402944	3432625	29681	g_25836	g_25837
Super-Scaffold_18	3433344	3494512	61168	g_25837	g_25838
Super-Scaffold_18	3494727	3765552	270825	g_25838	g_25842
Super-Scaffold_18	3767145	3775910	8765	g_25842	g_25843
Super-Scaffold_18	3776233	3809034	32801	g_25843	g_36109
Super-Scaffold_18	3809246	3870137	60891	g_36109	g_25845
Super-Scaffold_18	3870340	3909576	39236	g_25845	g_25847
Super-Scaffold_18	3918132	3972235	54103	g_25847	g_25849
Super-Scaffold_18	3992530	4015348	22818	g_25849	g_25850
Super-Scaffold_18	4016999	4051080	34081	g_25850	g_25851
Super-Scaffold_18	4051355	4085542	34187	g_25851	g_25853
Super-Scaffold_18	4099714	4103680	3966	g_25853	g_25854
Super-Scaffold_18	4104273	4121955	17682	g_25854	g_25855
Super-Scaffold_18	4122314	4246245	123931	g_25855	g_25856
Super-Scaffold_18	4270805	4307890	37085	g_25856	g_25857
Super-Scaffold_18	4332794	4342653	9859	g_25857	g_25858
Super-Scaffold_18	4360922	4364945	4023	g_25858	g_25859
Super-Scaffold_18	4366948	4370814	3866	g_25859	g_25860
Super-Scaffold_18	4388380	4464595	76215	g_25860	g_25862
Super-Scaffold_18	4468769	4571793	103024	g_25862	g_25865
Super-Scaffold_18	4576036	4637475	61439	g_25865	g_25868
Super-Scaffold_18	4638623	4643487	4864	g_25868	g_25869
Super-Scaffold_18	4653546	4656333	2787	g_25869	g_25870
Super-Scaffold_18	4665864	4678470	12606	g_25870	g_25871
Super-Scaffold_18	4684939	4686243	1304	g_25871	g_25872
Super-Scaffold_18	4686512	4750256	63744	g_25872	g_25874
Super-Scaffold_18	4768937	4776341	7404	g_25874	g_25875
Super-Scaffold_18	4783635	4789676	6041	g_25875	g_25876
Super-Scaffold_18	4801580	4805529	3949	g_25876	g_25877
Super-Scaffold_18	4813827	4815311	1484	g_25877	g_25878
Super-Scaffold_18	4855795	4861341	5546	g_25878	g_25879
Super-Scaffold_18	4861604	4866371	4767	g_25879	g_25880
Super-Scaffold_18	4869933	4880094	10161	g_25880	g_25881
Super-Scaffold_18	4883866	4891397	7531	g_25881	g_25882
Super-Scaffold_18	4892086	4893874	1788	g_25882	g_25883
Super-Scaffold_18	4896498	4928321	31823	g_36115	g_25884
Super-Scaffold_18	4937023	4944214	7191	g_25884	g_25885
Super-Scaffold_18	4951677	4963249	11572	g_25885	g_25886
Super-Scaffold_18	4979137	5090764	111627	g_25886	g_25889
Super-Scaffold_18	5091168	5132458	41290	g_25889	g_25890
Super-Scaffold_18	5133693	5143827	10134	g_25890	g_36118
Super-Scaffold_18	5144051	5169461	25410	g_36118	g_25891
Super-Scaffold_18	5176787	5468243	291456	g_25891	g_25892
Super-Scaffold_18	5468563	5538327	69764	g_25892	g_25893
Super-Scaffold_18	5538941	5593091	54150	g_25893	g_25894
Super-Scaffold_18	5593396	5645936	52540	g_25894	g_25896
Super-Scaffold_18	5646232	5663936	17704	g_25896	g_36121
Super-Scaffold_18	5664142	5873797	209655	g_36121	g_25899
Super-Scaffold_18	5894515	5899768	5253	g_25899	g_36123
Super-Scaffold_18	5900337	5983283	82946	g_36123	g_25902
Super-Scaffold_18	5985457	5988511	3054	g_25902	g_25903
Super-Scaffold_18	5993846	6005867	12021	g_25903	g_25904
Super-Scaffold_18	6019334	6031452	12118	g_25904	g_25905
Super-Scaffold_18	6056969	6067257	10288	g_25905	g_25906
Super-Scaffold_18	6080386	6136604	56218	g_25906	g_36124
Super-Scaffold_18	6137116	6137173	57	g_36124	g_36125
Super-Scaffold_18	6137391	6148407	11016	g_36125	g_25911
Super-Scaffold_18	6165502	6168070	2568	g_25911	g_25912
Super-Scaffold_18	6176131	6182182	6051	g_25912	g_25913
Super-Scaffold_18	6199239	6221460	22221	g_25913	g_25915
Super-Scaffold_18	6221969	6222147	178	g_25915	g_25916
Super-Scaffold_18	6222482	6240884	18402	g_25916	g_25917
Super-Scaffold_18	6247666	6288881	41215	g_25917	g_45012
Super-Scaffold_18	6291214	6347785	56571	g_45012	g_25918
Super-Scaffold_18	6353930	6354088	158	g_25918	g_25919
Super-Scaffold_18	6354462	6395047	40585	g_25919	g_25920
Super-Scaffold_18	6395277	6419637	24360	g_25920	g_25921
Super-Scaffold_18	6421138	6487463	66325	g_36127	g_25923
Super-Scaffold_18	6497891	6577123	79232	g_25923	g_25924
Super-Scaffold_18	6584327	6587323	2996	g_25924	g_25925
Super-Scaffold_18	6607795	6639299	31504	g_25925	g_25927
Super-Scaffold_18	6639772	6642074	2302	g_25927	g_25928
Super-Scaffold_18	6665573	6681250	15677	g_25928	g_25929
Super-Scaffold_18	6695728	6698400	2672	g_25929	g_36128
Super-Scaffold_18	6698657	6856846	158189	g_36128	g_25930
Super-Scaffold_18	6861859	6871624	9765	g_25930	g_25931
Super-Scaffold_18	6878156	6879688	1532	g_25931	g_25932
Super-Scaffold_18	6889899	6901287	11388	g_25932	g_25933
Super-Scaffold_18	6901664	6902470	806	g_25933	g_25934
Super-Scaffold_18	6903357	6909463	6106	g_25934	g_25935
Super-Scaffold_18	6909840	6911534	1694	g_25935	g_45013
Super-Scaffold_18	6912421	6914458	2037	g_45013	g_25936
Super-Scaffold_18	6920739	6924328	3589	g_25936	g_25937
Super-Scaffold_18	6946511	6950172	3661	g_25937	g_25938
Super-Scaffold_18	6963813	6968091	4278	g_25938	g_25939
Super-Scaffold_18	6971135	6978311	7176	g_25939	g_45014
Super-Scaffold_18	6991367	6993478	2111	g_45014	g_25940
Super-Scaffold_18	6999002	7000052	1050	g_25940	g_25941
Super-Scaffold_18	7021243	7030938	9695	g_25941	g_25942
Super-Scaffold_18	7031357	7045601	14244	g_25942	g_25943
Super-Scaffold_18	7056669	7057529	860	g_25943	g_25944
Super-Scaffold_18	7058684	7100803	42119	g_25944	g_25947
Super-Scaffold_18	7107782	7109425	1643	g_25947	g_45015
Super-Scaffold_18	7122879	7125171	2292	g_45015	g_25948
Super-Scaffold_18	7140219	7143871	3652	g_25948	g_25949
Super-Scaffold_18	7167061	7178311	11250	g_36130	g_25950
Super-Scaffold_18	7182507	7217342	34835	g_25950	g_25952
Super-Scaffold_18	7222497	7227743	5246	g_25952	g_25953
Super-Scaffold_18	7228765	7232158	3393	g_25953	g_25954
Super-Scaffold_18	7242166	7243739	1573	g_25954	g_25955
Super-Scaffold_18	7244050	7247059	3009	g_25955	g_25956
Super-Scaffold_18	7247688	7250490	2802	g_25956	g_25957
Super-Scaffold_18	7250900	7253076	2176	g_25957	g_25958
Super-Scaffold_18	7253459	7255756	2297	g_25958	g_25959
Super-Scaffold_18	7256067	7263484	7417	g_25959	g_25960
Super-Scaffold_18	7263867	7264576	709	g_25960	g_25961
Super-Scaffold_18	7264986	7266127	1141	g_25961	g_25962
Super-Scaffold_18	7266756	7269699	2943	g_25962	g_25963
Super-Scaffold_18	7270010	7275671	5661	g_25963	g_36132
Super-Scaffold_18	7320527	7328397	7870	g_25964	g_25965
Super-Scaffold_18	7333158	7336757	3599	g_25965	g_25966
Super-Scaffold_18	7346658	7351997	5339	g_25966	g_25967
Super-Scaffold_18	7354693	7363336	8643	g_25967	g_25968
Super-Scaffold_18	7374668	7388595	13927	g_25968	g_25969
Super-Scaffold_18	7403474	7404652	1178	g_25969	g_25970
Super-Scaffold_18	7406366	7409652	3286	g_25970	g_25971
Super-Scaffold_18	7413871	7417421	3550	g_25971	g_25972
Super-Scaffold_18	7427194	7431166	3972	g_25972	g_25973
Super-Scaffold_18	7456470	7540745	84275	g_25973	g_25975
Super-Scaffold_18	7541234	7616302	75068	g_36138	g_25977
Super-Scaffold_18	7626302	7639941	13639	g_25977	g_25979
Super-Scaffold_18	7647502	7667034	19532	g_25978	g_25980
Super-Scaffold_18	7667306	7683969	16663	g_25980	g_25981
Super-Scaffold_18	7688817	7696063	7246	g_25981	g_25982
Super-Scaffold_18	7715599	7721615	6016	g_25982	g_25983
Super-Scaffold_18	7733304	7738507	5203	g_25983	g_25984
Super-Scaffold_18	7745814	7749047	3233	g_25984	g_25985
Super-Scaffold_18	7755212	7782850	27638	g_25985	g_25987
Super-Scaffold_18	7800127	7803558	3431	g_25987	g_25988
Super-Scaffold_18	7811376	7817609	6233	g_25988	g_25989
Super-Scaffold_18	7822611	7828344	5733	g_25989	g_25990
Super-Scaffold_18	7844403	7851582	7179	g_25990	g_25991
Super-Scaffold_18	7866535	7871439	4904	g_25991	g_25992
Super-Scaffold_18	7885719	7891985	6266	g_25992	g_45016
Super-Scaffold_18	7909922	7918487	8565	g_45016	g_25994
Super-Scaffold_18	7927252	7937766	10514	g_25994	g_25995
Super-Scaffold_18	7950296	7951593	1297	g_25995	g_25996
Super-Scaffold_18	7960184	7970424	10240	g_25996	g_25998
Super-Scaffold_18	7983888	7987293	3405	g_25998	g_25999
Super-Scaffold_18	7987583	7987703	120	g_25999	g_26000
Super-Scaffold_18	7995146	8008328	13182	g_26000	g_45017
Super-Scaffold_18	8013018	8015823	2805	g_45017	g_26001
Super-Scaffold_18	8021292	8024437	3145	g_26001	g_26002
Super-Scaffold_18	8027095	8028125	1030	g_26002	g_26003
Super-Scaffold_18	8033639	8037984	4345	g_26003	g_26004
Super-Scaffold_18	8043168	8051318	8150	g_26004	g_26005
Super-Scaffold_18	8058121	8065381	7260	g_26005	g_26006
Super-Scaffold_18	8068499	8070176	1677	g_26006	g_26007
Super-Scaffold_18	8074249	8081230	6981	g_26007	g_26008
Super-Scaffold_18	8087367	8089142	1775	g_26008	g_26010
Super-Scaffold_18	8093336	8095485	2149	g_26010	g_26011
Super-Scaffold_18	8096066	8127976	31910	g_26011	g_26012
Super-Scaffold_18	8131365	8136208	4843	g_26012	g_26013
Super-Scaffold_18	8136852	8140982	4130	g_26013	g_45018
Super-Scaffold_18	8149774	8152100	2326	g_45018	g_26014
Super-Scaffold_18	8174643	8231307	56664	g_26014	g_26017
Super-Scaffold_18	8231639	8238958	7319	g_26017	g_26018
Super-Scaffold_18	8239215	8260741	21526	g_26018	g_26019
Super-Scaffold_18	8269307	8271506	2199	g_26019	g_26020
Super-Scaffold_18	8280590	8350485	69895	g_26020	g_26021
Super-Scaffold_18	8362003	8363940	1937	g_26021	g_26022
Super-Scaffold_18	8372610	8376102	3492	g_26022	g_26023
Super-Scaffold_18	8377973	8385887	7914	g_26023	g_26024
Super-Scaffold_18	8413294	8423129	9835	g_26024	g_26025
Super-Scaffold_18	8423557	8425695	2138	g_26025	g_26026
Super-Scaffold_18	8443977	8445067	1090	g_26026	g_26027
Super-Scaffold_18	8449969	8451828	1859	g_26027	g_26028
Super-Scaffold_18	8458095	8459488	1393	g_26028	g_26029
Super-Scaffold_18	8462189	8463706	1517	g_26029	g_26030
Super-Scaffold_18	8466170	8467581	1411	g_26030	g_26031
Super-Scaffold_18	8467865	8470283	2418	g_26031	g_26032
Super-Scaffold_18	8483182	8488464	5282	g_26032	g_45019
Super-Scaffold_18	8502568	8523088	20520	g_45019	g_26034
Super-Scaffold_18	8541028	8562842	21814	g_26034	g_26035
Super-Scaffold_18	8573687	8581942	8255	g_26035	g_26037
Super-Scaffold_18	8602603	8608531	5928	g_26037	g_26038
Super-Scaffold_18	8628128	8641725	13597	g_26038	g_36142
Super-Scaffold_18	8641964	8742492	100528	g_36142	g_26040
Super-Scaffold_18	8753316	8759647	6331	g_26040	g_26041
Super-Scaffold_18	8767318	8769623	2305	g_26041	g_26042
Super-Scaffold_18	8778354	8782747	4393	g_26042	g_26043
Super-Scaffold_18	8788568	8806445	17877	g_26043	g_26044
Super-Scaffold_18	8806759	8816658	9899	g_26044	g_45020
Super-Scaffold_18	8828984	8833284	4300	g_45020	g_36144
Super-Scaffold_18	8833514	8851000	17486	g_36144	g_26045
Super-Scaffold_18	8851458	8856569	5111	g_26045	g_36146
Super-Scaffold_18	8858840	8865233	6393	g_26046	g_26047
Super-Scaffold_18	8880424	8940005	59581	g_26047	g_26051
Super-Scaffold_18	8940349	8956308	15959	g_26051	g_26053
Super-Scaffold_18	8982800	8986414	3614	g_26053	g_26054
Super-Scaffold_18	8992399	8996395	3996	g_26054	g_26055
Super-Scaffold_18	9009126	9017891	8765	g_26055	g_26056
Super-Scaffold_18	9018386	9020041	1655	g_26056	g_45021
Super-Scaffold_18	9023840	9026275	2435	g_45021	g_26057
Super-Scaffold_18	9030074	9032126	2052	g_26057	g_26058
Super-Scaffold_18	9057579	9060566	2987	g_26058	g_26059
Super-Scaffold_18	9062614	9063916	1302	g_26059	g_26060
Super-Scaffold_18	9069855	9071850	1995	g_26060	g_45022
Super-Scaffold_18	9075941	9076595	654	g_45022	g_26061
Super-Scaffold_18	9082105	9090008	7903	g_26061	g_26062
Super-Scaffold_18	9098597	9101082	2485	g_26062	g_26063
Super-Scaffold_18	9110023	9113060	3037	g_26063	g_26064
Super-Scaffold_18	9115396	9152711	37315	g_26064	g_26065
Super-Scaffold_18	9177020	9180046	3026	g_26065	g_26066
Super-Scaffold_18	9191364	9195156	3792	g_26066	g_26067
Super-Scaffold_18	9227054	9234918	7864	g_26067	g_26068
Super-Scaffold_18	9242870	9244906	2036	g_26068	g_45023
Super-Scaffold_18	9249034	9255212	6178	g_45023	g_26069
Super-Scaffold_18	9259076	9263573	4497	g_26069	g_26070
Super-Scaffold_18	9284309	9287864	3555	g_26070	g_26071
Super-Scaffold_18	9290660	9292924	2264	g_26071	g_26072
Super-Scaffold_18	9303587	9374183	70596	g_26072	g_26074
Super-Scaffold_18	9374431	9450525	76094	g_26074	g_26075
Super-Scaffold_18	9450944	9453979	3035	g_26075	g_45024
Super-Scaffold_18	9455531	9459352	3821	g_45024	g_26076
Super-Scaffold_18	9465490	9467000	1510	g_26076	g_45025
Super-Scaffold_18	9472164	9473905	1741	g_45025	g_26077
Super-Scaffold_18	9478418	9480231	1813	g_26077	g_26078
Super-Scaffold_18	9482423	9483281	858	g_26078	g_26079
Super-Scaffold_18	9489564	9492943	3379	g_26079	g_45026
Super-Scaffold_18	9498725	9499615	890	g_45026	g_26080
Super-Scaffold_18	9510307	9512783	2476	g_26080	g_45027
Super-Scaffold_18	9518173	9521886	3713	g_45027	g_26081
Super-Scaffold_18	9533046	9543123	10077	g_26081	g_45028
Super-Scaffold_18	9550127	9564389	14262	g_45028	g_26082
Super-Scaffold_18	9571342	9579179	7837	g_26082	g_26083
Super-Scaffold_18	9588883	9806399	217516	g_26083	g_36153
Super-Scaffold_18	9806602	10001199	194597	g_36153	g_26085
Super-Scaffold_18	10017809	10020477	2668	g_26085	g_26086
Super-Scaffold_18	10027223	10029633	2410	g_26086	g_26087
Super-Scaffold_18	10047146	10050157	3011	g_26087	g_26088
Super-Scaffold_18	10058379	10087298	28919	g_26088	g_26090
Super-Scaffold_18	10092090	10101133	9043	g_26090	g_26091
Super-Scaffold_18	10103882	10104822	940	g_26091	g_26092
Super-Scaffold_18	10107225	10108049	824	g_26092	g_45029
Super-Scaffold_18	10110111	10117994	7883	g_45029	g_26093
Super-Scaffold_18	10120024	10147543	27519	g_26093	g_26094
Super-Scaffold_18	10149375	10156079	6704	g_26094	g_26095
Super-Scaffold_18	10162738	10166838	4100	g_26095	g_26096
Super-Scaffold_18	10176416	10180372	3956	g_26096	g_26097
Super-Scaffold_18	10182447	10187407	4960	g_26097	g_45030
Super-Scaffold_18	10190019	10192000	1981	g_45030	g_26098
Super-Scaffold_18	10198887	10200970	2083	g_26098	g_26099
Super-Scaffold_18	10206868	10213536	6668	g_26099	g_45031
Super-Scaffold_18	10216669	10219338	2669	g_45031	g_26100
Super-Scaffold_18	10219619	10222501	2882	g_26100	g_26101
Super-Scaffold_18	10226711	10228241	1530	g_26101	g_26102
Super-Scaffold_18	10230976	10234206	3230	g_26102	g_26103
Super-Scaffold_18	10234578	10236719	2141	g_26103	g_26104
Super-Scaffold_18	10248133	10249991	1858	g_26104	g_26105
Super-Scaffold_18	10255830	10257087	1257	g_26105	g_45032
Super-Scaffold_18	10259182	10260570	1388	g_45032	g_26106
Super-Scaffold_18	10267655	10274708	7053	g_26106	g_26107
Super-Scaffold_18	10281724	10286521	4797	g_26107	g_26108
Super-Scaffold_18	10291326	10293966	2640	g_26108	g_26109
Super-Scaffold_18	10303501	10304523	1022	g_26109	g_26110
Super-Scaffold_18	10321452	10323488	2036	g_26110	g_26111
Super-Scaffold_18	10325274	10326947	1673	g_26111	g_26112
Super-Scaffold_18	10327684	10328689	1005	g_26112	g_26113
Super-Scaffold_18	10332880	10336424	3544	g_26113	g_26114
Super-Scaffold_18	10337140	10353098	15958	g_26114	g_26115
Super-Scaffold_18	10359972	10364469	4497	g_26115	g_26116
Super-Scaffold_18	10373789	10374825	1036	g_26116	g_26117
Super-Scaffold_18	10379718	10381890	2172	g_26117	g_26118
Super-Scaffold_18	10392398	10396077	3679	g_26118	g_45033
Super-Scaffold_18	10402152	10403298	1146	g_45033	g_26119
Super-Scaffold_18	10409883	10411872	1989	g_26119	g_45034
Super-Scaffold_18	10414778	10416095	1317	g_45034	g_26120
Super-Scaffold_18	10418242	10420278	2036	g_26120	g_26121
Super-Scaffold_18	10424556	10426061	1505	g_26121	g_26122
Super-Scaffold_18	10426805	10428346	1541	g_26122	g_26123
Super-Scaffold_18	10429271	10431349	2078	g_26123	g_26124
Super-Scaffold_18	10454625	10537971	83346	g_26124	g_26125
Super-Scaffold_18	10539549	10541213	1664	g_26125	g_26126
Super-Scaffold_18	10552650	10555193	2543	g_26126	g_26127
Super-Scaffold_18	10562467	10564836	2369	g_26127	g_26128
Super-Scaffold_18	10570468	10573147	2679	g_26128	g_26129
Super-Scaffold_18	10581545	10586525	4980	g_26129	g_26130
Super-Scaffold_18	10603280	10637398	34118	g_26130	g_26131
Super-Scaffold_18	10637640	10638245	605	g_26131	g_36158
Super-Scaffold_18	10638499	10653736	15237	g_36158	g_26132
Super-Scaffold_18	10671753	10691540	19787	g_26132	g_45035
Super-Scaffold_18	10693448	10698630	5182	g_45035	g_26133
Super-Scaffold_18	10699367	10749001	49634	g_26133	g_26136
Super-Scaffold_18	10759287	10760495	1208	g_26136	g_26137
Super-Scaffold_18	10769054	10774376	5322	g_26137	g_26138
Super-Scaffold_18	10774672	10777430	2758	g_26138	g_36159
Super-Scaffold_18	10777678	10781404	3726	g_36159	g_26139
Super-Scaffold_18	10802751	10811822	9071	g_26139	g_26140
Super-Scaffold_18	10818505	10823591	5086	g_26140	g_45036
Super-Scaffold_18	10823827	10823908	81	g_45036	g_26141
Super-Scaffold_18	10830776	10841606	10830	g_26141	g_26143
Super-Scaffold_18	10841830	10845744	3914	g_26143	g_26144
Super-Scaffold_18	10863758	10873765	10007	g_26144	g_26145
Super-Scaffold_18	10883827	10887846	4019	g_26145	g_26146
Super-Scaffold_18	10900332	10923425	23093	g_26146	g_26147
Super-Scaffold_18	10923649	10931812	8163	g_26147	g_26148
Super-Scaffold_18	10932102	10933506	1404	g_26148	g_26149
Super-Scaffold_18	10938693	10947517	8824	g_26149	g_45037
Super-Scaffold_18	10951289	10952880	1591	g_45037	g_26150
Super-Scaffold_18	10958616	10966486	7870	g_26150	g_26151
Super-Scaffold_18	10971594	10972572	978	g_26151	g_26152
Super-Scaffold_18	10973914	10979545	5631	g_26152	g_26153
Super-Scaffold_18	10994939	10999689	4750	g_26153	g_26154
Super-Scaffold_18	10999982	11011608	11626	g_26154	g_26155
Super-Scaffold_18	11029755	11061527	31772	g_26155	g_26156
Super-Scaffold_18	11076487	11155639	79152	g_26156	g_26158
Super-Scaffold_18	11159161	11172721	13560	g_26158	g_26159
Super-Scaffold_18	11174701	11180022	5321	g_26159	g_26160
Super-Scaffold_18	11180465	11188746	8281	g_26160	g_26161
Super-Scaffold_18	11194660	11196956	2296	g_26161	g_26162
Super-Scaffold_18	11200752	11243748	42996	g_26162	g_26163
Super-Scaffold_18	11248298	11251618	3320	g_26163	g_26164
Super-Scaffold_18	11257765	11262403	4638	g_26164	g_26165
Super-Scaffold_18	11269868	11281424	11556	g_26165	g_26166
Super-Scaffold_18	11285525	11289650	4125	g_26166	g_26167
Super-Scaffold_18	11296876	11303031	6155	g_26167	g_45038
Super-Scaffold_18	11312717	11319972	7255	g_45038	g_26168
Super-Scaffold_18	11320809	11339008	18199	g_26168	g_26169
Super-Scaffold_18	11339220	11354102	14882	g_26169	g_26170
Super-Scaffold_18	11357777	11360015	2238	g_26170	g_26171
Super-Scaffold_18	11364739	11368551	3812	g_26171	g_26172
Super-Scaffold_18	11372467	11377983	5516	g_26172	g_26173
Super-Scaffold_18	11380075	11383010	2935	g_26173	g_26174
Super-Scaffold_18	11387077	11389063	1986	g_26174	g_26175
Super-Scaffold_18	11389534	11390566	1032	g_26175	g_26176
Super-Scaffold_18	11391616	11393144	1528	g_26176	g_26177
Super-Scaffold_18	11396424	11399210	2786	g_26177	g_26178
Super-Scaffold_18	11404623	11406662	2039	g_26178	g_26179
Super-Scaffold_18	11417056	11428449	11393	g_26179	g_26180
Super-Scaffold_18	11434691	11437831	3140	g_26180	g_45039
Super-Scaffold_18	11439627	11440954	1327	g_45039	g_26181
Super-Scaffold_18	11446029	11448402	2373	g_26181	g_26182
Super-Scaffold_18	11452951	11454672	1721	g_26182	g_26183
Super-Scaffold_18	11459920	11463612	3692	g_26183	g_26184
Super-Scaffold_18	11466772	11468960	2188	g_26184	g_26185
Super-Scaffold_18	11472820	11477665	4845	g_26186	g_26187
Super-Scaffold_18	11491630	11496535	4905	g_26187	g_26188
Super-Scaffold_18	11501515	11504238	2723	g_26188	g_26189
Super-Scaffold_18	11511953	11514993	3040	g_26189	g_45040
Super-Scaffold_18	11530990	11532947	1957	g_45040	g_26190
Super-Scaffold_18	11539203	11602653	63450	g_26190	g_26192
Super-Scaffold_18	11612876	11698296	85420	g_26192	g_26195
Super-Scaffold_18	11720843	11740807	19964	g_26195	g_26196
Super-Scaffold_18	11741205	11766083	24878	g_26196	g_26198
Super-Scaffold_18	11775558	11780924	5366	g_26198	g_36163
Super-Scaffold_18	11786527	11804239	17712	g_26199	g_26200
Super-Scaffold_18	11814935	11819949	5014	g_26200	g_26201
Super-Scaffold_18	11824890	11941685	116795	g_26201	g_26203
Super-Scaffold_18	11961320	11966091	4771	g_26203	g_26204
Super-Scaffold_18	11983746	12000784	17038	g_26204	g_26205
Super-Scaffold_18	12002694	12040086	37392	g_26205	g_26206
Super-Scaffold_18	12056838	12057722	884	g_26206	g_26207
Super-Scaffold_18	12060888	12061781	893	g_26207	g_26208
Super-Scaffold_18	12065707	12071577	5870	g_26208	g_26210
Super-Scaffold_18	12075543	12077572	2029	g_26210	g_26212
Super-Scaffold_18	12078983	12083566	4583	g_26212	g_26213
Super-Scaffold_18	12093092	12131990	38898	g_26213	g_26215
Super-Scaffold_18	12136147	12137197	1050	g_26215	g_26216
Super-Scaffold_18	12142362	12143604	1242	g_26216	g_45041
Super-Scaffold_18	12145594	12156823	11229	g_45041	g_26217
Super-Scaffold_18	12158412	12158734	322	g_26217	g_26218
Super-Scaffold_18	12159849	12169851	10002	g_26218	g_26220
Super-Scaffold_18	12170192	12173397	3205	g_26220	g_26221
Super-Scaffold_18	12236755	12257241	20486	g_26221	g_26223
Super-Scaffold_18	12257657	12258884	1227	g_26223	g_26224
Super-Scaffold_18	12259216	12273355	14139	g_26224	g_26225
Super-Scaffold_18	12289210	12304496	15286	g_26225	g_26228
Super-Scaffold_18	12316424	12320942	4518	g_26228	g_26229
Super-Scaffold_18	12323640	12324672	1032	g_26229	g_26230
Super-Scaffold_18	12333512	12338729	5217	g_26230	g_26231
Super-Scaffold_18	12362510	12372536	10026	g_26231	g_26232
Super-Scaffold_18	12374070	12427177	53107	g_26232	g_26234
Super-Scaffold_18	12427458	12438027	10569	g_26234	g_26235
Super-Scaffold_18	12453169	12461005	7836	g_26235	g_26236
Super-Scaffold_18	12480000	12514215	34215	g_26236	g_26237
Super-Scaffold_18	12537358	12540766	3408	g_26237	g_26238
Super-Scaffold_18	12542105	12543155	1050	g_26238	g_26239
Super-Scaffold_18	12546415	12549240	2825	g_26239	g_26240
Super-Scaffold_18	12560872	12567783	6911	g_26240	g_26241
Super-Scaffold_18	12568915	12611301	42386	g_26241	g_26242
Super-Scaffold_18	12617376	12682515	65139	g_26242	g_26243
Super-Scaffold_18	12682766	12694069	11303	g_26243	g_26244
Super-Scaffold_18	12694887	12695069	182	g_26244	g_26245
Super-Scaffold_18	12695551	12723649	28098	g_26245	g_26246
Super-Scaffold_18	12724719	12738149	13430	g_26246	g_26247
Super-Scaffold_18	12743198	12743669	471	g_26247	g_26248
Super-Scaffold_18	12777761	12813977	36216	g_26248	g_26250
Super-Scaffold_18	12814339	12884798	70459	g_26250	g_26252
Super-Scaffold_18	12885412	12933339	47927	g_26252	g_26253
Super-Scaffold_18	12934593	12950998	16405	g_26253	g_26254
Super-Scaffold_18	12961892	12972600	10708	g_26254	g_26255
Super-Scaffold_18	12982372	12986017	3645	g_26255	g_26256
Super-Scaffold_18	12990857	12992959	2102	g_26256	g_26257
Super-Scaffold_18	12999006	13004144	5138	g_26257	g_26258
Super-Scaffold_18	13011067	13015938	4871	g_26258	g_26260
Super-Scaffold_18	13017094	13019207	2113	g_26260	g_26261
Super-Scaffold_18	13030005	13036050	6045	g_26261	g_45042
Super-Scaffold_18	13045466	13057480	12014	g_45042	g_26262
Super-Scaffold_18	13060945	13062346	1401	g_26262	g_26263
Super-Scaffold_18	13068398	13081281	12883	g_26263	g_26264
Super-Scaffold_18	13083965	13089362	5397	g_26264	g_26266
Super-Scaffold_18	13092799	13093969	1170	g_26266	g_26267
Super-Scaffold_18	13094211	13096130	1919	g_26267	g_26268
Super-Scaffold_18	13101408	13103887	2479	g_26268	g_26269
Super-Scaffold_18	13119074	13121577	2503	g_26269	g_26270
Super-Scaffold_18	13124324	13129815	5491	g_26270	g_26271
Super-Scaffold_18	13149372	13175128	25756	g_26271	g_26273
Super-Scaffold_18	13175454	13178197	2743	g_26273	g_26274
Super-Scaffold_18	13183145	13183968	823	g_26274	g_26275
Super-Scaffold_18	13185017	13185285	268	g_26275	g_26276
Super-Scaffold_18	13189633	13191877	2244	g_26276	g_26277
Super-Scaffold_18	13193559	13194535	976	g_26277	g_26278
Super-Scaffold_18	13195707	13197700	1993	g_26278	g_26279
Super-Scaffold_18	13198662	13200647	1985	g_26279	g_26280
Super-Scaffold_18	13201279	13205611	4332	g_26280	g_26282
Super-Scaffold_18	13206168	13207306	1138	g_26282	g_26283
Super-Scaffold_18	13207938	13208925	987	g_26283	g_26284
Super-Scaffold_18	13209557	13210517	960	g_26284	g_26285
Super-Scaffold_18	13211014	13212085	1071	g_26285	g_26286
Super-Scaffold_18	13212717	13213677	960	g_26286	g_26287
Super-Scaffold_18	13214324	13215247	923	g_26287	g_26288
Super-Scaffold_18	13215870	13226032	10162	g_26288	g_26289
Super-Scaffold_18	13226667	13228615	1948	g_26289	g_26290
Super-Scaffold_18	13229253	13230817	1564	g_26290	g_26291
Super-Scaffold_18	13231461	13237826	6365	g_26291	g_26292
Super-Scaffold_18	13238497	13242209	3712	g_26292	g_26293
Super-Scaffold_18	13242859	13249624	6765	g_26293	g_26294
Super-Scaffold_18	13253948	13256219	2271	g_26294	g_26295
Super-Scaffold_18	13260697	13263276	2579	g_26295	g_26296
Super-Scaffold_18	13267293	13268666	1373	g_26296	g_45043
Super-Scaffold_18	13275588	13278416	2828	g_45043	g_45044
Super-Scaffold_18	13283013	13283805	792	g_45044	g_45045
Super-Scaffold_18	13284783	13323550	38767	g_45045	g_36175
Super-Scaffold_18	13323840	13335662	11822	g_36175	g_26302
Super-Scaffold_18	13345102	13346848	1746	g_26302	g_26303
Super-Scaffold_18	13352189	13355915	3726	g_26303	g_26304
Super-Scaffold_18	13369031	13376636	7605	g_26304	g_26305
Super-Scaffold_18	13383195	13392194	8999	g_26305	g_26306
Super-Scaffold_18	13403859	13409568	5709	g_26306	g_26307
Super-Scaffold_18	13411738	13413036	1298	g_26307	g_26309
Super-Scaffold_18	13417107	13418481	1374	g_26309	g_26310
Super-Scaffold_18	13423587	13424264	677	g_26310	g_26311
Super-Scaffold_18	13427481	13429171	1690	g_26311	g_26312
Super-Scaffold_18	13439703	13442782	3079	g_26312	g_26313
Super-Scaffold_18	13444394	13460953	16559	g_26313	g_26315
Super-Scaffold_18	13468462	13470275	1813	g_26315	g_26316
Super-Scaffold_18	13471376	13477971	6595	g_26316	g_26317
Super-Scaffold_18	13488041	13490499	2458	g_26317	g_26318
Super-Scaffold_18	13498110	13501431	3321	g_26318	g_26319
Super-Scaffold_18	13505189	13507057	1868	g_26319	g_26320
Super-Scaffold_18	13509688	13516246	6558	g_26320	g_26321
Super-Scaffold_18	13522828	13531313	8485	g_26321	g_26322
Super-Scaffold_18	13536373	13538554	2181	g_26322	g_26323
Super-Scaffold_18	13542459	13547636	5177	g_26323	g_26324
Super-Scaffold_18	13548899	13554902	6003	g_26324	g_26326
Super-Scaffold_18	13559438	13560788	1350	g_26326	g_26327
Super-Scaffold_18	13561722	13564856	3134	g_26327	g_26328
Super-Scaffold_18	13566241	13567029	788	g_26328	g_26329
Super-Scaffold_18	13568287	13573875	5588	g_26329	g_26330
Super-Scaffold_18	13585049	13591157	6108	g_26330	g_26331
Super-Scaffold_18	13605217	13606512	1295	g_26331	g_45046
Super-Scaffold_18	13613315	13628117	14802	g_45046	g_26332
Super-Scaffold_18	13638123	13648154	10031	g_26332	g_26333
Super-Scaffold_18	13651921	13653601	1680	g_26333	g_26334
Super-Scaffold_18	13658386	13662451	4065	g_26334	g_26335
Super-Scaffold_18	13663812	13665064	1252	g_26335	g_26336
Super-Scaffold_18	13668388	13669341	953	g_26336	g_26337
Super-Scaffold_18	13670968	13696610	25642	g_26337	g_26338
Super-Scaffold_18	13708727	13736805	28078	g_26338	g_26340
Super-Scaffold_18	13761330	13792221	30891	g_26340	g_26341
Super-Scaffold_18	13810650	13810887	237	g_26341	g_45047
Super-Scaffold_18	13811573	13817172	5599	g_45047	g_26342
Super-Scaffold_18	13827195	13832950	5755	g_26342	g_26343
Super-Scaffold_18	13836503	13838359	1856	g_26343	g_26344
Super-Scaffold_18	13843296	13847725	4429	g_26344	g_26345
Super-Scaffold_18	13856951	13877354	20403	g_26345	g_26346
Super-Scaffold_18	13884872	13950555	65683	g_26346	g_26349
Super-Scaffold_18	13968848	13972181	3333	g_26349	g_26350
Super-Scaffold_18	13981434	13981783	349	g_26350	g_26351
Super-Scaffold_18	13982049	14006932	24883	g_26351	g_26353
Super-Scaffold_18	14013471	14018099	4628	g_26353	g_26354
Super-Scaffold_18	14036187	14043940	7753	g_26354	g_26355
Super-Scaffold_18	14047137	14050009	2872	g_26355	g_45048
Super-Scaffold_18	14052112	14053809	1697	g_45048	g_45049
Super-Scaffold_18	14054794	14057968	3174	g_45049	g_26356
Super-Scaffold_18	14086132	14090248	4116	g_26356	g_26357
Super-Scaffold_18	14093751	14101141	7390	g_26357	g_26359
Super-Scaffold_18	14104715	14106358	1643	g_26359	g_26360
Super-Scaffold_18	14121890	14122978	1088	g_26360	g_26361
Super-Scaffold_18	14125727	14129036	3309	g_26361	g_26362
Super-Scaffold_18	14132196	14139831	7635	g_26362	g_26363
Super-Scaffold_18	14159323	14164128	4805	g_36181	g_26364
Super-Scaffold_18	14167742	14170391	2649	g_26364	g_26365
Super-Scaffold_18	14172925	14178334	5409	g_26365	g_26366
Super-Scaffold_18	14184387	14199522	15135	g_26366	g_26367
Super-Scaffold_18	14202691	14204539	1848	g_26367	g_26368
Super-Scaffold_18	14208307	14211243	2936	g_26368	g_26369
Super-Scaffold_18	14221917	14224347	2430	g_26369	g_26370
Super-Scaffold_18	14233848	14249929	16081	g_26370	g_26371
Super-Scaffold_18	14269258	14271184	1926	g_26371	g_26372
Super-Scaffold_18	14278291	14289877	11586	g_26372	g_26373
Super-Scaffold_18	14290155	14339179	49024	g_26373	g_26375
Super-Scaffold_18	14363460	14397018	33558	g_26375	g_26379
Super-Scaffold_18	14399404	14444835	45431	g_26379	g_26380
Super-Scaffold_18	14445194	14445532	338	g_26380	g_26381
Super-Scaffold_18	14446077	14467290	21213	g_26381	g_26382
Super-Scaffold_18	14468668	14589149	120481	g_26382	g_26384
Super-Scaffold_18	14589913	14599580	9667	g_26384	g_26386
Super-Scaffold_18	14600971	14624205	23234	g_26386	g_26387
Super-Scaffold_18	14645863	14657819	11956	g_26387	g_26389
Super-Scaffold_18	14659252	14665307	6055	g_26389	g_45050
Super-Scaffold_18	14678342	14679145	803	g_45050	g_26391
Super-Scaffold_18	14698909	14701419	2510	g_26391	g_26392
Super-Scaffold_18	14704072	14719375	15303	g_26392	g_26393
Super-Scaffold_18	14720910	14745645	24735	g_26393	g_26394
Super-Scaffold_18	14757378	14866578	109200	g_26394	g_26396
Super-Scaffold_18	14866814	14907174	40360	g_26396	g_26397
Super-Scaffold_18	14908019	14922178	14159	g_26397	g_26398
Super-Scaffold_18	14925366	14953673	28307	g_26398	g_26399
Super-Scaffold_18	14954914	14990063	35149	g_26399	g_26400
Super-Scaffold_18	15014278	15014333	55	g_26400	g_45051
Super-Scaffold_18	15014572	15117320	102748	g_45051	g_26402
Super-Scaffold_18	15118889	15161249	42360	g_26402	g_26403
Super-Scaffold_18	15162388	15217898	55510	g_26403	g_26404
Super-Scaffold_18	15224815	15225734	919	g_26404	g_45052
Super-Scaffold_18	15230785	15234665	3880	g_45052	g_26405
Super-Scaffold_18	15238242	15238372	130	g_26406	g_26407
Super-Scaffold_18	15239292	15239663	371	g_26407	g_26408
Super-Scaffold_18	15241252	15247023	5771	g_26408	g_26409
Super-Scaffold_18	15261083	15278456	17373	g_26409	g_26411
Super-Scaffold_18	15295863	15321350	25487	g_26411	g_26413
Super-Scaffold_18	15330255	15337472	7217	g_26413	g_26414
Super-Scaffold_18	15338905	15349276	10371	g_26414	g_26415
Super-Scaffold_18	15369067	15374132	5065	g_26415	g_26416
Super-Scaffold_18	15380084	15485187	105103	g_26416	g_26417
Super-Scaffold_18	15485387	15698437	213050	g_26417	g_26419
Super-Scaffold_18	15720710	15776312	55602	g_26419	g_26420
Super-Scaffold_18	15792075	16013757	221682	g_26420	g_26423
Super-Scaffold_18	16020072	16034814	14742	g_26423	g_26424
Super-Scaffold_18	16058751	16062764	4013	g_26424	g_26425
Super-Scaffold_18	16101894	16104592	2698	g_26425	g_26426
Super-Scaffold_18	16106717	16115160	8443	g_26426	g_26428
Super-Scaffold_18	16134490	16154346	19856	g_26428	g_45053
Super-Scaffold_18	16174253	16228788	54535	g_45053	g_26430
Super-Scaffold_18	16249374	16262347	12973	g_26430	g_26431
Super-Scaffold_18	16272984	16316428	43444	g_26431	g_26432
Super-Scaffold_18	16328662	16335829	7167	g_26432	g_26433
Super-Scaffold_18	16341226	16342649	1423	g_26433	g_26434
Super-Scaffold_18	16351317	16368980	17663	g_26434	g_26435
Super-Scaffold_18	16369447	16383452	14005	g_26435	g_45054
Super-Scaffold_18	16414981	16416095	1114	g_45054	g_26436
Super-Scaffold_18	16416361	16420062	3701	g_26436	g_26437
Super-Scaffold_18	16435768	16447200	11432	g_26437	g_26438
Super-Scaffold_18	16458662	16564345	105683	g_26438	g_26439
Super-Scaffold_18	16564626	16572061	7435	g_26439	g_45055
Super-Scaffold_18	16577863	16589395	11532	g_45055	g_26440
Super-Scaffold_18	16601214	16603445	2231	g_26440	g_26441
Super-Scaffold_18	16608242	16608951	709	g_26441	g_26442
Super-Scaffold_18	16610624	16615145	4521	g_26442	g_26443
Super-Scaffold_18	16616818	16621513	4695	g_26443	g_26444
Super-Scaffold_18	16624048	16624940	892	g_26444	g_45056
Super-Scaffold_18	16638135	16640934	2799	g_45056	g_26445
Super-Scaffold_18	16643640	16648328	4688	g_26445	g_26446
Super-Scaffold_18	16670227	16675963	5736	g_26446	g_26447
Super-Scaffold_18	16679499	16684941	5442	g_26447	g_26448
Super-Scaffold_18	16686614	16692272	5658	g_26448	g_26449
Super-Scaffold_18	16694623	16695290	667	g_26449	g_36196
Super-Scaffold_18	16695934	16726617	30683	g_36196	g_26452
Super-Scaffold_18	16740213	16891034	150821	g_26452	g_26456
Super-Scaffold_18	16892137	16894571	2434	g_26456	g_26457
Super-Scaffold_18	16900627	16920860	20233	g_26457	g_26458
Super-Scaffold_18	16929711	16932067	2356	g_26458	g_45057
Super-Scaffold_18	16934481	17032617	98136	g_45057	g_26462
Super-Scaffold_18	17038215	17040140	1925	g_26462	g_26463
Super-Scaffold_18	17045575	17066583	21008	g_26463	g_26464
Super-Scaffold_18	17067509	17340986	273477	g_26464	g_26467
Super-Scaffold_18	17352242	17506406	154164	g_26467	g_26468
Super-Scaffold_18	17506699	17524016	17317	g_26468	g_26469
Super-Scaffold_18	17524942	17531478	6536	g_26469	g_26470
Super-Scaffold_18	17537726	17538781	1055	g_26470	g_26471
Super-Scaffold_18	17581793	17599359	17566	g_26471	g_26472
Super-Scaffold_18	17599580	17613095	13515	g_26472	g_26474
Super-Scaffold_18	17613778	17621412	7634	g_26474	g_45058
Super-Scaffold_18	17643367	17712248	68881	g_45058	g_26477
Super-Scaffold_18	17715276	17718469	3193	g_26477	g_26478
Super-Scaffold_18	17736200	17746720	10520	g_26478	g_36205
Super-Scaffold_18	17746920	17757409	10489	g_36205	g_26480
Super-Scaffold_18	17760095	17782919	22824	g_26480	g_26481
Super-Scaffold_18	17785459	17787318	1859	g_26481	g_26482
Super-Scaffold_18	17787878	17788050	172	g_26482	g_26483
Super-Scaffold_18	17789144	17807990	18846	g_26483	g_26487
Super-Scaffold_18	17810381	17821814	11433	g_26487	g_45059
Super-Scaffold_18	17827475	17828740	1265	g_45059	g_45060
Super-Scaffold_18	17837538	17847189	9651	g_45060	g_26488
Super-Scaffold_18	17847566	17869548	21982	g_26488	g_26490
Super-Scaffold_18	17875289	17879165	3876	g_26490	g_26491
Super-Scaffold_18	17886938	17894840	7902	g_26491	g_26492
Super-Scaffold_18	17903068	17919492	16424	g_26492	g_26493
Super-Scaffold_18	17925987	17927355	1368	g_26493	g_45061
Super-Scaffold_18	17934684	17937013	2329	g_45061	g_26494
Super-Scaffold_18	17939101	18022901	83800	g_26494	g_26496
Super-Scaffold_18	18023332	18044348	21016	g_26496	g_26497
Super-Scaffold_18	18047423	18085248	37825	g_26497	g_26499
Super-Scaffold_18	18086802	18092371	5569	g_26499	g_26500
Super-Scaffold_18	18099632	18166638	67006	g_26500	g_26501
Super-Scaffold_18	18168170	18210590	42420	g_26501	g_26502
Super-Scaffold_18	18211390	18244571	33181	g_26502	g_26503
Super-Scaffold_18	18244891	18313696	68805	g_26503	g_26506
Super-Scaffold_18	18313986	18465704	151718	g_26506	g_26507
Super-Scaffold_18	18497115	18510050	12935	g_26507	g_45062
Super-Scaffold_18	18522515	18596495	73980	g_45062	g_26508
Super-Scaffold_18	18598267	18600833	2566	g_26508	g_26509
Super-Scaffold_18	18605554	18608793	3239	g_26509	g_26510
Super-Scaffold_18	18611190	18612508	1318	g_26510	g_26511
Super-Scaffold_18	18629505	18629900	395	g_26511	g_26512
Super-Scaffold_18	18634145	18785376	151231	g_26512	g_26513
Super-Scaffold_18	18787181	18908647	121466	g_26513	g_26514
Super-Scaffold_18	18909321	18909493	172	g_26514	g_26515
Super-Scaffold_18	18910251	19014313	104062	g_26515	g_36209
Super-Scaffold_18	19014534	19130768	116234	g_36209	g_36211
Super-Scaffold_18	19131826	19162874	31048	g_36211	g_26518
Super-Scaffold_18	19163191	19171512	8321	g_26518	g_26519
Super-Scaffold_18	19180509	19383050	202541	g_26519	g_26522
Super-Scaffold_18	19413229	19428035	14806	g_26522	g_26523
Super-Scaffold_18	19454207	19515036	60829	g_26523	g_26525
Super-Scaffold_18	19527688	19534830	7142	g_26525	g_26526
Super-Scaffold_18	19541303	19580418	39115	g_26526	g_26528
Super-Scaffold_18	19600075	19620442	20367	g_26528	g_26529
Super-Scaffold_18	19620675	19622049	1374	g_26529	g_26530
Super-Scaffold_18	19630682	19646965	16283	g_26530	g_26531
Super-Scaffold_18	19666777	19696898	30121	g_26531	g_26532
Super-Scaffold_18	19697209	19745233	48024	g_26532	g_26533
Super-Scaffold_18	19745475	19758858	13383	g_26533	g_26534
Super-Scaffold_18	19782663	19808473	25810	g_26534	g_26535
Super-Scaffold_18	19820576	19848383	27807	g_26535	g_26538
Super-Scaffold_18	19858494	19878738	20244	g_26538	g_26540
Super-Scaffold_18	19878956	19879633	677	g_26540	g_26541
Super-Scaffold_18	19880718	19893738	13020	g_26541	g_26543
Super-Scaffold_18	19900158	19901889	1731	g_26543	g_26544
Super-Scaffold_18	19907744	19911929	4185	g_26544	g_26545
Super-Scaffold_18	19926947	19960001	33054	g_26545	g_26546
Super-Scaffold_18	19979103	19984108	5005	g_26546	g_26547
Super-Scaffold_18	19986324	19990240	3916	g_26547	g_26548
Super-Scaffold_18	19992828	19995440	2612	g_26548	g_26549
Super-Scaffold_18	19999088	20002143	3055	g_26549	g_26550
Super-Scaffold_18	20007122	20011548	4426	g_26550	g_45063
Super-Scaffold_18	20021155	20029361	8206	g_45063	g_26551
Super-Scaffold_18	20050817	20052601	1784	g_26551	g_26552
Super-Scaffold_18	20056221	20058680	2459	g_26552	g_26553
Super-Scaffold_18	20060392	20063606	3214	g_26553	g_26554
Super-Scaffold_18	20065094	20067300	2206	g_26554	g_26555
Super-Scaffold_18	20071389	20073941	2552	g_26555	g_26556
Super-Scaffold_18	20078234	20093872	15638	g_26556	g_26557
Super-Scaffold_18	20107799	20118837	11038	g_26557	g_26558
Super-Scaffold_18	20124154	20131633	7479	g_26558	g_26559
Super-Scaffold_18	20133529	20136580	3051	g_26559	g_26560
Super-Scaffold_18	20138627	20138814	187	g_26560	g_26561
Super-Scaffold_18	20141628	20144250	2622	g_26561	g_45064
Super-Scaffold_18	20152200	20178502	26302	g_45064	g_36219
Super-Scaffold_18	20178747	20188859	10112	g_36219	g_26564
Super-Scaffold_18	20190486	20200260	9774	g_26564	g_26565
Super-Scaffold_18	20204035	20215501	11466	g_26565	g_26566
Super-Scaffold_18	20216152	20222767	6615	g_26566	g_26567
Super-Scaffold_18	20228007	20232936	4929	g_26567	g_26568
Super-Scaffold_18	20233151	20233897	746	g_26568	g_26569
Super-Scaffold_18	20239366	20269225	29859	g_26569	g_26571
Super-Scaffold_18	20269506	20278638	9132	g_26571	g_26570
Super-Scaffold_18	20305194	20311774	6580	g_26570	g_26572
Super-Scaffold_18	20318508	20326562	8054	g_26572	g_26573
Super-Scaffold_18	20340673	20341358	685	g_26573	g_26574
Super-Scaffold_18	20342410	20350278	7868	g_26574	g_26575
Super-Scaffold_18	20351516	20355484	3968	g_26575	g_45065
Super-Scaffold_18	20369618	20372204	2586	g_45065	g_45066
Super-Scaffold_18	20391556	20397554	5998	g_45066	g_26576
Super-Scaffold_18	20405426	20406852	1426	g_26576	g_26577
Super-Scaffold_18	20407085	20412412	5327	g_26577	g_36220
Super-Scaffold_18	20413680	20419549	5869	g_36220	g_26578
Super-Scaffold_18	20432403	20473817	41414	g_26578	g_26580
Super-Scaffold_18	20474430	20474494	64	g_26580	g_26581
Super-Scaffold_18	20474718	20488067	13349	g_26581	g_26582
Super-Scaffold_18	20496219	20504792	8573	g_26582	g_26583
Super-Scaffold_18	20516252	20522821	6569	g_26583	g_26584
Super-Scaffold_18	20525241	20526290	1049	g_26584	g_26585
Super-Scaffold_18	20529284	20529989	705	g_26585	g_26586
Super-Scaffold_18	20532207	20544286	12079	g_36221	g_26588
Super-Scaffold_18	20545625	20547257	1632	g_26588	g_26589
Super-Scaffold_18	20552674	20555774	3100	g_26589	g_26590
Super-Scaffold_18	20559464	20562113	2649	g_26590	g_26591
Super-Scaffold_18	20579976	20581847	1871	g_26591	g_26592
Super-Scaffold_18	20584238	20587050	2812	g_26592	g_26593
Super-Scaffold_18	20596794	20599487	2693	g_26593	g_26594
Super-Scaffold_18	20607326	20607537	211	g_26594	g_26595
Super-Scaffold_18	20608517	20611838	3321	g_26595	g_26596
Super-Scaffold_18	20612932	20614001	1069	g_26596	g_26597
Super-Scaffold_18	20617529	20620446	2917	g_26597	g_26598
Super-Scaffold_18	20626725	20628315	1590	g_26598	g_26599
Super-Scaffold_18	20634213	20635252	1039	g_26599	g_26600
Super-Scaffold_18	20644009	20645502	1493	g_26600	g_26601
Super-Scaffold_18	20646599	20647792	1193	g_26601	g_26602
Super-Scaffold_18	20651695	20656554	4859	g_26602	g_26603
Super-Scaffold_18	20685093	20701028	15935	g_26603	g_26604
Super-Scaffold_18	20701708	20709086	7378	g_26604	g_26606
Super-Scaffold_18	20710516	20734184	23668	g_26606	g_26607
Super-Scaffold_18	20736349	20756914	20565	g_26607	g_26609
Super-Scaffold_18	20771705	20788010	16305	g_26609	g_26611
Super-Scaffold_18	20801025	20806083	5058	g_26611	g_36224
Super-Scaffold_18	20806373	20826444	20071	g_36224	g_26616
Super-Scaffold_18	20826773	20863844	37071	g_26616	g_26617
Super-Scaffold_18	20864343	20891990	27647	g_36227	g_26620
Super-Scaffold_18	20892355	20935947	43592	g_26620	g_26622
Super-Scaffold_18	20936351	21039411	103060	g_26622	g_26627
Super-Scaffold_18	21039818	21053404	13586	g_26627	g_26628
Super-Scaffold_18	21053712	21196964	143252	g_26628	g_26629
Super-Scaffold_18	21212500	21329389	116889	g_26629	g_26631
Super-Scaffold_18	21332335	21338304	5969	g_26631	g_26632
Super-Scaffold_18	21343116	21346747	3631	g_26632	g_26633
Super-Scaffold_18	21354065	21363578	9513	g_26633	g_26634
Super-Scaffold_18	21363796	21383756	19960	g_26634	g_26636
Super-Scaffold_18	21406208	21422693	16485	g_26636	g_45067
Super-Scaffold_18	21432681	21442594	9913	g_45067	g_26637
Super-Scaffold_18	21443109	21446306	3197	g_26637	g_26638
Super-Scaffold_18	21478839	21496778	17939	g_26638	g_26639
Super-Scaffold_18	21502961	21504673	1712	g_26639	g_45068
Super-Scaffold_18	21506228	21510435	4207	g_45068	g_26640
Super-Scaffold_18	21515717	21521742	6025	g_26640	g_26641
Super-Scaffold_18	21526608	21531108	4500	g_26641	g_26642
Super-Scaffold_18	21535371	21628869	93498	g_26642	g_26644
Super-Scaffold_18	21635516	21640765	5249	g_26644	g_26645
Super-Scaffold_18	21644578	21647458	2880	g_26645	g_45069
Super-Scaffold_18	21660701	21662232	1531	g_45069	g_26646
Super-Scaffold_18	21664553	21664851	298	g_26646	g_26647
Super-Scaffold_18	21701841	21728029	26188	g_26647	g_26649
Super-Scaffold_18	21728298	21742567	14269	g_26649	g_26650
Super-Scaffold_18	21743130	21815759	72629	g_26650	g_26651
Super-Scaffold_18	21817593	21881415	63822	g_36243	g_26653
Super-Scaffold_18	21897028	21901927	4899	g_26653	g_26654
Super-Scaffold_18	21907847	21911797	3950	g_26654	g_26655
Super-Scaffold_18	21919354	21922686	3332	g_26655	g_26656
Super-Scaffold_18	21926884	21928745	1861	g_26656	g_26657
Super-Scaffold_18	21950855	22031948	81093	g_26657	g_26661
Super-Scaffold_18	22036060	22060852	24792	g_26661	g_26662
Super-Scaffold_18	22070906	22073854	2948	g_26662	g_26663
Super-Scaffold_18	22082925	22173999	91074	g_26663	g_26666
Super-Scaffold_18	22175381	22178172	2791	g_26666	g_26667
Super-Scaffold_18	22182682	22208105	25423	g_26667	g_26668
Super-Scaffold_18	22208332	22220082	11750	g_26668	g_26670
Super-Scaffold_18	22220366	22266510	46144	g_26670	g_26672
Super-Scaffold_18	22270689	22280078	9389	g_26672	g_26674
Super-Scaffold_18	22288015	22301535	13520	g_26674	g_26675
Super-Scaffold_18	22301906	22306740	4834	g_26675	g_26676
Super-Scaffold_18	22332756	22332969	213	g_26676	g_26677
Super-Scaffold_18	22333238	22342649	9411	g_26677	g_26678
Super-Scaffold_18	22350442	22366162	15720	g_26678	g_36245
Super-Scaffold_18	22366365	22388515	22150	g_36245	g_26680
Super-Scaffold_18	22402543	22415918	13375	g_26680	g_26681
Super-Scaffold_18	22423337	22426052	2715	g_26681	g_26682
Super-Scaffold_18	22428371	22429889	1518	g_26682	g_26683
Super-Scaffold_18	22442718	22443842	1124	g_26683	g_26684
Super-Scaffold_18	22445317	22447310	1993	g_26684	g_26685
Super-Scaffold_18	22455253	22457036	1783	g_26685	g_45070
Super-Scaffold_18	22474009	22476070	2061	g_45070	g_26686
Super-Scaffold_18	22484168	22508553	24385	g_26686	g_26688
Super-Scaffold_18	22509038	22509051	13	g_26688	g_26689
Super-Scaffold_18	22509302	22510081	779	g_26689	g_26690
Super-Scaffold_18	22525348	22534460	9112	g_26690	g_26691
Super-Scaffold_18	22539761	22575280	35519	g_26691	g_26695
Super-Scaffold_18	22584479	22591554	7075	g_26695	g_45071
Super-Scaffold_18	22595537	22597286	1749	g_45071	g_26697
Super-Scaffold_18	22597618	22599087	1469	g_26697	g_26698
Super-Scaffold_18	22607402	22614815	7413	g_26698	g_26699
Super-Scaffold_18	22615504	22619258	3754	g_26699	g_26700
Super-Scaffold_18	22620859	22624240	3381	g_26700	g_26701
Super-Scaffold_18	22625754	22626113	359	g_26701	g_26702
Super-Scaffold_18	22638923	22701240	62317	g_26702	g_26704
Super-Scaffold_18	22713248	22716157	2909	g_26704	g_26705
Super-Scaffold_18	22716858	22726550	9692	g_26705	g_26706
Super-Scaffold_18	22726876	22753109	26233	g_26706	g_26707
Super-Scaffold_18	22775609	22791736	16127	g_26707	g_26708
Super-Scaffold_18	22791951	22792044	93	g_26708	g_26709
Super-Scaffold_18	22792292	22792365	73	g_26709	g_26710
Super-Scaffold_18	22792598	22813025	20427	g_26710	g_26712
Super-Scaffold_18	22816895	22820437	3542	g_26712	g_26713
Super-Scaffold_18	22835171	22958746	123575	g_26713	g_26715
Super-Scaffold_18	22966246	22980418	14172	g_26715	g_26716
Super-Scaffold_18	22983836	22985977	2141	g_26716	g_26717
Super-Scaffold_18	23001332	23056842	55510	g_26717	g_36253
Super-Scaffold_18	23057084	23078230	21146	g_36253	g_26721
Super-Scaffold_18	23078577	23109724	31147	g_26721	g_26723
Super-Scaffold_18	23113967	23122555	8588	g_26723	g_26724
Super-Scaffold_18	23131231	23133721	2490	g_26724	g_26725
Super-Scaffold_18	23144455	23147486	3031	g_26725	g_26726
Super-Scaffold_18	23152490	23221841	69351	g_26726	g_26729
Super-Scaffold_18	23223898	23244102	20204	g_26729	g_26730
Super-Scaffold_18	23247500	23256245	8745	g_26730	g_26732
Super-Scaffold_18	23257255	23257319	64	g_26732	g_26733
Super-Scaffold_18	23258011	23259271	1260	g_26733	g_45072
Super-Scaffold_18	23261151	23263259	2108	g_45072	g_26734
Super-Scaffold_18	23266406	23277430	11024	g_26734	g_26735
Super-Scaffold_18	23286025	23290821	4796	g_26735	g_26736
Super-Scaffold_18	23297090	23299594	2504	g_26736	g_45073
Super-Scaffold_18	23308334	23317041	8707	g_45073	g_26737
Super-Scaffold_18	23326047	23348130	22083	g_26737	g_26738
Super-Scaffold_18	23364603	23389721	25118	g_26738	g_26739
Super-Scaffold_18	23393546	23409025	15479	g_26739	g_26740
Super-Scaffold_18	23410331	23413729	3398	g_26740	g_26741
Super-Scaffold_18	23414834	23416833	1999	g_26741	g_26742
Super-Scaffold_18	23419816	23423850	4034	g_26742	g_26743
Super-Scaffold_18	23429752	23460217	30465	g_26743	g_26744
Super-Scaffold_18	23473027	23491013	17986	g_26744	g_45074
Super-Scaffold_18	23502675	23530116	27441	g_45074	g_26745
Super-Scaffold_18	23542641	23546871	4230	g_26745	g_26746
Super-Scaffold_18	23552790	23555250	2460	g_26746	g_36257
Super-Scaffold_18	23555492	23574679	19187	g_36257	g_26747
Super-Scaffold_18	23586718	23838081	251363	g_26747	g_26750
Super-Scaffold_18	23846475	23868412	21937	g_26750	g_26751
Super-Scaffold_18	23877612	23880911	3299	g_26751	g_45075
Super-Scaffold_18	23890157	23912181	22024	g_45075	g_26752
Super-Scaffold_18	23919790	23920662	872	g_26752	g_26753
Super-Scaffold_18	23920898	23922672	1774	g_26753	g_26754
Super-Scaffold_18	23923244	23923610	366	g_26754	g_45076
Super-Scaffold_18	23925249	23936816	11567	g_45076	g_26756
Super-Scaffold_18	23954718	23961740	7022	g_26756	g_26757
Super-Scaffold_18	23962099	23967490	5391	g_26757	g_26758
Super-Scaffold_18	23974304	23976286	1982	g_26758	g_26759
Super-Scaffold_18	23977801	23985370	7569	g_26759	g_45077
Super-Scaffold_18	24001522	24016374	14852	g_45077	g_26761
Super-Scaffold_18	24018297	24025296	6999	g_26761	g_26762
Super-Scaffold_18	24036412	24140513	104101	g_26762	g_26766
Super-Scaffold_18	24140929	24184182	43253	g_26766	g_26767
Super-Scaffold_18	24185343	24212298	26955	g_26767	g_26768
Super-Scaffold_18	24215364	24218546	3182	g_26768	g_26769
Super-Scaffold_18	24222999	24225728	2729	g_26769	g_26770
Super-Scaffold_18	24234925	24251696	16771	g_26770	g_26771
Super-Scaffold_18	24251992	24265429	13437	g_26771	g_26772
Super-Scaffold_18	24266754	24305173	38419	g_26772	g_26773
Super-Scaffold_18	24311931	24321708	9777	g_26773	g_26774
Super-Scaffold_18	24346491	24359733	13242	g_26775	g_26776
Super-Scaffold_18	24365918	24376745	10827	g_26776	g_26777
Super-Scaffold_18	24381483	24521568	140085	g_26777	g_26778
Super-Scaffold_18	24521930	24561752	39822	g_26778	g_26779
Super-Scaffold_18	24565697	24581028	15331	g_26779	g_26780
Super-Scaffold_18	24581387	24772810	191423	g_26780	g_26784
Super-Scaffold_18	24773262	24801551	28289	g_26784	g_26786
Super-Scaffold_18	24802586	24877953	75367	g_26786	g_36261
Super-Scaffold_18	24878222	24973294	95072	g_36261	g_26790
Super-Scaffold_18	25015859	25107606	91747	g_26790	g_26791
Super-Scaffold_18	25118112	25149607	31495	g_26791	g_26792
Super-Scaffold_18	25155020	25222552	67532	g_26792	g_26793
Super-Scaffold_18	25226577	25233655	7078	g_26793	g_26794
Super-Scaffold_18	25233897	25333592	99695	g_26794	g_26795
Super-Scaffold_18	25336557	25386818	50261	g_26795	g_36262
Super-Scaffold_18	25387159	25448724	61565	g_36262	g_36264
Super-Scaffold_18	25448954	25459927	10973	g_36264	g_26796
Super-Scaffold_18	25461516	25465118	3602	g_26796	g_26798
Super-Scaffold_18	25548598	25560464	11866	g_26798	g_45078
Super-Scaffold_18	25561408	25566628	5220	g_45078	g_26799
Super-Scaffold_18	25567752	25577209	9457	g_26799	g_26800
Super-Scaffold_18	25577460	25577572	112	g_26800	g_26801
Super-Scaffold_18	25588138	25600249	12111	g_26801	g_26802
Super-Scaffold_18	25600545	25613331	12786	g_26802	g_45079
Super-Scaffold_18	25632226	25647391	15165	g_45079	g_26803
Super-Scaffold_18	25648197	25716613	68416	g_26803	g_26805
Super-Scaffold_18	25716933	25824643	107710	g_26805	g_26806
Super-Scaffold_18	25826052	25826380	328	g_26806	g_26807
Super-Scaffold_18	25827747	25827819	72	g_26807	g_26808
Super-Scaffold_18	25829381	25933322	103941	g_26808	g_26812
Super-Scaffold_18	25933630	25983675	50045	g_26812	g_26815
Super-Scaffold_18	25989906	25996248	6342	g_26815	g_26816
Super-Scaffold_18	26009334	26011260	1926	g_26816	g_45080
Super-Scaffold_18	26027610	26037603	9993	g_45080	g_26817
Super-Scaffold_18	26052396	26058113	5717	g_26817	g_26818
Super-Scaffold_18	26061184	26067498	6314	g_26818	g_26819
Super-Scaffold_18	26070686	26086845	16159	g_26819	g_26820
Super-Scaffold_18	26101058	26147715	46657	g_26820	g_26821
Super-Scaffold_18	26148740	26159341	10601	g_26821	g_45081
Super-Scaffold_18	26174691	26184858	10167	g_45081	g_26822
Super-Scaffold_18	26195278	26202480	7202	g_26822	g_26823
Super-Scaffold_18	26213785	26223562	9777	g_26823	g_26824
Super-Scaffold_18	26225586	26237853	12267	g_36269	g_26825
Super-Scaffold_18	26238902	26259331	20429	g_26825	g_26826
Super-Scaffold_18	26277868	26288496	10628	g_26826	g_26827
Super-Scaffold_18	26299005	26340787	41782	g_36270	g_26828
Super-Scaffold_18	26361965	26420206	58241	g_26828	g_26829
Super-Scaffold_18	26421060	26561666	140606	g_26829	g_26833
Super-Scaffold_18	26566296	26573614	7318	g_26833	g_26834
Super-Scaffold_18	26578847	26604209	25362	g_26834	g_26835
Super-Scaffold_18	26620734	26624888	4154	g_26835	g_45082
Super-Scaffold_18	26625313	26627556	2243	g_45082	g_26836
Super-Scaffold_18	26644762	26651471	6709	g_26836	g_26837
Super-Scaffold_18	26666535	26677182	10647	g_26837	g_26838
Super-Scaffold_18	26678167	26686015	7848	g_26838	g_26839
Super-Scaffold_18	26688189	26705470	17281	g_26839	g_26840
Super-Scaffold_18	26715157	26717290	2133	g_26840	g_26841
Super-Scaffold_18	26733729	26747466	13737	g_26841	g_26842
Super-Scaffold_18	26750245	26757077	6832	g_26842	g_26843
Super-Scaffold_18	26758974	26777876	18902	g_26843	g_26844
Super-Scaffold_18	26782119	26790054	7935	g_26844	g_26845
Super-Scaffold_18	26801963	26807174	5211	g_26845	g_26846
Super-Scaffold_18	26817171	26831979	14808	g_26846	g_26847
Super-Scaffold_18	26832551	26843153	10602	g_26847	g_26848
Super-Scaffold_18	26858267	26862385	4118	g_26848	g_26849
Super-Scaffold_18	26864884	26880715	15831	g_26849	g_26850
Super-Scaffold_18	26887279	26905422	18143	g_26850	g_26851
Super-Scaffold_18	26921433	26925321	3888	g_26851	g_26852
Super-Scaffold_18	26934631	26936589	1958	g_26852	g_26853
Super-Scaffold_18	26938361	26941188	2827	g_26853	g_26854
Super-Scaffold_18	26950304	26955988	5684	g_26854	g_26855
Super-Scaffold_18	26980274	26989006	8732	g_26855	g_26856
Super-Scaffold_18	26996569	26999082	2513	g_26856	g_26857
Super-Scaffold_18	27012429	27013451	1022	g_26857	g_26858
Super-Scaffold_18	27031424	27038746	7322	g_26858	g_26859
Super-Scaffold_18	27055847	27068947	13100	g_26859	g_26860
Super-Scaffold_18	27072526	27075812	3286	g_26860	g_26861
Super-Scaffold_18	27091168	27106936	15768	g_26861	g_26863
Super-Scaffold_18	27123763	27149382	25619	g_26863	g_26864
Super-Scaffold_18	27150251	27151532	1281	g_26864	g_26865
Super-Scaffold_18	27151774	27176097	24323	g_26865	g_26866
Super-Scaffold_18	27176546	27194957	18411	g_26866	g_45083
Super-Scaffold_18	27213264	27225385	12121	g_45083	g_26868
Super-Scaffold_18	27225729	27243312	17583	g_26868	g_26869
Super-Scaffold_18	27243728	27244272	544	g_26869	g_26870
Super-Scaffold_18	27244523	27263544	19021	g_26870	g_26871
Super-Scaffold_18	27264011	27282857	18846	g_26871	g_36280
Super-Scaffold_18	27283120	27326882	43762	g_36280	g_26872
Super-Scaffold_18	27327109	27340226	13117	g_26872	g_26873
Super-Scaffold_18	27341152	27413382	72230	g_26873	g_26875
Super-Scaffold_18	27414518	27416954	2436	g_26875	g_36281
Super-Scaffold_18	27417244	27421125	3881	g_36281	g_26876
Super-Scaffold_18	27424748	27509697	84949	g_26876	g_26881
Super-Scaffold_18	27520713	27522061	1348	g_26881	g_26882
Super-Scaffold_18	27546854	27560441	13587	g_26882	g_26883
Super-Scaffold_18	27563241	27566407	3166	g_26883	g_26884
Super-Scaffold_18	27569582	27604823	35241	g_26884	g_26885
Super-Scaffold_18	27613373	27639310	25937	g_26885	g_26886
Super-Scaffold_18	27649121	27650536	1415	g_26886	g_26887
Super-Scaffold_18	27653341	27672914	19573	g_26887	g_26888
Super-Scaffold_18	27676869	27701852	24983	g_26888	g_26889
Super-Scaffold_18	27705491	27708686	3195	g_26889	g_26890
Super-Scaffold_18	27716269	27720259	3990	g_26890	g_26891
Super-Scaffold_18	27733734	27736199	2465	g_26891	g_45084
Super-Scaffold_18	27741967	27757494	15527	g_45084	g_45085
Super-Scaffold_18	27759838	27813031	53193	g_45085	g_26892
Super-Scaffold_18	27814337	27852816	38479	g_26892	g_26893
Super-Scaffold_18	27853094	27940811	87717	g_26893	g_26896
Super-Scaffold_18	27957919	27960926	3007	g_26896	g_26897
Super-Scaffold_18	27961306	27962090	784	g_26897	g_26898
Super-Scaffold_18	27963686	27963870	184	g_26898	g_26899
Super-Scaffold_18	27964764	28022441	57677	g_26899	g_26900
Super-Scaffold_18	28031883	28045181	13298	g_26900	g_26902
Super-Scaffold_18	28058669	28107109	48440	g_26902	g_26903
Super-Scaffold_18	28112042	28142663	30621	g_26903	g_26904
Super-Scaffold_18	28145007	28147479	2472	g_26904	g_26905
Super-Scaffold_18	28163107	28207312	44205	g_26905	g_26907
Super-Scaffold_18	28209584	28275085	65501	g_26907	g_26908
Super-Scaffold_18	28276649	28376609	99960	g_26908	g_26909
Super-Scaffold_18	28380439	28393308	12869	g_26909	g_26910
Super-Scaffold_18	28393736	28445661	51925	g_26910	g_26912
Super-Scaffold_18	28450069	28484284	34215	g_26912	g_26913
Super-Scaffold_18	28485865	28526742	40877	g_26913	g_26914
Super-Scaffold_18	28528261	28531036	2775	g_26914	g_36289
Super-Scaffold_18	28531320	28819531	288211	g_36289	g_26917
Super-Scaffold_18	28819770	28875835	56065	g_26917	g_26918
Super-Scaffold_18	28876320	28883340	7020	g_26918	g_36292
Super-Scaffold_18	28883552	28916472	32920	g_36292	g_26919
Super-Scaffold_18	28919154	28934908	15754	g_26919	g_26920
Super-Scaffold_18	28940250	29008344	68094	g_26920	g_26922
Super-Scaffold_18	29008592	29099846	91254	g_26922	g_26923
Super-Scaffold_18	29127270	29168812	41542	g_26923	g_26924
Super-Scaffold_18	29169012	29178274	9262	g_26924	g_26926
Super-Scaffold_18	29190978	29197590	6612	g_26926	g_45086
Super-Scaffold_18	29216877	29229981	13104	g_45086	g_26927
Super-Scaffold_18	29232031	29235240	3209	g_26927	g_26928
Super-Scaffold_18	29256227	29262924	6697	g_26928	g_26929
Super-Scaffold_18	29270514	29279019	8505	g_26929	g_26930
Super-Scaffold_18	29288477	29289396	919	g_26930	g_26931
Super-Scaffold_18	29291693	29297311	5618	g_26931	g_26932
Super-Scaffold_18	29301091	29303291	2200	g_36295	g_26933
Super-Scaffold_18	29314316	29316015	1699	g_26933	g_26934
Super-Scaffold_18	29316407	29322372	5965	g_26934	g_26935
Super-Scaffold_18	29322614	29326025	3411	g_26935	g_26936
Super-Scaffold_18	29333728	29526830	193102	g_26936	g_26942
Super-Scaffold_18	29536691	29544546	7855	g_26942	g_26943
Super-Scaffold_18	29554327	29557745	3418	g_26943	g_26944
Super-Scaffold_18	29558494	29581523	23029	g_26944	g_26945
Super-Scaffold_18	29582950	29587263	4313	g_26945	g_26946
Super-Scaffold_18	29587556	29600899	13343	g_26946	g_26947
Super-Scaffold_18	29616967	29622390	5423	g_26947	g_26948
Super-Scaffold_18	29625449	29628977	3528	g_26948	g_26949
Super-Scaffold_18	29629722	29630852	1130	g_26949	g_26950
Super-Scaffold_18	29650949	29653702	2753	g_26950	g_45087
Super-Scaffold_18	29672035	29678431	6396	g_45087	g_26951
Super-Scaffold_18	29688311	29725018	36707	g_26951	g_26953
Super-Scaffold_18	29731661	29742280	10619	g_26953	g_36298
Super-Scaffold_18	29744787	29745256	469	g_36298	g_26954
Super-Scaffold_18	29748289	29756311	8022	g_26954	g_45088
Super-Scaffold_18	29767240	29767306	66	g_45088	g_26955
Super-Scaffold_18	29767881	29792313	24432	g_26955	g_26956
Super-Scaffold_18	29799317	29861252	61935	g_26956	g_26957
Super-Scaffold_18	29861536	29865221	3685	g_26957	g_26958
Super-Scaffold_18	29865550	29869362	3812	g_26958	g_26959
Super-Scaffold_18	29877128	29881724	4596	g_26959	g_26960
Super-Scaffold_18	29882149	29883683	1534	g_26960	g_26962
Super-Scaffold_18	29888417	29904587	16170	g_26962	g_26963
Super-Scaffold_18	29919903	30021623	101720	g_26963	g_26964
Super-Scaffold_18	30028201	30042517	14316	g_26964	g_26965
Super-Scaffold_18	30044499	30138312	93813	g_26965	g_26969
Super-Scaffold_18	30138557	30180427	41870	g_26969	g_26973
Super-Scaffold_18	30180735	30195767	15032	g_26973	g_26974
Super-Scaffold_18	30212863	30214513	1650	g_26974	g_26975
Super-Scaffold_18	30218202	30220512	2310	g_26975	g_26976
Super-Scaffold_18	30222206	30226449	4243	g_26976	g_26977
Super-Scaffold_18	30248754	30260406	11652	g_26977	g_26978
Super-Scaffold_18	30284234	30285841	1607	g_26978	g_26979
Super-Scaffold_18	30286053	30289223	3170	g_26979	g_36308
Super-Scaffold_18	30289462	30290570	1108	g_36308	g_45089
Super-Scaffold_18	30290791	30301681	10890	g_45089	g_26980
Super-Scaffold_18	30301977	30318496	16519	g_26980	g_26981
Super-Scaffold_18	30324312	30426427	102115	g_26981	g_26984
Super-Scaffold_18	30435639	30440260	4621	g_26984	g_26986
Super-Scaffold_18	30445901	30485674	39773	g_26986	g_26988
Super-Scaffold_18	30492281	30597522	105241	g_26988	g_26992
Super-Scaffold_18	30599700	30603722	4022	g_26992	g_26993
Super-Scaffold_18	30604348	30604417	69	g_26993	g_45090
Super-Scaffold_18	30604845	30622562	17717	g_45090	g_26994
Super-Scaffold_18	30622837	30657089	34252	g_26994	g_26995
Super-Scaffold_18	30657532	30657815	283	g_26995	g_45091
Super-Scaffold_18	30660670	30660704	34	g_45091	g_26996
Super-Scaffold_18	30663016	30685503	22487	g_26996	g_26998
Super-Scaffold_18	30686018	30700884	14866	g_26998	g_26999
Super-Scaffold_18	30701678	30778986	77308	g_26999	g_27000
Super-Scaffold_18	30779756	30780152	396	g_27000	g_36312
Super-Scaffold_18	30780637	30933906	153269	g_36312	g_27005
Super-Scaffold_18	30934853	31014791	79938	g_27005	g_27008
Super-Scaffold_18	31016650	31053174	36524	g_27008	g_27009
Super-Scaffold_18	31061916	31131574	69658	g_27009	g_27010
Super-Scaffold_18	31138853	31199422	60569	g_27010	g_27014
Super-Scaffold_18	31200909	31201333	424	g_27014	g_27015
Super-Scaffold_18	31202145	31202245	100	g_27015	g_27016
Super-Scaffold_18	31203366	31203921	555	g_27016	g_27017
Super-Scaffold_18	31204391	31364303	159912	g_27017	g_27019
Super-Scaffold_18	31364620	31509372	144752	g_27019	g_27021
Super-Scaffold_18	31509629	31817207	307578	g_27021	g_27024
Super-Scaffold_18	31819442	31821899	2457	g_27024	g_45092
Super-Scaffold_18	31823603	31827605	4002	g_45092	g_27025
Super-Scaffold_18	31842924	31846818	3894	g_27025	g_27026
Super-Scaffold_18	31849844	31852003	2159	g_27026	g_45093
Super-Scaffold_18	31858113	31921287	63174	g_45093	g_27028
Super-Scaffold_18	31921721	31926014	4293	g_27028	g_27029
Super-Scaffold_18	31940415	31943183	2768	g_27029	g_27030
Super-Scaffold_18	31949259	31955897	6638	g_27030	g_27031
Super-Scaffold_18	31972695	32032282	59587	g_27031	g_27032
Super-Scaffold_18	32035862	32036579	717	g_27032	g_27033
Super-Scaffold_18	32038562	32041209	2647	g_27033	g_27034
Super-Scaffold_18	32041595	32042884	1289	g_27034	g_27035
Super-Scaffold_18	32043123	32049956	6833	g_27035	g_27036
Super-Scaffold_18	32050603	32075625	25022	g_27036	g_27038
Super-Scaffold_18	32077160	32081258	4098	g_27038	g_36325
Super-Scaffold_18	32081584	32090410	8826	g_36325	g_27039
Super-Scaffold_18	32104794	32106869	2075	g_27039	g_45094
Super-Scaffold_18	32118628	32142260	23632	g_45094	g_36326
Super-Scaffold_18	32144071	32222923	78852	g_36326	g_36327
Super-Scaffold_18	32223204	32394938	171734	g_36327	g_27045
Super-Scaffold_18	32409451	32426241	16790	g_27045	g_45095
Super-Scaffold_18	32431487	32444723	13236	g_45095	g_27049
Super-Scaffold_18	32445022	32445120	98	g_27049	g_27050
Super-Scaffold_18	32447270	32449013	1743	g_27050	g_27051
Super-Scaffold_18	32467765	32474308	6543	g_27051	g_27052
Super-Scaffold_18	32474637	32507283	32646	g_27052	g_27053
Super-Scaffold_18	32515085	32541423	26338	g_27053	g_27054
Super-Scaffold_18	32541806	32572586	30780	g_27054	g_27055
Super-Scaffold_18	32606466	32612872	6406	g_27055	g_27056
Super-Scaffold_18	32634009	32654343	20334	g_27056	g_45096
Super-Scaffold_18	32655397	32708362	52965	g_45096	g_27058
Super-Scaffold_18	32709456	32709555	99	g_27058	g_27059
Super-Scaffold_18	32709935	32710585	650	g_27059	g_27060
Super-Scaffold_18	32711064	32711300	236	g_27060	g_27061
Super-Scaffold_18	32711695	32713471	1776	g_27061	g_27062
Super-Scaffold_18	32714526	32714604	78	g_27062	g_27063
Super-Scaffold_18	32716733	32716949	216	g_27063	g_27064
Super-Scaffold_18	32718439	32728259	9820	g_27064	g_27065
Super-Scaffold_18	32730133	32850865	120732	g_27065	g_27067
Super-Scaffold_18	32851224	32886332	35108	g_27067	g_27070
Super-Scaffold_18	32902585	32922770	20185	g_27070	g_27072
Super-Scaffold_18	32928219	33025195	96976	g_27072	g_27074
Super-Scaffold_18	33026646	33028030	1384	g_27074	g_27075
Super-Scaffold_18	33030387	33114014	83627	g_27075	g_27077
Super-Scaffold_18	33155915	33247105	91190	g_27077	g_27079
Super-Scaffold_18	33247305	33318224	70919	g_27079	g_27080
Super-Scaffold_18	33319510	33329997	10487	g_27080	g_36329
Super-Scaffold_189	18845	19154	309	g_34419	g_34420
Super-Scaffold_189	19435	21007	1572	g_34420	g_34421
Super-Scaffold_189	21825	21934	109	g_34421	g_34422
Super-Scaffold_189	22197	68857	46660	g_34422	g_34424
Super-Scaffold_189	99109	100560	1451	g_34424	g_34425
Super-Scaffold_189	101606	157871	56265	g_34425	g_38861
Super-Scaffold_189	158074	159071	997	g_38861	g_34428
Super-Scaffold_189	159379	159739	360	g_34428	g_34429
Super-Scaffold_189	160422	160716	294	g_34429	g_34430
Super-Scaffold_189	165765	170138	4373	g_34430	g_34431
Super-Scaffold_189	171208	171260	52	g_34431	g_34432
Super-Scaffold_189	171754	177396	5642	g_34432	g_34433
Super-Scaffold_189	180050	183027	2977	g_34433	g_45627
Super-Scaffold_189	183917	192095	8178	g_45627	g_34434
Super-Scaffold_189	221666	298175	76509	g_34434	g_34437
Super-Scaffold_189	303943	318774	14831	g_34437	g_34439
Super-Scaffold_189	329617	331036	1419	g_34439	g_34440
Super-Scaffold_189	347070	359723	12653	g_34440	g_34441
Super-Scaffold_189	359950	370146	10196	g_34441	g_34442
Super-Scaffold_189	389803	436760	46957	g_34442	g_34443
Super-Scaffold_189	439423	443122	3699	g_34443	g_34445
Super-Scaffold_189	468101	477938	9837	g_34445	g_34447
Super-Scaffold_189	487896	494249	6353	g_34447	g_34448
Super-Scaffold_189	494644	495657	1013	g_34448	g_34449
Super-Scaffold_189	501767	502682	915	g_34449	g_34450
Super-Scaffold_189	508087	515870	7783	g_34450	g_34452
Super-Scaffold_189	522784	550171	27387	g_34452	g_34454
Super-Scaffold_189	550625	550766	141	g_34454	g_34455
Super-Scaffold_189	557003	584553	27550	g_34455	g_34456
Super-Scaffold_189	596422	598147	1725	g_34456	g_34457
Super-Scaffold_189	616909	625119	8210	g_34457	g_34458
Super-Scaffold_189	629831	631326	1495	g_34458	g_34459
Super-Scaffold_189	631616	632418	802	g_34459	g_45628
Super-Scaffold_189	635646	636284	638	g_45628	g_34460
Super-Scaffold_189	636786	638400	1614	g_34460	g_34461
Super-Scaffold_189	645911	673968	28057	g_34461	g_34462
Super-Scaffold_189	677660	679043	1383	g_34462	g_34463
Super-Scaffold_189	704895	709657	4762	g_34463	g_34464
Super-Scaffold_189	712794	713215	421	g_34464	g_34465
Super-Scaffold_189	719755	730945	11190	g_34465	g_34468
Super-Scaffold_189	732990	762520	29530	g_34468	g_34469
Super-Scaffold_189	764101	778613	14512	g_34469	g_34472
Super-Scaffold_189	783191	794875	11684	g_34472	g_34474
Super-Scaffold_189	795969	839350	43381	g_34474	g_34476
Super-Scaffold_189	843584	862361	18777	g_34476	g_34477
Super-Scaffold_189	863218	863279	61	g_34477	g_34478
Super-Scaffold_189	863857	888637	24780	g_34478	g_34481
Super-Scaffold_189	897004	901224	4220	g_34481	g_34483
Super-Scaffold_189	901706	935890	34184	g_34483	g_34486
Super-Scaffold_189	936924	937086	162	g_34486	g_34487
Super-Scaffold_189	937655	949767	12112	g_34487	g_34488
Super-Scaffold_189	957936	999490	41554	g_34488	g_34490
Super-Scaffold_189	1005310	1028642	23332	g_34490	g_34491
Super-Scaffold_189	1030297	1031369	1072	g_34491	g_34492
Super-Scaffold_189	1073721	1084094	10373	g_34492	g_34493
Super-Scaffold_189	1092872	1103743	10871	g_34493	g_34495
Super-Scaffold_189	1110214	1132481	22267	g_34495	g_34496
Super-Scaffold_189	1140137	1143831	3694	g_34496	g_34497
Super-Scaffold_189	1157152	1161073	3921	g_34497	g_45629
Super-Scaffold_189	1167895	1186898	19003	g_45629	g_34499
Super-Scaffold_189	1188022	1239540	51518	g_34499	g_38871
Super-Scaffold_189	1239830	1349149	109319	g_38871	g_34505
Super-Scaffold_189	1357959	1363194	5235	g_34505	g_45630
Super-Scaffold_189	1369691	1428693	59002	g_45630	g_34507
Super-Scaffold_189	1432542	1438556	6014	g_34507	g_34508
Super-Scaffold_189	1474577	1506229	31652	g_34508	g_34509
Super-Scaffold_189	1518171	1520719	2548	g_34509	g_45631
Super-Scaffold_189	1523586	1532205	8619	g_45631	g_34510
Super-Scaffold_189	1536334	1541363	5029	g_34510	g_45632
Super-Scaffold_189	1557838	1569143	11305	g_45632	g_34511
Super-Scaffold_189	1569367	1572327	2960	g_34511	g_34512
Super-Scaffold_189	1582124	1649081	66957	g_34512	g_34514
Super-Scaffold_189	1651150	1704707	53557	g_34514	g_34518
Super-Scaffold_189	1706029	1717594	11565	g_34518	g_34519
Super-Scaffold_189	1721673	1739551	17878	g_34519	g_38875
Super-Scaffold_189	1739787	1751911	12124	g_38875	g_34521
Super-Scaffold_189	1754717	1756441	1724	g_34521	g_38876
Super-Scaffold_189	1757316	1757584	268	g_38876	g_34522
Super-Scaffold_189	1777192	1777668	476	g_34522	g_34523
Super-Scaffold_189	1778009	1788000	9991	g_34523	g_34524
Super-Scaffold_189	1803973	1808689	4716	g_34524	g_34525
Super-Scaffold_189	1834619	1855005	20386	g_34525	g_34526
Super-Scaffold_189	1872036	1883280	11244	g_34526	g_34527
Super-Scaffold_189	1894091	1916701	22610	g_34527	g_34529
Super-Scaffold_189	1930329	1952125	21796	g_34529	g_34530
Super-Scaffold_189	1952445	1960510	8065	g_34530	g_34531
Super-Scaffold_189	1960791	2026516	65725	g_34531	g_34532
Super-Scaffold_189	2030288	2042961	12673	g_34532	g_34533
Super-Scaffold_189	2048753	2071984	23231	g_34533	g_34534
Super-Scaffold_189	2079013	2089922	10909	g_34534	g_34535
Super-Scaffold_189	2099653	2103793	4140	g_34535	g_34536
Super-Scaffold_189	2120177	2141327	21150	g_34536	g_34537
Super-Scaffold_189	2165179	3682005	1516826	g_34537	g_34538
Super-Scaffold_189	3683180	3706119	22939	g_34538	g_34540
Super-Scaffold_189	3706639	3721055	14416	g_34540	g_34541
Super-Scaffold_189	3721575	3786723	65148	g_34541	g_34544
Super-Scaffold_189	3789794	3835959	46165	g_34544	g_34546
Super-Scaffold_189	3837134	3844889	7755	g_34546	g_34547
Super-Scaffold_189	3848370	3854375	6005	g_34547	g_34548
Super-Scaffold_189	3861013	3864282	3269	g_34548	g_34549
Super-Scaffold_189	3872794	3878403	5609	g_34549	g_34550
Super-Scaffold_189	3896381	4033535	137154	g_34550	g_34555
Super-Scaffold_189	4033762	4108311	74549	g_34555	g_34556
Super-Scaffold_189	4114743	4172222	57479	g_34556	g_34558
Super-Scaffold_189	4195053	4218316	23263	g_34558	g_34559
Super-Scaffold_189	4249400	4271217	21817	g_34559	g_34560
Super-Scaffold_189	4271543	4318452	46909	g_34560	g_34563
Super-Scaffold_189	4320188	4326050	5862	g_34563	g_34564
Super-Scaffold_189	4327999	4370953	42954	g_34564	g_34565
Super-Scaffold_189	4372809	4378685	5876	g_34565	g_45633
Super-Scaffold_189	4380661	4386523	5862	g_45633	g_34566
Super-Scaffold_189	4388379	4394255	5876	g_34566	g_45634
Super-Scaffold_189	4396231	4418064	21833	g_45634	g_45635
Super-Scaffold_189	4419833	4425364	5531	g_45635	g_45636
Super-Scaffold_189	4427163	4499317	72154	g_45636	g_34568
Super-Scaffold_189	4501718	4513453	11735	g_34568	g_34569
Super-Scaffold_189	4514514	4534724	20210	g_34569	g_34571
Super-Scaffold_189	4539731	4547611	7880	g_34571	g_34572
Super-Scaffold_189	4553190	4559480	6290	g_34572	g_34573
Super-Scaffold_189	4562040	4575341	13301	g_34573	g_34574
Super-Scaffold_189	4575541	4581000	5459	g_34574	g_34575
Super-Scaffold_189	4589601	4592439	2838	g_34575	g_34576
Super-Scaffold_189	4606197	4637268	31071	g_34576	g_34577
Super-Scaffold_189	4658504	4714053	55549	g_34577	g_34578
Super-Scaffold_189	4719123	4869137	150014	g_34578	g_34583
Super-Scaffold_189	4869736	4876117	6381	g_34583	g_34585
Super-Scaffold_189	4881517	4890120	8603	g_34585	g_45637
Super-Scaffold_189	4899260	4903192	3932	g_45637	g_34586
Super-Scaffold_189	4903638	4907896	4258	g_34586	g_34587
Super-Scaffold_189	4912011	4912041	30	g_34587	g_45638
Super-Scaffold_189	4913941	4917848	3907	g_45638	g_45639
Super-Scaffold_189	4926869	4930474	3605	g_45639	g_34588
Super-Scaffold_189	4931016	4937354	6338	g_34588	g_34589
Super-Scaffold_189	4937581	4939125	1544	g_34589	g_34590
Super-Scaffold_189	4940543	4943141	2598	g_34590	g_34591
Super-Scaffold_189	4949016	4952152	3136	g_34591	g_34592
Super-Scaffold_189	4960678	4964610	3932	g_34592	g_34593
Super-Scaffold_189	4978386	5002144	23758	g_34593	g_34595
Super-Scaffold_189	5003286	5067481	64195	g_34595	g_34598
Super-Scaffold_189	5072219	5096021	23802	g_34598	g_34599
Super-Scaffold_189	5096368	5143606	47238	g_34599	g_38885
Super-Scaffold_189	5143854	5161516	17662	g_38885	g_34602
Super-Scaffold_189	5162160	5164602	2442	g_34602	g_34603
Super-Scaffold_189	5171481	5222227	50746	g_34603	g_34604
Super-Scaffold_189	5250745	5256756	6011	g_34604	g_45640
Super-Scaffold_189	5260746	5262164	1418	g_45640	g_34605
Super-Scaffold_189	5280008	5307027	27019	g_34605	g_34606
Super-Scaffold_189	5328107	5335856	7749	g_34606	g_34607
Super-Scaffold_189	5345627	5355131	9504	g_34607	g_38886
Super-Scaffold_189	5362477	5365905	3428	g_34608	g_34609
Super-Scaffold_189	5378001	5383271	5270	g_34609	g_34610
Super-Scaffold_189	5396709	5400401	3692	g_34610	g_34611
Super-Scaffold_189	5403148	5446810	43662	g_34611	g_34613
Super-Scaffold_189	5462376	5466882	4506	g_34613	g_34614
Super-Scaffold_189	5492299	5522474	30175	g_34614	g_34615
Super-Scaffold_189	5523607	5531961	8354	g_34615	g_45641
Super-Scaffold_189	5537747	5574538	36791	g_45641	g_45642
Super-Scaffold_189	5578977	5632866	53889	g_45642	g_34616
Super-Scaffold_189	5643233	5826956	183723	g_34616	g_34619
Super-Scaffold_189	5831896	5879635	47739	g_34619	g_34621
Super-Scaffold_189	5893213	5984313	91100	g_34621	g_34623
Super-Scaffold_189	5985350	6003553	18203	g_34623	g_34625
Super-Scaffold_189	6029223	6031109	1886	g_34625	g_34627
Super-Scaffold_189	6031507	6042974	11467	g_34627	g_34628
Super-Scaffold_189	6063757	6099717	35960	g_34628	g_34629
Super-Scaffold_189	6110977	6114262	3285	g_34629	g_38888
Super-Scaffold_189	6114495	6114913	418	g_38888	g_34630
Super-Scaffold_189	6122860	6136617	13757	g_34630	g_34631
Super-Scaffold_189	6163586	6210973	47387	g_34631	g_34633
Super-Scaffold_189	6238584	6368693	130109	g_34633	g_34637
Super-Scaffold_189	6378924	6385869	6945	g_34637	g_38891
Super-Scaffold_189	6386120	6386623	503	g_38891	g_34638
Super-Scaffold_189	6397684	6408369	10685	g_34638	g_34639
Super-Scaffold_189	6412501	6467684	55183	g_34639	g_34640
Super-Scaffold_189	6484704	6489106	4402	g_34640	g_34641
Super-Scaffold_189	6496421	6499526	3105	g_34641	g_34642
Super-Scaffold_189	6507818	6508656	838	g_34642	g_34643
Super-Scaffold_189	6517987	6570919	52932	g_34643	g_34645
Super-Scaffold_189	6573630	6575022	1392	g_34645	g_34646
Super-Scaffold_189	6575282	6606621	31339	g_34646	g_34647
Super-Scaffold_189	6609577	6670729	61152	g_34647	g_34649
Super-Scaffold_189	6671430	6813060	141630	g_34649	g_34651
Super-Scaffold_189	6821797	6837960	16163	g_34651	g_34653
Super-Scaffold_189	6839060	6951869	112809	g_34653	g_34655
Super-Scaffold_189	7022516	7023523	1007	g_34655	g_38896
Super-Scaffold_189	7032153	7039623	7470	g_34656	g_34657
Super-Scaffold_189	7049044	7051827	2783	g_34657	g_34658
Super-Scaffold_189	7070971	7097409	26438	g_34658	g_34659
Super-Scaffold_189	7097684	7129878	32194	g_34659	g_34660
Super-Scaffold_189	7132709	7167704	34995	g_34660	g_34661
Super-Scaffold_189	7167997	7172732	4735	g_34661	g_34662
Super-Scaffold_189	7173640	7323343	149703	g_34662	g_34664
Super-Scaffold_189	7325902	7357475	31573	g_34664	g_34665
Super-Scaffold_189	7363636	7366341	2705	g_34665	g_34666
Super-Scaffold_189	7375532	7437247	61715	g_34666	g_34667
Super-Scaffold_189	7443800	7450398	6598	g_34667	g_34668
Super-Scaffold_189	7458078	7483231	25153	g_34668	g_34669
Super-Scaffold_189	7489833	7509453	19620	g_34669	g_34670
Super-Scaffold_189	7533015	7537057	4042	g_34670	g_34671
Super-Scaffold_189	7586563	7589894	3331	g_34671	g_34672
Super-Scaffold_189	7596823	7692144	95321	g_34672	g_34676
Super-Scaffold_189	7692410	7778111	85701	g_34676	g_34678
Super-Scaffold_189	7791092	7792003	911	g_34678	g_34679
Super-Scaffold_189	7832941	7834268	1327	g_34679	g_34680
Super-Scaffold_189	7837111	7897923	60812	g_34680	g_34681
Super-Scaffold_189	7900806	7911130	10324	g_34681	g_45643
Super-Scaffold_189	7915917	7920367	4450	g_45643	g_34682
Super-Scaffold_189	7931289	7950721	19432	g_34682	g_34683
Super-Scaffold_189	7953326	7967524	14198	g_34683	g_34684
Super-Scaffold_189	8002979	8008078	5099	g_34684	g_34685
Super-Scaffold_189	8018292	8020395	2103	g_34685	g_34686
Super-Scaffold_189	8039763	8046628	6865	g_34686	g_34687
Super-Scaffold_189	8049929	8051783	1854	g_34687	g_34688
Super-Scaffold_189	8052872	8055382	2510	g_34688	g_45644
Super-Scaffold_189	8061307	8062280	973	g_45644	g_34689
Super-Scaffold_189	8069392	8080864	11472	g_34689	g_34690
Super-Scaffold_189	8091690	8105402	13712	g_34690	g_34691
Super-Scaffold_189	8113043	8117740	4697	g_34691	g_34692
Super-Scaffold_189	8124709	8127605	2896	g_34692	g_34693
Super-Scaffold_189	8134239	8158822	24583	g_34693	g_34694
Super-Scaffold_189	8160964	8203163	42199	g_34694	g_34695
Super-Scaffold_189	8205383	8210614	5231	g_34695	g_45645
Super-Scaffold_189	8227674	8241087	13413	g_45645	g_34696
Super-Scaffold_189	8241314	8264268	22954	g_34696	g_34697
Super-Scaffold_189	8274858	8295105	20247	g_34697	g_34698
Super-Scaffold_189	8304758	8414649	109891	g_34698	g_34701
Super-Scaffold_189	8417389	8437972	20583	g_34701	g_34703
Super-Scaffold_189	8441341	8513961	72620	g_34703	g_34706
Super-Scaffold_189	8514212	8584221	70009	g_34706	g_34709
Super-Scaffold_189	8584685	8601457	16772	g_34709	g_34710
Super-Scaffold_189	8606534	8607538	1004	g_34710	g_34711
Super-Scaffold_189	8610649	8667779	57130	g_34711	g_34713
Super-Scaffold_189	8668945	8669842	897	g_34713	g_38910
Super-Scaffold_189	8670135	8677615	7480	g_38910	g_34714
Super-Scaffold_189	8685140	8686559	1419	g_34714	g_34715
Super-Scaffold_189	8692403	8697899	5496	g_34715	g_34716
Super-Scaffold_189	8707439	8709368	1929	g_34716	g_34717
Super-Scaffold_189	8716765	8719875	3110	g_34717	g_34718
Super-Scaffold_189	8726716	8735164	8448	g_34718	g_34719
Super-Scaffold_189	8740385	8742174	1789	g_34719	g_34720
Super-Scaffold_189	8743671	8744840	1169	g_34720	g_34721
Super-Scaffold_189	8746141	8747292	1151	g_34721	g_45646
Super-Scaffold_189	8757841	8759267	1426	g_45646	g_34722
Super-Scaffold_189	8767283	8776837	9554	g_34722	g_34723
Super-Scaffold_189	8792233	8798449	6216	g_34723	g_34724
Super-Scaffold_189	8826403	8833911	7508	g_34724	g_34725
Super-Scaffold_189	8834291	8850664	16373	g_34725	g_34727
Super-Scaffold_189	8859801	8863469	3668	g_34727	g_34728
Super-Scaffold_189	8872990	8882914	9924	g_34728	g_34730
Super-Scaffold_189	8883135	8944970	61835	g_34730	g_34733
Super-Scaffold_189	8953508	8955291	1783	g_34733	g_45647
Super-Scaffold_189	8957991	8964680	6689	g_45647	g_34734
Super-Scaffold_189	8970401	8974144	3743	g_34734	g_34735
Super-Scaffold_189	8984958	8992586	7628	g_34735	g_34736
Super-Scaffold_189	9020464	9031790	11326	g_34736	g_34738
Super-Scaffold_189	9035971	9040575	4604	g_34738	g_34739
Super-Scaffold_189	9054242	9084507	30265	g_34739	g_34741
Super-Scaffold_189	9098343	9140729	42386	g_34741	g_34742
Super-Scaffold_189	9161816	9172510	10694	g_34742	g_34743
Super-Scaffold_189	9172710	9198369	25659	g_34743	g_34744
Super-Scaffold_189	9206300	9215025	8725	g_34744	g_34745
Super-Scaffold_189	9234309	9235287	978	g_34745	g_34746
Super-Scaffold_189	9246531	9250296	3765	g_34746	g_34747
Super-Scaffold_189	9252027	9254451	2424	g_34747	g_34748
Super-Scaffold_189	9257548	9258819	1271	g_34748	g_34749
Super-Scaffold_189	9260323	9268221	7898	g_34749	g_38912
Super-Scaffold_189	9273116	9278309	5193	g_34750	g_34751
Super-Scaffold_189	9279918	9305511	25593	g_34751	g_34752
Super-Scaffold_189	9309465	9314295	4830	g_34752	g_45648
Super-Scaffold_189	9388476	9450568	62092	g_45648	g_34755
Super-Scaffold_189	9450837	9465313	14476	g_34755	g_34756
Super-Scaffold_189	9473708	9479896	6188	g_34756	g_34757
Super-Scaffold_189	9492594	9509054	16460	g_34757	g_34759
Super-Scaffold_189	9512955	9515809	2854	g_34759	g_34760
Super-Scaffold_189	9520763	9525875	5112	g_34760	g_34761
Super-Scaffold_189	9533197	9542168	8971	g_34761	g_45649
Super-Scaffold_189	9550917	9561429	10512	g_45649	g_34763
Super-Scaffold_189	9561743	9569764	8021	g_34763	g_45650
Super-Scaffold_189	9595939	9600713	4774	g_45650	g_34764
Super-Scaffold_189	9608379	9608769	390	g_34764	g_34765
Super-Scaffold_189	9621965	9626152	4187	g_34765	g_34766
Super-Scaffold_189	9647197	9649999	2802	g_34766	g_34767
Super-Scaffold_189	9652034	9654027	1993	g_34767	g_34768
Super-Scaffold_189	9665877	9670027	4150	g_34768	g_34769
Super-Scaffold_189	9687767	9701416	13649	g_34769	g_34770
Super-Scaffold_189	9721327	9730579	9252	g_34770	g_45651
Super-Scaffold_189	9751821	9758106	6285	g_45651	g_45652
Super-Scaffold_189	9766228	9769339	3111	g_45652	g_34771
Super-Scaffold_189	9786724	9817560	30836	g_34771	g_34772
Super-Scaffold_189	9848499	10247253	398754	g_34772	g_34775
Super-Scaffold_189	10249097	10446178	197081	g_34775	g_34776
Super-Scaffold_189	10446489	10474306	27817	g_34776	g_34778
Super-Scaffold_189	10481948	10560541	78593	g_34778	g_34779
Super-Scaffold_189	10576634	10599220	22586	g_38921	g_34781
Super-Scaffold_189	10613965	10616929	2964	g_34781	g_34782
Super-Scaffold_189	10632131	10634119	1988	g_34782	g_34783
Super-Scaffold_189	10634781	10639243	4462	g_34783	g_45653
Super-Scaffold_189	10640590	10649379	8789	g_45653	g_34784
Super-Scaffold_189	10650098	10664825	14727	g_34784	g_34785
Super-Scaffold_189	10667776	10674973	7197	g_34785	g_45654
Super-Scaffold_189	10676049	10687235	11186	g_45654	g_34786
Super-Scaffold_189	10689305	10690661	1356	g_34786	g_45655
Super-Scaffold_189	10692884	10706272	13388	g_45655	g_34787
Super-Scaffold_189	10713772	10714065	293	g_38923	g_34788
Super-Scaffold_189	10715482	10718486	3004	g_34788	g_34789
Super-Scaffold_189	10722321	10725426	3105	g_34789	g_34790
Super-Scaffold_189	10725856	10731776	5920	g_34790	g_34792
Super-Scaffold_189	10734083	10737899	3816	g_34792	g_45656
Super-Scaffold_189	10755380	10863198	107818	g_45656	g_34794
Super-Scaffold_189	10863521	10870876	7355	g_34794	g_34795
Super-Scaffold_189	10871670	10881056	9386	g_34795	g_34796
Super-Scaffold_189	10904469	10909670	5201	g_34796	g_34797
Super-Scaffold_189	10913840	10917300	3460	g_34797	g_34798
Super-Scaffold_189	10919852	10922522	2670	g_34798	g_34799
Super-Scaffold_189	10922752	10926517	3765	g_34799	g_45657
Super-Scaffold_189	10927791	10928694	903	g_45657	g_34800
Super-Scaffold_189	10931699	10937424	5725	g_34800	g_34801
Super-Scaffold_189	10948002	10952986	4984	g_34801	g_34802
Super-Scaffold_189	10956345	11035715	79370	g_34802	g_34804
Super-Scaffold_189	11036956	11038342	1386	g_34804	g_34805
Super-Scaffold_189	11039592	11042694	3102	g_34805	g_34806
Super-Scaffold_189	11043251	11065620	22369	g_34806	g_34807
Super-Scaffold_189	11067639	11093052	25413	g_34807	g_34808
Super-Scaffold_189	11121162	11124896	3734	g_34808	g_34809
Super-Scaffold_189	11125213	11173518	48305	g_34809	g_34812
Super-Scaffold_189	11173718	11174001	283	g_34812	g_34813
Super-Scaffold_189	11175820	11179582	3762	g_34813	g_34814
Super-Scaffold_189	11189841	11197561	7720	g_34814	g_34815
Super-Scaffold_189	11200940	11206290	5350	g_34815	g_34816
Super-Scaffold_189	11216176	11220015	3839	g_34816	g_34817
Super-Scaffold_189	11231595	11242224	10629	g_34817	g_34818
Super-Scaffold_189	11242493	11250907	8414	g_34818	g_34819
Super-Scaffold_189	11251110	11311802	60692	g_34819	g_34821
Super-Scaffold_189	11312005	11392116	80111	g_34821	g_34825
Super-Scaffold_189	11392322	11416832	24510	g_34825	g_34828
Super-Scaffold_189	11417050	11431718	14668	g_34828	g_34829
Super-Scaffold_189	11447772	11452070	4298	g_34829	g_34830
Super-Scaffold_189	11455939	11457954	2015	g_34830	g_34831
Super-Scaffold_189	11458777	11527499	68722	g_34831	g_34834
Super-Scaffold_189	11535464	11600454	64990	g_34834	g_34839
Super-Scaffold_189	11610655	11614940	4285	g_34839	g_45658
Super-Scaffold_189	11622865	11638540	15675	g_45658	g_34840
Super-Scaffold_189	11639022	11642753	3731	g_34840	g_34841
Super-Scaffold_189	11651346	11652451	1105	g_34841	g_34842
Super-Scaffold_189	11654443	11690369	35926	g_34842	g_34843
Super-Scaffold_189	11707886	11715014	7128	g_34843	g_34844
Super-Scaffold_189	11715265	11726576	11311	g_34844	g_34846
Super-Scaffold_189	11730435	11733414	2979	g_34846	g_34847
Super-Scaffold_189	11757348	11801238	43890	g_34847	g_34850
Super-Scaffold_189	11807459	11809282	1823	g_34850	g_34851
Super-Scaffold_189	11810305	11813816	3511	g_34851	g_34852
Super-Scaffold_189	11815225	11816623	1398	g_34852	g_34853
Super-Scaffold_189	11825770	11826638	868	g_34853	g_34854
Super-Scaffold_189	11842601	11845633	3032	g_34854	g_45659
Super-Scaffold_189	11853732	11862359	8627	g_45659	g_34855
Super-Scaffold_189	11868467	11882760	14293	g_34855	g_45660
Super-Scaffold_189	11893865	12034767	140902	g_45660	g_34858
Super-Scaffold_189	12034979	12086626	51647	g_34858	g_34862
Super-Scaffold_189	12124297	12160927	36630	g_34862	g_34864
Super-Scaffold_189	12178243	12187944	9701	g_34864	g_38940
Super-Scaffold_189	12188204	12199162	10958	g_38940	g_34865
Super-Scaffold_189	12199479	12247150	47671	g_34865	g_34868
Super-Scaffold_189	12261618	12268169	6551	g_34868	g_34869
Super-Scaffold_189	12280466	12285584	5118	g_34869	g_34870
Super-Scaffold_189	12286873	12290402	3529	g_34870	g_34871
Super-Scaffold_189	12294035	12302976	8941	g_34871	g_34872
Super-Scaffold_189	12326890	12359538	32648	g_34872	g_34873
Super-Scaffold_189	12359774	12366738	6964	g_34873	g_34874
Super-Scaffold_189	12368566	12368821	255	g_34875	g_34876
Super-Scaffold_189	12370911	12393667	22756	g_34876	g_34877
Super-Scaffold_189	12412675	12417556	4881	g_34877	g_34878
Super-Scaffold_189	12420317	12433151	12834	g_34878	g_34881
Super-Scaffold_189	12442214	12443611	1397	g_34881	g_34882
Super-Scaffold_189	12449025	12472387	23362	g_34882	g_38943
Super-Scaffold_189	12472635	12484717	12082	g_38943	g_34884
Super-Scaffold_189	12489213	12519087	29874	g_34884	g_34886
Super-Scaffold_189	12538844	12554232	15388	g_34886	g_34888
Super-Scaffold_189	12559138	12573658	14520	g_34888	g_34889
Super-Scaffold_189	12575990	12578267	2277	g_34889	g_34890
Super-Scaffold_189	12579271	12625069	45798	g_34890	g_34891
Super-Scaffold_189	12625434	12637453	12019	g_34891	g_34892
Super-Scaffold_189	12637722	12638255	533	g_34892	g_34893
Super-Scaffold_189	12638479	12640993	2514	g_34893	g_34894
Super-Scaffold_189	12641244	12642576	1332	g_34894	g_34895
Super-Scaffold_189	12648692	12649820	1128	g_34895	g_34896
Super-Scaffold_189	12663498	12667258	3760	g_34896	g_34898
Super-Scaffold_189	12669801	12671594	1793	g_34898	g_45661
Super-Scaffold_189	12678409	12710960	32551	g_45661	g_34899
Super-Scaffold_189	12731079	12822872	91793	g_34899	g_34900
Super-Scaffold_189	12823321	12828783	5462	g_34900	g_34901
Super-Scaffold_189	12871002	12904537	33535	g_34901	g_34903
Super-Scaffold_189	12927341	12935547	8206	g_34903	g_34904
Super-Scaffold_189	12935954	12961826	25872	g_34904	g_38946
Super-Scaffold_189	12962104	12965415	3311	g_38946	g_38947
Super-Scaffold_189	12965678	12970064	4386	g_38947	g_34906
Super-Scaffold_189	12970294	12981974	11680	g_34906	g_34907
Super-Scaffold_189	12985584	12990283	4699	g_34907	g_45662
Super-Scaffold_189	13003711	13005454	1743	g_45662	g_34909
Super-Scaffold_189	13006381	13008595	2214	g_34909	g_45663
Super-Scaffold_189	13021462	13022261	799	g_45663	g_34910
Super-Scaffold_189	13043009	13054026	11017	g_34910	g_34911
Super-Scaffold_189	13055688	13062351	6663	g_34911	g_34912
Super-Scaffold_189	13066434	13072066	5632	g_34912	g_34913
Super-Scaffold_189	13075615	13080175	4560	g_34913	g_34914
Super-Scaffold_189	13083763	13085166	1403	g_34914	g_45664
Super-Scaffold_189	13090821	13093551	2730	g_45664	g_45665
Super-Scaffold_189	13101727	13102341	614	g_45665	g_34915
Super-Scaffold_189	13102598	13119219	16621	g_34915	g_34918
Super-Scaffold_189	13120694	13124914	4220	g_34918	g_34917
Super-Scaffold_189	13126344	13138252	11908	g_34917	g_34919
Super-Scaffold_189	13139175	13142546	3371	g_34919	g_34920
Super-Scaffold_189	13143574	13162948	19374	g_34920	g_34921
Super-Scaffold_189	13163163	13170091	6928	g_34921	g_34922
Super-Scaffold_189	13173069	13180637	7568	g_34922	g_45666
Super-Scaffold_189	13184464	13189129	4665	g_45666	g_34923
Super-Scaffold_189	13190716	13192592	1876	g_34923	g_34924
Super-Scaffold_189	13196200	13229943	33743	g_34924	g_34925
Super-Scaffold_189	13236371	13243033	6662	g_34925	g_34926
Super-Scaffold_189	13246536	13249399	2863	g_34926	g_34927
Super-Scaffold_189	13260202	13268632	8430	g_34927	g_34928
Super-Scaffold_189	13274547	13278298	3751	g_34928	g_34929
Super-Scaffold_189	13287621	13292687	5066	g_34929	g_34930
Super-Scaffold_189	13316781	13317338	557	g_34930	g_34931
Super-Scaffold_189	13317724	13324651	6927	g_34931	g_34932
Super-Scaffold_189	13337219	13339249	2030	g_34932	g_38952
Super-Scaffold_189	13339542	13339760	218	g_38952	g_34933
Super-Scaffold_189	13360864	13363334	2470	g_34933	g_34934
Super-Scaffold_189	13368639	13371215	2576	g_34934	g_45667
Super-Scaffold_189	13371688	13380036	8348	g_45667	g_34935
Super-Scaffold_189	13380353	13383911	3558	g_34935	g_45668
Super-Scaffold_189	13404036	13406012	1976	g_45668	g_34936
Super-Scaffold_189	13410401	13415710	5309	g_34936	g_34937
Super-Scaffold_189	13421878	13431945	10067	g_34937	g_34938
Super-Scaffold_189	13440060	13442097	2037	g_34938	g_34939
Super-Scaffold_189	13448301	13448973	672	g_34939	g_34940
Super-Scaffold_189	13457251	13459248	1997	g_34940	g_45669
Super-Scaffold_189	13471201	13474045	2844	g_45669	g_34941
Super-Scaffold_189	13479456	13482948	3492	g_34941	g_34942
Super-Scaffold_189	13494555	13525922	31367	g_34942	g_34943
Super-Scaffold_189	13536810	13544746	7936	g_34943	g_34944
Super-Scaffold_189	13567499	13590330	22831	g_34944	g_34945
Super-Scaffold_189	13591445	13605764	14319	g_34945	g_34946
Super-Scaffold_189	13606021	13610328	4307	g_34946	g_34947
Super-Scaffold_189	13610597	13613720	3123	g_34947	g_45670
Super-Scaffold_189	13620633	13622507	1874	g_45670	g_34948
Super-Scaffold_189	13624584	13631497	6913	g_34948	g_34949
Super-Scaffold_189	13634636	13638713	4077	g_34949	g_34950
Super-Scaffold_189	13645250	13648200	2950	g_34950	g_34951
Super-Scaffold_189	13654798	13659658	4860	g_34951	g_34952
Super-Scaffold_189	13666412	13669565	3153	g_34952	g_34953
Super-Scaffold_189	13675748	13728371	52623	g_34953	g_34954
Super-Scaffold_189	13729684	13740205	10521	g_34954	g_34955
Super-Scaffold_189	13741995	13743019	1024	g_34955	g_34956
Super-Scaffold_189	13760862	13770303	9441	g_34956	g_34957
Super-Scaffold_189	13792161	13887106	94945	g_34957	g_34961
Super-Scaffold_189	13887438	13908103	20665	g_34961	g_34962
Super-Scaffold_189	13920684	13922877	2193	g_34962	g_34963
Super-Scaffold_189	13941006	13941070	64	g_34963	g_34964
Super-Scaffold_189	13955513	14017621	62108	g_34964	g_34965
Super-Scaffold_189	14031392	14032897	1505	g_34965	g_34966
Super-Scaffold_189	14045891	14047990	2099	g_34966	g_34967
Super-Scaffold_189	14048570	14049001	431	g_34967	g_34968
Super-Scaffold_189	14049619	14050660	1041	g_34968	g_34969
Super-Scaffold_189	14051043	14055153	4110	g_34969	g_34970
Super-Scaffold_189	14092487	14093425	938	g_34970	g_34971
Super-Scaffold_189	14093856	14096881	3025	g_34971	g_34972
Super-Scaffold_189	14107364	14115037	7673	g_34972	g_45671
Super-Scaffold_189	14115294	14141841	26547	g_45671	g_38958
Super-Scaffold_189	14142113	14187176	45063	g_38958	g_34976
Super-Scaffold_189	14190403	14193037	2634	g_34976	g_34977
Super-Scaffold_189	14198807	14211203	12396	g_34977	g_34978
Super-Scaffold_189	14243050	14301757	58707	g_34978	g_34979
Super-Scaffold_189	14310686	14320130	9444	g_34979	g_45672
Super-Scaffold_189	14334078	14386845	52767	g_45672	g_34983
Super-Scaffold_189	14395336	14404941	9605	g_34983	g_34985
Super-Scaffold_189	14409723	14440284	30561	g_34985	g_34987
Super-Scaffold_189	14440721	14466525	25804	g_34987	g_34989
Super-Scaffold_189	14469538	14476700	7162	g_34989	g_34990
Super-Scaffold_189	14484275	14486613	2338	g_34990	g_34991
Super-Scaffold_189	14494577	14494974	397	g_34991	g_34992
Super-Scaffold_189	14502253	14509310	7057	g_34992	g_34993
Super-Scaffold_189	14516238	14520641	4403	g_34993	g_34994
Super-Scaffold_189	14521018	14525039	4021	g_34994	g_34995
Super-Scaffold_189	14528135	14529769	1634	g_34995	g_34996
Super-Scaffold_189	14536256	14537011	755	g_34996	g_34997
Super-Scaffold_189	14540318	14543197	2879	g_34997	g_34998
Super-Scaffold_189	14553775	14556677	2902	g_34998	g_34999
Super-Scaffold_189	14560168	14561447	1279	g_34999	g_35000
Super-Scaffold_189	14562118	14562268	150	g_35000	g_35001
Super-Scaffold_189	14569514	14575565	6051	g_35001	g_35002
Super-Scaffold_189	14580731	14583815	3084	g_35002	g_35003
Super-Scaffold_189	14597125	14602277	5152	g_35003	g_35004
Super-Scaffold_189	14616486	14625049	8563	g_35004	g_35005
Super-Scaffold_189	14632808	14638246	5438	g_35005	g_35006
Super-Scaffold_189	14641955	14645398	3443	g_35006	g_35007
Super-Scaffold_189	14648515	14651437	2922	g_35007	g_35008
Super-Scaffold_189	14653349	14656494	3145	g_35008	g_35009
Super-Scaffold_189	14663486	14667615	4129	g_35009	g_35010
Super-Scaffold_189	14670730	14676787	6057	g_35010	g_35011
Super-Scaffold_189	14685198	14686711	1513	g_35011	g_35012
Super-Scaffold_189	14690834	14693178	2344	g_35012	g_35013
Super-Scaffold_189	14709633	14713806	4173	g_35013	g_35014
Super-Scaffold_189	14719688	14728039	8351	g_35014	g_35015
Super-Scaffold_189	14734933	14739200	4267	g_35015	g_35016
Super-Scaffold_189	14758490	14772324	13834	g_35016	g_35017
Super-Scaffold_189	14772665	14784508	11843	g_38962	g_35018
Super-Scaffold_189	14791148	14791157	9	g_35018	g_38963
Super-Scaffold_189	14791603	14805384	13781	g_38963	g_35020
Super-Scaffold_189	14818086	14819066	980	g_35020	g_35021
Super-Scaffold_189	14820992	14822742	1750	g_35021	g_35022
Super-Scaffold_189	14828858	14831811	2953	g_35022	g_35023
Super-Scaffold_189	14838520	14840050	1530	g_35023	g_35024
Super-Scaffold_189	14851372	14858602	7230	g_35024	g_35025
Super-Scaffold_189	14862810	14863430	620	g_35025	g_35026
Super-Scaffold_189	14873424	14878214	4790	g_35026	g_35027
Super-Scaffold_189	14887778	14896528	8750	g_35027	g_35029
Super-Scaffold_189	14900813	14900839	26	g_35029	g_45673
Super-Scaffold_189	14905874	14911232	5358	g_45673	g_35030
Super-Scaffold_189	14924852	14928197	3345	g_35030	g_35031
Super-Scaffold_189	14930235	14931607	1372	g_35031	g_35032
Super-Scaffold_189	14932497	14934890	2393	g_35032	g_35033
Super-Scaffold_189	14950668	14952637	1969	g_35033	g_35034
Super-Scaffold_189	14964215	14965379	1164	g_35034	g_35035
Super-Scaffold_189	14969198	14970917	1719	g_35035	g_45674
Super-Scaffold_189	14974061	14974379	318	g_45674	g_35036
Super-Scaffold_189	14980142	14982645	2503	g_35036	g_35037
Super-Scaffold_189	14986348	14988445	2097	g_35037	g_35038
Super-Scaffold_189	15001465	15001738	273	g_35038	g_35039
Super-Scaffold_189	15003202	15005420	2218	g_35039	g_35040
Super-Scaffold_189	15013313	15015409	2096	g_35040	g_35041
Super-Scaffold_189	15017985	15018605	620	g_35041	g_35042
Super-Scaffold_189	15024097	15026503	2406	g_35042	g_45675
Super-Scaffold_189	15028794	15030457	1663	g_45675	g_35043
Super-Scaffold_189	15031975	15036498	4523	g_35043	g_35044
Super-Scaffold_189	15037127	15048714	11587	g_35044	g_35045
Super-Scaffold_189	15070277	15093022	22745	g_35045	g_35046
Super-Scaffold_189	15105292	15110309	5017	g_35046	g_35047
Super-Scaffold_189	15111337	15119612	8275	g_35047	g_35048
Super-Scaffold_189	15128773	15129840	1067	g_35048	g_35049
Super-Scaffold_189	15131145	15133136	1991	g_35049	g_35050
Super-Scaffold_189	15149195	15188563	39368	g_35050	g_35052
Super-Scaffold_189	15201707	15207724	6017	g_35052	g_45676
Super-Scaffold_189	15217175	15219505	2330	g_45676	g_35053
Super-Scaffold_189	15230405	15235301	4896	g_35053	g_35054
Super-Scaffold_189	15236953	15244995	8042	g_38966	g_45677
Super-Scaffold_189	15249121	15257993	8872	g_45677	g_45678
Super-Scaffold_189	15265854	15270097	4243	g_45678	g_35055
Super-Scaffold_189	15292478	15294265	1787	g_35055	g_35056
Super-Scaffold_189	15302298	15315328	13030	g_35056	g_35057
Super-Scaffold_189	15318196	15320669	2473	g_35057	g_35058
Super-Scaffold_189	15325660	15328772	3112	g_35058	g_45679
Super-Scaffold_189	15339636	15341764	2128	g_45679	g_35059
Super-Scaffold_189	15349634	15352365	2731	g_35059	g_35060
Super-Scaffold_189	15360261	15361747	1486	g_35060	g_35061
Super-Scaffold_189	15365497	15366056	559	g_35061	g_35062
Super-Scaffold_189	15367548	15370009	2461	g_35062	g_45680
Super-Scaffold_189	15379537	15381692	2155	g_45680	g_45681
Super-Scaffold_189	15391236	15396078	4842	g_45681	g_35063
Super-Scaffold_189	15410689	15414832	4143	g_35063	g_35064
Super-Scaffold_189	15420526	15423239	2713	g_35064	g_35065
Super-Scaffold_189	15432612	15437750	5138	g_35065	g_35066
Super-Scaffold_189	15438025	15439717	1692	g_35066	g_35067
Super-Scaffold_189	15443643	15502900	59257	g_35067	g_35070
Super-Scaffold_189	15524480	15538033	13553	g_35070	g_35072
Super-Scaffold_189	15541160	15543661	2501	g_35072	g_35073
Super-Scaffold_189	15544845	15549367	4522	g_35073	g_35074
Super-Scaffold_189	15553058	15560277	7219	g_35074	g_35075
Super-Scaffold_189	15577248	15607567	30319	g_35075	g_35076
Super-Scaffold_189	15610417	15613580	3163	g_35076	g_35077
Super-Scaffold_189	15615060	15616372	1312	g_35077	g_35078
Super-Scaffold_189	15617818	15621127	3309	g_35078	g_35079
Super-Scaffold_189	15627222	15628633	1411	g_35079	g_45682
Super-Scaffold_189	15632375	15633024	649	g_45682	g_35080
Super-Scaffold_189	15635257	15636055	798	g_35080	g_35081
Super-Scaffold_189	15638917	15639898	981	g_35081	g_35082
Super-Scaffold_189	15645582	15645828	246	g_35082	g_35083
Super-Scaffold_189	15649218	15651448	2230	g_35083	g_45683
Super-Scaffold_189	15657828	15659627	1799	g_45683	g_35085
Super-Scaffold_189	15662092	15663927	1835	g_35085	g_35086
Super-Scaffold_189	15664687	15665213	526	g_35086	g_35087
Super-Scaffold_189	15669544	15671008	1464	g_35087	g_35088
Super-Scaffold_189	15689717	15749593	59876	g_35088	g_35091
Super-Scaffold_189	15766880	15797759	30879	g_35091	g_35094
Super-Scaffold_189	15798040	15820091	22051	g_35094	g_35095
Super-Scaffold_189	15823624	15827347	3723	g_35095	g_35096
Super-Scaffold_189	15834246	15836181	1935	g_35096	g_35097
Super-Scaffold_189	15842174	15877493	35319	g_35097	g_35099
Super-Scaffold_189	15878069	15879510	1441	g_35099	g_45684
Super-Scaffold_189	15899793	15900712	919	g_45684	g_35100
Super-Scaffold_189	15903178	15905498	2320	g_35100	g_35101
Super-Scaffold_189	15914482	15930501	16019	g_35101	g_35102
Super-Scaffold_189	15930950	15939216	8266	g_35102	g_35103
Super-Scaffold_189	15939749	16006743	66994	g_35103	g_35107
Super-Scaffold_189	16008341	16010133	1792	g_35107	g_35108
Super-Scaffold_189	16014649	16015269	620	g_35108	g_35109
Super-Scaffold_189	16019809	16020423	614	g_35109	g_35110
Super-Scaffold_189	16023691	16029177	5486	g_35110	g_35112
Super-Scaffold_189	16037435	16096052	58617	g_35112	g_35115
Super-Scaffold_189	16125830	16138917	13087	g_35115	g_35116
Super-Scaffold_189	16156807	16158983	2176	g_35116	g_35117
Super-Scaffold_189	16164477	16167986	3509	g_35117	g_38978
Super-Scaffold_189	16168192	16169836	1644	g_38978	g_35118
Super-Scaffold_189	16173753	16174615	862	g_35118	g_35119
Super-Scaffold_189	16178406	16178692	286	g_35119	g_35120
Super-Scaffold_189	16182898	16197719	14821	g_35120	g_35121
Super-Scaffold_189	16204562	16208406	3844	g_38979	g_35122
Super-Scaffold_189	16220356	16221293	937	g_35122	g_35123
Super-Scaffold_189	16228224	16233425	5201	g_35123	g_45685
Super-Scaffold_189	16235614	16236782	1168	g_45685	g_35124
Super-Scaffold_189	16239968	16240407	439	g_35124	g_45686
Super-Scaffold_189	16243035	16243258	223	g_45686	g_35125
Super-Scaffold_189	16249053	16289036	39983	g_35125	g_35127
Super-Scaffold_189	16300674	16303007	2333	g_35127	g_35128
Super-Scaffold_189	16305121	16315644	10523	g_35128	g_35129
Super-Scaffold_189	16316555	16329341	12786	g_35129	g_45687
Super-Scaffold_189	16337035	16340221	3186	g_45687	g_35130
Super-Scaffold_189	16342547	16344044	1497	g_35130	g_45688
Super-Scaffold_189	16346586	16346882	296	g_45688	g_35131
Super-Scaffold_189	16353962	16361874	7912	g_35131	g_35132
Super-Scaffold_189	16371292	16373323	2031	g_35132	g_35133
Super-Scaffold_189	16375888	16379258	3370	g_35133	g_45689
Super-Scaffold_189	16386422	16391226	4804	g_45689	g_35134
Super-Scaffold_189	16395697	16427473	31776	g_35134	g_35137
Super-Scaffold_189	16432268	16442536	10268	g_35137	g_35138
Super-Scaffold_189	16443845	16444973	1128	g_35138	g_35139
Super-Scaffold_189	16456704	16459999	3295	g_35139	g_35140
Super-Scaffold_189	16471256	16473730	2474	g_35140	g_35141
Super-Scaffold_189	16476869	16479926	3057	g_35141	g_35142
Super-Scaffold_189	16485849	16491455	5606	g_35142	g_35143
Super-Scaffold_189	16495138	16496256	1118	g_35143	g_35144
Super-Scaffold_189	16500705	16502806	2101	g_35144	g_35145
Super-Scaffold_189	16505470	16506105	635	g_35145	g_38981
Super-Scaffold_189	16507338	16509320	1982	g_38981	g_35146
Super-Scaffold_189	16511606	16512873	1267	g_35146	g_35147
Super-Scaffold_189	16530648	16549163	18515	g_35147	g_35148
Super-Scaffold_189	16560973	16574809	13836	g_35148	g_35149
Super-Scaffold_189	16594097	16613226	19129	g_35149	g_35152
Super-Scaffold_189	16627573	16628256	683	g_35152	g_35153
Super-Scaffold_189	16629530	16630989	1459	g_35153	g_35154
Super-Scaffold_189	16639888	16667470	27582	g_35154	g_35155
Super-Scaffold_189	16668411	16699771	31360	g_35155	g_35158
Super-Scaffold_189	16703076	16704298	1222	g_35158	g_45690
Super-Scaffold_189	16714448	16753757	39309	g_45690	g_35159
Super-Scaffold_189	16754059	16910210	156151	g_35159	g_35165
Super-Scaffold_189	16910425	16931934	21509	g_35165	g_35167
Super-Scaffold_189	16932225	16948328	16103	g_35167	g_35168
Super-Scaffold_189	16949674	17041920	92246	g_35168	g_35171
Super-Scaffold_189	17049998	17055420	5422	g_35171	g_35172
Super-Scaffold_189	17062190	17064369	2179	g_35172	g_35173
Super-Scaffold_189	17065127	17086895	21768	g_35173	g_35175
Super-Scaffold_189	17094070	17095565	1495	g_35175	g_35176
Super-Scaffold_189	17101631	17103093	1462	g_35176	g_38992
Super-Scaffold_189	17107072	17109794	2722	g_35177	g_35178
Super-Scaffold_189	17122271	17122531	260	g_35178	g_35179
Super-Scaffold_189	17166235	17167873	1638	g_35179	g_35180
Super-Scaffold_189	17169444	17170053	609	g_35180	g_45691
Super-Scaffold_189	17176249	17178742	2493	g_45691	g_35181
Super-Scaffold_189	17181735	17186022	4287	g_35181	g_35182
Super-Scaffold_189	17189949	17190826	877	g_35182	g_35183
Super-Scaffold_189	17191653	17192353	700	g_35183	g_35184
Super-Scaffold_189	17196029	17199540	3511	g_35184	g_35185
Super-Scaffold_189	17204993	17205690	697	g_35185	g_35186
Super-Scaffold_189	17214942	17215918	976	g_35186	g_35187
Super-Scaffold_189	17226882	17229060	2178	g_35187	g_35188
Super-Scaffold_189	17236062	17269000	32938	g_35188	g_35190
Super-Scaffold_189	17289442	17294328	4886	g_35190	g_35191
Super-Scaffold_189	17304197	17305032	835	g_35191	g_35192
Super-Scaffold_189	17307877	17311330	3453	g_35192	g_45692
Super-Scaffold_189	17329801	17350150	20349	g_45692	g_38996
Super-Scaffold_189	17350437	17369410	18973	g_38996	g_35193
Super-Scaffold_189	17370987	17372159	1172	g_35193	g_35194
Super-Scaffold_189	17375145	17386910	11765	g_35194	g_35195
Super-Scaffold_189	17399004	17400947	1943	g_35196	g_35197
Super-Scaffold_189	17406226	17465665	59439	g_35197	g_35200
Super-Scaffold_189	17485156	17488613	3457	g_35200	g_35201
Super-Scaffold_189	17497295	17498060	765	g_35201	g_35202
Super-Scaffold_189	17507373	17524142	16769	g_35202	g_45693
Super-Scaffold_189	17526071	17528477	2406	g_45693	g_35203
Super-Scaffold_189	17550379	17578367	27988	g_35203	g_35204
Super-Scaffold_189	17579118	17590927	11809	g_35204	g_45694
Super-Scaffold_189	17595759	17644805	49046	g_45694	g_35205
Super-Scaffold_189	17646005	17691195	45190	g_35205	g_35207
Super-Scaffold_189	17700956	17706981	6025	g_35207	g_35208
Super-Scaffold_189	17715966	17738893	22927	g_35208	g_35209
Super-Scaffold_189	17754179	17758140	3961	g_35209	g_35210
Super-Scaffold_189	17758574	17758701	127	g_35210	g_45695
Super-Scaffold_189	17768823	17846698	77875	g_45695	g_35211
Super-Scaffold_189	17848144	17914378	66234	g_35211	g_35214
Super-Scaffold_189	17914587	17980834	66247	g_35214	g_38999
Super-Scaffold_189	17981049	17999714	18665	g_38999	g_35215
Super-Scaffold_189	18000223	18039660	39437	g_35215	g_35216
Super-Scaffold_189	18043803	18098870	55067	g_35216	g_35217
Super-Scaffold_189	18099103	18101482	2379	g_35217	g_35218
Super-Scaffold_189	18101685	18130817	29132	g_35218	g_35219
Super-Scaffold_189	18131170	18131907	737	g_35219	g_35220
Super-Scaffold_189	18132239	18169676	37437	g_35220	g_39005
Super-Scaffold_189	18169924	18193772	23848	g_39005	g_35222
Super-Scaffold_189	18194017	18216104	22087	g_35222	g_35224
Super-Scaffold_189	18227331	18230419	3088	g_35224	g_35225
Super-Scaffold_189	18246152	18252987	6835	g_35225	g_35226
Super-Scaffold_189	18261958	18332824	70866	g_35226	g_35229
Super-Scaffold_189	18341627	18343758	2131	g_35229	g_35230
Super-Scaffold_189	18350148	18360852	10704	g_35230	g_35231
Super-Scaffold_189	18392682	18414845	22163	g_35231	g_35234
Super-Scaffold_189	18415084	18429315	14231	g_35234	g_35235
Super-Scaffold_189	18439438	18444393	4955	g_35235	g_35237
Super-Scaffold_189	18449317	18452030	2713	g_35237	g_35238
Super-Scaffold_189	18455600	18456336	736	g_35238	g_45696
Super-Scaffold_189	18459125	18461692	2567	g_45696	g_35239
Super-Scaffold_189	18476044	18481449	5405	g_35239	g_35240
Super-Scaffold_189	18502342	18518003	15661	g_35240	g_35241
Super-Scaffold_189	18524024	18526037	2013	g_35241	g_35242
Super-Scaffold_189	18528258	18532229	3971	g_35242	g_35243
Super-Scaffold_189	18536540	18538587	2047	g_35243	g_35244
Super-Scaffold_189	18565715	18567305	1590	g_35244	g_45697
Super-Scaffold_189	18601742	18605084	3342	g_45697	g_35245
Super-Scaffold_189	18621844	18630297	8453	g_35245	g_35247
Super-Scaffold_189	18630818	18631928	1110	g_35247	g_35248
Super-Scaffold_189	18638034	18639066	1032	g_35248	g_35249
Super-Scaffold_189	18646726	18648022	1296	g_35249	g_35250
Super-Scaffold_189	18653880	18659124	5244	g_35250	g_39011
Super-Scaffold_189	18675437	18683114	7677	g_35251	g_35252
Super-Scaffold_189	18686822	18694884	8062	g_35252	g_35253
Super-Scaffold_189	18714221	18717604	3383	g_35253	g_35254
Super-Scaffold_189	18726947	18727711	764	g_35254	g_35255
Super-Scaffold_189	18732177	18735786	3609	g_35255	g_39012
Super-Scaffold_189	18740152	18746794	6642	g_35256	g_35257
Super-Scaffold_189	18751281	18755285	4004	g_35257	g_45698
Super-Scaffold_189	18763032	18767035	4003	g_45698	g_35258
Super-Scaffold_189	18770826	18772456	1630	g_35258	g_35259
Super-Scaffold_189	18777922	18779126	1204	g_35259	g_35260
Super-Scaffold_189	18796395	18800141	3746	g_35260	g_35261
Super-Scaffold_189	18805690	18808906	3216	g_35261	g_35262
Super-Scaffold_189	18811310	18813746	2436	g_35262	g_35263
Super-Scaffold_189	18815817	18824513	8696	g_35263	g_35264
Super-Scaffold_189	18836065	18843530	7465	g_35264	g_35265
Super-Scaffold_189	18843874	18847730	3856	g_35265	g_35266
Super-Scaffold_189	18853096	18854191	1095	g_35266	g_35267
Super-Scaffold_189	18858079	18860162	2083	g_35267	g_35268
Super-Scaffold_189	18865336	18882833	17497	g_35268	g_35269
Super-Scaffold_189	18885921	18889456	3535	g_35269	g_35270
Super-Scaffold_189	18900694	18906042	5348	g_35270	g_35271
Super-Scaffold_189	18926001	18972307	46306	g_35271	g_35272
Super-Scaffold_189	18972525	18998008	25483	g_35272	g_35273
Super-Scaffold_189	19026021	19069100	43079	g_35273	g_35274
Super-Scaffold_189	19090647	19113844	23197	g_35274	g_35275
Super-Scaffold_189	19123376	19136347	12971	g_35275	g_35276
Super-Scaffold_189	19199447	19207886	8439	g_35276	g_35277
Super-Scaffold_189	19208119	19226072	17953	g_35277	g_35278
Super-Scaffold_189	19259202	19272056	12854	g_35278	g_35279
Super-Scaffold_189	19289632	19335768	46136	g_35279	g_35280
Super-Scaffold_189	19337762	19447673	109911	g_35280	g_35281
Super-Scaffold_189	19459177	19477463	18286	g_35281	g_35282
Super-Scaffold_189	19478045	19479255	1210	g_35282	g_35283
Super-Scaffold_189	19487089	19490708	3619	g_35283	g_35284
Super-Scaffold_189	19492751	19536166	43415	g_35284	g_35285
Super-Scaffold_189	19540428	19542901	2473	g_39016	g_35286
Super-Scaffold_189	19548426	19550217	1791	g_35286	g_35287
Super-Scaffold_189	19553126	19671773	118647	g_35287	g_35290
Super-Scaffold_189	19673217	19674529	1312	g_35290	g_45699
Super-Scaffold_189	19679547	19680644	1097	g_45699	g_35291
Super-Scaffold_189	19683600	19684930	1330	g_35291	g_35292
Super-Scaffold_189	19692827	19696107	3280	g_35292	g_35293
Super-Scaffold_189	19697066	19698795	1729	g_35293	g_35294
Super-Scaffold_189	19699298	19700747	1449	g_35294	g_35295
Super-Scaffold_189	19701874	19711668	9794	g_35295	g_35296
Super-Scaffold_189	19716929	19726696	9767	g_35296	g_35297
Super-Scaffold_189	19730381	19731514	1133	g_35297	g_35298
Super-Scaffold_189	19735933	19744817	8884	g_35298	g_35299
Super-Scaffold_189	19748268	19749066	798	g_35299	g_45700
Super-Scaffold_189	19751426	19753087	1661	g_45700	g_35300
Super-Scaffold_189	19755459	19760744	5285	g_35300	g_35301
Super-Scaffold_189	19770659	19773772	3113	g_35301	g_45701
Super-Scaffold_189	19776699	19818221	41522	g_45701	g_35303
Super-Scaffold_189	19818658	19837204	18546	g_35303	g_35304
Super-Scaffold_189	19851559	19972924	121365	g_35304	g_35308
Super-Scaffold_189	19977128	19979919	2791	g_35308	g_35309
Super-Scaffold_189	19994580	19995492	912	g_35309	g_35310
Super-Scaffold_189	19998987	20006058	7071	g_35310	g_35311
Super-Scaffold_189	20008105	20019747	11642	g_35311	g_35313
Super-Scaffold_189	20028123	20029626	1503	g_35313	g_35314
Super-Scaffold_189	20032578	20034739	2161	g_35314	g_45702
Super-Scaffold_189	20041737	20043391	1654	g_45702	g_35315
Super-Scaffold_189	20047333	20050606	3273	g_35315	g_35316
Super-Scaffold_189	20054273	20055756	1483	g_35316	g_35317
Super-Scaffold_189	20062227	20066730	4503	g_35317	g_35318
Super-Scaffold_189	20073477	20121925	48448	g_35318	g_35319
Super-Scaffold_189	20122899	20173757	50858	g_35319	g_35322
Super-Scaffold_189	20174008	20190455	16447	g_35322	g_35324
Super-Scaffold_189	20190718	20245333	54615	g_35324	g_35328
Super-Scaffold_189	20254808	20275865	21057	g_35328	g_35331
Super-Scaffold_189	20293358	20296048	2690	g_35331	g_35332
Super-Scaffold_189	20312096	20316257	4161	g_35332	g_35333
Super-Scaffold_189	20325761	20326987	1226	g_35333	g_35334
Super-Scaffold_189	20331219	20332495	1276	g_35334	g_35335
Super-Scaffold_189	20337112	20337271	159	g_35335	g_35336
Super-Scaffold_189	20338112	20340705	2593	g_35336	g_35337
Super-Scaffold_189	20353064	20384701	31637	g_35337	g_35339
Super-Scaffold_189	20384937	20390529	5592	g_35339	g_35340
Super-Scaffold_189	20391740	20395636	3896	g_35340	g_35341
Super-Scaffold_189	20412036	20417257	5221	g_35341	g_35342
Super-Scaffold_189	20441011	20444008	2997	g_35342	g_35343
Super-Scaffold_189	20449609	20475435	25826	g_35343	g_35344
Super-Scaffold_189	20480050	20482753	2703	g_35344	g_35345
Super-Scaffold_189	20483157	20486033	2876	g_35345	g_35346
Super-Scaffold_189	20496009	20505233	9224	g_35346	g_35347
Super-Scaffold_189	20508334	20509617	1283	g_35347	g_45703
Super-Scaffold_189	20512430	20513909	1479	g_45703	g_35348
Super-Scaffold_189	20517871	20517969	98	g_35348	g_35349
Super-Scaffold_189	20520836	20521064	228	g_35349	g_35350
Super-Scaffold_189	20527133	20529109	1976	g_35350	g_35351
Super-Scaffold_189	20531093	20534279	3186	g_35351	g_35352
Super-Scaffold_189	20550737	20555890	5153	g_35352	g_35353
Super-Scaffold_189	20563918	20567179	3261	g_35353	g_45704
Super-Scaffold_189	20568224	20570680	2456	g_45704	g_45705
Super-Scaffold_189	20574742	20643296	68554	g_45705	g_35355
Super-Scaffold_189	20662842	20669703	6861	g_35355	g_35356
Super-Scaffold_189	20678472	20695206	16734	g_35356	g_35357
Super-Scaffold_189	20697082	20699987	2905	g_35357	g_35358
Super-Scaffold_189	20712992	20732264	19272	g_35358	g_35360
Super-Scaffold_189	20740006	20743729	3723	g_35360	g_35361
Super-Scaffold_189	20748001	20750579	2578	g_35361	g_35362
Super-Scaffold_189	20765079	20772242	7163	g_35362	g_35363
Super-Scaffold_189	20772880	20773043	163	g_35363	g_35364
Super-Scaffold_189	20773648	20774932	1284	g_35364	g_35365
Super-Scaffold_189	20775228	20775432	204	g_35365	g_35366
Super-Scaffold_189	20775761	20776889	1128	g_35366	g_35367
Super-Scaffold_189	20777821	20777945	124	g_35367	g_35368
Super-Scaffold_189	20779300	20779359	59	g_35368	g_35369
Super-Scaffold_189	20780336	20785137	4801	g_35369	g_35371
Super-Scaffold_189	20786033	20790376	4343	g_35371	g_35372
Super-Scaffold_189	20792845	20806789	13944	g_35372	g_35373
Super-Scaffold_189	20809238	20814957	5719	g_35373	g_35374
Super-Scaffold_189	20816213	20827961	11748	g_35374	g_35375
Super-Scaffold_189	20831669	20834031	2362	g_35375	g_35376
Super-Scaffold_189	20842818	20846511	3693	g_35376	g_35377
Super-Scaffold_189	20863223	20865550	2327	g_35377	g_35378
Super-Scaffold_189	20886182	20887459	1277	g_35378	g_35379
Super-Scaffold_189	20890941	20893078	2137	g_35379	g_35380
Super-Scaffold_189	20910016	20921430	11414	g_35380	g_35381
Super-Scaffold_189	20934180	20938073	3893	g_35381	g_45706
Super-Scaffold_189	20950054	20952012	1958	g_45706	g_35382
Super-Scaffold_189	20957489	20965970	8481	g_35382	g_45707
Super-Scaffold_189	20977096	20982227	5131	g_45707	g_35383
Super-Scaffold_189	20992246	20994009	1763	g_35383	g_39029
Super-Scaffold_189	20996635	21004545	7910	g_35384	g_35385
Super-Scaffold_189	21008905	21024962	16057	g_35385	g_35386
Super-Scaffold_189	21043520	21046977	3457	g_35386	g_35387
Super-Scaffold_189	21058654	21111997	53343	g_35387	g_35388
Super-Scaffold_189	21121639	21128400	6761	g_35388	g_35390
Super-Scaffold_189	21132187	21134057	1870	g_35390	g_35391
Super-Scaffold_189	21135909	21140616	4707	g_35391	g_35392
Super-Scaffold_189	21146140	21157834	11694	g_35392	g_35393
Super-Scaffold_189	21163689	21176788	13099	g_35393	g_39031
Super-Scaffold_189	21177081	21184530	7449	g_39031	g_35395
Super-Scaffold_189	21196307	21264399	68092	g_35395	g_35397
Super-Scaffold_189	21265418	21410966	145548	g_35397	g_35400
Super-Scaffold_189	21421977	21427118	5141	g_35400	g_35401
Super-Scaffold_189	21431417	21433483	2066	g_35401	g_35402
Super-Scaffold_189	21441513	21444002	2489	g_35402	g_35403
Super-Scaffold_189	21454354	21454458	104	g_35403	g_35404
Super-Scaffold_189	21465101	21466516	1415	g_35404	g_35405
Super-Scaffold_189	21467823	21493028	25205	g_35405	g_35408
Super-Scaffold_189	21499340	21503187	3847	g_35408	g_35409
Super-Scaffold_189	21504269	21512659	8390	g_35409	g_35410
Super-Scaffold_189	21520123	21521230	1107	g_35410	g_35411
Super-Scaffold_189	21522765	21523100	335	g_35411	g_35412
Super-Scaffold_189	21525866	21527425	1559	g_35412	g_35413
Super-Scaffold_189	21534950	21539652	4702	g_35413	g_35414
Super-Scaffold_189	21553643	21553756	113	g_35414	g_35415
Super-Scaffold_189	21553989	21558699	4710	g_35415	g_35416
Super-Scaffold_189	21576513	21625013	48500	g_35416	g_39039
Super-Scaffold_189	21625372	21632728	7356	g_39039	g_35418
Super-Scaffold_189	21641092	21642402	1310	g_35418	g_45708
Super-Scaffold_189	21644571	21657347	12776	g_45708	g_35419
Super-Scaffold_189	21661482	21664042	2560	g_35419	g_35420
Super-Scaffold_189	21665637	21806646	141009	g_35420	g_35424
Super-Scaffold_189	21806909	21877585	70676	g_35424	g_39040
Super-Scaffold_189	21877800	21966158	88358	g_39040	g_35426
Super-Scaffold_189	21968101	22236600	268499	g_35426	g_35427
Super-Scaffold_189	22239970	22310993	71023	g_35427	g_35428
Super-Scaffold_189	22315906	22324834	8928	g_35428	g_35429
Super-Scaffold_189	22334014	22393320	59306	g_35429	g_35430
Super-Scaffold_189	22403121	22410295	7174	g_35430	g_35431
Super-Scaffold_189	22417908	22421403	3495	g_35431	g_35432
Super-Scaffold_189	22421750	22422701	951	g_35432	g_39046
Super-Scaffold_189	22422931	22429131	6200	g_39046	g_35433
Super-Scaffold_189	22429334	22455001	25667	g_35433	g_35434
Super-Scaffold_189	22473090	22489420	16330	g_35434	g_35435
Super-Scaffold_189	22490715	22516968	26253	g_35435	g_35436
Super-Scaffold_189	22559812	22676219	116407	g_35436	g_35440
Super-Scaffold_189	22676632	22733609	56977	g_35440	g_35442
Super-Scaffold_189	22734205	22740625	6420	g_35442	g_35443
Super-Scaffold_189	22743464	22746135	2671	g_35443	g_35444
Super-Scaffold_189	22757425	22764411	6986	g_35444	g_45709
Super-Scaffold_189	22770317	22785777	15460	g_45709	g_35446
Super-Scaffold_189	22786163	22803011	16848	g_35446	g_35447
Super-Scaffold_189	22813142	22822678	9536	g_35447	g_35448
Super-Scaffold_189	22826596	22832606	6010	g_35448	g_35449
Super-Scaffold_189	22839613	22842178	2565	g_35449	g_35450
Super-Scaffold_189	22848061	22875932	27871	g_35450	g_35451
Super-Scaffold_189	22876132	22952457	76325	g_35451	g_39053
Super-Scaffold_189	22952657	23040900	88243	g_39053	g_35456
Super-Scaffold_189	23081471	23086378	4907	g_35456	g_35457
Super-Scaffold_189	23097672	23190739	93067	g_35457	g_35459
Super-Scaffold_189	23190981	23270495	79514	g_35459	g_35464
Super-Scaffold_189	23278389	23279649	1260	g_35464	g_45710
Super-Scaffold_189	23284000	23286406	2406	g_45710	g_35465
Super-Scaffold_189	23296312	23341317	45005	g_35465	g_35467
Super-Scaffold_189	23354731	23363168	8437	g_35467	g_35468
Super-Scaffold_189	23377921	23395443	17522	g_35468	g_35470
Super-Scaffold_189	23411796	23429141	17345	g_35470	g_35472
Super-Scaffold_189	23429422	23490323	60901	g_35472	g_35476
Super-Scaffold_189	23491396	23528299	36903	g_35476	g_35477
Super-Scaffold_189	23533080	23536765	3685	g_35477	g_35478
Super-Scaffold_189	23542072	23556732	14660	g_35478	g_35479
Super-Scaffold_189	23557139	23576794	19655	g_35479	g_35480
Super-Scaffold_189	23584595	23603826	19231	g_35480	g_35481
Super-Scaffold_189	23604242	23609078	4836	g_35481	g_35482
Super-Scaffold_189	23609320	23628894	19574	g_35482	g_35483
Super-Scaffold_189	23646672	23684831	38159	g_35483	g_35484
Super-Scaffold_189	23704270	23729680	25410	g_35484	g_35485
Super-Scaffold_189	23729892	23755893	26001	g_35485	g_35486
Super-Scaffold_189	23764678	23800302	35624	g_35486	g_35490
Super-Scaffold_189	23808826	23825359	16533	g_35490	g_35491
Super-Scaffold_189	23826183	23887874	61691	g_35491	g_35493
Super-Scaffold_189	23897203	23899667	2464	g_35493	g_35494
Super-Scaffold_189	23900824	23901976	1152	g_35494	g_35495
Super-Scaffold_189	23972533	23977848	5315	g_35495	g_35496
Super-Scaffold_189	23996042	23997509	1467	g_35496	g_35497
Super-Scaffold_189	24000997	24002050	1053	g_35497	g_35498
Super-Scaffold_189	24008275	24009605	1330	g_35498	g_35499
Super-Scaffold_189	24011790	24013028	1238	g_35499	g_35500
Super-Scaffold_189	24015914	24019448	3534	g_35500	g_35501
Super-Scaffold_189	24023677	24025003	1326	g_35501	g_35502
Super-Scaffold_189	24028663	24029794	1131	g_35502	g_45711
Super-Scaffold_189	24032517	24033374	857	g_45711	g_35503
Super-Scaffold_189	24038897	24039332	435	g_35503	g_35504
Super-Scaffold_189	24051594	24053365	1771	g_35504	g_35505
Super-Scaffold_189	24060036	24060428	392	g_35505	g_35506
Super-Scaffold_189	24061702	24064605	2903	g_35506	g_35507
Super-Scaffold_189	24065429	24068614	3185	g_35507	g_35508
Super-Scaffold_189	24076098	24078681	2583	g_35508	g_35509
Super-Scaffold_189	24091887	24093923	2036	g_35509	g_35510
Super-Scaffold_189	24101559	24155651	54092	g_35510	g_35511
Super-Scaffold_189	24156655	24171414	14759	g_35511	g_35513
Super-Scaffold_189	24171698	24171893	195	g_35513	g_35514
Super-Scaffold_189	24172246	24182277	10031	g_35514	g_35516
Super-Scaffold_189	24182951	24183108	157	g_35516	g_35515
Super-Scaffold_189	24183869	24186971	3102	g_35515	g_35518
Super-Scaffold_189	24188077	24208437	20360	g_35518	g_35520
Super-Scaffold_189	24209785	24215269	5484	g_35520	g_35521
Super-Scaffold_189	24219396	24249135	29739	g_35521	g_35522
Super-Scaffold_189	24252369	24255576	3207	g_35522	g_39065
Super-Scaffold_189	24255797	24280876	25079	g_39065	g_35523
Super-Scaffold_189	24282405	24287310	4905	g_35523	g_35524
Super-Scaffold_189	24288437	24292771	4334	g_35524	g_35525
Super-Scaffold_189	24295917	24298282	2365	g_35525	g_35526
Super-Scaffold_189	24307909	24312467	4558	g_35526	g_35527
Super-Scaffold_189	24319178	24326108	6930	g_35527	g_45712
Super-Scaffold_189	24345031	24350306	5275	g_45712	g_45713
Super-Scaffold_189	24359699	24360569	870	g_45713	g_35528
Super-Scaffold_189	24367922	24373018	5096	g_35528	g_35529
Super-Scaffold_189	24392068	24399774	7706	g_35529	g_39067
Super-Scaffold_189	24400034	24419588	19554	g_39067	g_35531
Super-Scaffold_189	24425767	24427989	2222	g_35531	g_35532
Super-Scaffold_189	24432422	24434393	1971	g_35532	g_35533
Super-Scaffold_189	24450457	24452702	2245	g_35533	g_35534
Super-Scaffold_189	24454492	24456302	1810	g_35534	g_35535
Super-Scaffold_189	24459642	24460962	1320	g_35535	g_35536
Super-Scaffold_189	24466268	24471734	5466	g_35536	g_35537
Super-Scaffold_189	24475665	24476246	581	g_35537	g_35538
Super-Scaffold_189	24492813	24495682	2869	g_35538	g_35539
Super-Scaffold_189	24506223	24553336	47113	g_35539	g_35541
Super-Scaffold_189	24554523	24567643	13120	g_35541	g_35543
Super-Scaffold_189	24582754	24607429	24675	g_35543	g_35545
Super-Scaffold_189	24610016	24624069	14053	g_35545	g_35546
Super-Scaffold_189	24633958	24670933	36975	g_35546	g_35548
Super-Scaffold_189	24671256	24671774	518	g_35548	g_35549
Super-Scaffold_189	24672076	24672148	72	g_35549	g_35550
Super-Scaffold_189	24672552	24783309	110757	g_35550	g_39071
Super-Scaffold_189	24783515	24784814	1299	g_39071	g_35553
Super-Scaffold_189	24785065	24793271	8206	g_35553	g_35554
Super-Scaffold_189	24793663	24827394	33731	g_35554	g_35556
Super-Scaffold_189	24828413	24886070	57657	g_35556	g_35557
Super-Scaffold_189	24906331	25205865	299534	g_35557	g_35563
Super-Scaffold_189	25224312	25235414	11102	g_35563	g_35564
Super-Scaffold_189	25250880	25251511	631	g_35564	g_35565
Super-Scaffold_189	25262958	25274424	11466	g_35565	g_35566
Super-Scaffold_189	25293765	25296027	2262	g_35566	g_35567
Super-Scaffold_189	25321892	25378943	57051	g_35567	g_35569
Super-Scaffold_189	25415909	25425267	9358	g_35569	g_35570
Super-Scaffold_189	25450874	25462517	11643	g_35570	g_39077
Super-Scaffold_189	25462753	25480771	18018	g_39077	g_35572
Super-Scaffold_189	25482683	25580128	97445	g_35572	g_39079
Super-Scaffold_189	25580349	25583880	3531	g_39079	g_35575
Super-Scaffold_189	25586260	25592192	5932	g_35575	g_35576
Super-Scaffold_189	25598375	25599604	1229	g_35576	g_35577
Super-Scaffold_189	25608851	25609763	912	g_35577	g_35578
Super-Scaffold_189	25616498	25701567	85069	g_39080	g_35582
Super-Scaffold_189	25701884	25707837	5953	g_35582	g_35584
Super-Scaffold_189	25711055	25711465	410	g_35584	g_35585
Super-Scaffold_189	25713095	25714362	1267	g_39081	g_35586
Super-Scaffold_189	25714876	25717505	2629	g_35586	g_35587
Super-Scaffold_189	25725342	25738850	13508	g_35587	g_35588
Super-Scaffold_189	25754179	25778975	24796	g_35588	g_35591
Super-Scaffold_189	25785286	25790737	5451	g_35591	g_35592
Super-Scaffold_189	25791507	25895805	104298	g_35592	g_35596
Super-Scaffold_189	25907725	25913160	5435	g_35596	g_39087
Super-Scaffold_189	25913495	25933460	19965	g_39087	g_35597
Super-Scaffold_189	25934467	25934646	179	g_35597	g_35598
Super-Scaffold_189	25934888	25942135	7247	g_35598	g_35599
Super-Scaffold_189	25959109	25981095	21986	g_35599	g_35602
Super-Scaffold_189	25987487	25989287	1800	g_35602	g_35603
Super-Scaffold_189	25997090	25999562	2472	g_35603	g_45714
Super-Scaffold_189	26003977	26006949	2972	g_45714	g_35604
Super-Scaffold_189	26013669	26015891	2222	g_35604	g_39088
Super-Scaffold_189	26016166	26018661	2495	g_39088	g_45715
Super-Scaffold_189	26023165	26099084	75919	g_45715	g_35606
Super-Scaffold_189	26099284	26106470	7186	g_35606	g_35607
Super-Scaffold_189	26107333	26125232	17899	g_35607	g_35608
Super-Scaffold_189	26130492	26132992	2500	g_35608	g_35609
Super-Scaffold_189	26147247	26151274	4027	g_35609	g_45716
Super-Scaffold_189	26151483	26165117	13634	g_45716	g_35611
Super-Scaffold_189	26167619	26169217	1598	g_35611	g_35612
Super-Scaffold_189	26171019	26171199	180	g_35612	g_35613
Super-Scaffold_189	26171672	26272817	101145	g_35613	g_35617
Super-Scaffold_189	26273687	26289495	15808	g_35617	g_35618
Super-Scaffold_189	26289818	26395963	106145	g_35618	g_35621
Super-Scaffold_189	26430208	26435733	5525	g_35621	g_35622
Super-Scaffold_189	26448807	26978586	529779	g_35622	g_39091
Super-Scaffold_189	26978795	27175853	197058	g_39091	g_39092
Super-Scaffold_189	27176143	27180124	3981	g_39092	g_35629
Super-Scaffold_189	27180537	27186236	5699	g_35629	g_35630
Super-Scaffold_189	27186568	27327993	141425	g_35630	g_35634
Super-Scaffold_189	27334095	27337290	3195	g_35634	g_35636
Super-Scaffold_189	27338520	27346593	8073	g_35636	g_35637
Super-Scaffold_189	27349862	27354160	4298	g_35637	g_35639
Super-Scaffold_189	27370761	27399174	28413	g_35639	g_35640
Super-Scaffold_189	27413818	27416626	2808	g_35640	g_35641
Super-Scaffold_189	27419343	27420762	1419	g_35641	g_45717
Super-Scaffold_189	27423317	27432453	9136	g_45717	g_35642
Super-Scaffold_189	27449877	27452501	2624	g_35642	g_35643
Super-Scaffold_189	27460564	27463072	2508	g_35643	g_35644
Super-Scaffold_189	27485415	27493607	8192	g_35644	g_35645
Super-Scaffold_189	27505243	27506488	1245	g_35645	g_35646
Super-Scaffold_189	27509452	27514143	4691	g_35646	g_35647
Super-Scaffold_189	27529600	27540765	11165	g_35647	g_45718
Super-Scaffold_189	27542661	27550706	8045	g_45718	g_35648
Super-Scaffold_189	27551383	27582098	30715	g_35648	g_35650
Super-Scaffold_189	27584378	27585393	1015	g_35650	g_35651
Super-Scaffold_189	27585795	27589224	3429	g_35651	g_35652
Super-Scaffold_189	27600155	27602865	2710	g_35652	g_45719
Super-Scaffold_189	27605727	27608161	2434	g_45719	g_35653
Super-Scaffold_189	27624097	27629604	5507	g_35653	g_35654
Super-Scaffold_189	27637419	27651917	14498	g_35654	g_35655
Super-Scaffold_189	27671561	27714931	43370	g_35655	g_35656
Super-Scaffold_189	27728196	27740123	11927	g_35656	g_35657
Super-Scaffold_189	27740377	27756679	16302	g_35657	g_35658
Super-Scaffold_189	27756909	27859785	102876	g_35658	g_35659
Super-Scaffold_189	27866136	27878955	12819	g_35659	g_35660
Super-Scaffold_189	27885336	27917514	32178	g_35660	g_35661
Super-Scaffold_189	27926570	27935139	8569	g_35661	g_35662
Super-Scaffold_189	27976349	28005496	29147	g_35662	g_35663
Super-Scaffold_189	28015290	28018420	3130	g_35663	g_35664
Super-Scaffold_189	28021923	28025027	3104	g_35664	g_45720
Super-Scaffold_189	28026128	28037920	11792	g_45720	g_35665
Super-Scaffold_189	28051646	28060591	8945	g_35665	g_35666
Super-Scaffold_189	28061511	28064440	2929	g_35666	g_35667
Super-Scaffold_189	28064817	28065554	737	g_35667	g_35668
Super-Scaffold_189	28065865	28069098	3233	g_35668	g_35669
Super-Scaffold_189	28070389	28075284	4895	g_35669	g_35670
Super-Scaffold_189	28091453	28099147	7694	g_35670	g_35671
Super-Scaffold_189	28111431	28154467	43036	g_35671	g_35672
Super-Scaffold_189	28154679	28243809	89130	g_35672	g_35673
Super-Scaffold_189	28253398	28258318	4920	g_35673	g_35674
Super-Scaffold_189	28281381	28292406	11025	g_35674	g_35675
Super-Scaffold_189	28292675	28293268	593	g_35675	g_35676
Super-Scaffold_189	28307339	28336581	29242	g_35676	g_35677
Super-Scaffold_189	28354874	28463755	108881	g_35677	g_45721
Super-Scaffold_189	28465350	28470345	4995	g_45721	g_35679
Super-Scaffold_189	28470815	28487928	17113	g_35679	g_35681
Super-Scaffold_189	28488269	28652242	163973	g_35681	g_35683
Super-Scaffold_189	28655811	28869767	213956	g_35683	g_35686
Super-Scaffold_189	28870139	28871162	1023	g_35686	g_35687
Super-Scaffold_189	28871443	28941017	69574	g_35687	g_35692
Super-Scaffold_189	28941217	28948274	7057	g_35692	g_35693
Super-Scaffold_189	28964521	28998935	34414	g_35693	g_35695
Super-Scaffold_189	28999426	29051192	51766	g_35695	g_35698
Super-Scaffold_189	29058546	29062207	3661	g_35698	g_35699
Super-Scaffold_189	29081769	29084435	2666	g_35699	g_35700
Super-Scaffold_189	29087023	29118201	31178	g_35700	g_35702
Super-Scaffold_189	29124337	29146818	22481	g_35702	g_35703
Super-Scaffold_189	29180976	29201406	20430	g_35703	g_45722
Super-Scaffold_189	29201757	29222954	21197	g_45722	g_35704
Super-Scaffold_189	29259287	29309542	50255	g_35704	g_39104
Super-Scaffold_189	29311816	29329796	17980	g_39104	g_35705
Super-Scaffold_189	29336130	29355382	19252	g_35705	g_35706
Super-Scaffold_189	29355876	29383818	27942	g_35706	g_35708
Super-Scaffold_189	29398591	29404179	5588	g_35708	g_35709
Super-Scaffold_189	29416075	29420510	4435	g_35709	g_35710
Super-Scaffold_189	29426396	29433909	7513	g_35710	g_35711
Super-Scaffold_189	29434958	29434973	15	g_35711	g_35712
Super-Scaffold_189	29436373	29436410	37	g_35712	g_35713
Super-Scaffold_189	29437276	29437901	625	g_35713	g_35714
Super-Scaffold_189	29551338	29553361	2023	g_35714	g_35715
Super-Scaffold_189	29553765	29575424	21659	g_35715	g_35716
Super-Scaffold_189	29576179	29576246	67	g_35716	g_35717
Super-Scaffold_189	29577520	29680806	103286	g_35717	g_35719
Super-Scaffold_189	29681246	29681400	154	g_35719	g_35718
Super-Scaffold_189	29690944	29699060	8116	g_35718	g_35720
Super-Scaffold_189	29711171	29738625	27454	g_35720	g_35723
Super-Scaffold_189	29766131	29789652	23521	g_35723	g_35724
Super-Scaffold_189	29796675	29839638	42963	g_35724	g_39106
Super-Scaffold_189	29839898	29940001	100103	g_39106	g_35727
Super-Scaffold_189	29967103	29971184	4081	g_35727	g_35728
Super-Scaffold_189	29978116	29982074	3958	g_35728	g_35729
Super-Scaffold_189	29994215	30059715	65500	g_35729	g_39107
Super-Scaffold_189	30059936	30083675	23739	g_39107	g_35733
Super-Scaffold_189	30092809	30093030	221	g_35733	g_35734
Super-Scaffold_189	30093299	30132344	39045	g_35734	g_35735
Super-Scaffold_189	30142485	30150151	7666	g_35735	g_35736
Super-Scaffold_189	30164475	30167133	2658	g_35736	g_39108
Super-Scaffold_189	30168101	30202625	34524	g_39108	g_45723
Super-Scaffold_189	30205648	30235031	29383	g_45723	g_35739
Super-Scaffold_189	30238181	30256507	18326	g_35739	g_35740
Super-Scaffold_189	30256905	30257296	391	g_35740	g_35741
Super-Scaffold_189	30257607	30271309	13702	g_35741	g_35742
Super-Scaffold_189	30280188	30300955	20767	g_35742	g_35743
Super-Scaffold_189	30330278	30347510	17232	g_35743	g_35744
Super-Scaffold_189	30356195	30363905	7710	g_35744	g_35745
Super-Scaffold_189	30380001	30383316	3315	g_35745	g_35746
Super-Scaffold_189	30395758	30399837	4079	g_35746	g_35747
Super-Scaffold_189	30410739	30413160	2421	g_35747	g_35748
Super-Scaffold_189	30418982	30427540	8558	g_35748	g_35750
Super-Scaffold_189	30427834	30428438	604	g_35750	g_35749
Super-Scaffold_189	30437215	30438517	1302	g_35749	g_35751
Super-Scaffold_189	30441469	30443060	1591	g_35751	g_45724
Super-Scaffold_189	30454950	30478087	23137	g_35752	g_35754
Super-Scaffold_189	30478404	30515090	36686	g_35754	g_35755
Super-Scaffold_189	30515389	30519449	4060	g_35755	g_45725
Super-Scaffold_189	30539227	30552769	13542	g_45725	g_35756
Super-Scaffold_189	30553101	30557867	4766	g_35756	g_35757
Super-Scaffold_189	30567611	30591370	23759	g_35757	g_35758
Super-Scaffold_189	30592491	30595900	3409	g_35758	g_35760
Super-Scaffold_189	30608123	30610851	2728	g_35760	g_35761
Super-Scaffold_189	30628207	30637396	9189	g_35761	g_35762
Super-Scaffold_189	30659903	30687837	27934	g_35762	g_35763
Super-Scaffold_189	30712195	30715289	3094	g_35763	g_35764
Super-Scaffold_189	30726825	30728546	1721	g_35764	g_45726
Super-Scaffold_189	30744118	30754943	10825	g_45726	g_35765
Super-Scaffold_189	30756772	30772401	15629	g_35765	g_45727
Super-Scaffold_189	30793515	30830269	36754	g_45727	g_35767
Super-Scaffold_189	30830580	30842678	12098	g_35767	g_35768
Super-Scaffold_189	30855685	30932053	76368	g_35768	g_45728
Super-Scaffold_189	30939346	30954908	15562	g_45728	g_35770
Super-Scaffold_189	30955869	31007842	51973	g_35770	g_35771
Super-Scaffold_189	31009308	31047268	37960	g_35771	g_39112
Super-Scaffold_189	31048013	31107712	59699	g_35772	g_35773
Super-Scaffold_189	31130696	31300076	169380	g_35773	g_35776
Super-Scaffold_189	31301323	31461388	160065	g_35776	g_35780
Super-Scaffold_189	31466873	31468702	1829	g_35780	g_45729
Super-Scaffold_189	31476036	31482963	6927	g_45729	g_35781
Super-Scaffold_189	31483838	31608987	125149	g_35781	g_35784
Super-Scaffold_189	31610408	31621297	10889	g_35784	g_35785
Super-Scaffold_189	31632634	31644569	11935	g_35785	g_35787
Super-Scaffold_189	31651409	31689249	37840	g_35787	g_35788
Super-Scaffold_189	31714222	31716904	2682	g_35788	g_35789
Super-Scaffold_189	31730693	31734869	4176	g_35789	g_35790
Super-Scaffold_189	31769384	31808530	39146	g_35790	g_35792
Super-Scaffold_189	31817082	31840311	23229	g_35792	g_35793
Super-Scaffold_189	31840526	31844017	3491	g_35793	g_35794
Super-Scaffold_189	31878481	31884569	6088	g_35794	g_45730
Super-Scaffold_189	31909051	31916430	7379	g_45730	g_35795
Super-Scaffold_189	31916684	31940170	23486	g_35795	g_35796
Super-Scaffold_189	31941084	31943118	2034	g_35796	g_35797
Super-Scaffold_189	31949633	31959502	9869	g_35797	g_35798
Super-Scaffold_189	31960833	31999686	38853	g_35798	g_35800
Super-Scaffold_189	32000036	32037715	37679	g_35800	g_35802
Super-Scaffold_189	32039655	32074757	35102	g_35802	g_35805
Super-Scaffold_189	32079695	32095062	15367	g_35805	g_35806
Super-Scaffold_189	32096374	32096401	27	g_35806	g_45731
Super-Scaffold_189	32098507	32101077	2570	g_45731	g_35807
Super-Scaffold_189	32156305	32307373	151068	g_35807	g_35810
Super-Scaffold_189	32309126	32309477	351	g_35810	g_35811
Super-Scaffold_189	32310970	32311128	158	g_35811	g_45732
Super-Scaffold_189	32312104	32427384	115280	g_45732	g_35815
Super-Scaffold_189	32428748	32428813	65	g_35815	g_35816
Super-Scaffold_189	32430450	32548668	118218	g_35816	g_35819
Super-Scaffold_189	32548949	32559871	10922	g_35819	g_35820
Super-Scaffold_189	32560251	32632215	71964	g_35820	g_35821
Super-Scaffold_189	32632556	32705737	73181	g_35821	g_35824
Super-Scaffold_189	32705943	32706114	171	g_35824	g_45733
Super-Scaffold_189	32730014	32753831	23817	g_45733	g_35825
Super-Scaffold_189	32771014	32777213	6199	g_35825	g_35826
Super-Scaffold_189	32786878	32800910	14032	g_35826	g_35827
Super-Scaffold_189	32807640	32827036	19396	g_35827	g_35828
Super-Scaffold_189	32840643	32902184	61541	g_35828	g_35829
Super-Scaffold_189	32902633	32916567	13934	g_35829	g_35830
Super-Scaffold_189	32917715	32952746	35031	g_35830	g_35831
Super-Scaffold_189	32960863	32962672	1809	g_35831	g_35832
Super-Scaffold_189	32970113	32973602	3489	g_35832	g_35833
Super-Scaffold_189	32978458	33032579	54121	g_35833	g_35834
Super-Scaffold_189	33053251	33072035	18784	g_35834	g_45734
Super-Scaffold_189	33093011	33138090	45079	g_45734	g_35835
Super-Scaffold_189	33140183	33147128	6945	g_35835	g_35836
Super-Scaffold_189	33152371	33176272	23901	g_35836	g_35837
Super-Scaffold_189	33177718	33191869	14151	g_35837	g_35838
Super-Scaffold_189	33215829	33222441	6612	g_35838	g_35839
Super-Scaffold_189	33242431	33254635	12204	g_35839	g_35840
Super-Scaffold_189	33257042	33264356	7314	g_35840	g_35842
Super-Scaffold_189	33264787	33265000	213	g_35842	g_35841
Super-Scaffold_189	33265980	33277906	11926	g_35841	g_35844
Super-Scaffold_189	33287945	33329284	41339	g_35844	g_35845
Super-Scaffold_189	33348570	33360139	11569	g_35845	g_35846
Super-Scaffold_189	33410085	33449175	39090	g_35846	g_35847
Super-Scaffold_189	33452570	33499196	46626	g_35847	g_35849
Super-Scaffold_189	33499606	33542907	43301	g_35849	g_35850
Super-Scaffold_189	33543113	33568578	25465	g_35850	g_35851
Super-Scaffold_189	33569186	33574456	5270	g_35851	g_35852
Super-Scaffold_189	33574998	33584700	9702	g_35852	g_35853
Super-Scaffold_189	33585574	33634141	48567	g_35853	g_35854
Super-Scaffold_189	33635325	33744119	108794	g_35854	g_35859
Super-Scaffold_189	33747015	33775436	28421	g_35859	g_35860
Super-Scaffold_189	33775936	33814912	38976	g_35860	g_35861
Super-Scaffold_189	33816975	33822715	5740	g_35861	g_35862
Super-Scaffold_189	33826920	33862335	35415	g_35862	g_35863
Super-Scaffold_189	33863090	33863269	179	g_35863	g_35864
Super-Scaffold_189	33863622	33865501	1879	g_35864	g_35865
Super-Scaffold_189	33865968	33877704	11736	g_35865	g_35866
Super-Scaffold_189	33901715	33930375	28660	g_35866	g_35867
Super-Scaffold_189	33930593	33936820	6227	g_35867	g_35868
Super-Scaffold_189	33937230	34102726	165496	g_35868	g_35871
Super-Scaffold_189	34103816	34108213	4397	g_39127	g_35872
Super-Scaffold_189	34143477	34166761	23284	g_35872	g_35874
Super-Scaffold_189	34170177	34173284	3107	g_35874	g_35875
Super-Scaffold_189	34195112	34196941	1829	g_35875	g_35876
Super-Scaffold_189	34204414	34208966	4552	g_35876	g_35877
Super-Scaffold_189	34215068	34219794	4726	g_35877	g_35878
Super-Scaffold_189	34241622	34249751	8129	g_35878	g_35879
Super-Scaffold_189	34250176	34250530	354	g_35879	g_35880
Super-Scaffold_189	34251015	34343420	92405	g_35880	g_35883
Super-Scaffold_189	34349457	34432569	83112	g_35883	g_35885
Super-Scaffold_189	34440948	34443610	2662	g_35885	g_35886
Super-Scaffold_189	34444116	34449447	5331	g_35886	g_35887
Super-Scaffold_189	34464883	34469912	5029	g_35887	g_35888
Super-Scaffold_189	34486225	34489764	3539	g_35888	g_35889
Super-Scaffold_189	34492762	34638759	145997	g_35889	g_35890
Super-Scaffold_189	34648005	34755942	107937	g_35890	g_39133
Super-Scaffold_189	34756184	34814428	58244	g_39133	g_35893
Super-Scaffold_189	34815616	34837597	21981	g_35893	g_35894
Super-Scaffold_189	34859528	34874943	15415	g_35894	g_35895
Super-Scaffold_189	34893461	35013138	119677	g_35895	g_35897
Super-Scaffold_189	35014584	35018428	3844	g_35897	g_35898
Super-Scaffold_189	35047304	35050680	3376	g_35898	g_39136
Super-Scaffold_189	35051411	35073156	21745	g_39136	g_35900
Super-Scaffold_189	35075545	35127528	51983	g_35900	g_35902
Super-Scaffold_189	35127737	35167977	40240	g_35902	g_35905
Super-Scaffold_189	35168216	35186397	18181	g_35905	g_35906
Super-Scaffold_189	35199309	35201310	2001	g_35906	g_35907
Super-Scaffold_189	35203118	35208351	5233	g_35907	g_35908
Super-Scaffold_189	35209499	35238205	28706	g_35908	g_35909
Super-Scaffold_189	35249882	35260101	10219	g_35909	g_35910
Super-Scaffold_189	35261974	35269718	7744	g_35910	g_35911
Super-Scaffold_189	35270694	35337212	66518	g_35911	g_35912
Super-Scaffold_189	35337616	35337714	98	g_35912	g_35913
Super-Scaffold_189	35337959	35379403	41444	g_35913	g_35917
Super-Scaffold_189	35380734	35399446	18712	g_35917	g_35916
Super-Scaffold_189	35405803	35552915	147112	g_35916	g_35919
Super-Scaffold_189	35553571	35597411	43840	g_35919	g_35920
Super-Scaffold_189	35606963	35631467	24504	g_35920	g_35923
Super-Scaffold_189	35637501	35644051	6550	g_35923	g_35925
Super-Scaffold_189	35644977	35645704	727	g_35925	g_35924
Super-Scaffold_189	35645907	35653801	7894	g_35924	g_35926
Super-Scaffold_189	35677211	35685801	8590	g_35926	g_35927
Super-Scaffold_189	35688419	35696613	8194	g_35927	g_35928
Super-Scaffold_189	35709931	35710471	540	g_35928	g_35929
Super-Scaffold_189	35713974	35761614	47640	g_35929	g_35931
Super-Scaffold_189	35762492	35763574	1082	g_35931	g_35932
Super-Scaffold_189	35764074	35779318	15244	g_35932	g_35933
Super-Scaffold_189	35782020	35789475	7455	g_35933	g_35935
Super-Scaffold_189	35789852	35795496	5644	g_35935	g_35936
Super-Scaffold_189	35820774	35884818	64044	g_35936	g_35938
Super-Scaffold_189	35910594	35920130	9536	g_35938	g_35939
Super-Scaffold_189	35926098	35998553	72455	g_35939	g_35941
Super-Scaffold_189	36012979	36050500	37521	g_35941	g_35943
Super-Scaffold_189	36052737	36063069	10332	g_35943	g_35944
Super-Scaffold_189	36063350	36147887	84537	g_35944	g_35946
Super-Scaffold_189	36156687	36163460	6773	g_35946	g_35947
Super-Scaffold_189	36164640	36189531	24891	g_35947	g_35949
Super-Scaffold_189	36208803	36211428	2625	g_35949	g_35950
Super-Scaffold_189	36212417	36212576	159	g_35950	g_35951
Super-Scaffold_189	36221391	36267545	46154	g_35951	g_35953
Super-Scaffold_189	36268438	36269149	711	g_35953	g_35952
Super-Scaffold_189	36300464	36419458	118994	g_35952	g_35955
Super-Scaffold_189	36431284	36440824	9540	g_35955	g_35956
Super-Scaffold_189	36441267	36444144	2877	g_35956	g_35957
Super-Scaffold_189	36460914	36468929	8015	g_35957	g_35958
Super-Scaffold_189	36495869	36497833	1964	g_35958	g_35959
Super-Scaffold_189	36499406	36518456	19050	g_35959	g_45735
Super-Scaffold_189	36524394	36531549	7155	g_45735	g_35960
Super-Scaffold_189	36537893	36558740	20847	g_35960	g_35962
Super-Scaffold_189	36571068	36579303	8235	g_35962	g_35963
Super-Scaffold_189	36596657	36608762	12105	g_35963	g_35964
Super-Scaffold_189	36610232	36627029	16797	g_35964	g_35966
Super-Scaffold_189	36627547	36627583	36	g_35966	g_35967
Super-Scaffold_189	36628227	36633034	4807	g_35967	g_35968
Super-Scaffold_189	36633596	36688180	54584	g_35968	g_35969
Super-Scaffold_189	36688389	36726364	37975	g_35969	g_35971
Super-Scaffold_189	36726642	36819888	93246	g_35971	g_35972
Super-Scaffold_189	36821476	36842128	20652	g_35972	g_35973
Super-Scaffold_189	36848566	36863985	15419	g_35973	g_45736
Super-Scaffold_189	36879393	36955766	76373	g_45736	g_35975
Super-Scaffold_189	36956770	36992326	35556	g_35975	g_35976
Super-Scaffold_189	36993111	37034154	41043	g_35976	g_35977
Super-Scaffold_189	37036174	37036260	86	g_35977	g_35978
Super-Scaffold_189	37036472	37038376	1904	g_35978	g_35979
Super-Scaffold_189	37040792	37061422	20630	g_35979	g_35980
Super-Scaffold_189	37061890	37075026	13136	g_35980	g_35981
Super-Scaffold_189	37088110	37088144	34	g_35981	g_35982
Super-Scaffold_189	37088971	37120107	31136	g_35982	g_35984
Super-Scaffold_189	37139907	37188614	48707	g_35984	g_35986
Super-Scaffold_189	37193001	37203336	10335	g_35986	g_35987
Super-Scaffold_189	37229173	37254638	25465	g_35987	g_35988
Super-Scaffold_189	37255802	37283672	27870	g_35988	g_35989
Super-Scaffold_189	37293315	37304721	11406	g_35989	g_35990
Super-Scaffold_189	37314734	37317027	2293	g_35990	g_35991
Super-Scaffold_189	37335878	37344773	8895	g_35991	g_35992
Super-Scaffold_189	37354552	37369275	14723	g_35992	g_35994
Super-Scaffold_189	37382574	37382637	63	g_35994	g_35995
Super-Scaffold_189	37382885	37384195	1310	g_35995	g_45737
Super-Scaffold_189	37386916	37389553	2637	g_45737	g_35996
Super-Scaffold_189	37393118	37395855	2737	g_35996	g_35997
Super-Scaffold_189	37400419	37426896	26477	g_35997	g_35998
Super-Scaffold_189	37454817	37482557	27740	g_35998	g_35999
Super-Scaffold_189	37544161	37545525	1364	g_35999	g_36000
Super-Scaffold_189	37545848	37546380	532	g_36000	g_36001
Super-Scaffold_189	37557548	37562049	4501	g_36001	g_36002
Super-Scaffold_189	37568885	37569875	990	g_36002	g_36003
Super-Scaffold_189	37580335	37605788	25453	g_36003	g_36004
Super-Scaffold_189	37606144	37623445	17301	g_36004	g_36006
Super-Scaffold_189	37624647	37637101	12454	g_36006	g_36007
Super-Scaffold_189	37637424	37667184	29760	g_36007	g_36008
Super-Scaffold_189	37669185	37677820	8635	g_36008	g_45738
Super-Scaffold_189	37706942	37765330	58388	g_45738	g_36010
Super-Scaffold_189	37785875	37787222	1347	g_36010	g_36011
Super-Scaffold_189	37788904	37793697	4793	g_36011	g_36012
Super-Scaffold_189	37804190	37804219	29	g_36012	g_45739
Super-Scaffold_189	37806219	37809241	3022	g_45739	g_36013
Super-Scaffold_189	37819151	37824415	5264	g_36013	g_36014
Super-Scaffold_189	37826535	37838083	11548	g_36014	g_36015
Super-Scaffold_189	37845334	37850543	5209	g_36015	g_36016
Super-Scaffold_189	37851785	37851848	63	g_36016	g_45740
Super-Scaffold_189	37854946	37859441	4495	g_45740	g_36017
Super-Scaffold_189	37860856	37865877	5021	g_36017	g_36018
Super-Scaffold_189	37878490	37891347	12857	g_36018	g_45741
Super-Scaffold_189	37932299	37933303	1004	g_45741	g_36019
Super-Scaffold_189	37941494	37947405	5911	g_36019	g_36020
Super-Scaffold_189	37954436	37960343	5907	g_36020	g_45742
Super-Scaffold_189	37970262	37971377	1115	g_45742	g_36021
Super-Scaffold_189	37974967	37976888	1921	g_36021	g_36022
Super-Scaffold_189	37996939	38018412	21473	g_36022	g_36025
Super-Scaffold_19	209720	215531	5811	g_30651	g_30652
Super-Scaffold_19	215845	256193	40348	g_30652	g_30655
Super-Scaffold_19	256447	256927	480	g_30655	g_30657
Super-Scaffold_19	258746	338062	79316	g_30657	g_30659
Super-Scaffold_19	338304	338851	547	g_30659	g_30660
Super-Scaffold_19	339165	345137	5972	g_30660	g_30661
Super-Scaffold_19	346378	355232	8854	g_30661	g_30662
Super-Scaffold_19	356485	386583	30098	g_30662	g_39719
Super-Scaffold_19	388475	394222	5747	g_39719	g_30664
Super-Scaffold_19	394815	395518	703	g_30664	g_30665
Super-Scaffold_19	398411	398703	292	g_30665	g_30666
Super-Scaffold_19	400925	429808	28883	g_30666	g_30667
Super-Scaffold_19	430455	431412	957	g_30667	g_30668
Super-Scaffold_19	431927	432018	91	g_30668	g_39720
Super-Scaffold_19	433688	493723	60035	g_30669	g_39721
Super-Scaffold_19	493983	733076	239093	g_39721	g_39723
Super-Scaffold_19	733339	734659	1320	g_39723	g_30675
Super-Scaffold_19	735039	763652	28613	g_30675	g_30676
Super-Scaffold_19	766117	766467	350	g_30676	g_30677
Super-Scaffold_19	766736	872323	105587	g_30677	g_30679
Super-Scaffold_19	872604	1043364	170760	g_30679	g_30681
Super-Scaffold_19	1046205	1146655	100450	g_30681	g_30682
Super-Scaffold_19	1146927	1314724	167797	g_30682	g_30686
Super-Scaffold_19	1315002	1499032	184030	g_30686	g_30688
Super-Scaffold_19	1499265	1527421	28156	g_30688	g_39733
Super-Scaffold_19	1528284	1606633	78349	g_39733	g_30692
Super-Scaffold_19	1606857	1659370	52513	g_30692	g_30694
Super-Scaffold_19	1681932	1707108	25176	g_30694	g_30695
Super-Scaffold_19	1708863	1724875	16012	g_30695	g_30696
Super-Scaffold_19	1726411	1726674	263	g_30696	g_30697
Super-Scaffold_19	1730549	1745946	15397	g_30697	g_30698
Super-Scaffold_19	1746276	1748011	1735	g_30698	g_30699
Super-Scaffold_19	1748253	1756648	8395	g_30699	g_30700
Super-Scaffold_19	1760087	1769489	9402	g_30700	g_30701
Super-Scaffold_19	1771561	1784268	12707	g_30701	g_30702
Super-Scaffold_19	1786095	1789603	3508	g_30702	g_30703
Super-Scaffold_19	1789818	1799203	9385	g_30703	g_30704
Super-Scaffold_19	1799499	1806477	6978	g_30704	g_30705
Super-Scaffold_19	1806728	1896036	89308	g_30705	g_30713
Super-Scaffold_19	1901376	1911001	9625	g_30713	g_30714
Super-Scaffold_19	1911243	1953170	41927	g_30714	g_30715
Super-Scaffold_19	1953451	1985634	32183	g_30715	g_30716
Super-Scaffold_19	1985996	2006571	20575	g_30716	g_30717
Super-Scaffold_19	2018627	2025760	7133	g_30717	g_45385
Super-Scaffold_19	2036408	2047751	11343	g_45385	g_30718
Super-Scaffold_19	2049546	2056592	7046	g_30718	g_30719
Super-Scaffold_19	2057296	2102850	45554	g_30719	g_30720
Super-Scaffold_19	2103236	2155892	52656	g_30720	g_30722
Super-Scaffold_19	2156203	2171760	15557	g_30722	g_30725
Super-Scaffold_19	2174634	2202650	28016	g_30725	g_30727
Super-Scaffold_19	2204147	2269881	65734	g_30727	g_30730
Super-Scaffold_19	2301646	2382914	81268	g_30730	g_30732
Super-Scaffold_19	2383366	2431249	47883	g_30732	g_30734
Super-Scaffold_19	2432205	2432239	34	g_30734	g_45386
Super-Scaffold_19	2432736	2452035	19299	g_45386	g_30735
Super-Scaffold_19	2456225	2468925	12700	g_30735	g_45387
Super-Scaffold_19	2469590	2470059	469	g_45387	g_30736
Super-Scaffold_19	2470796	2472407	1611	g_30736	g_30737
Super-Scaffold_19	2476091	2481836	5745	g_30737	g_30738
Super-Scaffold_19	2490229	2493363	3134	g_30738	g_30739
Super-Scaffold_19	2496331	2505248	8917	g_30739	g_30740
Super-Scaffold_19	2506258	2518749	12491	g_30740	g_30741
Super-Scaffold_19	2521062	2553005	31943	g_30741	g_30742
Super-Scaffold_19	2555859	2618566	62707	g_30742	g_30743
Super-Scaffold_19	2626470	2639640	13170	g_30743	g_30744
Super-Scaffold_19	2648954	2668248	19294	g_30744	g_30745
Super-Scaffold_19	2668448	2669440	992	g_30745	g_30746
Super-Scaffold_19	2691367	2696881	5514	g_30746	g_45388
Super-Scaffold_19	2721024	2735072	14048	g_45388	g_30747
Super-Scaffold_19	2743030	2780927	37897	g_30747	g_30748
Super-Scaffold_19	2781822	2783817	1995	g_30748	g_30749
Super-Scaffold_19	2786779	2860594	73815	g_30749	g_30751
Super-Scaffold_19	2865303	2880589	15286	g_30751	g_30753
Super-Scaffold_19	2881365	2917408	36043	g_30753	g_30755
Super-Scaffold_19	2917887	2921623	3736	g_30755	g_30756
Super-Scaffold_19	2921868	2948251	26383	g_30756	g_30757
Super-Scaffold_19	2948613	2957013	8400	g_30757	g_30758
Super-Scaffold_19	2974379	2980674	6295	g_30758	g_30759
Super-Scaffold_19	2997124	3007874	10750	g_30759	g_30760
Super-Scaffold_19	3008155	3024308	16153	g_30760	g_30761
Super-Scaffold_19	3041380	3085442	44062	g_30761	g_30763
Super-Scaffold_19	3085759	3090018	4259	g_30763	g_30765
Super-Scaffold_19	3092223	3097731	5508	g_30765	g_45389
Super-Scaffold_19	3116538	3122356	5818	g_45389	g_30766
Super-Scaffold_19	3128514	3141009	12495	g_30766	g_30767
Super-Scaffold_19	3152922	3163377	10455	g_30767	g_30768
Super-Scaffold_19	3176483	3180783	4300	g_30768	g_30769
Super-Scaffold_19	3182626	3408197	225571	g_30769	g_30772
Super-Scaffold_19	3408643	3408687	44	g_30772	g_30773
Super-Scaffold_19	3409445	3451889	42444	g_30773	g_30775
Super-Scaffold_19	3452092	3454815	2723	g_30775	g_30776
Super-Scaffold_19	3455888	3485895	30007	g_30776	g_30778
Super-Scaffold_19	3510150	3516379	6229	g_30778	g_45390
Super-Scaffold_19	3526239	3536980	10741	g_45390	g_30779
Super-Scaffold_19	3540385	3544987	4602	g_30779	g_30780
Super-Scaffold_19	3549379	3560386	11007	g_30780	g_30781
Super-Scaffold_19	3566078	3605694	39616	g_30781	g_30782
Super-Scaffold_19	3621482	3624285	2803	g_30782	g_30783
Super-Scaffold_19	3626378	3685590	59212	g_30783	g_30786
Super-Scaffold_19	3697081	3698882	1801	g_30786	g_30787
Super-Scaffold_19	3699898	3711497	11599	g_30787	g_30788
Super-Scaffold_19	3715492	3751281	35789	g_30788	g_30789
Super-Scaffold_19	3751766	3754108	2342	g_30789	g_30790
Super-Scaffold_19	3768562	3770563	2001	g_30790	g_39743
Super-Scaffold_19	3779326	3780257	931	g_30791	g_45391
Super-Scaffold_19	3781881	3793417	11536	g_45391	g_30792
Super-Scaffold_19	3796415	3798716	2301	g_30792	g_30793
Super-Scaffold_19	3809636	3813808	4172	g_30793	g_30794
Super-Scaffold_19	3816724	3832922	16198	g_30794	g_30795
Super-Scaffold_19	3834694	3853703	19009	g_30795	g_30797
Super-Scaffold_19	3856822	3863557	6735	g_30797	g_39746
Super-Scaffold_19	3863859	3869845	5986	g_39746	g_30798
Super-Scaffold_19	3870078	3875927	5849	g_30798	g_30799
Super-Scaffold_19	3881804	3975250	93446	g_30799	g_30801
Super-Scaffold_19	4022110	4025577	3467	g_30801	g_45392
Super-Scaffold_19	4028486	4046880	18394	g_45392	g_30802
Super-Scaffold_19	4063492	4082313	18821	g_30802	g_30803
Super-Scaffold_19	4100874	4145907	45033	g_30803	g_30807
Super-Scaffold_19	4148281	4150057	1776	g_30807	g_39749
Super-Scaffold_19	4150338	4177251	26913	g_39749	g_30808
Super-Scaffold_19	4178204	4240921	62717	g_30808	g_30809
Super-Scaffold_19	4264760	4301305	36545	g_30809	g_30811
Super-Scaffold_19	4302372	4322175	19803	g_30811	g_30812
Super-Scaffold_19	4328963	4391672	62709	g_30812	g_30813
Super-Scaffold_19	4391977	4392248	271	g_30813	g_30814
Super-Scaffold_19	4392544	4392595	51	g_30814	g_30815
Super-Scaffold_19	4393071	4437829	44758	g_30815	g_30817
Super-Scaffold_19	4438440	4438527	87	g_30817	g_30816
Super-Scaffold_19	4438745	4439127	382	g_30816	g_30818
Super-Scaffold_19	4439360	4640531	201171	g_30818	g_30822
Super-Scaffold_19	4642746	4672344	29598	g_30822	g_30823
Super-Scaffold_19	4673228	4719135	45907	g_30823	g_30824
Super-Scaffold_19	4719350	4719388	38	g_30824	g_30825
Super-Scaffold_19	4719588	4743714	24126	g_30825	g_30826
Super-Scaffold_19	4745263	4835750	90487	g_30826	g_30827
Super-Scaffold_19	4836106	4972971	136865	g_30827	g_30829
Super-Scaffold_19	4976423	5027851	51428	g_30829	g_30830
Super-Scaffold_19	5028623	5096581	67958	g_30830	g_30831
Super-Scaffold_19	5097150	5144302	47152	g_30831	g_30832
Super-Scaffold_19	5145912	5157812	11900	g_30832	g_45393
Super-Scaffold_19	5158165	5193233	35068	g_45393	g_30833
Super-Scaffold_19	5193679	5231935	38256	g_30833	g_30834
Super-Scaffold_19	5250339	5263429	13090	g_30834	g_30835
Super-Scaffold_19	5282415	5288986	6571	g_30835	g_30836
Super-Scaffold_19	5291988	5311159	19171	g_30836	g_30837
Super-Scaffold_19	5317387	5341183	23796	g_30837	g_30838
Super-Scaffold_19	5348650	5430086	81436	g_30838	g_30839
Super-Scaffold_19	5445746	5454839	9093	g_30839	g_45394
Super-Scaffold_19	5458987	5489347	30360	g_45394	g_30840
Super-Scaffold_19	5506816	5515782	8966	g_30840	g_30841
Super-Scaffold_19	5530804	5542941	12137	g_30841	g_30842
Super-Scaffold_19	5554740	5688966	134226	g_30842	g_30845
Super-Scaffold_19	5707473	5740734	33261	g_30845	g_30846
Super-Scaffold_19	5744901	5831996	87095	g_30846	g_30847
Super-Scaffold_19	5836510	6008966	172456	g_30847	g_30850
Super-Scaffold_19	6009361	6162518	153157	g_30850	g_30852
Super-Scaffold_19	6184890	6201360	16470	g_30852	g_30853
Super-Scaffold_19	6215422	6220478	5056	g_30853	g_30854
Super-Scaffold_19	6242500	6292911	50411	g_30854	g_30855
Super-Scaffold_19	6306417	6495193	188776	g_30855	g_39762
Super-Scaffold_19	6495615	6596131	100516	g_39762	g_30858
Super-Scaffold_19	6596940	6612719	15779	g_30858	g_30859
Super-Scaffold_19	6612958	6635057	22099	g_30859	g_30860
Super-Scaffold_19	6635365	6729144	93779	g_30860	g_30861
Super-Scaffold_19	6743447	6891974	148527	g_30861	g_30866
Super-Scaffold_19	6893341	7105089	211748	g_30866	g_30867
Super-Scaffold_19	7107479	7141706	34227	g_30867	g_30870
Super-Scaffold_19	7142521	7231841	89320	g_30870	g_30871
Super-Scaffold_19	7232158	7322507	90349	g_30871	g_30872
Super-Scaffold_19	7323286	7366166	42880	g_30872	g_30874
Super-Scaffold_19	7366615	7447295	80680	g_30874	g_39766
Super-Scaffold_19	7448242	7448796	554	g_30876	g_30877
Super-Scaffold_19	7449227	7757908	308681	g_30877	g_30882
Super-Scaffold_19	7766772	7980257	213485	g_30882	g_30883
Super-Scaffold_19	7981513	7982039	526	g_30883	g_30884
Super-Scaffold_19	7982629	8062477	79848	g_30884	g_30885
Super-Scaffold_19	8074901	8088210	13309	g_30885	g_30886
Super-Scaffold_19	8088668	8114678	26010	g_30886	g_30887
Super-Scaffold_19	8180438	8251528	71090	g_30887	g_39768
Super-Scaffold_19	8251764	8273164	21400	g_39768	g_30888
Super-Scaffold_19	8279035	8294609	15574	g_30888	g_30889
Super-Scaffold_19	8339035	8343947	4912	g_30889	g_30890
Super-Scaffold_19	8344210	8356488	12278	g_30890	g_30891
Super-Scaffold_19	8357645	8367521	9876	g_30891	g_30893
Super-Scaffold_19	8369806	8378835	9029	g_30893	g_30894
Super-Scaffold_19	8379233	8385699	6466	g_30894	g_30895
Super-Scaffold_19	8390812	8399077	8265	g_30895	g_30896
Super-Scaffold_19	8420986	8429877	8891	g_30896	g_30897
Super-Scaffold_19	8430119	8458683	28564	g_30897	g_30899
Super-Scaffold_19	8468800	8478633	9833	g_30899	g_30900
Super-Scaffold_19	8484245	8488490	4245	g_30900	g_30901
Super-Scaffold_19	8522285	8524326	2041	g_30901	g_45395
Super-Scaffold_19	8541091	8578782	37691	g_45395	g_30903
Super-Scaffold_19	8579684	8580870	1186	g_30903	g_30904
Super-Scaffold_19	8602824	8649290	46466	g_30904	g_30906
Super-Scaffold_19	8665021	8670061	5040	g_30906	g_30907
Super-Scaffold_19	8675623	8692795	17172	g_30907	g_30908
Super-Scaffold_19	8704603	8705505	902	g_30908	g_30909
Super-Scaffold_19	8710945	8732501	21556	g_30909	g_30910
Super-Scaffold_19	8749074	8771151	22077	g_30910	g_45396
Super-Scaffold_19	8787420	8809467	22047	g_45396	g_30911
Super-Scaffold_19	8809895	8823154	13259	g_30911	g_30912
Super-Scaffold_19	8823462	8870435	46973	g_30912	g_30915
Super-Scaffold_19	8907195	8922701	15506	g_30915	g_30916
Super-Scaffold_19	8933334	8946796	13462	g_30916	g_30917
Super-Scaffold_19	8956887	8960005	3118	g_30917	g_45397
Super-Scaffold_19	8962056	8963715	1659	g_45397	g_30918
Super-Scaffold_19	8975204	8976922	1718	g_30918	g_30919
Super-Scaffold_19	8981220	8986335	5115	g_30919	g_30920
Super-Scaffold_19	8995721	8999179	3458	g_30920	g_30921
Super-Scaffold_19	9000294	9015993	15699	g_30921	g_30922
Super-Scaffold_19	9021751	9026237	4486	g_30922	g_30923
Super-Scaffold_19	9039218	9042717	3499	g_30923	g_30924
Super-Scaffold_19	9044256	9046749	2493	g_30924	g_30925
Super-Scaffold_19	9047225	9048242	1017	g_30925	g_30926
Super-Scaffold_19	9074468	9082526	8058	g_30926	g_30927
Super-Scaffold_19	9083362	9120885	37523	g_30927	g_30929
Super-Scaffold_19	9122147	9122253	106	g_30929	g_30930
Super-Scaffold_19	9122636	9142575	19939	g_30930	g_30931
Super-Scaffold_19	9148253	9158381	10128	g_30931	g_30932
Super-Scaffold_19	9163682	9210343	46661	g_30932	g_30935
Super-Scaffold_19	9211413	9290211	78798	g_30935	g_30937
Super-Scaffold_19	9303741	9328016	24275	g_30937	g_45398
Super-Scaffold_19	9404715	9409620	4905	g_45398	g_30938
Super-Scaffold_19	9410438	9418948	8510	g_30938	g_30939
Super-Scaffold_19	9443181	9445872	2691	g_30939	g_30940
Super-Scaffold_19	9446495	9462436	15941	g_30940	g_30941
Super-Scaffold_19	9470053	9474888	4835	g_30941	g_30942
Super-Scaffold_19	9479542	9482956	3414	g_30942	g_30943
Super-Scaffold_19	9499456	9502365	2909	g_30943	g_30944
Super-Scaffold_19	9516548	9533925	17377	g_30944	g_30946
Super-Scaffold_19	9551965	9569398	17433	g_30946	g_30947
Super-Scaffold_19	9574568	9609545	34977	g_30947	g_30948
Super-Scaffold_19	9615394	9634672	19278	g_30948	g_30950
Super-Scaffold_19	9640170	9643924	3754	g_30950	g_30951
Super-Scaffold_19	9654156	9654987	831	g_30951	g_30952
Super-Scaffold_19	9659545	9679562	20017	g_30952	g_30953
Super-Scaffold_19	9679903	9740492	60589	g_30953	g_45399
Super-Scaffold_19	9740749	9789330	48581	g_45399	g_30954
Super-Scaffold_19	9789659	9813432	23773	g_30954	g_30955
Super-Scaffold_19	9813644	9977624	163980	g_30955	g_30956
Super-Scaffold_19	9980784	9986626	5842	g_30956	g_45400
Super-Scaffold_19	9987755	9992638	4883	g_45400	g_45401
Super-Scaffold_19	10001817	10007870	6053	g_45401	g_30957
Super-Scaffold_19	10011426	10015782	4356	g_30957	g_30958
Super-Scaffold_19	10028231	10034784	6553	g_30958	g_30959
Super-Scaffold_19	10045234	10051437	6203	g_30959	g_30960
Super-Scaffold_19	10054142	10061907	7765	g_30960	g_30961
Super-Scaffold_19	10070653	10073998	3345	g_30961	g_30962
Super-Scaffold_19	10124907	10128092	3185	g_30962	g_30963
Super-Scaffold_19	10150700	10150782	82	g_30963	g_30964
Super-Scaffold_19	10150988	10156036	5048	g_30964	g_30965
Super-Scaffold_19	10163774	10190988	27214	g_30965	g_30967
Super-Scaffold_19	10204064	10212862	8798	g_30967	g_30968
Super-Scaffold_19	10222455	10233752	11297	g_30968	g_30969
Super-Scaffold_19	10236795	10239361	2566	g_30969	g_30970
Super-Scaffold_19	10249015	10300489	51474	g_30970	g_30972
Super-Scaffold_19	10302425	10307618	5193	g_30972	g_30973
Super-Scaffold_19	10320368	10326862	6494	g_30973	g_30974
Super-Scaffold_19	10334198	10340131	5933	g_30974	g_30975
Super-Scaffold_19	10340699	10347426	6727	g_30975	g_30976
Super-Scaffold_19	10347994	10351538	3544	g_30976	g_30977
Super-Scaffold_19	10352105	10355638	3533	g_30977	g_30978
Super-Scaffold_19	10356205	10359749	3544	g_30978	g_30979
Super-Scaffold_19	10360317	10369863	9546	g_30979	g_30980
Super-Scaffold_19	10370521	10380876	10355	g_30980	g_30981
Super-Scaffold_19	10381444	10385182	3738	g_30981	g_30982
Super-Scaffold_19	10385750	10389773	4023	g_30982	g_30983
Super-Scaffold_19	10390431	10398325	7894	g_30983	g_30984
Super-Scaffold_19	10398732	10401441	2709	g_30984	g_30985
Super-Scaffold_19	10402089	10405603	3514	g_30985	g_30986
Super-Scaffold_19	10406261	10408426	2165	g_30986	g_30987
Super-Scaffold_19	10421855	10438294	16439	g_30987	g_30988
Super-Scaffold_19	10451703	10460185	8482	g_30988	g_30989
Super-Scaffold_19	10468931	10482573	13642	g_30989	g_30990
Super-Scaffold_19	10489953	10490017	64	g_30990	g_30991
Super-Scaffold_19	10504396	10505416	1020	g_30991	g_30992
Super-Scaffold_19	10506750	10511224	4474	g_30992	g_30994
Super-Scaffold_19	10515014	10524227	9213	g_30994	g_30996
Super-Scaffold_19	10526373	10638343	111970	g_39776	g_39777
Super-Scaffold_19	10638573	10849384	210811	g_39777	g_31003
Super-Scaffold_19	10849790	11157241	307451	g_31003	g_31007
Super-Scaffold_19	11187321	11204195	16874	g_31007	g_31008
Super-Scaffold_19	11206465	11208751	2286	g_31008	g_31009
Super-Scaffold_19	11210499	11210999	500	g_31009	g_31010
Super-Scaffold_19	11213467	11216181	2714	g_31010	g_31011
Super-Scaffold_19	11224493	11260969	36476	g_31011	g_39779
Super-Scaffold_19	11261199	11267140	5941	g_39779	g_31013
Super-Scaffold_19	11267376	11281836	14460	g_31013	g_31014
Super-Scaffold_19	11282471	11328465	45994	g_31014	g_39781
Super-Scaffold_19	11328674	11332682	4008	g_39781	g_31015
Super-Scaffold_19	11332987	11334981	1994	g_31015	g_31016
Super-Scaffold_19	11353844	11515391	161547	g_31016	g_31021
Super-Scaffold_19	11519757	11521667	1910	g_31021	g_31022
Super-Scaffold_19	11521915	11538647	16732	g_31022	g_31023
Super-Scaffold_19	11543711	11547188	3477	g_31023	g_31024
Super-Scaffold_19	11550436	11574590	24154	g_31024	g_31025
Super-Scaffold_19	11575229	11577889	2660	g_31025	g_31026
Super-Scaffold_19	11579398	11633294	53896	g_31026	g_31028
Super-Scaffold_19	11647724	11681104	33380	g_31028	g_31029
Super-Scaffold_19	11696520	11712603	16083	g_31029	g_45402
Super-Scaffold_19	11720405	11725845	5440	g_45402	g_45403
Super-Scaffold_19	11752828	11755478	2650	g_45403	g_31031
Super-Scaffold_19	11765258	11767891	2633	g_31031	g_45404
Super-Scaffold_19	11772116	11774248	2132	g_45404	g_31032
Super-Scaffold_19	11783278	11785723	2445	g_31032	g_31033
Super-Scaffold_19	11787405	11806053	18648	g_31033	g_31034
Super-Scaffold_19	11807219	11810822	3603	g_31034	g_45405
Super-Scaffold_19	11813205	11819516	6311	g_45405	g_31036
Super-Scaffold_19	11828990	11830483	1493	g_31036	g_31037
Super-Scaffold_19	11840649	11843201	2552	g_31037	g_31038
Super-Scaffold_19	11844142	11849192	5050	g_31038	g_31039
Super-Scaffold_19	11850148	11860237	10089	g_31039	g_31040
Super-Scaffold_19	11860476	11891140	30664	g_31040	g_31041
Super-Scaffold_19	11891382	11892735	1353	g_31041	g_31042
Super-Scaffold_19	11896389	11900083	3694	g_31042	g_31043
Super-Scaffold_19	11900412	11974200	73788	g_31043	g_31045
Super-Scaffold_19	11974559	11981050	6491	g_31045	g_31047
Super-Scaffold_19	11989592	11992224	2632	g_31047	g_31048
Super-Scaffold_19	11992922	12032113	39191	g_31048	g_31049
Super-Scaffold_19	12049317	12064013	14696	g_31049	g_45406
Super-Scaffold_19	12074484	12192602	118118	g_45406	g_31052
Super-Scaffold_19	12192994	12199513	6519	g_31052	g_31053
Super-Scaffold_19	12219242	12221562	2320	g_31053	g_31054
Super-Scaffold_19	12241283	12257815	16532	g_31054	g_31055
Super-Scaffold_19	12271179	12281915	10736	g_31055	g_31057
Super-Scaffold_19	12301365	12453754	152389	g_31057	g_31058
Super-Scaffold_19	12463107	12548653	85546	g_31058	g_39794
Super-Scaffold_19	12549066	12550126	1060	g_39794	g_31061
Super-Scaffold_19	12551394	12591498	40104	g_31062	g_31063
Super-Scaffold_19	12591824	12609021	17197	g_31063	g_31065
Super-Scaffold_19	12612902	12616531	3629	g_31065	g_31066
Super-Scaffold_19	12624113	12654827	30714	g_31066	g_31067
Super-Scaffold_19	12657949	12667758	9809	g_31067	g_31068
Super-Scaffold_19	12674353	12695925	21572	g_31068	g_31069
Super-Scaffold_19	12699122	12703559	4437	g_31069	g_31070
Super-Scaffold_19	12708566	12753573	45007	g_31070	g_31072
Super-Scaffold_19	12754133	12938872	184739	g_31072	g_31075
Super-Scaffold_19	12941147	12995239	54092	g_31075	g_31076
Super-Scaffold_19	13013660	13017348	3688	g_31076	g_45407
Super-Scaffold_19	13027161	13038431	11270	g_45407	g_45408
Super-Scaffold_19	13051487	13053926	2439	g_45408	g_45409
Super-Scaffold_19	13064826	13069808	4982	g_45409	g_45410
Super-Scaffold_19	13072490	13075942	3452	g_45410	g_31077
Super-Scaffold_19	13082702	13088239	5537	g_31077	g_31078
Super-Scaffold_19	13094452	13098957	4505	g_31078	g_31079
Super-Scaffold_19	13099286	13118721	19435	g_31079	g_31080
Super-Scaffold_19	13119161	13130072	10911	g_31080	g_31081
Super-Scaffold_19	13139893	13143429	3536	g_31081	g_31082
Super-Scaffold_19	13172878	13185590	12712	g_31082	g_45411
Super-Scaffold_19	13193826	13193927	101	g_45411	g_31083
Super-Scaffold_19	13194250	13216481	22231	g_31083	g_31085
Super-Scaffold_19	13216804	13220250	3446	g_31085	g_31086
Super-Scaffold_19	13222457	13223231	774	g_31086	g_39798
Super-Scaffold_19	13226063	13236900	10837	g_39798	g_31087
Super-Scaffold_19	13239851	13252761	12910	g_31087	g_31090
Super-Scaffold_19	13268031	13270960	2929	g_31090	g_31091
Super-Scaffold_19	13276184	13281291	5107	g_31091	g_45412
Super-Scaffold_19	13300659	13317597	16938	g_45412	g_31093
Super-Scaffold_19	13327426	13347323	19897	g_31093	g_39799
Super-Scaffold_19	13348549	13370209	21660	g_31094	g_31097
Super-Scaffold_19	13372592	13374372	1780	g_31097	g_31098
Super-Scaffold_19	13374716	13376978	2262	g_31098	g_45413
Super-Scaffold_19	13377751	13380496	2745	g_45413	g_31099
Super-Scaffold_19	13384551	13395294	10743	g_31099	g_31100
Super-Scaffold_19	13396979	13420693	23714	g_31100	g_31101
Super-Scaffold_19	13422177	13435288	13111	g_31101	g_31103
Super-Scaffold_19	13436841	13534772	97931	g_31103	g_31105
Super-Scaffold_19	13535359	13541427	6068	g_31105	g_31106
Super-Scaffold_19	13549656	13552247	2591	g_31106	g_31107
Super-Scaffold_19	13555962	13560634	4672	g_31107	g_45414
Super-Scaffold_19	13561719	13563720	2001	g_45414	g_31108
Super-Scaffold_19	13569894	13572925	3031	g_31108	g_31109
Super-Scaffold_19	13580237	13582076	1839	g_31109	g_31110
Super-Scaffold_19	13587697	13700373	112676	g_31110	g_31113
Super-Scaffold_19	13700621	13733608	32987	g_31113	g_31115
Super-Scaffold_19	13733877	13825147	91270	g_31115	g_31116
Super-Scaffold_19	13838715	13850118	11403	g_31116	g_31117
Super-Scaffold_19	13853821	13856863	3042	g_31117	g_31118
Super-Scaffold_19	13871682	13873897	2215	g_31118	g_31119
Super-Scaffold_19	13878254	13884375	6121	g_31119	g_31120
Super-Scaffold_19	13891276	13903219	11943	g_31120	g_31122
Super-Scaffold_19	13904808	13905197	389	g_31122	g_31123
Super-Scaffold_19	13906327	13906399	72	g_31123	g_31124
Super-Scaffold_19	13908248	13908660	412	g_31124	g_31121
Super-Scaffold_19	13922834	13941847	19013	g_31121	g_31125
Super-Scaffold_19	13942302	14047565	105263	g_31125	g_31127
Super-Scaffold_19	14047858	14066459	18601	g_31127	g_31128
Super-Scaffold_19	14068586	14072362	3776	g_31128	g_45415
Super-Scaffold_19	14074412	14079252	4840	g_45415	g_31129
Super-Scaffold_19	14079641	14080326	685	g_31129	g_31130
Super-Scaffold_19	14083646	14090646	7000	g_31130	g_31131
Super-Scaffold_19	14090999	14091349	350	g_31131	g_31132
Super-Scaffold_19	14091915	14129302	37387	g_31132	g_31133
Super-Scaffold_19	14129973	14153298	23325	g_31133	g_31134
Super-Scaffold_19	14159907	14165829	5922	g_31134	g_31135
Super-Scaffold_19	14176391	14178378	1987	g_31135	g_45416
Super-Scaffold_19	14180050	14181551	1501	g_45416	g_31136
Super-Scaffold_19	14181754	14188863	7109	g_31136	g_31137
Super-Scaffold_19	14198636	14238865	40229	g_31137	g_31139
Super-Scaffold_19	14251655	14263605	11950	g_31139	g_31140
Super-Scaffold_19	14280875	14286348	5473	g_31140	g_31141
Super-Scaffold_19	14292268	14299175	6907	g_39810	g_31142
Super-Scaffold_19	14313809	14316775	2966	g_31142	g_31143
Super-Scaffold_19	14318944	14321949	3005	g_31143	g_31144
Super-Scaffold_19	14341863	14344640	2777	g_31144	g_31145
Super-Scaffold_19	14350080	14353222	3142	g_31145	g_31146
Super-Scaffold_19	14366710	14373451	6741	g_31146	g_31147
Super-Scaffold_19	14399835	14404860	5025	g_31147	g_45417
Super-Scaffold_19	14405612	14425388	19776	g_45417	g_31148
Super-Scaffold_19	14426059	14560692	134633	g_31148	g_39816
Super-Scaffold_19	14560975	14564391	3416	g_31152	g_31153
Super-Scaffold_19	14566859	14584729	17870	g_31153	g_31154
Super-Scaffold_19	14592191	14593396	1205	g_31154	g_31155
Super-Scaffold_19	14603652	14605688	2036	g_31155	g_31156
Super-Scaffold_19	14608269	14610827	2558	g_31156	g_31157
Super-Scaffold_19	14613524	14615911	2387	g_31157	g_31158
Super-Scaffold_19	14628429	14632730	4301	g_31158	g_31159
Super-Scaffold_19	14634770	14639479	4709	g_31159	g_45418
Super-Scaffold_19	14645386	14647601	2215	g_45418	g_31160
Super-Scaffold_19	14652738	14654989	2251	g_31160	g_45419
Super-Scaffold_19	14664026	14705706	41680	g_45419	g_31162
Super-Scaffold_19	14707416	14710047	2631	g_31162	g_31163
Super-Scaffold_19	14713226	14717433	4207	g_31163	g_31164
Super-Scaffold_19	14721798	14728821	7023	g_31164	g_31165
Super-Scaffold_19	14735851	14773773	37922	g_31165	g_31168
Super-Scaffold_19	14774429	14779993	5564	g_31168	g_39818
Super-Scaffold_19	14780268	14957944	177676	g_39818	g_31169
Super-Scaffold_19	14969391	15184079	214688	g_31169	g_31173
Super-Scaffold_19	15184471	15225078	40607	g_31173	g_31174
Super-Scaffold_19	15241257	15245117	3860	g_31174	g_31175
Super-Scaffold_19	15250686	15253682	2996	g_31175	g_31176
Super-Scaffold_19	15260646	15282145	21499	g_31176	g_31178
Super-Scaffold_19	15296548	15328462	31914	g_31178	g_31179
Super-Scaffold_19	15337999	15419485	81486	g_31179	g_31182
Super-Scaffold_19	15429582	15556869	127287	g_31182	g_31184
Super-Scaffold_19	15570001	15579357	9356	g_31184	g_31185
Super-Scaffold_19	15589032	15595697	6665	g_31185	g_31187
Super-Scaffold_19	15609204	15629825	20621	g_31187	g_31188
Super-Scaffold_19	15630931	15633708	2777	g_31188	g_39823
Super-Scaffold_19	15634016	15686256	52240	g_39823	g_31189
Super-Scaffold_19	15699389	15717229	17840	g_31189	g_45420
Super-Scaffold_19	15718449	15725378	6929	g_45420	g_45421
Super-Scaffold_19	15725683	15758389	32706	g_45421	g_31190
Super-Scaffold_19	15765391	15775701	10310	g_31190	g_31191
Super-Scaffold_19	15779492	15781935	2443	g_31191	g_45422
Super-Scaffold_19	15785692	15789707	4015	g_45422	g_31192
Super-Scaffold_19	15796299	15798660	2361	g_31192	g_31193
Super-Scaffold_19	15809669	15809971	302	g_31193	g_45423
Super-Scaffold_19	15816196	15822997	6801	g_45423	g_31194
Super-Scaffold_19	15835641	15838220	2579	g_31194	g_31195
Super-Scaffold_19	15847736	15853593	5857	g_31195	g_39826
Super-Scaffold_19	15856526	15858325	1799	g_31196	g_31197
Super-Scaffold_19	15861375	15863236	1861	g_31197	g_31198
Super-Scaffold_19	15867614	15875247	7633	g_31198	g_31199
Super-Scaffold_19	15884213	15887466	3253	g_31199	g_31200
Super-Scaffold_19	15890205	15890601	396	g_31200	g_39827
Super-Scaffold_19	15890828	15916226	25398	g_39827	g_31203
Super-Scaffold_19	15928536	15933839	5303	g_39830	g_31204
Super-Scaffold_19	15934276	16030760	96484	g_31204	g_31206
Super-Scaffold_19	16035889	16044670	8781	g_31206	g_31207
Super-Scaffold_19	16051384	16065917	14533	g_31207	g_31208
Super-Scaffold_19	16072396	16088950	16554	g_31208	g_31209
Super-Scaffold_19	16101899	16102221	322	g_31210	g_31211
Super-Scaffold_19	16102955	16102984	29	g_31211	g_31212
Super-Scaffold_19	16103784	16133519	29735	g_31212	g_31214
Super-Scaffold_19	16133725	16173317	39592	g_31214	g_31215
Super-Scaffold_19	16173661	16259299	85638	g_31215	g_31216
Super-Scaffold_19	16265520	16328242	62722	g_31216	g_31219
Super-Scaffold_19	16329773	16381796	52023	g_31219	g_31221
Super-Scaffold_19	16392796	16407346	14550	g_31221	g_31223
Super-Scaffold_19	16407828	16418220	10392	g_31223	g_31224
Super-Scaffold_19	16424122	16429150	5028	g_31224	g_31225
Super-Scaffold_19	16461188	16480265	19077	g_31225	g_31226
Super-Scaffold_19	16496848	16498369	1521	g_31226	g_31227
Super-Scaffold_19	16499506	16508780	9274	g_31227	g_31228
Super-Scaffold_19	16519776	16584737	64961	g_31228	g_31230
Super-Scaffold_19	16584982	16593855	8873	g_31230	g_31231
Super-Scaffold_19	16604086	16608841	4755	g_31231	g_31232
Super-Scaffold_19	16619328	16639937	20609	g_31232	g_31234
Super-Scaffold_19	16642962	16647801	4839	g_31234	g_39839
Super-Scaffold_19	16648016	16652621	4605	g_39839	g_31235
Super-Scaffold_19	16656834	16658486	1652	g_31235	g_31236
Super-Scaffold_19	16665565	16669173	3608	g_31236	g_31237
Super-Scaffold_19	16676420	16678254	1834	g_31237	g_31238
Super-Scaffold_19	16682266	16683569	1303	g_31238	g_31239
Super-Scaffold_19	16690309	16693000	2691	g_31239	g_31240
Super-Scaffold_19	16696450	16696491	41	g_31240	g_31241
Super-Scaffold_19	16703220	16708167	4947	g_31241	g_31242
Super-Scaffold_19	16721877	16733685	11808	g_31242	g_31243
Super-Scaffold_19	16752467	16758167	5700	g_31243	g_31244
Super-Scaffold_19	16759021	16852508	93487	g_31244	g_31247
Super-Scaffold_19	16871976	16877300	5324	g_31247	g_31248
Super-Scaffold_19	16896025	16900626	4601	g_31248	g_31249
Super-Scaffold_19	16921345	16932942	11597	g_31249	g_31250
Super-Scaffold_19	16934920	16941240	6320	g_31250	g_31251
Super-Scaffold_19	16958741	16976566	17825	g_31251	g_31252
Super-Scaffold_19	16978581	16983108	4527	g_31252	g_31253
Super-Scaffold_19	16987193	16987397	204	g_31253	g_31254
Super-Scaffold_19	16988517	16992199	3682	g_31254	g_31255
Super-Scaffold_19	16995032	16999639	4607	g_31255	g_31256
Super-Scaffold_19	17003840	17007008	3168	g_31256	g_31257
Super-Scaffold_19	17011872	17016746	4874	g_31257	g_31258
Super-Scaffold_19	17018340	17040604	22264	g_31258	g_31259
Super-Scaffold_19	17043323	17048338	5015	g_31259	g_45424
Super-Scaffold_19	17058472	17060803	2331	g_45424	g_31260
Super-Scaffold_19	17066834	17079429	12595	g_31260	g_31261
Super-Scaffold_19	17080618	17084578	3960	g_31261	g_31262
Super-Scaffold_19	17096377	17101779	5402	g_31262	g_31263
Super-Scaffold_19	17112248	17116250	4002	g_31263	g_31264
Super-Scaffold_19	17124241	17125911	1670	g_31264	g_45425
Super-Scaffold_19	17128903	17130031	1128	g_45425	g_31265
Super-Scaffold_19	17136076	17137988	1912	g_31265	g_45426
Super-Scaffold_19	17156026	17158796	2770	g_45426	g_45427
Super-Scaffold_19	17160049	17163650	3601	g_45427	g_31266
Super-Scaffold_19	17167664	17174483	6819	g_31266	g_45428
Super-Scaffold_19	17184076	17195488	11412	g_45428	g_31267
Super-Scaffold_19	17196594	17230878	34284	g_31267	g_31269
Super-Scaffold_19	17231300	17234134	2834	g_31269	g_31270
Super-Scaffold_19	17237439	17240481	3042	g_31270	g_31271
Super-Scaffold_19	17248950	17252039	3089	g_31271	g_31272
Super-Scaffold_19	17254609	17257810	3201	g_31272	g_31273
Super-Scaffold_19	17261762	17267099	5337	g_31273	g_31274
Super-Scaffold_19	17274393	17280589	6196	g_31274	g_31275
Super-Scaffold_19	17285646	17287921	2275	g_31275	g_31276
Super-Scaffold_19	17295960	17309535	13575	g_31276	g_31277
Super-Scaffold_19	17312663	17314634	1971	g_31277	g_31278
Super-Scaffold_19	17319992	17326482	6490	g_31278	g_31279
Super-Scaffold_19	17331309	17335458	4149	g_31279	g_31280
Super-Scaffold_19	17339402	17343810	4408	g_31280	g_45429
Super-Scaffold_19	17349327	17358290	8963	g_45429	g_31281
Super-Scaffold_19	17366774	17369042	2268	g_31281	g_31282
Super-Scaffold_19	17374667	17384020	9353	g_31282	g_31283
Super-Scaffold_19	17390615	17394796	4181	g_31283	g_31285
Super-Scaffold_19	17410742	17415024	4282	g_31285	g_31286
Super-Scaffold_19	17427720	17429604	1884	g_31286	g_31287
Super-Scaffold_19	17430773	17434820	4047	g_31287	g_31288
Super-Scaffold_19	17449996	17456110	6114	g_31288	g_31289
Super-Scaffold_19	17466116	17472937	6821	g_31289	g_31290
Super-Scaffold_19	17487377	17494933	7556	g_31290	g_31291
Super-Scaffold_19	17510292	17512896	2604	g_31291	g_45430
Super-Scaffold_19	17519858	17523525	3667	g_45430	g_31292
Super-Scaffold_19	17537375	17537619	244	g_31292	g_31293
Super-Scaffold_19	17537909	17558834	20925	g_31293	g_39841
Super-Scaffold_19	17559145	17568853	9708	g_39841	g_31295
Super-Scaffold_19	17577139	17583917	6778	g_31295	g_31296
Super-Scaffold_19	17586728	17592451	5723	g_31296	g_31297
Super-Scaffold_19	17608530	17695764	87234	g_31297	g_31301
Super-Scaffold_19	17696780	17698978	2198	g_31301	g_31302
Super-Scaffold_19	17716254	17736453	20199	g_31302	g_31303
Super-Scaffold_19	17739873	17742098	2225	g_31303	g_31304
Super-Scaffold_19	17759914	17761190	1276	g_31304	g_31305
Super-Scaffold_19	17763904	17765108	1204	g_31305	g_31306
Super-Scaffold_19	17766749	17767291	542	g_31306	g_31307
Super-Scaffold_19	17771828	17834192	62364	g_31307	g_31310
Super-Scaffold_19	17836333	17838202	1869	g_31310	g_31311
Super-Scaffold_19	17845326	17846904	1578	g_31311	g_31312
Super-Scaffold_19	17910401	17914324	3923	g_31312	g_31313
Super-Scaffold_19	17916760	17919993	3233	g_31313	g_31314
Super-Scaffold_19	17927494	17929615	2121	g_31314	g_31315
Super-Scaffold_19	17951806	17970995	19189	g_31315	g_31316
Super-Scaffold_19	17972119	17983969	11850	g_31316	g_31317
Super-Scaffold_19	17985132	17985689	557	g_31317	g_31318
Super-Scaffold_19	18017517	18023187	5670	g_31318	g_45431
Super-Scaffold_19	18023531	18032949	9418	g_45431	g_31319
Super-Scaffold_19	18037041	18037674	633	g_31319	g_31320
Super-Scaffold_19	18040259	18041199	940	g_31320	g_31321
Super-Scaffold_19	18045016	18049695	4679	g_31321	g_45432
Super-Scaffold_19	18075646	18090013	14367	g_45432	g_31322
Super-Scaffold_19	18093918	18097801	3883	g_31322	g_31323
Super-Scaffold_19	18107768	18111592	3824	g_31323	g_31324
Super-Scaffold_19	18113635	18114916	1281	g_31324	g_31325
Super-Scaffold_19	18130027	18131413	1386	g_31325	g_45433
Super-Scaffold_19	18138467	18139349	882	g_45433	g_45434
Super-Scaffold_19	18140600	18173296	32696	g_45434	g_31326
Super-Scaffold_19	18173925	18195128	21203	g_31326	g_31327
Super-Scaffold_19	18206646	18214784	8138	g_31327	g_31328
Super-Scaffold_19	18217813	18226443	8630	g_31328	g_31329
Super-Scaffold_19	18231034	18237526	6492	g_31329	g_31330
Super-Scaffold_19	18238524	18260410	21886	g_31330	g_31332
Super-Scaffold_19	18275392	18279896	4504	g_31332	g_31333
Super-Scaffold_19	18281140	18292073	10933	g_31333	g_31334
Super-Scaffold_19	18300835	18305772	4937	g_31334	g_31335
Super-Scaffold_19	18307070	18317132	10062	g_31335	g_39847
Super-Scaffold_19	18317341	18325686	8345	g_39847	g_31336
Super-Scaffold_19	18327935	18330774	2839	g_31336	g_45435
Super-Scaffold_19	18342760	18345765	3005	g_45435	g_31337
Super-Scaffold_19	18348200	18349790	1590	g_31337	g_31339
Super-Scaffold_19	18350251	18360630	10379	g_31339	g_31340
Super-Scaffold_19	18368814	18371029	2215	g_31340	g_31341
Super-Scaffold_19	18371376	18372224	848	g_31341	g_45436
Super-Scaffold_19	18374991	18378469	3478	g_45436	g_31342
Super-Scaffold_19	18397832	18403483	5651	g_31342	g_31343
Super-Scaffold_19	18407006	18408910	1904	g_31343	g_31344
Super-Scaffold_19	18417330	18431089	13759	g_31344	g_31345
Super-Scaffold_19	18434011	18437066	3055	g_31345	g_31346
Super-Scaffold_19	18440713	18444995	4282	g_31346	g_31347
Super-Scaffold_19	18446757	18447829	1072	g_31347	g_31348
Super-Scaffold_19	18449820	18449897	77	g_31348	g_31349
Super-Scaffold_19	18450121	18455368	5247	g_31349	g_31350
Super-Scaffold_19	18456639	18463182	6543	g_31350	g_31351
Super-Scaffold_19	18483740	18485148	1408	g_31351	g_31352
Super-Scaffold_19	18490855	18508313	17458	g_31352	g_31353
Super-Scaffold_19	18516977	18529136	12159	g_31353	g_31354
Super-Scaffold_19	18530409	18531444	1035	g_31354	g_31355
Super-Scaffold_19	18534250	18538019	3769	g_31355	g_31356
Super-Scaffold_19	18539597	18543703	4106	g_31356	g_31357
Super-Scaffold_19	18547635	18552607	4972	g_31357	g_31359
Super-Scaffold_19	18552846	18553040	194	g_31359	g_31360
Super-Scaffold_19	18553555	18554310	755	g_31360	g_45437
Super-Scaffold_19	18558535	18606306	47771	g_45437	g_31362
Super-Scaffold_19	18608782	18613553	4771	g_31362	g_31363
Super-Scaffold_19	18626008	18627697	1689	g_31363	g_31364
Super-Scaffold_19	18631224	18632501	1277	g_31364	g_45438
Super-Scaffold_19	18633273	18634395	1122	g_45438	g_31365
Super-Scaffold_19	18639688	18640460	772	g_31365	g_31366
Super-Scaffold_19	18651020	18700059	49039	g_31366	g_31369
Super-Scaffold_19	18707099	18723764	16665	g_31369	g_31370
Super-Scaffold_19	18727478	18736315	8837	g_31370	g_31371
Super-Scaffold_19	18738977	18748269	9292	g_31371	g_31373
Super-Scaffold_19	18753746	18760722	6976	g_31373	g_31374
Super-Scaffold_19	18764186	18765886	1700	g_31374	g_45439
Super-Scaffold_19	18771306	18772765	1459	g_45439	g_31375
Super-Scaffold_19	18779985	18782344	2359	g_31375	g_31376
Super-Scaffold_19	18783589	18785436	1847	g_31376	g_31377
Super-Scaffold_19	18790720	18801812	11092	g_31377	g_31378
Super-Scaffold_19	18806029	18817276	11247	g_31378	g_45440
Super-Scaffold_19	18818016	18842848	24832	g_45440	g_31379
Super-Scaffold_19	18844566	18870928	26362	g_31379	g_31380
Super-Scaffold_19	18885905	18902554	16649	g_31380	g_45441
Super-Scaffold_19	18926540	18951486	24946	g_45441	g_31381
Super-Scaffold_19	18951821	18955505	3684	g_31381	g_31382
Super-Scaffold_19	18955831	18969188	13357	g_31382	g_39849
Super-Scaffold_19	18969643	19012452	42809	g_39849	g_31383
Super-Scaffold_19	19014949	19020696	5747	g_31383	g_31384
Super-Scaffold_19	19071449	19076029	4580	g_31384	g_31386
Super-Scaffold_19	19092337	19113473	21136	g_31386	g_31387
Super-Scaffold_19	19121540	19136089	14549	g_31387	g_31389
Super-Scaffold_19	19138347	19139351	1004	g_31389	g_31390
Super-Scaffold_19	19149543	19152329	2786	g_31390	g_31391
Super-Scaffold_19	19153915	19155329	1414	g_31391	g_31392
Super-Scaffold_19	19173543	19175596	2053	g_31392	g_31393
Super-Scaffold_19	19175874	19194500	18626	g_31393	g_31395
Super-Scaffold_19	19195459	19257032	61573	g_31395	g_31397
Super-Scaffold_19	19274662	19279610	4948	g_31397	g_31398
Super-Scaffold_19	19282708	19285978	3270	g_31398	g_31399
Super-Scaffold_19	19287276	19296017	8741	g_31399	g_31400
Super-Scaffold_19	19296313	19304615	8302	g_31400	g_31401
Super-Scaffold_19	19306569	19309105	2536	g_31401	g_45442
Super-Scaffold_19	19310810	19313896	3086	g_45442	g_31402
Super-Scaffold_19	19320191	19351827	31636	g_31402	g_31403
Super-Scaffold_19	19356350	19380235	23885	g_31403	g_31404
Super-Scaffold_19	19389920	19394396	4476	g_31404	g_31406
Super-Scaffold_19	19395984	19396446	462	g_31406	g_45443
Super-Scaffold_19	19399212	19483713	84501	g_45443	g_31408
Super-Scaffold_19	19491194	19492832	1638	g_31408	g_31409
Super-Scaffold_19	19500790	19503528	2738	g_31409	g_31410
Super-Scaffold_19	19504121	19545035	40914	g_31410	g_31413
Super-Scaffold_19	19547502	19548419	917	g_31413	g_31414
Super-Scaffold_19	19557307	19559053	1746	g_31414	g_31415
Super-Scaffold_19	19571328	19575535	4207	g_31415	g_31416
Super-Scaffold_19	19579400	19581541	2141	g_31416	g_31417
Super-Scaffold_19	19589344	19595866	6522	g_31417	g_31418
Super-Scaffold_19	19597812	19600616	2804	g_31418	g_31419
Super-Scaffold_19	19605223	19609302	4079	g_31419	g_31420
Super-Scaffold_19	19609997	19615163	5166	g_31420	g_31421
Super-Scaffold_19	19617522	19619949	2427	g_31421	g_31422
Super-Scaffold_19	19625676	19629912	4236	g_31422	g_31423
Super-Scaffold_19	19653729	19660795	7066	g_39850	g_31424
Super-Scaffold_19	19662198	19674396	12198	g_31424	g_31425
Super-Scaffold_19	19675916	19681440	5524	g_31425	g_31426
Super-Scaffold_19	19685831	19692397	6566	g_31426	g_31428
Super-Scaffold_19	19694886	19711637	16751	g_31428	g_31429
Super-Scaffold_19	19719994	19724956	4962	g_31429	g_31430
Super-Scaffold_19	19728631	19732710	4079	g_31430	g_31431
Super-Scaffold_19	19741153	19744841	3688	g_31431	g_31432
Super-Scaffold_19	19754801	19758055	3254	g_31432	g_31433
Super-Scaffold_19	19760955	19765448	4493	g_31433	g_31434
Super-Scaffold_19	19765678	19767206	1528	g_31434	g_31435
Super-Scaffold_19	19767807	19770815	3008	g_31435	g_31436
Super-Scaffold_19	19774947	19780049	5102	g_31436	g_31437
Super-Scaffold_19	19783103	19786948	3845	g_31437	g_31439
Super-Scaffold_19	19788504	19789001	497	g_31439	g_31440
Super-Scaffold_19	19798637	19800127	1490	g_31440	g_31441
Super-Scaffold_19	19802941	19805259	2318	g_31441	g_31442
Super-Scaffold_19	19813649	19818208	4559	g_31442	g_31444
Super-Scaffold_19	19837261	19841335	4074	g_31444	g_31445
Super-Scaffold_19	19862281	19892081	29800	g_39853	g_31447
Super-Scaffold_19	19892428	19897605	5177	g_31447	g_31448
Super-Scaffold_19	19901195	19910423	9228	g_31448	g_31449
Super-Scaffold_19	19919345	19929543	10198	g_31449	g_31451
Super-Scaffold_19	19932648	19937207	4559	g_31451	g_45444
Super-Scaffold_19	19939926	19952477	12551	g_45444	g_31452
Super-Scaffold_19	19953505	19991084	37579	g_31452	g_31453
Super-Scaffold_19	19998899	20001952	3053	g_31453	g_31454
Super-Scaffold_19	20004308	20004828	520	g_31454	g_31455
Super-Scaffold_19	20006018	20008425	2407	g_31455	g_31456
Super-Scaffold_19	20009438	20011828	2390	g_31456	g_31457
Super-Scaffold_19	20016069	20018619	2550	g_31457	g_39856
Super-Scaffold_19	20018882	20020389	1507	g_39856	g_31458
Super-Scaffold_19	20025504	20028148	2644	g_31458	g_31459
Super-Scaffold_19	20029375	20029986	611	g_31459	g_31460
Super-Scaffold_19	20033489	20036879	3390	g_31460	g_31461
Super-Scaffold_19	20043382	20044921	1539	g_31461	g_31462
Super-Scaffold_19	20064290	20069328	5038	g_31462	g_31463
Super-Scaffold_19	20073318	20076914	3596	g_31463	g_31464
Super-Scaffold_19	20078734	20082381	3647	g_31464	g_31465
Super-Scaffold_19	20087958	20090461	2503	g_31465	g_31466
Super-Scaffold_19	20095119	20096122	1003	g_31466	g_45445
Super-Scaffold_19	20098375	20101449	3074	g_45445	g_45446
Super-Scaffold_19	20104464	20106476	2012	g_45446	g_31467
Super-Scaffold_19	20123568	20124967	1399	g_31467	g_31468
Super-Scaffold_19	20129393	20130587	1194	g_31468	g_31469
Super-Scaffold_19	20137047	20139933	2886	g_31469	g_31470
Super-Scaffold_19	20150622	20151660	1038	g_31470	g_31471
Super-Scaffold_19	20153914	20156542	2628	g_31471	g_31472
Super-Scaffold_19	20161067	20162913	1846	g_31472	g_31473
Super-Scaffold_19	20164996	20168991	3995	g_31473	g_31474
Super-Scaffold_19	20169919	20173786	3867	g_31474	g_31475
Super-Scaffold_19	20184033	20184698	665	g_31475	g_31476
Super-Scaffold_19	20189108	20190317	1209	g_31476	g_31477
Super-Scaffold_19	20194732	20199925	5193	g_31477	g_31478
Super-Scaffold_19	20200161	20202324	2163	g_31478	g_31479
Super-Scaffold_19	20203202	20213230	10028	g_31479	g_31480
Super-Scaffold_19	20218698	20221458	2760	g_31480	g_45447
Super-Scaffold_19	20222880	20223318	438	g_45447	g_31481
Super-Scaffold_19	20224831	20249439	24608	g_31481	g_31482
Super-Scaffold_19	20255116	20256439	1323	g_31482	g_31483
Super-Scaffold_19	20260041	20261924	1883	g_31483	g_45448
Super-Scaffold_19	20264942	20268862	3920	g_45448	g_45449
Super-Scaffold_19	20273299	20274513	1214	g_45449	g_31484
Super-Scaffold_19	20296300	20313561	17261	g_31484	g_31485
Super-Scaffold_19	20317327	20320424	3097	g_31485	g_31486
Super-Scaffold_19	20343464	20343527	63	g_31486	g_45450
Super-Scaffold_19	20347319	20369222	21903	g_45450	g_31487
Super-Scaffold_19	20369533	20385829	16296	g_31487	g_31489
Super-Scaffold_19	20393625	20397460	3835	g_31489	g_45451
Super-Scaffold_19	20406529	20409711	3182	g_45451	g_45452
Super-Scaffold_19	20411938	20414782	2844	g_45452	g_31490
Super-Scaffold_19	20420495	20427161	6666	g_31490	g_31491
Super-Scaffold_19	20447142	20449574	2432	g_31491	g_31492
Super-Scaffold_19	20470642	20486495	15853	g_31492	g_31493
Super-Scaffold_19	20486827	20487825	998	g_31493	g_31495
Super-Scaffold_19	20488595	20508410	19815	g_31495	g_31496
Super-Scaffold_19	20510618	20515402	4784	g_31496	g_31497
Super-Scaffold_19	20526059	20530828	4769	g_31497	g_31498
Super-Scaffold_19	20541538	20542755	1217	g_31498	g_31499
Super-Scaffold_19	20547450	20565220	17770	g_31499	g_45453
Super-Scaffold_19	20568859	20571447	2588	g_45453	g_45454
Super-Scaffold_19	20576510	20578415	1905	g_45454	g_31500
Super-Scaffold_19	20580076	20643602	63526	g_31500	g_31502
Super-Scaffold_19	20643997	20669101	25104	g_31502	g_31503
Super-Scaffold_19	20669466	20696803	27337	g_31503	g_31505
Super-Scaffold_19	20706397	20708934	2537	g_31505	g_31506
Super-Scaffold_19	20713306	20714899	1593	g_31506	g_31507
Super-Scaffold_19	20715906	20717737	1831	g_31507	g_31508
Super-Scaffold_19	20722556	20726427	3871	g_31508	g_31509
Super-Scaffold_19	20727496	20732183	4687	g_31509	g_31510
Super-Scaffold_19	20736175	20738450	2275	g_31510	g_31511
Super-Scaffold_19	20739536	20744317	4781	g_31511	g_31512
Super-Scaffold_19	20746172	20749733	3561	g_31512	g_31513
Super-Scaffold_19	20751978	20754198	2220	g_31513	g_31514
Super-Scaffold_19	20760987	20786441	25454	g_31514	g_31516
Super-Scaffold_19	20803258	20812959	9701	g_31516	g_31517
Super-Scaffold_19	20818612	20831202	12590	g_31517	g_31518
Super-Scaffold_19	20846517	20856732	10215	g_31518	g_31519
Super-Scaffold_19	20863930	20865462	1532	g_31519	g_31520
Super-Scaffold_19	20869912	20870652	740	g_31520	g_31521
Super-Scaffold_19	20877278	20879598	2320	g_31521	g_31522
Super-Scaffold_19	20882036	20882987	951	g_31522	g_31523
Super-Scaffold_19	20886159	20888643	2484	g_31523	g_31524
Super-Scaffold_19	20890885	20894538	3653	g_31524	g_45455
Super-Scaffold_19	20898203	20901368	3165	g_45455	g_31525
Super-Scaffold_19	20911772	20913175	1403	g_31525	g_45456
Super-Scaffold_19	20919368	20921589	2221	g_45456	g_31526
Super-Scaffold_19	20923413	20925740	2327	g_31526	g_45457
Super-Scaffold_19	20941412	20949677	8265	g_45457	g_31527
Super-Scaffold_19	20973995	20982578	8583	g_31527	g_31528
Super-Scaffold_19	20989662	20997596	7934	g_31528	g_31529
Super-Scaffold_19	20998442	20999880	1438	g_31529	g_31530
Super-Scaffold_19	21002474	21004179	1705	g_31530	g_31531
Super-Scaffold_19	21004970	21006816	1846	g_31531	g_31532
Super-Scaffold_19	21008306	21009971	1665	g_31532	g_31533
Super-Scaffold_19	21016691	21017176	485	g_31533	g_31534
Super-Scaffold_19	21027118	21029354	2236	g_31534	g_31535
Super-Scaffold_19	21039360	21041906	2546	g_31535	g_31536
Super-Scaffold_19	21048755	21053536	4781	g_31536	g_31537
Super-Scaffold_19	21058271	21062604	4333	g_31537	g_31538
Super-Scaffold_19	21063554	21069387	5833	g_31538	g_31539
Super-Scaffold_19	21083534	21086211	2677	g_31539	g_31540
Super-Scaffold_19	21091340	21097770	6430	g_31540	g_31541
Super-Scaffold_19	21099118	21108064	8946	g_31541	g_31543
Super-Scaffold_19	21110666	21114373	3707	g_31543	g_45458
Super-Scaffold_19	21119506	21120497	991	g_45458	g_31544
Super-Scaffold_19	21126188	21155715	29527	g_31544	g_31546
Super-Scaffold_19	21167107	21171504	4397	g_31546	g_31547
Super-Scaffold_19	21186483	21205294	18811	g_31547	g_31549
Super-Scaffold_19	21211732	21229383	17651	g_31549	g_31550
Super-Scaffold_19	21231074	21241867	10793	g_31550	g_31551
Super-Scaffold_19	21243637	21247109	3472	g_31551	g_31552
Super-Scaffold_19	21250349	21260765	10416	g_31552	g_31554
Super-Scaffold_19	21261130	21323897	62767	g_31554	g_31555
Super-Scaffold_19	21346866	21505350	158484	g_31555	g_31557
Super-Scaffold_19	21506863	21512912	6049	g_31557	g_31558
Super-Scaffold_19	21513391	21514819	1428	g_31558	g_31559
Super-Scaffold_19	21518623	21522224	3601	g_31559	g_31560
Super-Scaffold_19	21534025	21537494	3469	g_31560	g_31561
Super-Scaffold_19	21551278	21554035	2757	g_31561	g_31562
Super-Scaffold_19	21558907	21560456	1549	g_31562	g_31563
Super-Scaffold_19	21563650	21566450	2800	g_31563	g_31564
Super-Scaffold_19	21572547	21577914	5367	g_31564	g_31565
Super-Scaffold_19	21599250	21601534	2284	g_31565	g_31566
Super-Scaffold_19	21601776	21602654	878	g_31566	g_31567
Super-Scaffold_19	21609107	21666408	57301	g_31567	g_31569
Super-Scaffold_19	21670785	21681891	11106	g_31569	g_31570
Super-Scaffold_19	21683311	21688314	5003	g_31570	g_31571
Super-Scaffold_19	21689591	21692691	3100	g_31571	g_31572
Super-Scaffold_19	21695145	21696057	912	g_31572	g_31573
Super-Scaffold_19	21701120	21703301	2181	g_31573	g_31574
Super-Scaffold_19	21722486	21762500	40014	g_31574	g_31576
Super-Scaffold_19	21764005	21764842	837	g_31576	g_31577
Super-Scaffold_19	21765603	21767299	1696	g_31577	g_31578
Super-Scaffold_19	21776406	21792612	16206	g_31578	g_31579
Super-Scaffold_19	21804665	21824214	19549	g_31579	g_31580
Super-Scaffold_19	21835822	21859750	23928	g_31580	g_31582
Super-Scaffold_19	21875576	21879601	4025	g_31582	g_31583
Super-Scaffold_19	21888894	21907386	18492	g_31583	g_31584
Super-Scaffold_19	21910924	21913991	3067	g_31584	g_31585
Super-Scaffold_19	21926396	22002114	75718	g_31585	g_31588
Super-Scaffold_19	22021440	22024805	3365	g_31588	g_31589
Super-Scaffold_19	22027294	22030178	2884	g_31589	g_31590
Super-Scaffold_19	22038538	22079021	40483	g_31590	g_31591
Super-Scaffold_19	22082995	22088909	5914	g_31591	g_45459
Super-Scaffold_19	22091747	22101919	10172	g_45459	g_31592
Super-Scaffold_19	22110745	22114133	3388	g_31592	g_31593
Super-Scaffold_19	22116702	22117840	1138	g_31593	g_31594
Super-Scaffold_19	22119477	22126852	7375	g_31594	g_31595
Super-Scaffold_19	22138989	22152762	13773	g_31595	g_31596
Super-Scaffold_19	22157366	22159068	1702	g_31596	g_31597
Super-Scaffold_19	22160526	22161275	749	g_31597	g_31598
Super-Scaffold_19	22162661	22163803	1142	g_31598	g_31599
Super-Scaffold_19	22165961	22168205	2244	g_31599	g_31600
Super-Scaffold_19	22170386	22174366	3980	g_31600	g_31601
Super-Scaffold_19	22177134	22181682	4548	g_31601	g_31602
Super-Scaffold_19	22186642	22186684	42	g_31602	g_31603
Super-Scaffold_19	22186950	22198303	11353	g_31603	g_31605
Super-Scaffold_19	22202285	22206759	4474	g_31605	g_31606
Super-Scaffold_19	22218805	22224163	5358	g_31606	g_31607
Super-Scaffold_19	22226334	22230560	4226	g_31607	g_31609
Super-Scaffold_19	22236764	22259756	22992	g_31609	g_31612
Super-Scaffold_19	22260043	22390592	130549	g_31612	g_31620
Super-Scaffold_19	22390819	22409284	18465	g_31620	g_31621
Super-Scaffold_19	22411632	22413305	1673	g_31621	g_45460
Super-Scaffold_19	22416717	22421567	4850	g_45460	g_45461
Super-Scaffold_19	22422709	22424973	2264	g_45461	g_31622
Super-Scaffold_19	22434158	22436725	2567	g_31622	g_31623
Super-Scaffold_19	22442013	22442960	947	g_31623	g_31624
Super-Scaffold_19	22448039	22449132	1093	g_31624	g_31625
Super-Scaffold_19	22455171	22456187	1016	g_31625	g_31626
Super-Scaffold_19	22457702	22462163	4461	g_31626	g_31627
Super-Scaffold_19	22469052	22473068	4016	g_31627	g_31628
Super-Scaffold_19	22476689	22479161	2472	g_31628	g_31629
Super-Scaffold_19	22481004	22482662	1658	g_31629	g_31630
Super-Scaffold_19	22483373	22485349	1976	g_31630	g_31631
Super-Scaffold_19	22490845	22493781	2936	g_31631	g_31632
Super-Scaffold_19	22500487	22503781	3294	g_31632	g_31633
Super-Scaffold_19	22507597	22508201	604	g_31633	g_31634
Super-Scaffold_19	22516229	22519771	3542	g_31634	g_31635
Super-Scaffold_19	22524535	22549951	25416	g_31635	g_31637
Super-Scaffold_19	22551593	22559574	7981	g_31637	g_31638
Super-Scaffold_19	22584478	22587580	3102	g_31638	g_31639
Super-Scaffold_19	22587828	22611820	23992	g_31639	g_39870
Super-Scaffold_19	22612077	22661379	49302	g_39870	g_31642
Super-Scaffold_19	22671360	22678155	6795	g_31642	g_45462
Super-Scaffold_19	22682745	22690483	7738	g_45462	g_31645
Super-Scaffold_19	22703924	22723316	19392	g_31645	g_31646
Super-Scaffold_19	22723627	22747570	23943	g_31646	g_31649
Super-Scaffold_19	22747815	22761682	13867	g_31649	g_31650
Super-Scaffold_19	22763273	22763693	420	g_31650	g_31651
Super-Scaffold_19	22771550	22773123	1573	g_31651	g_31652
Super-Scaffold_19	22778180	22779681	1501	g_31652	g_31653
Super-Scaffold_19	22781048	22797900	16852	g_31653	g_31654
Super-Scaffold_19	22818770	22830434	11664	g_31654	g_31655
Super-Scaffold_19	22832390	22902349	69959	g_31655	g_31656
Super-Scaffold_19	22907737	22915538	7801	g_31656	g_31657
Super-Scaffold_19	22917195	22927112	9917	g_31657	g_39873
Super-Scaffold_19	22927363	22927596	233	g_39873	g_31658
Super-Scaffold_19	22942033	22958727	16694	g_31658	g_45463
Super-Scaffold_19	22959170	22962069	2899	g_45463	g_31659
Super-Scaffold_19	22967904	22970913	3009	g_31659	g_45464
Super-Scaffold_19	22974088	22986350	12262	g_45464	g_31660
Super-Scaffold_19	22995551	23000633	5082	g_31660	g_31661
Super-Scaffold_19	23006037	23008544	2507	g_31661	g_31662
Super-Scaffold_19	23013445	23016485	3040	g_31662	g_31663
Super-Scaffold_19	23018218	23028249	10031	g_31663	g_31664
Super-Scaffold_19	23033529	23035467	1938	g_31664	g_45465
Super-Scaffold_19	23039362	23040780	1418	g_45465	g_45466
Super-Scaffold_19	23044581	23084300	39719	g_45466	g_31665
Super-Scaffold_19	23086056	23093721	7665	g_31665	g_31666
Super-Scaffold_19	23096194	23108832	12638	g_31666	g_31667
Super-Scaffold_19	23110564	23147296	36732	g_31667	g_31668
Super-Scaffold_19	23149301	23170199	20898	g_31668	g_31669
Super-Scaffold_19	23181530	23184862	3332	g_31669	g_31670
Super-Scaffold_19	23185164	23235562	50398	g_31670	g_31674
Super-Scaffold_19	23239686	23302919	63233	g_31674	g_31676
Super-Scaffold_19	23325255	23325951	696	g_31676	g_39879
Super-Scaffold_19	23326190	23329616	3426	g_39879	g_31677
Super-Scaffold_19	23357267	23373436	16169	g_31677	g_31678
Super-Scaffold_19	23383418	23384163	745	g_31678	g_31679
Super-Scaffold_19	23384540	23385979	1439	g_31679	g_31680
Super-Scaffold_19	23386602	23388644	2042	g_31680	g_31681
Super-Scaffold_19	23391726	23392356	630	g_31681	g_31682
Super-Scaffold_19	23394713	23396094	1381	g_31682	g_31683
Super-Scaffold_19	23396570	23423577	27007	g_31683	g_31684
Super-Scaffold_19	23429133	23445240	16107	g_31684	g_31685
Super-Scaffold_19	23458452	23479077	20625	g_31685	g_31686
Super-Scaffold_19	23490058	23492895	2837	g_31686	g_31687
Super-Scaffold_19	23501587	23552228	50641	g_31687	g_31689
Super-Scaffold_19	23552674	23553258	584	g_31689	g_39880
Super-Scaffold_19	23553482	23561577	8095	g_39880	g_31690
Super-Scaffold_19	23563376	23565628	2252	g_31690	g_31691
Super-Scaffold_19	23568252	23570302	2050	g_31691	g_31692
Super-Scaffold_19	23570556	23586156	15600	g_31692	g_31693
Super-Scaffold_19	23591745	23627631	35886	g_31693	g_31695
Super-Scaffold_19	23667476	23673789	6313	g_31695	g_31696
Super-Scaffold_19	23675432	23720843	45411	g_31696	g_39882
Super-Scaffold_19	23721196	23727871	6675	g_39882	g_31697
Super-Scaffold_19	23737351	23748646	11295	g_31697	g_31698
Super-Scaffold_19	23750290	23775047	24757	g_31698	g_31699
Super-Scaffold_19	23792942	23808794	15852	g_31699	g_31700
Super-Scaffold_19	23818071	23821677	3606	g_31700	g_31702
Super-Scaffold_19	23847434	23868761	21327	g_31702	g_31704
Super-Scaffold_19	23869099	23923455	54356	g_31704	g_31705
Super-Scaffold_19	23923700	23928335	4635	g_31705	g_31706
Super-Scaffold_19	23967505	23969233	1728	g_31706	g_45467
Super-Scaffold_19	23970369	23971186	817	g_45467	g_31707
Super-Scaffold_19	23982626	23989470	6844	g_31707	g_31708
Super-Scaffold_19	23991113	24031095	39982	g_31708	g_31709
Super-Scaffold_19	24036413	24082623	46210	g_31709	g_31711
Super-Scaffold_19	24083150	24098948	15798	g_31711	g_31712
Super-Scaffold_19	24102939	24109407	6468	g_31712	g_31713
Super-Scaffold_19	24117297	24121447	4150	g_31713	g_31714
Super-Scaffold_19	24122326	24127738	5412	g_31714	g_31715
Super-Scaffold_19	24129621	24133192	3571	g_31715	g_45468
Super-Scaffold_19	24137736	24146107	8371	g_45468	g_31717
Super-Scaffold_19	24147561	24154275	6714	g_31717	g_31718
Super-Scaffold_19	24160351	24170272	9921	g_31718	g_31719
Super-Scaffold_19	24182229	24187390	5161	g_31719	g_31720
Super-Scaffold_19	24189711	24214355	24644	g_31720	g_31721
Super-Scaffold_19	24217415	24227404	9989	g_31721	g_31723
Super-Scaffold_19	24232625	24235365	2740	g_31723	g_45469
Super-Scaffold_19	24238387	24248468	10081	g_45469	g_31724
Super-Scaffold_19	24251195	24272541	21346	g_31724	g_31725
Super-Scaffold_19	24275910	24280188	4278	g_31725	g_45470
Super-Scaffold_19	24281688	24286777	5089	g_45470	g_45471
Super-Scaffold_19	24288498	24294730	6232	g_45471	g_31726
Super-Scaffold_19	24316926	24334888	17962	g_31726	g_31728
Super-Scaffold_19	24342503	24348495	5992	g_31728	g_31729
Super-Scaffold_19	24373601	24375706	2105	g_31729	g_31730
Super-Scaffold_19	24384897	24389655	4758	g_31730	g_45472
Super-Scaffold_19	24415106	24444481	29375	g_45472	g_31732
Super-Scaffold_19	24445905	24451662	5757	g_31732	g_31733
Super-Scaffold_19	24451904	24585908	134004	g_31733	g_31736
Super-Scaffold_19	24586153	24612103	25950	g_31736	g_31738
Super-Scaffold_19	24612495	24676631	64136	g_31738	g_31740
Super-Scaffold_19	24698761	24754916	56155	g_31740	g_31744
Super-Scaffold_19	24765638	24786633	20995	g_31744	g_31745
Super-Scaffold_19	24789839	24795014	5175	g_31745	g_31746
Super-Scaffold_19	24795322	24847527	52205	g_31746	g_31748
Super-Scaffold_19	24847853	24850371	2518	g_31748	g_31749
Super-Scaffold_19	24851806	24855068	3262	g_31749	g_45473
Super-Scaffold_19	24855361	24862267	6906	g_45473	g_31750
Super-Scaffold_19	24867256	24872691	5435	g_31750	g_31751
Super-Scaffold_19	24886405	24887735	1330	g_31751	g_31752
Super-Scaffold_19	24890542	24892376	1834	g_31752	g_31753
Super-Scaffold_19	24899392	24903168	3776	g_31753	g_31754
Super-Scaffold_19	24911481	24914347	2866	g_31754	g_31755
Super-Scaffold_19	24921815	24934915	13100	g_31755	g_31756
Super-Scaffold_19	24946022	24969486	23464	g_31756	g_31758
Super-Scaffold_19	24976371	24977251	880	g_31758	g_31759
Super-Scaffold_19	24978665	24979693	1028	g_31759	g_31760
Super-Scaffold_19	24982713	24985173	2460	g_31760	g_31761
Super-Scaffold_19	24986851	24987753	902	g_31761	g_31762
Super-Scaffold_19	24992929	24994251	1322	g_31762	g_31763
Super-Scaffold_19	24996504	25036050	39546	g_31763	g_31764
Super-Scaffold_19	25041211	25046975	5764	g_31764	g_31765
Super-Scaffold_19	25049460	25064993	15533	g_31765	g_39895
Super-Scaffold_19	25065235	25184520	119285	g_39895	g_31768
Super-Scaffold_19	25184962	25190840	5878	g_31768	g_31769
Super-Scaffold_19	25191109	25202453	11344	g_31769	g_31771
Super-Scaffold_19	25235891	25258433	22542	g_31771	g_31773
Super-Scaffold_19	25258732	25266753	8021	g_31773	g_31774
Super-Scaffold_19	25269612	25272369	2757	g_31774	g_31775
Super-Scaffold_19	25286434	25297541	11107	g_31775	g_31776
Super-Scaffold_19	25317900	25330985	13085	g_31776	g_31777
Super-Scaffold_19	25332004	25333846	1842	g_31777	g_31778
Super-Scaffold_19	25342020	25343824	1804	g_31778	g_31779
Super-Scaffold_19	25346495	25348417	1922	g_31779	g_31780
Super-Scaffold_19	25353025	25355959	2934	g_31780	g_31781
Super-Scaffold_19	25361754	25363953	2199	g_31781	g_45474
Super-Scaffold_19	25365078	25373809	8731	g_45474	g_39898
Super-Scaffold_19	25374051	25378873	4822	g_39898	g_31782
Super-Scaffold_19	25382902	25385297	2395	g_31782	g_31783
Super-Scaffold_19	25398109	25399149	1040	g_31783	g_45475
Super-Scaffold_19	25399352	25422573	23221	g_45475	g_31784
Super-Scaffold_19	25436486	25442879	6393	g_31784	g_45476
Super-Scaffold_19	25451487	25461096	9609	g_45476	g_31785
Super-Scaffold_19	25465880	25468458	2578	g_31785	g_31786
Super-Scaffold_19	25469903	25475044	5141	g_31786	g_31787
Super-Scaffold_19	25475634	25487941	12307	g_31787	g_31788
Super-Scaffold_19	25488531	25499256	10725	g_31788	g_31789
Super-Scaffold_19	25499846	25528481	28635	g_31789	g_31791
Super-Scaffold_19	25528963	25534509	5546	g_31791	g_31792
Super-Scaffold_19	25536718	25552159	15441	g_31792	g_31793
Super-Scaffold_19	25555816	25570681	14865	g_39900	g_31794
Super-Scaffold_19	25575068	25576118	1050	g_31794	g_39901
Super-Scaffold_19	25576327	25582162	5835	g_39901	g_31795
Super-Scaffold_19	25585645	25587936	2291	g_31795	g_31796
Super-Scaffold_19	25598502	25602081	3579	g_31796	g_31797
Super-Scaffold_19	25611591	25620195	8604	g_31797	g_45477
Super-Scaffold_19	25630492	25649308	18816	g_45477	g_31798
Super-Scaffold_19	25658372	25697537	39165	g_31798	g_31799
Super-Scaffold_19	25719797	25728198	8401	g_31799	g_31800
Super-Scaffold_19	25728770	25739851	11081	g_31800	g_31802
Super-Scaffold_19	25747512	25748766	1254	g_31802	g_39903
Super-Scaffold_19	25753751	25759743	5992	g_31803	g_31804
Super-Scaffold_19	25765034	25769294	4260	g_31804	g_31805
Super-Scaffold_19	25776961	25779774	2813	g_31805	g_31806
Super-Scaffold_19	25787033	25792578	5545	g_31806	g_31807
Super-Scaffold_19	25792844	25798911	6067	g_31807	g_31808
Super-Scaffold_19	25827298	25827548	250	g_31808	g_31809
Super-Scaffold_19	25827835	25835859	8024	g_31809	g_31810
Super-Scaffold_19	25846240	25849189	2949	g_31810	g_31811
Super-Scaffold_19	25849887	25857164	7277	g_31811	g_31812
Super-Scaffold_19	25861808	25866288	4480	g_31812	g_31813
Super-Scaffold_19	25876087	25882970	6883	g_31813	g_31814
Super-Scaffold_19	25888995	25892515	3520	g_31814	g_31815
Super-Scaffold_19	25896289	25897288	999	g_31815	g_31816
Super-Scaffold_19	25900012	25903373	3361	g_31816	g_45478
Super-Scaffold_19	25906918	25910293	3375	g_45478	g_31817
Super-Scaffold_19	25915121	25918220	3099	g_31817	g_31818
Super-Scaffold_19	25919602	25954034	34432	g_31818	g_31819
Super-Scaffold_19	25954333	26122572	168239	g_31819	g_31823
Super-Scaffold_19	26145900	26173986	28086	g_31823	g_31824
Super-Scaffold_19	26180612	26183107	2495	g_31824	g_31825
Super-Scaffold_19	26189575	26195186	5611	g_31825	g_31826
Super-Scaffold_19	26195434	26203854	8420	g_31826	g_31827
Super-Scaffold_19	26220550	26227768	7218	g_31827	g_45479
Super-Scaffold_19	26228327	26239105	10778	g_45479	g_31828
Super-Scaffold_19	26242877	26270514	27637	g_31828	g_31829
Super-Scaffold_19	26289563	26312580	23017	g_31829	g_31830
Super-Scaffold_19	26312819	26316349	3530	g_31830	g_31831
Super-Scaffold_19	26328910	26333011	4101	g_31831	g_31832
Super-Scaffold_19	26334961	26341234	6273	g_39908	g_31833
Super-Scaffold_19	26357819	26363029	5210	g_31833	g_31834
Super-Scaffold_19	26365416	26368152	2736	g_31834	g_31835
Super-Scaffold_19	26369850	26373398	3548	g_31835	g_31836
Super-Scaffold_19	26398030	26398419	389	g_31836	g_31837
Super-Scaffold_19	26398718	26402473	3755	g_31837	g_31838
Super-Scaffold_19	26403538	26408821	5283	g_31838	g_31839
Super-Scaffold_19	26409372	26415612	6240	g_31839	g_31840
Super-Scaffold_19	26420233	26425093	4860	g_31840	g_31841
Super-Scaffold_19	26428755	26433672	4917	g_31841	g_31842
Super-Scaffold_19	26440642	26445167	4525	g_31842	g_31843
Super-Scaffold_19	26459676	26462674	2998	g_31843	g_31844
Super-Scaffold_19	26468484	26472280	3796	g_31844	g_31845
Super-Scaffold_19	26473457	26474055	598	g_31845	g_31846
Super-Scaffold_19	26484896	26493292	8396	g_31846	g_31847
Super-Scaffold_19	26495999	26497448	1449	g_31847	g_31848
Super-Scaffold_19	26499939	26500192	253	g_31848	g_31849
Super-Scaffold_19	26517844	26525549	7705	g_31849	g_31850
Super-Scaffold_19	26538577	26612658	74081	g_31850	g_31852
Super-Scaffold_19	26612966	26670094	57128	g_31852	g_39910
Super-Scaffold_19	26670372	26736906	66534	g_39910	g_31853
Super-Scaffold_19	26737187	26793675	56488	g_31853	g_31855
Super-Scaffold_19	26794710	26845481	50771	g_31855	g_31857
Super-Scaffold_19	26845732	26855223	9491	g_31857	g_31858
Super-Scaffold_19	26857422	26861886	4464	g_31858	g_31859
Super-Scaffold_19	26863664	26864873	1209	g_31859	g_45480
Super-Scaffold_19	26870191	26873770	3579	g_45480	g_31860
Super-Scaffold_19	26882545	26888113	5568	g_31860	g_31861
Super-Scaffold_19	26909211	26911362	2151	g_31861	g_31862
Super-Scaffold_19	26911574	26926611	15037	g_31862	g_31863
Super-Scaffold_19	26927670	26931878	4208	g_31863	g_31864
Super-Scaffold_19	26952869	26961457	8588	g_31864	g_31865
Super-Scaffold_19	26965969	26981388	15419	g_31865	g_31867
Super-Scaffold_19	26986682	26990497	3815	g_31867	g_31869
Super-Scaffold_19	26991687	27048134	56447	g_31869	g_31870
Super-Scaffold_19	27050566	27052957	2391	g_31870	g_31871
Super-Scaffold_19	27057320	27060052	2732	g_31871	g_31872
Super-Scaffold_19	27060351	27074308	13957	g_31872	g_31873
Super-Scaffold_19	27086235	27089130	2895	g_31873	g_31874
Super-Scaffold_19	27090446	27092034	1588	g_31874	g_31875
Super-Scaffold_19	27095009	27097299	2290	g_31875	g_31876
Super-Scaffold_19	27111790	27113117	1327	g_31876	g_31877
Super-Scaffold_19	27140053	27147019	6966	g_31877	g_31878
Super-Scaffold_19	27153644	27165084	11440	g_31878	g_31881
Super-Scaffold_19	27169867	27179534	9667	g_31881	g_31882
Super-Scaffold_19	27183354	27185836	2482	g_31882	g_31883
Super-Scaffold_19	27202259	27214340	12081	g_31883	g_31884
Super-Scaffold_19	27214789	27244665	29876	g_31884	g_31885
Super-Scaffold_19	27244865	27252205	7340	g_31885	g_31886
Super-Scaffold_19	27252504	27263671	11167	g_31886	g_31887
Super-Scaffold_19	27264714	27272865	8151	g_31887	g_31888
Super-Scaffold_19	27274210	27275238	1028	g_31888	g_45481
Super-Scaffold_19	27289426	27290285	859	g_45481	g_31889
Super-Scaffold_19	27296813	27299160	2347	g_31889	g_31890
Super-Scaffold_19	27302384	27307486	5102	g_31890	g_45482
Super-Scaffold_19	27315245	27400564	85319	g_45482	g_31892
Super-Scaffold_19	27401271	27485767	84496	g_31892	g_31895
Super-Scaffold_19	27526680	27571975	45295	g_31895	g_31896
Super-Scaffold_19	27573198	27608466	35268	g_31896	g_31898
Super-Scaffold_19	27608669	27661608	52939	g_31898	g_31899
Super-Scaffold_19	27686866	27702846	15980	g_31899	g_45483
Super-Scaffold_19	27706339	27708450	2111	g_45483	g_45484
Super-Scaffold_19	27712193	27714139	1946	g_45484	g_31900
Super-Scaffold_19	27715626	27718167	2541	g_31900	g_31901
Super-Scaffold_19	27727806	27739119	11313	g_31901	g_31902
Super-Scaffold_19	27740330	27743862	3532	g_31902	g_31903
Super-Scaffold_19	27748498	27753811	5313	g_31903	g_31904
Super-Scaffold_19	27775416	27890733	115317	g_31904	g_31905
Super-Scaffold_19	27909276	27915134	5858	g_31905	g_31906
Super-Scaffold_19	27923986	27952437	28451	g_31906	g_31908
Super-Scaffold_19	27952853	27985318	32465	g_31908	g_31909
Super-Scaffold_19	27987746	27994215	6469	g_31909	g_31910
Super-Scaffold_19	27996688	28039118	42430	g_31910	g_31911
Super-Scaffold_19	28045081	28058761	13680	g_31911	g_31912
Super-Scaffold_19	28059042	28059074	32	g_31912	g_45485
Super-Scaffold_19	28065552	28068589	3037	g_45485	g_31913
Super-Scaffold_19	28068999	28107383	38384	g_31913	g_31914
Super-Scaffold_19	28107964	28176127	68163	g_31914	g_31915
Super-Scaffold_19	28182433	28186334	3901	g_31915	g_31916
Super-Scaffold_19	28187360	28245950	58590	g_31916	g_31918
Super-Scaffold_19	28246675	28264158	17483	g_31918	g_31919
Super-Scaffold_19	28264796	28297114	32318	g_31919	g_31920
Super-Scaffold_19	28300392	28304439	4047	g_31920	g_31921
Super-Scaffold_19	28310156	28313188	3032	g_31921	g_31922
Super-Scaffold_19	28321693	28322610	917	g_31922	g_31923
Super-Scaffold_19	28325358	28335632	10274	g_31923	g_31925
Super-Scaffold_19	28354635	28357827	3192	g_31925	g_31926
Super-Scaffold_19	28361346	28362671	1325	g_31926	g_31927
Super-Scaffold_19	28367865	28379741	11876	g_31927	g_31928
Super-Scaffold_19	28394340	28570102	175762	g_31928	g_31931
Super-Scaffold_19	28570311	28572616	2305	g_31931	g_31932
Super-Scaffold_19	28573866	28574678	812	g_31932	g_31933
Super-Scaffold_19	28594047	28601395	7348	g_31933	g_31934
Super-Scaffold_19	28611865	28612759	894	g_31934	g_31935
Super-Scaffold_19	28615415	28645441	30026	g_31935	g_31937
Super-Scaffold_19	28645764	28751997	106233	g_31937	g_31940
Super-Scaffold_19	28768142	28810926	42784	g_31940	g_31943
Super-Scaffold_19	28819063	28867290	48227	g_31943	g_39933
Super-Scaffold_19	28867550	28901856	34306	g_39933	g_31946
Super-Scaffold_19	28906535	28910297	3762	g_31946	g_45486
Super-Scaffold_19	28922537	28946028	23491	g_45486	g_31948
Super-Scaffold_19	28946303	29000848	54545	g_31948	g_31950
Super-Scaffold_19	29023033	29035097	12064	g_31950	g_39939
Super-Scaffold_19	29056819	29081385	24566	g_39939	g_39941
Super-Scaffold_19	29081609	29115609	34000	g_39941	g_31952
Super-Scaffold_19	29115947	29154944	38997	g_31952	g_31954
Super-Scaffold_19	29155195	29163340	8145	g_31954	g_31955
Super-Scaffold_19	29163654	29225917	62263	g_31955	g_31957
Super-Scaffold_19	29226264	29238733	12469	g_31957	g_39946
Super-Scaffold_19	29238945	29266888	27943	g_39946	g_31959
Super-Scaffold_19	29283176	29312619	29443	g_31959	g_31962
Super-Scaffold_19	29333253	29336168	2915	g_31962	g_31963
Super-Scaffold_19	29348011	29349813	1802	g_31963	g_31964
Super-Scaffold_19	29354343	29384436	30093	g_31964	g_31965
Super-Scaffold_19	29387075	29390563	3488	g_31965	g_39948
Super-Scaffold_19	29390895	29393954	3059	g_39948	g_31966
Super-Scaffold_19	29406722	29407451	729	g_31966	g_39949
Super-Scaffold_19	29407789	29417084	9295	g_39949	g_31967
Super-Scaffold_19	29417575	29434984	17409	g_31967	g_31968
Super-Scaffold_19	29444600	29453336	8736	g_31968	g_31969
Super-Scaffold_19	29468952	29471712	2760	g_31969	g_31970
Super-Scaffold_19	29480406	29485111	4705	g_31970	g_31971
Super-Scaffold_19	29487025	29488920	1895	g_31971	g_31972
Super-Scaffold_19	29500703	29507669	6966	g_31972	g_31973
Super-Scaffold_19	29518048	29523929	5881	g_31973	g_45487
Super-Scaffold_19	29534919	29587332	52413	g_45487	g_31979
Super-Scaffold_19	29587538	29593162	5624	g_31979	g_31981
Super-Scaffold_19	29600578	29611665	11087	g_31981	g_31982
Super-Scaffold_19	29612063	29615929	3866	g_31982	g_31983
Super-Scaffold_19	29620425	29623989	3564	g_31983	g_31984
Super-Scaffold_19	29630075	29631679	1604	g_31984	g_31985
Super-Scaffold_19	29633833	29635497	1664	g_31985	g_31986
Super-Scaffold_19	29641717	29642395	678	g_31986	g_31987
Super-Scaffold_19	29649825	29655104	5279	g_31987	g_31988
Super-Scaffold_19	29655484	29660262	4778	g_31988	g_31989
Super-Scaffold_19	29663245	29665547	2302	g_31989	g_31990
Super-Scaffold_19	29665771	29675839	10068	g_31990	g_31991
Super-Scaffold_19	29677332	29699549	22217	g_31991	g_31992
Super-Scaffold_19	29705386	29716257	10871	g_31992	g_31994
Super-Scaffold_19	29720446	29722891	2445	g_31994	g_31995
Super-Scaffold_19	29724712	29726198	1486	g_31995	g_31996
Super-Scaffold_19	29732821	29741600	8779	g_31996	g_31997
Super-Scaffold_19	29786050	29786955	905	g_31997	g_31998
Super-Scaffold_19	29806203	29814588	8385	g_31998	g_31999
Super-Scaffold_19	29823702	29826239	2537	g_31999	g_32000
Super-Scaffold_19	29828384	29829309	925	g_32000	g_32001
Super-Scaffold_19	29833052	29853965	20913	g_32001	g_32002
Super-Scaffold_19	29862274	29865255	2981	g_32002	g_32003
Super-Scaffold_19	29868067	29871378	3311	g_32003	g_32004
Super-Scaffold_19	29882639	29885010	2371	g_32004	g_32005
Super-Scaffold_19	29887543	29909289	21746	g_32005	g_32006
Super-Scaffold_19	29916820	29917355	535	g_32006	g_32007
Super-Scaffold_19	29919235	29921081	1846	g_32007	g_32008
Super-Scaffold_19	29931308	29949186	17878	g_32008	g_32010
Super-Scaffold_19	29949416	29965894	16478	g_32010	g_32012
Super-Scaffold_19	29989708	29991996	2288	g_32012	g_32013
Super-Scaffold_19	29992298	30173178	180880	g_32013	g_32017
Super-Scaffold_19	30174556	30199469	24913	g_32017	g_32018
Super-Scaffold_19	30199819	30284823	85004	g_32018	g_32021
Super-Scaffold_19	30287098	30291058	3960	g_32021	g_32022
Super-Scaffold_19	30293662	30295386	1724	g_32022	g_32023
Super-Scaffold_19	30296989	30318099	21110	g_32024	g_32025
Super-Scaffold_19	30337455	30362002	24547	g_32025	g_32027
Super-Scaffold_19	30374106	30379925	5819	g_32027	g_32028
Super-Scaffold_19	30380664	30381465	801	g_32028	g_45488
Super-Scaffold_19	30381713	30384967	3254	g_45488	g_32029
Super-Scaffold_19	30385491	30389063	3572	g_32029	g_32031
Super-Scaffold_19	30389497	30445386	55889	g_32031	g_32033
Super-Scaffold_19	30445604	30445858	254	g_32033	g_32034
Super-Scaffold_19	30456179	30458537	2358	g_32034	g_32035
Super-Scaffold_19	30458761	30461723	2962	g_32035	g_32036
Super-Scaffold_19	30461941	30469923	7982	g_32036	g_32037
Super-Scaffold_19	30472689	30497321	24632	g_32038	g_32039
Super-Scaffold_19	30497593	30499440	1847	g_32039	g_32040
Super-Scaffold_19	30510918	30517493	6575	g_32040	g_39971
Super-Scaffold_19	30517735	30529319	11584	g_39971	g_32041
Super-Scaffold_19	30549836	30554793	4957	g_32041	g_45489
Super-Scaffold_19	30558511	30559724	1213	g_45489	g_32042
Super-Scaffold_19	30576178	30578788	2610	g_32042	g_32043
Super-Scaffold_19	30593368	30616218	22850	g_32043	g_32045
Super-Scaffold_19	30618804	30622636	3832	g_32045	g_32046
Super-Scaffold_19	30623644	30624211	567	g_32046	g_45490
Super-Scaffold_19	30630663	30633612	2949	g_45490	g_32047
Super-Scaffold_19	30640989	30644076	3087	g_32047	g_32048
Super-Scaffold_19	30655816	30660537	4721	g_32048	g_32049
Super-Scaffold_19	30664185	30676835	12650	g_32049	g_32050
Super-Scaffold_19	30685723	30709182	23459	g_32050	g_32052
Super-Scaffold_19	30710156	30714020	3864	g_32052	g_32053
Super-Scaffold_19	30716571	30718740	2169	g_32053	g_32054
Super-Scaffold_19	30721696	30724521	2825	g_32054	g_32055
Super-Scaffold_19	30726214	30731814	5600	g_32055	g_32056
Super-Scaffold_19	30734596	30742391	7795	g_32056	g_32057
Super-Scaffold_19	30744718	30746992	2274	g_32057	g_32058
Super-Scaffold_19	30760609	30766137	5528	g_32058	g_32059
Super-Scaffold_19	30768824	30777562	8738	g_32059	g_32060
Super-Scaffold_19	30780050	30789393	9343	g_32060	g_45491
Super-Scaffold_19	30791193	30793028	1835	g_45491	g_32061
Super-Scaffold_19	30798910	30800764	1854	g_32061	g_45492
Super-Scaffold_19	30808928	30810546	1618	g_45492	g_32062
Super-Scaffold_19	30814532	30817447	2915	g_32062	g_32063
Super-Scaffold_19	30825038	30830987	5949	g_32063	g_32064
Super-Scaffold_19	30844807	30856856	12049	g_32064	g_32066
Super-Scaffold_19	30865127	30870411	5284	g_32066	g_32067
Super-Scaffold_19	30880620	30883383	2763	g_32067	g_32068
Super-Scaffold_19	30893524	30896584	3060	g_32068	g_45493
Super-Scaffold_19	30914362	30916064	1702	g_45493	g_32069
Super-Scaffold_19	30920762	30923268	2506	g_32069	g_32070
Super-Scaffold_19	30929524	30937591	8067	g_32070	g_32071
Super-Scaffold_19	30954038	31028235	74197	g_32071	g_39974
Super-Scaffold_19	31028477	31052841	24364	g_39974	g_32073
Super-Scaffold_19	31062284	31076249	13965	g_32073	g_32075
Super-Scaffold_19	31099142	31183441	84299	g_32075	g_32078
Super-Scaffold_19	31183659	31216658	32999	g_32078	g_32080
Super-Scaffold_19	31221399	31225036	3637	g_32080	g_32081
Super-Scaffold_19	31229446	31237819	8373	g_32081	g_32082
Super-Scaffold_19	31239708	31241274	1566	g_32082	g_32083
Super-Scaffold_19	31241498	31364586	123088	g_32083	g_32085
Super-Scaffold_19	31366796	31380774	13978	g_32085	g_32086
Super-Scaffold_19	31382927	31420244	37317	g_32086	g_32091
Super-Scaffold_19	31437047	31457983	20936	g_32091	g_32092
Super-Scaffold_19	31461446	31490029	28583	g_32092	g_32093
Super-Scaffold_19	31492056	31492778	722	g_32093	g_32094
Super-Scaffold_19	31501462	31502069	607	g_32094	g_32095
Super-Scaffold_19	31507133	31563513	56380	g_32095	g_32097
Super-Scaffold_19	31563794	31598440	34646	g_32097	g_32100
Super-Scaffold_19	31599069	31599697	628	g_32100	g_32101
Super-Scaffold_19	31602431	31604233	1802	g_32101	g_32102
Super-Scaffold_19	31604457	31611721	7264	g_32102	g_32099
Super-Scaffold_19	31616860	31619612	2752	g_32099	g_32103
Super-Scaffold_19	31625098	31629563	4465	g_32103	g_32104
Super-Scaffold_19	31644542	31659456	14914	g_32104	g_32105
Super-Scaffold_19	31665025	31704655	39630	g_32105	g_32107
Super-Scaffold_19	31704891	31724829	19938	g_32107	g_32108
Super-Scaffold_19	31752442	31759641	7199	g_32108	g_45494
Super-Scaffold_19	31764895	31793022	28127	g_45494	g_32110
Super-Scaffold_19	31793267	31867502	74235	g_32110	g_32112
Super-Scaffold_19	31867882	31868705	823	g_32112	g_32113
Super-Scaffold_19	31869076	31917812	48736	g_32113	g_32116
Super-Scaffold_19	31925554	31930087	4533	g_32116	g_32117
Super-Scaffold_19	31931205	31936489	5284	g_32117	g_32118
Super-Scaffold_19	31938473	31992016	53543	g_32118	g_32119
Super-Scaffold_19	32000743	32014520	13777	g_32119	g_32121
Super-Scaffold_19	32022564	32039825	17261	g_32121	g_32122
Super-Scaffold_19	32049568	32065011	15443	g_32122	g_32124
Super-Scaffold_19	32073024	32103567	30543	g_32124	g_32127
Super-Scaffold_19	32103971	32119379	15408	g_32127	g_32128
Super-Scaffold_19	32119957	32163887	43930	g_32128	g_32130
Super-Scaffold_19	32184241	32186645	2404	g_32130	g_45495
Super-Scaffold_19	32196010	32218077	22067	g_45495	g_32131
Super-Scaffold_19	32226172	32268973	42801	g_32131	g_39979
Super-Scaffold_19	32269275	32304790	35515	g_39979	g_32133
Super-Scaffold_19	32314182	32414030	99848	g_32133	g_32134
Super-Scaffold_19	32414392	32481134	66742	g_32134	g_32136
Super-Scaffold_19	32481403	32539034	57631	g_32136	g_32137
Super-Scaffold_19	32539354	32564625	25271	g_32137	g_32138
Super-Scaffold_19	32566805	32577858	11053	g_32138	g_32139
Super-Scaffold_19	32581829	32592873	11044	g_32139	g_32140
Super-Scaffold_19	32597065	32692726	95661	g_32140	g_32142
Super-Scaffold_19	32693425	32744243	50818	g_32142	g_32143
Super-Scaffold_19	32744479	32747033	2554	g_32143	g_32144
Super-Scaffold_19	32785424	32787712	2288	g_32144	g_39984
Super-Scaffold_19	32787984	32856520	68536	g_39984	g_39986
Super-Scaffold_19	32856777	33041760	184983	g_39986	g_32147
Super-Scaffold_19	33041987	33100506	58519	g_32147	g_32148
Super-Scaffold_19	33123734	33144597	20863	g_32148	g_45496
Super-Scaffold_19	33167509	33289144	121635	g_45496	g_32150
Super-Scaffold_19	33295653	33307969	12316	g_32150	g_32151
Super-Scaffold_19	33308253	33310270	2017	g_32151	g_32152
Super-Scaffold_19	33310680	33327387	16707	g_32152	g_32153
Super-Scaffold_19	33333790	33334988	1198	g_32153	g_32154
Super-Scaffold_19	33342833	33348608	5775	g_32154	g_32155
Super-Scaffold_19	33352392	33356408	4016	g_32155	g_32156
Super-Scaffold_19	33368232	33369732	1500	g_32156	g_32157
Super-Scaffold_19	33374639	33376284	1645	g_32157	g_32158
Super-Scaffold_19	33378891	33380370	1479	g_32158	g_32159
Super-Scaffold_19	33391930	33403667	11737	g_32159	g_39990
Super-Scaffold_19	33403885	33411013	7128	g_39990	g_32160
Super-Scaffold_19	33418163	33476830	58667	g_32160	g_32161
Super-Scaffold_19	33504263	33563876	59613	g_32161	g_32163
Super-Scaffold_19	33564124	33670773	106649	g_32163	g_32165
Super-Scaffold_19	33681091	33714049	32958	g_32165	g_32167
Super-Scaffold_19	33718060	33735413	17353	g_32167	g_32168
Super-Scaffold_19	33748525	33753838	5313	g_32168	g_32169
Super-Scaffold_19	33768198	33925278	157080	g_32169	g_32174
Super-Scaffold_19	33925502	33961325	35823	g_32174	g_32175
Super-Scaffold_19	33982951	34007251	24300	g_32175	g_32176
Super-Scaffold_19	34033461	34039369	5908	g_32176	g_32177
Super-Scaffold_19	34048028	34067500	19472	g_32177	g_32178
Super-Scaffold_19	34086808	34094609	7801	g_32178	g_32179
Super-Scaffold_19	34111808	34151734	39926	g_39997	g_39999
Super-Scaffold_19	34151955	34159928	7973	g_39999	g_32180
Super-Scaffold_19	34160986	34193817	32831	g_32180	g_32181
Super-Scaffold_19	34196692	34243714	47022	g_32181	g_32183
Super-Scaffold_19	34251765	34278814	27049	g_32183	g_32184
Super-Scaffold_19	34284436	34290758	6322	g_32184	g_32185
Super-Scaffold_19	34291669	34298209	6540	g_32185	g_32187
Super-Scaffold_19	34314064	34317293	3229	g_32187	g_32188
Super-Scaffold_19	34323369	34325401	2032	g_32188	g_32189
Super-Scaffold_19	34327768	34368509	40741	g_40002	g_32191
Super-Scaffold_19	34369781	34386667	16886	g_32191	g_32193
Super-Scaffold_19	34387579	34413306	25727	g_32193	g_32192
Super-Scaffold_19	34436348	34440113	3765	g_32192	g_32195
Super-Scaffold_19	34451891	34468352	16461	g_32195	g_32196
Super-Scaffold_19	34475274	34493127	17853	g_32196	g_32198
Super-Scaffold_19	34551678	34558461	6783	g_32198	g_32199
Super-Scaffold_19	34561955	34564263	2308	g_32199	g_32200
Super-Scaffold_19	34564576	34722797	158221	g_32200	g_32202
Super-Scaffold_19	34735360	34749569	14209	g_32202	g_32203
Super-Scaffold_19	34763885	34771084	7199	g_32203	g_32204
Super-Scaffold_19	34775383	34781296	5913	g_32204	g_32205
Super-Scaffold_19	34785958	34787276	1318	g_32205	g_45497
Super-Scaffold_19	34791743	34792204	461	g_45497	g_40003
Super-Scaffold_19	34792801	34794202	1401	g_32206	g_32207
Super-Scaffold_19	34811829	34848933	37104	g_32207	g_32208
Super-Scaffold_19	34856206	34867527	11321	g_32208	g_32210
Super-Scaffold_19	34881105	34886160	5055	g_32210	g_32211
Super-Scaffold_19	34886438	34894251	7813	g_32211	g_32212
Super-Scaffold_19	34898238	34900725	2487	g_32212	g_45498
Super-Scaffold_19	34911566	34913733	2167	g_45498	g_45499
Super-Scaffold_19	34932466	34936175	3709	g_45499	g_32213
Super-Scaffold_19	34940477	34942697	2220	g_32213	g_32214
Super-Scaffold_19	34947906	34954121	6215	g_32214	g_32215
Super-Scaffold_19	34956814	34959860	3046	g_32215	g_32216
Super-Scaffold_19	34961801	34966958	5157	g_32216	g_32217
Super-Scaffold_19	34968667	34973806	5139	g_32217	g_32218
Super-Scaffold_19	34975502	34980550	5048	g_32218	g_32219
Super-Scaffold_19	34982246	34987881	5635	g_32219	g_32220
Super-Scaffold_19	34989577	34994934	5357	g_32220	g_32221
Super-Scaffold_19	34996632	35001835	5203	g_32221	g_32222
Super-Scaffold_19	35003574	35008750	5176	g_32222	g_32223
Super-Scaffold_19	35010446	35015962	5516	g_32223	g_32224
Super-Scaffold_19	35017658	35022925	5267	g_32224	g_32225
Super-Scaffold_19	35024627	35029994	5367	g_32225	g_32226
Super-Scaffold_19	35031903	35045791	13888	g_32226	g_32227
Super-Scaffold_19	35047286	35054857	7571	g_32227	g_45500
Super-Scaffold_19	35055612	35064071	8459	g_45500	g_45501
Super-Scaffold_19	35065644	35073796	8152	g_45501	g_45502
Super-Scaffold_19	35076587	35079020	2433	g_45502	g_45503
Super-Scaffold_19	35081295	35084855	3560	g_45503	g_32228
Super-Scaffold_19	35086552	35091664	5112	g_32228	g_32229
Super-Scaffold_19	35093192	35099783	6591	g_32229	g_45504
Super-Scaffold_19	35101981	35115136	13155	g_45504	g_45505
Super-Scaffold_19	35117315	35120768	3453	g_45505	g_45506
Super-Scaffold_19	35122947	35131120	8173	g_45506	g_45507
Super-Scaffold_19	35133893	35146914	13021	g_45507	g_45508
Super-Scaffold_19	35167493	35175559	8066	g_45508	g_32230
Super-Scaffold_19	35205815	35238471	32656	g_32230	g_32232
Super-Scaffold_19	35251734	35263232	11498	g_32232	g_32233
Super-Scaffold_19	35273402	35282800	9398	g_32233	g_45509
Super-Scaffold_19	35289808	35302734	12926	g_45509	g_32234
Super-Scaffold_19	35312106	35320355	8249	g_32234	g_32236
Super-Scaffold_19	35320753	35320876	123	g_32236	g_32237
Super-Scaffold_19	35322027	35322477	450	g_32237	g_45510
Super-Scaffold_19	35332419	35336498	4079	g_45510	g_45511
Super-Scaffold_19	35344967	35352858	7891	g_45511	g_32238
Super-Scaffold_19	35362463	35397981	35518	g_32238	g_32239
Super-Scaffold_19	35412638	35414995	2357	g_32239	g_32240
Super-Scaffold_19	35419789	35422753	2964	g_32240	g_32241
Super-Scaffold_19	35430173	35465906	35733	g_32241	g_32242
Super-Scaffold_19	35466199	35482040	15841	g_32242	g_32243
Super-Scaffold_19	35483818	35501467	17649	g_32243	g_32245
Super-Scaffold_19	35516214	35538194	21980	g_32245	g_32246
Super-Scaffold_19	35538475	35716499	178024	g_32246	g_40007
Super-Scaffold_19	35717035	35772192	55157	g_40007	g_32249
Super-Scaffold_19	35788685	35788920	235	g_32249	g_32250
Super-Scaffold_19	35802128	35804336	2208	g_32250	g_32251
Super-Scaffold_19	35824659	35826824	2165	g_32251	g_32252
Super-Scaffold_19	35853407	35853765	358	g_32252	g_32253
Super-Scaffold_19	35864937	35866712	1775	g_32253	g_32254
Super-Scaffold_19	35868163	35874451	6288	g_32254	g_32255
Super-Scaffold_19	35874780	35875110	330	g_32255	g_32256
Super-Scaffold_19	35884457	35916141	31684	g_32256	g_32257
Super-Scaffold_19	35916557	35929856	13299	g_32257	g_32258
Super-Scaffold_19	35933133	35935124	1991	g_32258	g_32259
Super-Scaffold_19	35940788	35949765	8977	g_32259	g_32260
Super-Scaffold_19	35952318	35954338	2020	g_32260	g_32261
Super-Scaffold_19	35955690	35955720	30	g_32261	g_45512
Super-Scaffold_19	35956993	35960116	3123	g_45512	g_32262
Super-Scaffold_19	35965181	35968035	2854	g_32262	g_32263
Super-Scaffold_19	35974244	35977809	3565	g_32263	g_45513
Super-Scaffold_19	35979854	35983411	3557	g_45513	g_32264
Super-Scaffold_19	35984273	35984537	264	g_32264	g_32265
Super-Scaffold_19	35986519	35993509	6990	g_32265	g_32266
Super-Scaffold_19	36012502	36013378	876	g_32266	g_32267
Super-Scaffold_19	36023828	36036624	12796	g_32267	g_32268
Super-Scaffold_19	36038676	36046892	8216	g_32268	g_32269
Super-Scaffold_19	36052400	36072809	20409	g_32269	g_32270
Super-Scaffold_19	36075644	36119398	43754	g_32270	g_32271
Super-Scaffold_19	36123710	36123817	107	g_32271	g_32272
Super-Scaffold_19	36125598	36132221	6623	g_32272	g_32273
Super-Scaffold_19	36133398	36160422	27024	g_32273	g_32275
Super-Scaffold_19	36161051	36161119	68	g_32275	g_32277
Super-Scaffold_19	36162129	36172297	10168	g_32277	g_32278
Super-Scaffold_19	36175587	36195574	19987	g_32278	g_32279
Super-Scaffold_19	36202514	36277309	74795	g_32279	g_32282
Super-Scaffold_19	36322113	36322908	795	g_32282	g_32283
Super-Scaffold_19	36324007	36331308	7301	g_32283	g_32284
Super-Scaffold_19	36338661	36341442	2781	g_32284	g_32285
Super-Scaffold_19	36347778	36349935	2157	g_32285	g_45514
Super-Scaffold_19	36367588	36368690	1102	g_45514	g_32286
Super-Scaffold_19	36390317	36400303	9986	g_32286	g_32287
Super-Scaffold_19	36401940	36441192	39252	g_32287	g_32288
Super-Scaffold_19	36443974	36445582	1608	g_32288	g_32289
Super-Scaffold_19	36447998	36449419	1421	g_32289	g_32290
Super-Scaffold_19	36458034	36460656	2622	g_32290	g_32291
Super-Scaffold_19	36466804	36483214	16410	g_32291	g_32293
Super-Scaffold_19	36494404	36502197	7793	g_32293	g_32294
Super-Scaffold_19	36508236	36546717	38481	g_32294	g_32295
Super-Scaffold_19	36553950	36557565	3615	g_32295	g_40009
Super-Scaffold_19	36558386	36580323	21937	g_40009	g_32297
Super-Scaffold_19	36580538	36617647	37109	g_32297	g_32298
Super-Scaffold_19	36636775	36656976	20201	g_32298	g_40010
Super-Scaffold_19	36657452	36717045	59593	g_40010	g_32299
Super-Scaffold_19	36720196	36823423	103227	g_32299	g_32300
Super-Scaffold_19	36823701	36834122	10421	g_32300	g_32301
Super-Scaffold_19	36837561	36915055	77494	g_32301	g_32304
Super-Scaffold_19	36915780	36918502	2722	g_32304	g_32305
Super-Scaffold_19	36935359	36940883	5524	g_32305	g_32306
Super-Scaffold_19	36942718	37023221	80503	g_32306	g_40012
Super-Scaffold_19	37023460	37023717	257	g_40012	g_32307
Super-Scaffold_19	37033718	37039887	6169	g_32307	g_45515
Super-Scaffold_19	37040186	37068093	27907	g_45515	g_32308
Super-Scaffold_19	37071777	37072251	474	g_32308	g_32309
Super-Scaffold_19	37072745	37079530	6785	g_32309	g_32310
Super-Scaffold_19	37081614	37083561	1947	g_32310	g_45516
Super-Scaffold_19	37084222	37099527	15305	g_45516	g_32312
Super-Scaffold_19	37104016	37108746	4730	g_32312	g_32313
Super-Scaffold_19	37117076	37121672	4596	g_32313	g_32314
Super-Scaffold_19	37128179	37132722	4543	g_32314	g_32315
Super-Scaffold_19	37137208	37147244	10036	g_32315	g_32316
Super-Scaffold_19	37150045	37153820	3775	g_32316	g_45517
Super-Scaffold_19	37158151	37163716	5565	g_45517	g_32317
Super-Scaffold_19	37174248	37185374	11126	g_32317	g_32318
Super-Scaffold_19	37247452	37331376	83924	g_32318	g_32321
Super-Scaffold_19	37331714	37353561	21847	g_32321	g_40013
Super-Scaffold_19	37353788	37411918	58130	g_40013	g_32323
Super-Scaffold_19	37421687	37461155	39468	g_32323	g_32324
Super-Scaffold_19	37493722	37619845	126123	g_32324	g_32332
Super-Scaffold_19	37634960	37635260	300	g_32332	g_40014
Super-Scaffold_19	37636138	37739454	103316	g_40014	g_32335
Super-Scaffold_19	37764709	37775355	10646	g_32335	g_32336
Super-Scaffold_19	37782857	37787803	4946	g_32336	g_32337
Super-Scaffold_19	37789323	37792851	3528	g_32337	g_32338
Super-Scaffold_19	37798713	37819077	20364	g_32338	g_32339
Super-Scaffold_19	37820965	37823766	2801	g_32339	g_45518
Super-Scaffold_19	37847275	37848161	886	g_45518	g_32340
Super-Scaffold_19	37848811	37855856	7045	g_32340	g_32341
Super-Scaffold_19	37870453	37902097	31644	g_32341	g_32343
Super-Scaffold_19	37903101	37907422	4321	g_32343	g_32345
Super-Scaffold_19	37907640	37924846	17206	g_32345	g_32346
Super-Scaffold_19	37941145	37949528	8383	g_32346	g_45519
Super-Scaffold_19	37950058	37972116	22058	g_45519	g_32347
Super-Scaffold_19	37988206	38079331	91125	g_32347	g_32348
Super-Scaffold_19	38088119	38110552	22433	g_32348	g_32349
Super-Scaffold_19	38111805	38187999	76194	g_32349	g_32351
Super-Scaffold_19	38191013	38224961	33948	g_32351	g_32353
Super-Scaffold_19	38226337	38288798	62461	g_32353	g_32355
Super-Scaffold_19	38296849	38300494	3645	g_32355	g_32356
Super-Scaffold_19	38311672	38319141	7469	g_32356	g_32357
Super-Scaffold_19	38330911	38427583	96672	g_32357	g_32363
Super-Scaffold_19	38427813	38464120	36307	g_32363	g_32366
Super-Scaffold_19	38471098	38524884	53786	g_32366	g_32367
Super-Scaffold_19	38534250	38535641	1391	g_32367	g_32368
Super-Scaffold_19	38543980	38546480	2500	g_32368	g_32370
Super-Scaffold_19	38547289	38547331	42	g_32370	g_32371
Super-Scaffold_19	38547585	38547627	42	g_32371	g_32372
Super-Scaffold_19	38562001	38572645	10644	g_32372	g_32374
Super-Scaffold_19	38599003	38631410	32407	g_32374	g_32376
Super-Scaffold_19	38638324	38686646	48322	g_32376	g_32377
Super-Scaffold_19	38687433	38738795	51362	g_40025	g_32380
Super-Scaffold_19	38749216	38753456	4240	g_40026	g_32381
Super-Scaffold_19	38762636	38766132	3496	g_32381	g_32382
Super-Scaffold_19	38770230	38798153	27923	g_32382	g_32383
Super-Scaffold_19	38803574	38805506	1932	g_32383	g_32384
Super-Scaffold_19	38808455	38810451	1996	g_32384	g_32385
Super-Scaffold_19	38813110	38813306	196	g_32385	g_32386
Super-Scaffold_19	38818715	38836498	17783	g_40027	g_32387
Super-Scaffold_19	38852839	38854395	1556	g_32387	g_40028
Super-Scaffold_19	38854634	38870991	16357	g_40028	g_32388
Super-Scaffold_19	38884894	38886535	1641	g_32388	g_45520
Super-Scaffold_19	38891993	38904259	12266	g_45520	g_32389
Super-Scaffold_19	38918268	38921859	3591	g_32389	g_45521
Super-Scaffold_19	38932525	38932587	62	g_45521	g_32390
Super-Scaffold_19	38934674	38937770	3096	g_32390	g_32391
Super-Scaffold_19	38940801	38941913	1112	g_32391	g_32392
Super-Scaffold_19	38950964	38982747	31783	g_32392	g_32395
Super-Scaffold_19	38984574	38984620	46	g_32395	g_40029
Super-Scaffold_19	38985096	38986079	983	g_40029	g_32396
Super-Scaffold_19	38986445	38998704	12259	g_32396	g_32397
Super-Scaffold_19	39027792	39028971	1179	g_32397	g_32398
Super-Scaffold_19	39034894	39039607	4713	g_32398	g_32399
Super-Scaffold_19	39044547	39044846	299	g_32399	g_32400
Super-Scaffold_19	39045124	39050310	5186	g_32400	g_32401
Super-Scaffold_19	39052363	39089446	37083	g_32401	g_32402
Super-Scaffold_19	39112867	39122141	9274	g_32402	g_32403
Super-Scaffold_19	39154873	39196207	41334	g_40030	g_32404
Super-Scaffold_19	39196500	39197391	891	g_32404	g_32405
Super-Scaffold_19	39198872	39319550	120678	g_32405	g_32406
Super-Scaffold_19	39320494	39351823	31329	g_32406	g_32408
Super-Scaffold_19	39352642	39418650	66008	g_32408	g_40036
Super-Scaffold_19	39418910	39473706	54796	g_40036	g_32413
Super-Scaffold_19	39474047	39538588	64541	g_32413	g_40039
Super-Scaffold_19	39538857	39582805	43948	g_40039	g_32418
Super-Scaffold_19	39583104	39583282	178	g_32418	g_32419
Super-Scaffold_19	39583581	39583642	61	g_32419	g_32420
Super-Scaffold_19	39584169	39691837	107668	g_32420	g_40044
Super-Scaffold_19	39692091	39695956	3865	g_40044	g_32425
Super-Scaffold_19	39696390	39785182	88792	g_32425	g_40045
Super-Scaffold_19	39786636	39821077	34441	g_40045	g_32429
Super-Scaffold_19	39821583	39821649	66	g_32429	g_32430
Super-Scaffold_19	39822068	39822207	139	g_32430	g_32431
Super-Scaffold_19	39822596	39859720	37124	g_32431	g_32434
Super-Scaffold_19	39861075	39903107	42032	g_32434	g_32438
Super-Scaffold_19	39903328	39905092	1764	g_32438	g_32440
Super-Scaffold_19	39905511	39921047	15536	g_32440	g_32441
Super-Scaffold_19	39930734	39945390	14656	g_32441	g_40049
Super-Scaffold_19	39946343	39976240	29897	g_40049	g_32444
Super-Scaffold_19	39976479	40017959	41480	g_32444	g_32445
Super-Scaffold_19	40019428	40021636	2208	g_32445	g_32447
Super-Scaffold_19	40022124	40104579	82455	g_32447	g_32448
Super-Scaffold_19	40105172	40105380	208	g_32448	g_32449
Super-Scaffold_19	40105679	40158481	52802	g_32449	g_32453
Super-Scaffold_19	40158918	40194612	35694	g_32453	g_45522
Super-Scaffold_19	40195184	40235433	40249	g_45522	g_32456
Super-Scaffold_190	12911	17982	5071	g_5832	g_5834
Super-Scaffold_190	27463	31836	4373	g_5834	g_5835
Super-Scaffold_190	33923	34865	942	g_5835	g_5836
Super-Scaffold_190	50863	55026	4163	g_5836	g_5838
Super-Scaffold_190	59145	61098	1953	g_5838	g_5839
Super-Scaffold_190	63616	63938	322	g_5839	g_39325
Super-Scaffold_190	64246	65726	1480	g_39325	g_5840
Super-Scaffold_190	66481	70852	4371	g_5840	g_5841
Super-Scaffold_190	72818	76309	3491	g_5841	g_5842
Super-Scaffold_190	83072	89461	6389	g_39326	g_5843
Super-Scaffold_190	102234	112866	10632	g_5843	g_5846
Super-Scaffold_190	113979	127321	13342	g_5846	g_5848
Super-Scaffold_190	132476	142002	9526	g_5848	g_5850
Super-Scaffold_190	159360	160054	694	g_5850	g_5851
Super-Scaffold_190	160302	161861	1559	g_5851	g_39327
Super-Scaffold_190	162961	167098	4137	g_39327	g_39328
Super-Scaffold_190	168564	168650	86	g_39328	g_5852
Super-Scaffold_190	172999	176959	3960	g_5852	g_5853
Super-Scaffold_190	185292	196973	11681	g_39329	g_5854
Super-Scaffold_190	221766	222348	582	g_5854	g_39330
Super-Scaffold_190	277315	290800	13485	g_39330	g_5856
Super-Scaffold_190	291417	292303	886	g_5856	g_39332
Super-Scaffold_190	292575	297484	4909	g_39332	g_5857
Super-Scaffold_190	298256	301221	2965	g_5857	g_5858
Super-Scaffold_190	320002	329805	9803	g_5858	g_5859
Super-Scaffold_190	330074	332195	2121	g_5859	g_5860
Super-Scaffold_190	333730	333801	71	g_5860	g_5861
Super-Scaffold_190	334079	335082	1003	g_5861	g_5862
Super-Scaffold_190	340175	347412	7237	g_5862	g_5863
Super-Scaffold_190	348386	349348	962	g_5863	g_5864
Super-Scaffold_190	355038	421498	66460	g_5864	g_5867
Super-Scaffold_190	427471	508519	81048	g_5867	g_5868
Super-Scaffold_190	512223	520784	8561	g_5868	g_5869
Super-Scaffold_190	521723	601180	79457	g_5869	g_5871
Super-Scaffold_190	601575	615771	14196	g_5871	g_5873
Super-Scaffold_190	616169	618460	2291	g_5873	g_5874
Super-Scaffold_190	619872	621025	1153	g_5874	g_5875
Super-Scaffold_190	621342	628806	7464	g_5875	g_5876
Super-Scaffold_190	629129	629728	599	g_5876	g_5877
Super-Scaffold_190	630018	635422	5404	g_5877	g_5878
Super-Scaffold_190	635826	1155267	519441	g_5878	g_5881
Super-Scaffold_190	1163456	1175845	12389	g_5881	g_39334
Super-Scaffold_190	1176069	1191925	15856	g_39334	g_5883
Super-Scaffold_190	1214882	1216001	1119	g_5883	g_5884
Super-Scaffold_190	1223434	1226331	2897	g_5884	g_5885
Super-Scaffold_190	1233601	1236324	2723	g_5885	g_5886
Super-Scaffold_190	1239280	1258106	18826	g_5886	g_5888
Super-Scaffold_190	1273022	1283326	10304	g_5888	g_5889
Super-Scaffold_190	1287487	1287967	480	g_5889	g_5890
Super-Scaffold_190	1288533	1290261	1728	g_5890	g_5891
Super-Scaffold_190	1292110	1294597	2487	g_5891	g_5892
Super-Scaffold_190	1298084	1300692	2608	g_5892	g_5893
Super-Scaffold_190	1301411	1305708	4297	g_5893	g_5894
Super-Scaffold_190	1319385	1334683	15298	g_5894	g_43309
Super-Scaffold_190	1349516	1353916	4400	g_43309	g_5895
Super-Scaffold_190	1357430	1358104	674	g_5895	g_5896
Super-Scaffold_190	1358418	1378706	20288	g_5896	g_5897
Super-Scaffold_190	1379875	1381092	1217	g_5897	g_5898
Super-Scaffold_190	1381406	1384433	3027	g_5898	g_5899
Super-Scaffold_190	1387564	1394292	6728	g_5899	g_39336
Super-Scaffold_190	1395512	1400204	4692	g_39336	g_5901
Super-Scaffold_190	1407155	1409123	1968	g_5901	g_5902
Super-Scaffold_190	1456098	1460077	3979	g_5902	g_5903
Super-Scaffold_190	1463640	1612698	149058	g_5903	g_5906
Super-Scaffold_190	1632944	1726464	93520	g_5906	g_5907
Super-Scaffold_190	1726706	1970097	243391	g_5907	g_5910
Super-Scaffold_190	1977445	1983531	6086	g_5910	g_5912
Super-Scaffold_190	1983998	1985806	1808	g_5912	g_5913
Super-Scaffold_190	2037464	2055897	18433	g_5913	g_5915
Super-Scaffold_190	2062955	2070452	7497	g_5915	g_5916
Super-Scaffold_190	2076853	2085077	8224	g_5916	g_5917
Super-Scaffold_190	2107864	2110586	2722	g_5917	g_5918
Super-Scaffold_190	2117645	2253138	135493	g_5918	g_5919
Super-Scaffold_190	2267685	2274353	6668	g_5919	g_5920
Super-Scaffold_190	2289286	2299405	10119	g_5920	g_5921
Super-Scaffold_190	2314120	2318279	4159	g_5921	g_43310
Super-Scaffold_190	2322972	2335013	12041	g_43310	g_5924
Super-Scaffold_190	2336638	2338480	1842	g_5924	g_5925
Super-Scaffold_190	2341007	2342203	1196	g_5925	g_5926
Super-Scaffold_190	2348367	2384431	36064	g_5926	g_5927
Super-Scaffold_190	2396049	2415109	19060	g_5927	g_5928
Super-Scaffold_190	2417637	2495001	77364	g_5928	g_5931
Super-Scaffold_190	2543713	2559564	15851	g_5931	g_5932
Super-Scaffold_190	2566750	2570161	3411	g_5932	g_5933
Super-Scaffold_190	2592930	2620944	28014	g_5933	g_5934
Super-Scaffold_190	2622158	2622794	636	g_5934	g_5935
Super-Scaffold_190	2623126	2663431	40305	g_5935	g_5937
Super-Scaffold_190	2663844	2672671	8827	g_5937	g_5938
Super-Scaffold_190	2678186	2691288	13102	g_5938	g_43311
Super-Scaffold_190	2691536	2696720	5184	g_43311	g_5939
Super-Scaffold_190	2696950	2765065	68115	g_5939	g_5941
Super-Scaffold_190	2768715	2777828	9113	g_5941	g_5942
Super-Scaffold_190	2787643	2792287	4644	g_5942	g_5943
Super-Scaffold_190	2799527	2802493	2966	g_5943	g_5944
Super-Scaffold_190	2811751	2817765	6014	g_5944	g_5945
Super-Scaffold_190	2820432	2821446	1014	g_5945	g_5946
Super-Scaffold_190	2825718	2887590	61872	g_5946	g_5948
Super-Scaffold_190	2887847	2930430	42583	g_5948	g_5949
Super-Scaffold_190	2935466	2951875	16409	g_5949	g_5950
Super-Scaffold_190	2953512	2955557	2045	g_5950	g_5951
Super-Scaffold_190	2955838	2959735	3897	g_5951	g_5952
Super-Scaffold_190	2965054	2967211	2157	g_5952	g_43312
Super-Scaffold_190	2968389	2969273	884	g_43312	g_5953
Super-Scaffold_190	2975607	2977892	2285	g_5953	g_5954
Super-Scaffold_190	2996080	3072710	76630	g_5954	g_5958
Super-Scaffold_190	3094958	3143879	48921	g_5958	g_5959
Super-Scaffold_190	3144403	3149637	5234	g_5959	g_43313
Super-Scaffold_190	3153828	3177678	23850	g_43313	g_5960
Super-Scaffold_190	3210270	3223771	13501	g_5960	g_5961
Super-Scaffold_190	3229569	3234977	5408	g_5961	g_5962
Super-Scaffold_190	3236119	3239524	3405	g_5962	g_5963
Super-Scaffold_190	3246871	3252467	5596	g_5963	g_43314
Super-Scaffold_190	3253904	3255685	1781	g_43314	g_5964
Super-Scaffold_190	3256831	3265270	8439	g_5964	g_5965
Super-Scaffold_190	3265518	3268656	3138	g_5965	g_5966
Super-Scaffold_190	3272978	3282918	9940	g_5966	g_5968
Super-Scaffold_190	3283292	3287227	3935	g_5968	g_5967
Super-Scaffold_190	3287496	3293988	6492	g_5967	g_5969
Super-Scaffold_190	3314400	3324118	9718	g_5969	g_5971
Super-Scaffold_190	3346950	3353508	6558	g_5971	g_5972
Super-Scaffold_190	3354005	3358047	4042	g_5972	g_5973
Super-Scaffold_190	3359315	3361577	2262	g_5973	g_5974
Super-Scaffold_190	3371960	3372320	360	g_5974	g_5975
Super-Scaffold_190	3376360	3384706	8346	g_5975	g_5976
Super-Scaffold_190	3396980	3402017	5037	g_5976	g_43315
Super-Scaffold_190	3405639	3427935	22296	g_43315	g_5979
Super-Scaffold_190	3430409	3444237	13828	g_5979	g_43316
Super-Scaffold_190	3453780	3463893	10113	g_43316	g_43317
Super-Scaffold_190	3474183	3481659	7476	g_43317	g_5980
Super-Scaffold_190	3494859	3495760	901	g_5980	g_43318
Super-Scaffold_190	3497884	3498267	383	g_43318	g_5981
Super-Scaffold_190	3499312	3559605	60293	g_5981	g_5984
Super-Scaffold_190	3575385	3580459	5074	g_5984	g_5985
Super-Scaffold_190	3595106	3608441	13335	g_5985	g_5986
Super-Scaffold_190	3617238	3620731	3493	g_5986	g_5987
Super-Scaffold_190	3627057	3632964	5907	g_5987	g_43319
Super-Scaffold_190	3651049	3668639	17590	g_43319	g_43320
Super-Scaffold_190	3673483	3675593	2110	g_43320	g_5989
Super-Scaffold_190	3677805	3678660	855	g_5989	g_5990
Super-Scaffold_190	3695005	3696660	1655	g_5990	g_5991
Super-Scaffold_190	3699225	3701635	2410	g_5991	g_5992
Super-Scaffold_190	3714348	3717017	2669	g_5992	g_5993
Super-Scaffold_190	3732035	3807815	75780	g_5993	g_5995
Super-Scaffold_190	3808819	3839081	30262	g_5995	g_5997
Super-Scaffold_190	3853834	3873401	19567	g_5997	g_5998
Super-Scaffold_190	3884686	3905148	20462	g_5998	g_5999
Super-Scaffold_190	3918942	3941044	22102	g_5999	g_6001
Super-Scaffold_190	3941580	3946359	4779	g_6001	g_43321
Super-Scaffold_190	3950536	3952843	2307	g_43321	g_6002
Super-Scaffold_190	3956789	3959448	2659	g_6002	g_6003
Super-Scaffold_190	3962669	3970374	7705	g_6003	g_6004
Super-Scaffold_190	3997875	4010342	12467	g_6004	g_6005
Super-Scaffold_190	4020049	4020109	60	g_6005	g_43322
Super-Scaffold_190	4020549	4023413	2864	g_43322	g_6006
Super-Scaffold_190	4029767	4031401	1634	g_6006	g_6007
Super-Scaffold_190	4041370	4051775	10405	g_6007	g_6008
Super-Scaffold_190	4052221	4076686	24465	g_6008	g_6010
Super-Scaffold_190	4087033	4094016	6983	g_6010	g_6011
Super-Scaffold_190	4101894	4103724	1830	g_6011	g_6012
Super-Scaffold_190	4106432	4107269	837	g_6012	g_6013
Super-Scaffold_190	4110155	4120696	10541	g_6013	g_6014
Super-Scaffold_190	4124376	4136659	12283	g_6014	g_6016
Super-Scaffold_190	4159666	4165830	6164	g_6016	g_6017
Super-Scaffold_190	4167530	4169375	1845	g_6017	g_6018
Super-Scaffold_190	4170692	4180283	9591	g_6018	g_43323
Super-Scaffold_190	4184809	4307335	122526	g_43323	g_6023
Super-Scaffold_190	4307769	4369186	61417	g_6023	g_6027
Super-Scaffold_190	4369488	4370692	1204	g_6027	g_6026
Super-Scaffold_190	4386348	4390553	4205	g_6026	g_43324
Super-Scaffold_190	4398568	4414240	15672	g_43324	g_6030
Super-Scaffold_190	4421035	4422396	1361	g_6030	g_43325
Super-Scaffold_190	4425600	4427377	1777	g_43325	g_6031
Super-Scaffold_190	4429523	4430739	1216	g_6031	g_6032
Super-Scaffold_190	4435302	4437131	1829	g_6032	g_6033
Super-Scaffold_190	4439483	4440243	760	g_6033	g_6034
Super-Scaffold_190	4444348	4445088	740	g_6034	g_6035
Super-Scaffold_190	4447159	4468176	21017	g_6035	g_6036
Super-Scaffold_190	4468565	4471617	3052	g_6036	g_6037
Super-Scaffold_190	4483296	4483920	624	g_6037	g_6038
Super-Scaffold_190	4486238	4488487	2249	g_6038	g_6039
Super-Scaffold_190	4489988	4501299	11311	g_6039	g_6040
Super-Scaffold_190	4517118	4531449	14331	g_6040	g_39362
Super-Scaffold_190	4531805	4542335	10530	g_39362	g_6041
Super-Scaffold_190	4543354	4556260	12906	g_6041	g_39364
Super-Scaffold_190	4556586	4593064	36478	g_39364	g_39365
Super-Scaffold_190	4593279	4617727	24448	g_39365	g_39366
Super-Scaffold_190	4618029	4658037	40008	g_39366	g_6044
Super-Scaffold_190	4660148	4669977	9829	g_6044	g_6045
Super-Scaffold_190	4670222	4709284	39062	g_6045	g_6046
Super-Scaffold_190	4709910	4745838	35928	g_6046	g_39369
Super-Scaffold_190	4746260	4772703	26443	g_39369	g_6047
Super-Scaffold_190	4773008	4951829	178821	g_6047	g_6048
Super-Scaffold_190	4952080	4989106	37026	g_6048	g_6049
Super-Scaffold_190	4991625	5099670	108045	g_6049	g_6050
Super-Scaffold_190	5102300	5170490	68190	g_6050	g_6053
Super-Scaffold_190	5170777	5388924	218147	g_6053	g_6055
Super-Scaffold_190	5389145	5446032	56887	g_6055	g_6056
Super-Scaffold_190	5464292	5508969	44677	g_6056	g_6057
Super-Scaffold_190	5522220	5562273	40053	g_6057	g_6059
Super-Scaffold_190	5569827	5573939	4112	g_6059	g_6060
Super-Scaffold_190	5574193	5580163	5970	g_6060	g_6061
Super-Scaffold_190	5580417	5591499	11082	g_6061	g_6062
Super-Scaffold_190	5591810	5591869	59	g_6062	g_6063
Super-Scaffold_190	5592132	5606784	14652	g_6063	g_6064
Super-Scaffold_190	5606984	5607180	196	g_6064	g_6065
Super-Scaffold_190	5625598	5627798	2200	g_6065	g_43326
Super-Scaffold_190	5629581	5635313	5732	g_43326	g_39377
Super-Scaffold_190	5635537	5637727	2190	g_39377	g_6066
Super-Scaffold_190	5638077	5718081	80004	g_6066	g_6067
Super-Scaffold_190	5718284	5820976	102692	g_6067	g_6071
Super-Scaffold_190	5821257	5890092	68835	g_6071	g_6075
Super-Scaffold_190	5905680	5907559	1879	g_6075	g_6076
Super-Scaffold_190	5908803	5908997	194	g_6076	g_6077
Super-Scaffold_190	5923762	5924406	644	g_6077	g_6078
Super-Scaffold_190	5924618	5929454	4836	g_6078	g_6079
Super-Scaffold_190	5930140	5933770	3630	g_6079	g_6080
Super-Scaffold_190	5949154	5961575	12421	g_6080	g_6082
Super-Scaffold_190	5965879	5969260	3381	g_6082	g_6083
Super-Scaffold_190	5974038	5974773	735	g_6083	g_6084
Super-Scaffold_190	5975156	5978987	3831	g_6084	g_6085
Super-Scaffold_190	5983629	5989931	6302	g_6085	g_6087
Super-Scaffold_190	5991025	5995704	4679	g_6087	g_6088
Super-Scaffold_190	6004300	6055785	51485	g_6088	g_6092
Super-Scaffold_190	6056063	6077042	20979	g_6092	g_6094
Super-Scaffold_190	6077431	6172890	95459	g_6094	g_6100
Super-Scaffold_190	6193926	6194811	885	g_6100	g_6101
Super-Scaffold_190	6196892	6198700	1808	g_6101	g_6102
Super-Scaffold_190	6201493	6206791	5298	g_6102	g_6103
Super-Scaffold_190	6207765	6209592	1827	g_6103	g_6104
Super-Scaffold_190	6210626	6211887	1261	g_6104	g_6105
Super-Scaffold_190	6214882	6218117	3235	g_6105	g_6106
Super-Scaffold_190	6226301	6229517	3216	g_6106	g_6107
Super-Scaffold_190	6241419	6242664	1245	g_6107	g_6108
Super-Scaffold_190	6247293	6250951	3658	g_6108	g_6109
Super-Scaffold_190	6258655	6259904	1249	g_6109	g_6110
Super-Scaffold_190	6262544	6268497	5953	g_6110	g_6112
Super-Scaffold_190	6270140	6271250	1110	g_6112	g_43327
Super-Scaffold_190	6272895	6273988	1093	g_43327	g_43328
Super-Scaffold_190	6275789	6276337	548	g_43328	g_43329
Super-Scaffold_190	6278031	6292378	14347	g_43329	g_6113
Super-Scaffold_190	6297684	6300763	3079	g_6113	g_6114
Super-Scaffold_190	6303168	6320006	16838	g_6114	g_43330
Super-Scaffold_190	6322522	6328280	5758	g_43330	g_43331
Super-Scaffold_190	6329900	6330701	801	g_43331	g_6115
Super-Scaffold_190	6332421	6333188	767	g_6115	g_6116
Super-Scaffold_190	6337367	6338127	760	g_6116	g_43332
Super-Scaffold_190	6339836	6340596	760	g_43332	g_43333
Super-Scaffold_190	6342275	6345486	3211	g_43333	g_6117
Super-Scaffold_190	6346765	6350357	3592	g_6117	g_6119
Super-Scaffold_190	6351725	6373102	21377	g_6119	g_6121
Super-Scaffold_190	6379052	6383508	4456	g_6121	g_6122
Super-Scaffold_190	6384113	6388505	4392	g_6122	g_6123
Super-Scaffold_190	6389404	6412396	22992	g_6123	g_39388
Super-Scaffold_190	6412617	6415821	3204	g_39388	g_6126
Super-Scaffold_190	6421725	6425865	4140	g_6126	g_6127
Super-Scaffold_190	6452571	6473020	20449	g_6127	g_6130
Super-Scaffold_190	6476055	6481316	5261	g_6130	g_6131
Super-Scaffold_190	6482338	6483971	1633	g_6131	g_6132
Super-Scaffold_190	6488377	6488755	378	g_6132	g_6133
Super-Scaffold_190	6492655	6494456	1801	g_6133	g_6134
Super-Scaffold_190	6496709	6497981	1272	g_6134	g_6135
Super-Scaffold_190	6504775	6507149	2374	g_6135	g_6136
Super-Scaffold_190	6508207	6510376	2169	g_6136	g_6137
Super-Scaffold_190	6513079	6525388	12309	g_6137	g_6138
Super-Scaffold_190	6525686	6528694	3008	g_6139	g_6140
Super-Scaffold_190	6532565	6535889	3324	g_6140	g_6141
Super-Scaffold_190	6539776	6540491	715	g_6141	g_6142
Super-Scaffold_190	6544283	6545770	1487	g_6142	g_6143
Super-Scaffold_190	6548676	6559709	11033	g_6143	g_6144
Super-Scaffold_190	6564690	6569630	4940	g_6144	g_6145
Super-Scaffold_190	6593373	6596136	2763	g_6145	g_43334
Super-Scaffold_190	6598221	6599911	1690	g_43334	g_6146
Super-Scaffold_190	6605454	6616753	11299	g_6146	g_43335
Super-Scaffold_190	6626565	6635455	8890	g_43335	g_6147
Super-Scaffold_190	6636039	6641827	5788	g_6147	g_6148
Super-Scaffold_190	6650725	6665665	14940	g_6148	g_6151
Super-Scaffold_190	6665964	6669382	3418	g_6151	g_6152
Super-Scaffold_190	6670336	6673058	2722	g_6152	g_6153
Super-Scaffold_190	6682650	6701497	18847	g_6153	g_6155
Super-Scaffold_190	6705755	6713974	8219	g_6155	g_6156
Super-Scaffold_190	6714276	6726493	12217	g_6156	g_6158
Super-Scaffold_190	6734452	6736960	2508	g_6158	g_6159
Super-Scaffold_190	6738138	6750540	12402	g_6159	g_6161
Super-Scaffold_190	6763711	6766125	2414	g_6161	g_43336
Super-Scaffold_190	6766991	6771341	4350	g_43336	g_6162
Super-Scaffold_190	6775885	6818391	42506	g_6162	g_6164
Super-Scaffold_190	6819841	6822014	2173	g_6164	g_6165
Super-Scaffold_190	6822889	6825873	2984	g_6165	g_43337
Super-Scaffold_190	6833347	6854033	20686	g_43337	g_6167
Super-Scaffold_190	6856853	6888328	31475	g_6167	g_6168
Super-Scaffold_190	6889973	6890351	378	g_6168	g_6169
Super-Scaffold_190	6890656	6891976	1320	g_6169	g_6170
Super-Scaffold_190	6895640	6896668	1028	g_6170	g_43338
Super-Scaffold_190	6897279	6897327	48	g_43338	g_6171
Super-Scaffold_190	6898351	7001261	102910	g_6171	g_6179
Super-Scaffold_190	7001512	7020191	18679	g_6179	g_6181
Super-Scaffold_190	7020463	7021271	808	g_6181	g_6182
Super-Scaffold_190	7021516	7025223	3707	g_6182	g_6183
Super-Scaffold_190	7036853	7077507	40654	g_6183	g_6185
Super-Scaffold_190	7094584	7108613	14029	g_6185	g_6186
Super-Scaffold_190	7112583	7113552	969	g_6186	g_6187
Super-Scaffold_190	7118409	7124808	6399	g_6187	g_6188
Super-Scaffold_190	7130860	7156029	25169	g_6188	g_6189
Super-Scaffold_190	7159558	7161337	1779	g_6189	g_6190
Super-Scaffold_190	7163379	7163493	114	g_6190	g_43339
Super-Scaffold_190	7165922	7168962	3040	g_43339	g_6191
Super-Scaffold_190	7170629	7172068	1439	g_6191	g_6192
Super-Scaffold_190	7176305	7181497	5192	g_6192	g_6193
Super-Scaffold_190	7195153	7211988	16835	g_6193	g_6195
Super-Scaffold_190	7217335	7218907	1572	g_6195	g_6196
Super-Scaffold_190	7226515	7235942	9427	g_6196	g_6197
Super-Scaffold_190	7238473	7241387	2914	g_6197	g_43340
Super-Scaffold_190	7248322	7250114	1792	g_43340	g_6198
Super-Scaffold_190	7256214	7258392	2178	g_6198	g_6199
Super-Scaffold_190	7260957	7305470	44513	g_6199	g_6200
Super-Scaffold_190	7321659	7324394	2735	g_6200	g_6201
Super-Scaffold_190	7329016	7340199	11183	g_6201	g_6202
Super-Scaffold_190	7354262	7360630	6368	g_6202	g_43341
Super-Scaffold_190	7366770	7369267	2497	g_43341	g_6203
Super-Scaffold_190	7371107	7373418	2311	g_6203	g_6204
Super-Scaffold_190	7487965	7552229	64264	g_6204	g_6207
Super-Scaffold_190	7552531	7557658	5127	g_6207	g_6209
Super-Scaffold_190	7571957	7572034	77	g_6209	g_6210
Super-Scaffold_190	7572264	7574554	2290	g_6210	g_6211
Super-Scaffold_190	7576395	7588018	11623	g_6211	g_43342
Super-Scaffold_190	7631721	7632947	1226	g_43342	g_6212
Super-Scaffold_190	7636062	7636880	818	g_6212	g_6213
Super-Scaffold_190	7641013	7652652	11639	g_6213	g_6214
Super-Scaffold_190	7656147	7658201	2054	g_6214	g_6215
Super-Scaffold_190	7665109	7667853	2744	g_6215	g_6216
Super-Scaffold_190	7668200	7669449	1249	g_6216	g_6217
Super-Scaffold_190	7674597	7677790	3193	g_6217	g_43343
Super-Scaffold_190	7699074	7751304	52230	g_43343	g_6220
Super-Scaffold_190	7757713	7759969	2256	g_6220	g_6221
Super-Scaffold_190	7766103	7777914	11811	g_6221	g_6222
Super-Scaffold_190	7798187	7800866	2679	g_6222	g_6223
Super-Scaffold_190	7803155	7804743	1588	g_6223	g_43344
Super-Scaffold_190	7812541	7818822	6281	g_43344	g_6224
Super-Scaffold_190	7822721	7877920	55199	g_6224	g_6226
Super-Scaffold_190	7878959	7907287	28328	g_6226	g_6229
Super-Scaffold_190	7907634	7923886	16252	g_6229	g_6230
Super-Scaffold_190	7924134	7931528	7394	g_6230	g_6232
Super-Scaffold_190	7933798	7957987	24189	g_6232	g_6233
Super-Scaffold_190	7958208	7994833	36625	g_6233	g_6235
Super-Scaffold_190	8000508	8009378	8870	g_6235	g_6236
Super-Scaffold_190	8027225	8028609	1384	g_6236	g_43345
Super-Scaffold_190	8030479	8035721	5242	g_43345	g_6237
Super-Scaffold_190	8040784	8051119	10335	g_6237	g_6238
Super-Scaffold_190	8051391	8074476	23085	g_6238	g_43346
Super-Scaffold_190	8091852	8092397	545	g_43346	g_6240
Super-Scaffold_190	8093545	8105911	12366	g_6240	g_6243
Super-Scaffold_190	8106216	8125824	19608	g_6243	g_6244
Super-Scaffold_190	8126057	8145181	19124	g_6244	g_39411
Super-Scaffold_190	8145390	8170157	24767	g_39411	g_6245
Super-Scaffold_190	8171137	8191624	20487	g_6245	g_6247
Super-Scaffold_190	8207482	8212075	4593	g_6247	g_6248
Super-Scaffold_190	8213822	8215931	2109	g_6248	g_6249
Super-Scaffold_190	8219233	8220503	1270	g_6249	g_43347
Super-Scaffold_190	8221495	8229879	8384	g_43347	g_6250
Super-Scaffold_190	8265708	8269282	3574	g_6250	g_6251
Super-Scaffold_190	8273895	8276813	2918	g_6251	g_6252
Super-Scaffold_190	8277814	8280325	2511	g_6252	g_39413
Super-Scaffold_190	8281059	8293649	12590	g_39413	g_6253
Super-Scaffold_190	8294194	8322197	28003	g_6253	g_6255
Super-Scaffold_190	8324280	8324993	713	g_6255	g_6256
Super-Scaffold_190	8326475	8327386	911	g_6256	g_6257
Super-Scaffold_190	8330082	8335263	5181	g_6257	g_6258
Super-Scaffold_190	8338164	8342655	4491	g_6258	g_6259
Super-Scaffold_190	8375844	8391888	16044	g_6259	g_6260
Super-Scaffold_190	8395441	8398263	2822	g_6260	g_43348
Super-Scaffold_190	8404906	8405520	614	g_43348	g_6261
Super-Scaffold_190	8407986	8409571	1585	g_6261	g_6262
Super-Scaffold_190	8412203	8412579	376	g_6262	g_6263
Super-Scaffold_190	8417326	8434908	17582	g_6263	g_6264
Super-Scaffold_190	8437490	8452855	15365	g_6264	g_6266
Super-Scaffold_190	8454870	8458076	3206	g_6266	g_6267
Super-Scaffold_190	8459003	8461334	2331	g_6267	g_6268
Super-Scaffold_190	8467989	8474210	6221	g_6268	g_43349
Super-Scaffold_190	8479028	8544274	65246	g_43349	g_6270
Super-Scaffold_190	8546318	8564881	18563	g_6270	g_6272
Super-Scaffold_190	8565714	8568951	3237	g_6272	g_6273
Super-Scaffold_190	8571968	8596730	24762	g_6273	g_6274
Super-Scaffold_190	8605388	8609128	3740	g_6274	g_6275
Super-Scaffold_190	8614816	8618911	4095	g_6275	g_6276
Super-Scaffold_190	8625081	8626763	1682	g_6276	g_6277
Super-Scaffold_190	8635575	8669782	34207	g_6277	g_6278
Super-Scaffold_190	8679166	8695267	16101	g_6278	g_6279
Super-Scaffold_190	8721262	8722297	1035	g_6279	g_6280
Super-Scaffold_190	8724656	8725409	753	g_6280	g_6281
Super-Scaffold_190	8727022	8730324	3302	g_6281	g_6282
Super-Scaffold_190	8731957	8735996	4039	g_6282	g_6283
Super-Scaffold_190	8738019	8744088	6069	g_6283	g_6284
Super-Scaffold_190	8747002	8747928	926	g_6284	g_6285
Super-Scaffold_190	8750489	8766612	16123	g_6285	g_6288
Super-Scaffold_190	8766932	8773228	6296	g_6288	g_6289
Super-Scaffold_190	8773602	8778596	4994	g_6289	g_6290
Super-Scaffold_190	8779084	8791109	12025	g_6290	g_6291
Super-Scaffold_190	8797749	8803830	6081	g_6291	g_6292
Super-Scaffold_190	8821058	8825760	4702	g_6292	g_6294
Super-Scaffold_190	8829893	8830483	590	g_6294	g_6295
Super-Scaffold_190	8835153	8837879	2726	g_6295	g_6296
Super-Scaffold_190	8842739	8859262	16523	g_6296	g_43350
Super-Scaffold_190	8863283	8884419	21136	g_43350	g_43351
Super-Scaffold_190	8899416	8914624	15208	g_43351	g_6298
Super-Scaffold_190	8933685	8936957	3272	g_6298	g_6299
Super-Scaffold_190	8937268	8937952	684	g_6299	g_6300
Super-Scaffold_190	8938389	8964634	26245	g_6300	g_6301
Super-Scaffold_190	8984085	8990759	6674	g_6301	g_43352
Super-Scaffold_190	8994955	8995237	282	g_43352	g_43353
Super-Scaffold_190	8995485	9000034	4549	g_43353	g_6302
Super-Scaffold_190	9017477	9025556	8079	g_6302	g_6303
Super-Scaffold_190	9028538	9310188	281650	g_6303	g_6315
Super-Scaffold_190	9310394	9448460	138066	g_6315	g_39433
Super-Scaffold_190	9448684	9477851	29167	g_39433	g_6317
Super-Scaffold_190	9478420	9479804	1384	g_6317	g_6318
Super-Scaffold_190	9502933	9505371	2438	g_6318	g_6319
Super-Scaffold_190	9505586	9579701	74115	g_6319	g_6320
Super-Scaffold_190	9580003	9624577	44574	g_6320	g_6323
Super-Scaffold_190	9624960	9698701	73741	g_6323	g_6327
Super-Scaffold_190	9699069	9749985	50916	g_6327	g_6332
Super-Scaffold_190	9796063	9798950	2887	g_6332	g_6333
Super-Scaffold_190	9815717	9848584	32867	g_6333	g_39448
Super-Scaffold_190	9848952	9849739	787	g_39448	g_6334
Super-Scaffold_190	9854138	9859560	5422	g_6334	g_43354
Super-Scaffold_190	9862277	9865907	3630	g_43354	g_6335
Super-Scaffold_190	9875135	9924481	49346	g_6335	g_6336
Super-Scaffold_190	9938856	9993283	54427	g_6336	g_6338
Super-Scaffold_190	9993513	10061689	68176	g_6338	g_6342
Super-Scaffold_190	10061934	10071011	9077	g_6342	g_6343
Super-Scaffold_190	10072762	10096080	23318	g_6343	g_6344
Super-Scaffold_190	10096409	10142497	46088	g_6344	g_6346
Super-Scaffold_190	10150024	10240196	90172	g_6346	g_6351
Super-Scaffold_190	10240507	10255207	14700	g_6351	g_6353
Super-Scaffold_190	10257648	10259509	1861	g_6353	g_6354
Super-Scaffold_190	10260560	10262424	1864	g_6354	g_6355
Super-Scaffold_190	10267405	10268751	1346	g_6355	g_43355
Super-Scaffold_190	10269770	10294845	25075	g_43355	g_6357
Super-Scaffold_190	10295111	10329457	34346	g_6357	g_6359
Super-Scaffold_190	10353754	10354108	354	g_6359	g_6360
Super-Scaffold_190	10354986	10357111	2125	g_6360	g_6361
Super-Scaffold_190	10362287	10388579	26292	g_6361	g_6362
Super-Scaffold_190	10394047	10396464	2417	g_6362	g_6363
Super-Scaffold_190	10408678	10414372	5694	g_6363	g_6364
Super-Scaffold_190	10435974	10438855	2881	g_6364	g_6365
Super-Scaffold_190	10439055	10444020	4965	g_6365	g_6366
Super-Scaffold_190	10445572	10447623	2051	g_6366	g_6367
Super-Scaffold_190	10449346	10481426	32080	g_6367	g_6369
Super-Scaffold_190	10510120	10516729	6609	g_6369	g_6370
Super-Scaffold_190	10519549	10522991	3442	g_6370	g_6371
Super-Scaffold_190	10533496	10562985	29489	g_6371	g_39456
Super-Scaffold_190	10563278	10563337	59	g_39456	g_6373
Super-Scaffold_190	10574952	10585665	10713	g_6373	g_6374
Super-Scaffold_190	10599497	10640437	40940	g_6374	g_6375
Super-Scaffold_190	10666295	10683577	17282	g_6375	g_6377
Super-Scaffold_190	10683831	10741878	58047	g_6377	g_6379
Super-Scaffold_190	10742336	10747453	5117	g_6379	g_6381
Super-Scaffold_190	10747728	10754020	6292	g_6381	g_43356
Super-Scaffold_190	10755368	10757179	1811	g_43356	g_6382
Super-Scaffold_190	10763733	10795212	31479	g_6382	g_6384
Super-Scaffold_190	10802978	10835090	32112	g_6384	g_6385
Super-Scaffold_190	10837670	10859142	21472	g_6385	g_6386
Super-Scaffold_190	10862047	10864597	2550	g_6386	g_6387
Super-Scaffold_190	10865427	10868444	3017	g_6387	g_6388
Super-Scaffold_190	10869022	10920885	51863	g_6388	g_6391
Super-Scaffold_190	10921472	10925361	3889	g_6391	g_6392
Super-Scaffold_190	10927780	10929619	1839	g_6392	g_6393
Super-Scaffold_190	10932742	10937646	4904	g_6393	g_6394
Super-Scaffold_190	10941423	10944131	2708	g_6394	g_6395
Super-Scaffold_190	10966112	10973694	7582	g_6395	g_6396
Super-Scaffold_190	10974614	10999289	24675	g_6396	g_6397
Super-Scaffold_190	11016265	11018118	1853	g_6397	g_43357
Super-Scaffold_190	11019104	11023395	4291	g_43357	g_43358
Super-Scaffold_190	11029461	11030291	830	g_43358	g_6398
Super-Scaffold_190	11035695	11036429	734	g_6398	g_43359
Super-Scaffold_190	11049742	11054477	4735	g_43359	g_6399
Super-Scaffold_190	11074015	11075171	1156	g_6399	g_6400
Super-Scaffold_190	11083707	11087588	3881	g_6400	g_6401
Super-Scaffold_190	11089658	11100347	10689	g_6401	g_6402
Super-Scaffold_190	11120868	11132766	11898	g_6402	g_6403
Super-Scaffold_190	11139480	11150853	11373	g_6403	g_6404
Super-Scaffold_190	11152004	11164422	12418	g_6404	g_6405
Super-Scaffold_190	11168747	11181624	12877	g_6405	g_43360
Super-Scaffold_190	11204789	11207983	3194	g_43360	g_6406
Super-Scaffold_190	11213360	11227501	14141	g_6406	g_6407
Super-Scaffold_190	11242522	11246031	3509	g_6407	g_6408
Super-Scaffold_190	11250613	11257215	6602	g_6408	g_6409
Super-Scaffold_190	11263310	11266104	2794	g_6409	g_6410
Super-Scaffold_190	11267194	11269395	2201	g_6410	g_6411
Super-Scaffold_190	11275434	11277218	1784	g_6411	g_6412
Super-Scaffold_190	11282303	11283086	783	g_6412	g_6413
Super-Scaffold_190	11288487	11289440	953	g_6413	g_6414
Super-Scaffold_190	11293293	11310176	16883	g_6414	g_6415
Super-Scaffold_190	11315656	11323943	8287	g_6415	g_6416
Super-Scaffold_190	11327164	11330113	2949	g_6416	g_6417
Super-Scaffold_190	11338612	11342098	3486	g_6417	g_6418
Super-Scaffold_190	11348985	11351317	2332	g_6418	g_6419
Super-Scaffold_190	11356380	11358607	2227	g_6419	g_6420
Super-Scaffold_190	11364808	11365028	220	g_6420	g_6421
Super-Scaffold_190	11371888	11372721	833	g_6421	g_6422
Super-Scaffold_190	11373737	11378093	4356	g_6422	g_6423
Super-Scaffold_190	11378623	11392433	13810	g_6423	g_6424
Super-Scaffold_190	11392726	11404386	11660	g_6424	g_6425
Super-Scaffold_190	11426369	11435868	9499	g_6425	g_43361
Super-Scaffold_190	11458901	11479715	20814	g_43361	g_6426
Super-Scaffold_190	11484786	11574410	89624	g_6426	g_6429
Super-Scaffold_190	11583975	11620793	36818	g_6429	g_6430
Super-Scaffold_190	11631799	11642334	10535	g_6430	g_6431
Super-Scaffold_190	11646152	11646341	189	g_6431	g_6432
Super-Scaffold_190	11662360	11664392	2032	g_6432	g_43362
Super-Scaffold_190	11670247	11676647	6400	g_43362	g_6433
Super-Scaffold_190	11686891	11689755	2864	g_6433	g_6434
Super-Scaffold_190	11728757	11837973	109216	g_6434	g_6439
Super-Scaffold_190	11843622	11844707	1085	g_6439	g_6440
Super-Scaffold_190	11855616	11910564	54948	g_6440	g_6442
Super-Scaffold_190	11910965	11930928	19963	g_6442	g_39466
Super-Scaffold_190	11931182	11975527	44345	g_39466	g_39468
Super-Scaffold_190	11975769	11996319	20550	g_39468	g_6445
Super-Scaffold_190	11997086	11997626	540	g_6445	g_6446
Super-Scaffold_190	11997910	11999480	1570	g_6446	g_6447
Super-Scaffold_190	11999707	12021196	21489	g_6447	g_6448
Super-Scaffold_190	12021588	12227611	206023	g_6448	g_6456
Super-Scaffold_190	12228051	12264245	36194	g_6456	g_6458
Super-Scaffold_190	12264664	12275222	10558	g_6458	g_6459
Super-Scaffold_190	12275548	12282266	6718	g_6459	g_6461
Super-Scaffold_190	12282481	12299591	17110	g_6461	g_6462
Super-Scaffold_190	12301217	12309076	7859	g_6462	g_6463
Super-Scaffold_190	12309366	12326719	17353	g_6463	g_6465
Super-Scaffold_190	12338460	12340849	2389	g_6465	g_6466
Super-Scaffold_190	12363083	12366668	3585	g_6466	g_6467
Super-Scaffold_190	12368924	12378489	9565	g_6467	g_6468
Super-Scaffold_190	12386548	12395240	8692	g_6468	g_6469
Super-Scaffold_190	12401435	12408066	6631	g_6469	g_6471
Super-Scaffold_190	12424683	12448584	23901	g_6471	g_6472
Super-Scaffold_190	12453640	12455957	2317	g_6472	g_6473
Super-Scaffold_190	12460146	12472851	12705	g_6473	g_6474
Super-Scaffold_190	12480000	12481207	1207	g_6474	g_6475
Super-Scaffold_190	12489563	12533667	44104	g_6475	g_39473
Super-Scaffold_190	12534041	12555416	21375	g_39473	g_6479
Super-Scaffold_190	12556250	12563023	6773	g_6479	g_6480
Super-Scaffold_190	12563259	12643455	80196	g_6480	g_6482
Super-Scaffold_190	12651283	12734751	83468	g_6482	g_6484
Super-Scaffold_190	12735542	12739722	4180	g_6484	g_6485
Super-Scaffold_190	12742112	12783882	41770	g_6485	g_6486
Super-Scaffold_190	12793570	12883209	89639	g_6486	g_6487
Super-Scaffold_190	12895650	12914037	18387	g_6487	g_6488
Super-Scaffold_190	12928723	12934919	6196	g_6488	g_39474
Super-Scaffold_190	12935386	12950760	15374	g_39474	g_6489
Super-Scaffold_190	12951427	12953991	2564	g_6489	g_6490
Super-Scaffold_190	12956969	13063534	106565	g_6490	g_6492
Super-Scaffold_190	13065573	13066464	891	g_6492	g_6493
Super-Scaffold_190	13066917	13125958	59041	g_6493	g_6494
Super-Scaffold_190	13126839	13127008	169	g_6494	g_6495
Super-Scaffold_190	13128173	13146235	18062	g_6495	g_6496
Super-Scaffold_190	13150300	13157642	7342	g_6496	g_6497
Super-Scaffold_190	13219783	13224798	5015	g_6497	g_6499
Super-Scaffold_190	13225412	13250278	24866	g_6499	g_6501
Super-Scaffold_190	13253462	13296667	43205	g_6501	g_6503
Super-Scaffold_190	13296930	13658579	361649	g_6503	g_39476
Super-Scaffold_190	13658986	13659023	37	g_39476	g_6505
Super-Scaffold_190	13659321	13663599	4278	g_6505	g_6506
Super-Scaffold_22	19634	139956	120322	g_28959	g_28961
Super-Scaffold_22	152047	158820	6773	g_28961	g_28963
Super-Scaffold_22	179673	186565	6892	g_28963	g_28965
Super-Scaffold_22	187293	187492	199	g_28965	g_28966
Super-Scaffold_22	195078	236797	41719	g_28966	g_28967
Super-Scaffold_22	248445	248606	161	g_28967	g_28968
Super-Scaffold_22	249511	309215	59704	g_28968	g_28970
Super-Scaffold_22	309493	339050	29557	g_28970	g_28972
Super-Scaffold_22	339484	357173	17689	g_28972	g_28973
Super-Scaffold_22	359320	361578	2258	g_28973	g_28974
Super-Scaffold_22	387315	393798	6483	g_28974	g_28976
Super-Scaffold_22	396348	407103	10755	g_28976	g_45266
Super-Scaffold_22	429206	433762	4556	g_45266	g_28978
Super-Scaffold_22	456904	476446	19542	g_36049	g_28981
Super-Scaffold_22	482576	485611	3035	g_28981	g_28982
Super-Scaffold_22	513353	515448	2095	g_28982	g_45267
Super-Scaffold_22	515705	524532	8827	g_45267	g_28984
Super-Scaffold_22	524996	529413	4417	g_28984	g_28985
Super-Scaffold_22	529790	531721	1931	g_28985	g_28986
Super-Scaffold_22	549441	632293	82852	g_28986	g_28987
Super-Scaffold_22	634518	637299	2781	g_28987	g_28988
Super-Scaffold_22	637643	691872	54229	g_28988	g_28991
Super-Scaffold_22	712760	773235	60475	g_28991	g_28994
Super-Scaffold_22	778306	781962	3656	g_28994	g_28995
Super-Scaffold_22	792065	794404	2339	g_28995	g_28996
Super-Scaffold_22	801957	804923	2966	g_28996	g_28997
Super-Scaffold_22	812759	814174	1415	g_28997	g_28998
Super-Scaffold_22	830529	835423	4894	g_28998	g_28999
Super-Scaffold_22	842842	860808	17966	g_28999	g_29000
Super-Scaffold_22	863890	873720	9830	g_29000	g_29001
Super-Scaffold_22	883063	886722	3659	g_29001	g_29002
Super-Scaffold_22	887027	887126	99	g_29002	g_29003
Super-Scaffold_22	897997	899841	1844	g_29003	g_29004
Super-Scaffold_22	900338	919736	19398	g_29004	g_29005
Super-Scaffold_22	936923	938356	1433	g_29005	g_29006
Super-Scaffold_22	941045	943632	2587	g_29006	g_45268
Super-Scaffold_22	947570	948221	651	g_45268	g_29007
Super-Scaffold_22	950707	951677	970	g_29007	g_45269
Super-Scaffold_22	952634	964497	11863	g_36055	g_29008
Super-Scaffold_24	236271	236348	77	g_18548	g_18549
Super-Scaffold_24	236599	237012	413	g_18549	g_18550
Super-Scaffold_24	237242	258239	20997	g_18550	g_18552
Super-Scaffold_25	260808	506636	245828	g_18552	g_13758
Super-Scaffold_25	506905	529985	23080	g_13758	g_13759
Super-Scaffold_25	530476	604801	74325	g_13759	g_13761
Super-Scaffold_25	607297	637863	30566	g_13761	g_13763
Super-Scaffold_25	638471	667569	29098	g_13763	g_13764
Super-Scaffold_25	668234	703551	35317	g_13764	g_13766
Super-Scaffold_25	703832	703904	72	g_13766	g_13767
Super-Scaffold_25	704488	753051	48563	g_13767	g_13769
Super-Scaffold_25	754970	776260	21290	g_13769	g_13771
Super-Scaffold_25	776604	777856	1252	g_13771	g_13772
Super-Scaffold_25	778242	786848	8606	g_13772	g_13773
Super-Scaffold_25	790057	818024	27967	g_13773	g_13776
Super-Scaffold_25	818389	825153	6764	g_13776	g_13777
Super-Scaffold_25	833960	871769	37809	g_13777	g_13779
Super-Scaffold_25	872188	873874	1686	g_13779	g_13781
Super-Scaffold_25	874734	890175	15441	g_13781	g_13783
Super-Scaffold_25	891071	954156	63085	g_13783	g_13784
Super-Scaffold_25	959958	1003543	43585	g_13784	g_13786
Super-Scaffold_25	1006800	1006844	44	g_13786	g_13787
Super-Scaffold_25	1007059	1010110	3051	g_13787	g_44070
Super-Scaffold_25	1014620	1028683	14063	g_44070	g_44071
Super-Scaffold_25	1035787	1054522	18735	g_44071	g_13788
Super-Scaffold_25	1056516	1062363	5847	g_13788	g_13789
Super-Scaffold_25	1074221	1079095	4874	g_13789	g_13790
Super-Scaffold_25	1084684	1106324	21640	g_13790	g_13791
Super-Scaffold_25	1106875	1284153	177278	g_13791	g_13795
Super-Scaffold_25	1286273	1310435	24162	g_13795	g_13797
Super-Scaffold_25	1310830	1312518	1688	g_13797	g_13798
Super-Scaffold_25	1312943	1330084	17141	g_13798	g_13800
Super-Scaffold_25	1330626	1383865	53239	g_13800	g_13802
Super-Scaffold_25	1387078	1387207	129	g_13802	g_13803
Super-Scaffold_25	1387693	1388057	364	g_13803	g_44072
Super-Scaffold_25	1388550	1388930	380	g_44072	g_13804
Super-Scaffold_25	1389670	1425727	36057	g_13804	g_13805
Super-Scaffold_25	1426725	1427097	372	g_13805	g_44073
Super-Scaffold_25	1427558	1442430	14872	g_44073	g_13806
Super-Scaffold_25	1443560	1443958	398	g_13806	g_13807
Super-Scaffold_25	1445273	1539201	93928	g_13807	g_13808
Super-Scaffold_25	1543300	1636172	92872	g_13808	g_13814
Super-Scaffold_25	1636459	1640575	4116	g_13814	g_13816
Super-Scaffold_25	1641831	1667922	26091	g_13816	g_13817
Super-Scaffold_25	1670612	1731439	60827	g_13817	g_13820
Super-Scaffold_25	1744581	1843220	98639	g_13820	g_13823
Super-Scaffold_25	1843630	1843694	64	g_13823	g_13824
Super-Scaffold_25	1849103	1909802	60699	g_13824	g_13825
Super-Scaffold_25	1917858	2141236	223378	g_13825	g_13833
Super-Scaffold_25	2142237	2145361	3124	g_13833	g_13834
Super-Scaffold_25	2147307	2150552	3245	g_13834	g_13835
Super-Scaffold_25	2163056	2171212	8156	g_13835	g_44074
Super-Scaffold_25	2174127	2246091	71964	g_44074	g_13838
Super-Scaffold_25	2247260	2263430	16170	g_13838	g_13839
Super-Scaffold_25	2264599	2370128	105529	g_13839	g_13841
Super-Scaffold_25	2371181	2371288	107	g_13841	g_44075
Super-Scaffold_25	2373283	2398136	24853	g_44075	g_13842
Super-Scaffold_25	2399189	2399296	107	g_13842	g_44076
Super-Scaffold_25	2401294	2482973	81679	g_44076	g_13843
Super-Scaffold_25	2484026	2484133	107	g_13843	g_13844
Super-Scaffold_25	2486128	2540759	54631	g_13844	g_13847
Super-Scaffold_25	2541812	2541919	107	g_13847	g_13848
Super-Scaffold_25	2543914	2552072	8158	g_13848	g_13849
Super-Scaffold_25	2553125	2553232	107	g_13849	g_13850
Super-Scaffold_25	2555227	2596576	41349	g_13850	g_13851
Super-Scaffold_25	2597629	2597736	107	g_13851	g_13852
Super-Scaffold_25	2599731	2723218	123487	g_13852	g_13853
Super-Scaffold_25	2724271	2724415	144	g_13853	g_13854
Super-Scaffold_25	2726370	2772935	46565	g_13854	g_13855
Super-Scaffold_25	2773987	2774094	107	g_13855	g_13856
Super-Scaffold_25	2776089	2817640	41551	g_13856	g_13857
Super-Scaffold_25	2818693	2818800	107	g_13857	g_44077
Super-Scaffold_25	2820795	2853019	32224	g_44077	g_13858
Super-Scaffold_25	2854072	2854216	144	g_13858	g_13859
Super-Scaffold_25	2856171	2937873	81702	g_13859	g_13860
Super-Scaffold_25	2938535	2943074	4539	g_13860	g_13861
Super-Scaffold_25	2943736	2950554	6818	g_13861	g_13862
Super-Scaffold_25	2951216	2954601	3385	g_13862	g_13863
Super-Scaffold_25	2955263	2960893	5630	g_13863	g_13864
Super-Scaffold_25	2961555	2967208	5653	g_13864	g_13865
Super-Scaffold_25	2967870	3010071	42201	g_13865	g_13866
Super-Scaffold_25	3011123	3011230	107	g_13866	g_13867
Super-Scaffold_25	3013225	3066120	52895	g_13867	g_36365
Super-Scaffold_25	3066332	3078772	12440	g_36365	g_13868
Super-Scaffold_25	3082250	3113991	31741	g_13868	g_13871
Super-Scaffold_25	3114440	3134877	20437	g_13871	g_44078
Super-Scaffold_25	3137506	3143517	6011	g_44078	g_13873
Super-Scaffold_25	3143804	3145294	1490	g_13873	g_44079
Super-Scaffold_25	3145767	3164170	18403	g_44079	g_13874
Super-Scaffold_25	3164940	3173325	8385	g_13874	g_13875
Super-Scaffold_25	3173654	3229894	56240	g_13875	g_13878
Super-Scaffold_25	3231386	3256295	24909	g_13879	g_13880
Super-Scaffold_25	3284283	3290267	5984	g_13880	g_13881
Super-Scaffold_25	3290533	3321257	30724	g_13881	g_13882
Super-Scaffold_25	3321925	3330566	8641	g_13882	g_13884
Super-Scaffold_25	3335406	3353609	18203	g_13884	g_44080
Super-Scaffold_25	3354097	3357213	3116	g_44080	g_13885
Super-Scaffold_25	3357812	3358186	374	g_13885	g_13886
Super-Scaffold_25	3358611	3387407	28796	g_13886	g_13888
Super-Scaffold_25	3387763	3427408	39645	g_13888	g_13889
Super-Scaffold_25	3429044	3431045	2001	g_13889	g_13890
Super-Scaffold_25	3431626	3466442	34816	g_13890	g_13891
Super-Scaffold_25	3473174	3501584	28410	g_13891	g_13893
Super-Scaffold_25	3503341	3508841	5500	g_13893	g_13894
Super-Scaffold_25	3510303	3541200	30897	g_13894	g_13895
Super-Scaffold_25	3542117	3566421	24304	g_13895	g_13896
Super-Scaffold_25	3566855	3567001	146	g_13896	g_13897
Super-Scaffold_25	3567642	3575192	7550	g_13897	g_13898
Super-Scaffold_25	3576490	3576532	42	g_13898	g_13899
Super-Scaffold_25	3577653	3602967	25314	g_13899	g_13901
Super-Scaffold_25	3603584	3603639	55	g_13901	g_13902
Super-Scaffold_25	3605711	3616706	10995	g_13902	g_13904
Super-Scaffold_25	3617842	3629170	11328	g_13904	g_13905
Super-Scaffold_25	3633336	3689863	56527	g_13905	g_13908
Super-Scaffold_25	3690726	3711011	20285	g_13908	g_13909
Super-Scaffold_25	3711286	3712279	993	g_13909	g_13910
Super-Scaffold_25	3712819	3714705	1886	g_13910	g_13911
Super-Scaffold_25	3715409	3723902	8493	g_13911	g_13912
Super-Scaffold_25	3726314	3736164	9850	g_13912	g_13913
Super-Scaffold_25	3736787	3767454	30667	g_13913	g_13914
Super-Scaffold_25	3767946	3787503	19557	g_13914	g_36367
Super-Scaffold_25	3787769	3801143	13374	g_36367	g_13915
Super-Scaffold_25	3802144	3808426	6282	g_13915	g_13916
Super-Scaffold_25	3809739	3809871	132	g_13916	g_13917
Super-Scaffold_25	3810449	3810477	28	g_13917	g_13918
Super-Scaffold_25	3811253	3836613	25360	g_13918	g_13919
Super-Scaffold_25	3843336	3892751	49415	g_13919	g_13920
Super-Scaffold_25	3892993	3901216	8223	g_13920	g_44081
Super-Scaffold_25	3906010	3910571	4561	g_44081	g_13921
Super-Scaffold_25	3910912	3911018	106	g_13921	g_13922
Super-Scaffold_25	3911581	3911762	181	g_13922	g_44082
Super-Scaffold_25	3914253	3946340	32087	g_44082	g_13924
Super-Scaffold_25	3947852	3968377	20525	g_13926	g_13927
Super-Scaffold_25	3968634	4002867	34233	g_13927	g_13928
Super-Scaffold_25	4003873	4006569	2696	g_13928	g_13929
Super-Scaffold_25	4007273	4030129	22856	g_13929	g_13932
Super-Scaffold_25	4032892	4038164	5272	g_13932	g_13933
Super-Scaffold_25	4038451	4039088	637	g_13933	g_13934
Super-Scaffold_25	4039387	4062737	23350	g_13934	g_13936
Super-Scaffold_25	4063543	4076902	13359	g_13936	g_13937
Super-Scaffold_25	4079270	4101117	21847	g_13937	g_13940
Super-Scaffold_25	4102975	4106696	3721	g_13940	g_44083
Super-Scaffold_25	4112334	4112375	41	g_44083	g_13941
Super-Scaffold_25	4113773	4129716	15943	g_13941	g_13942
Super-Scaffold_25	4130204	4146242	16038	g_13942	g_13943
Super-Scaffold_25	4148278	4203105	54827	g_13943	g_13945
Super-Scaffold_25	4204343	4288201	83858	g_13945	g_13946
Super-Scaffold_25	4288536	4298607	10071	g_13946	g_13947
Super-Scaffold_25	4299311	4306574	7263	g_13947	g_13948
Super-Scaffold_25	4307717	4365542	57825	g_13948	g_13949
Super-Scaffold_25	4365856	4420023	54167	g_13949	g_13950
Super-Scaffold_25	4420673	4428359	7686	g_13950	g_13951
Super-Scaffold_25	4428946	4450373	21427	g_13951	g_13952
Super-Scaffold_25	4451272	4474806	23534	g_13952	g_13953
Super-Scaffold_25	4475504	4525978	50474	g_13953	g_13955
Super-Scaffold_25	4526265	4571559	45294	g_13955	g_13956
Super-Scaffold_25	4571792	4654888	83096	g_13956	g_13960
Super-Scaffold_25	4655214	4656745	1531	g_13960	g_13961
Super-Scaffold_25	4657059	4690685	33626	g_13961	g_13962
Super-Scaffold_25	4691464	4882562	191098	g_13962	g_13969
Super-Scaffold_25	4882840	4950747	67907	g_13969	g_13970
Super-Scaffold_25	4951169	4978310	27141	g_13970	g_13971
Super-Scaffold_25	4981386	4990531	9145	g_13971	g_13972
Super-Scaffold_25	5001744	5003545	1801	g_13972	g_13973
Super-Scaffold_25	5016048	5020717	4669	g_13973	g_13974
Super-Scaffold_25	5041232	5055291	14059	g_13974	g_13976
Super-Scaffold_25	5097754	5103726	5972	g_13976	g_44084
Super-Scaffold_25	5128617	5133678	5061	g_44084	g_13978
Super-Scaffold_25	5149050	5164896	15846	g_13978	g_13980
Super-Scaffold_25	5178262	5181807	3545	g_13980	g_13981
Super-Scaffold_25	5253668	5267866	14198	g_13981	g_44085
Super-Scaffold_25	5282587	5324377	41790	g_44085	g_13982
Super-Scaffold_25	5326603	5337873	11270	g_13982	g_13983
Super-Scaffold_25	5370939	5391236	20297	g_13983	g_13984
Super-Scaffold_25	5402057	5407650	5593	g_13984	g_13985
Super-Scaffold_25	5408132	5409336	1204	g_13985	g_44086
Super-Scaffold_25	5410651	5423201	12550	g_44086	g_44087
Super-Scaffold_25	5437397	5439964	2567	g_44087	g_13986
Super-Scaffold_25	5442652	5467808	25156	g_13986	g_13987
Super-Scaffold_25	5492575	5493109	534	g_13987	g_13988
Super-Scaffold_25	5495627	5498270	2643	g_13988	g_44088
Super-Scaffold_25	5501762	5506739	4977	g_44088	g_13989
Super-Scaffold_25	5507272	5511470	4198	g_13989	g_13990
Super-Scaffold_25	5557089	5619130	62041	g_36379	g_13991
Super-Scaffold_25	5619795	5619860	65	g_13991	g_13992
Super-Scaffold_25	5620945	5667876	46931	g_13992	g_44089
Super-Scaffold_25	5668157	5668269	112	g_44089	g_13993
Super-Scaffold_25	5668895	5681556	12661	g_13993	g_13994
Super-Scaffold_25	5682606	5710403	27797	g_13994	g_13995
Super-Scaffold_25	5711797	6083879	372082	g_13995	g_13996
Super-Scaffold_25	6085273	6099589	14316	g_13996	g_13997
Super-Scaffold_25	6100890	6100971	81	g_13997	g_44090
Super-Scaffold_25	6101249	6119136	17887	g_44090	g_36381
Super-Scaffold_25	6122210	6126412	4202	g_13999	g_14000
Super-Scaffold_25	6126693	6127792	1099	g_14000	g_44091
Super-Scaffold_25	6128370	6157834	29464	g_44091	g_14002
Super-Scaffold_25	6162349	6178803	16454	g_14002	g_14003
Super-Scaffold_25	6199479	6226669	27190	g_14003	g_14004
Super-Scaffold_25	6227682	6342928	115246	g_14004	g_14008
Super-Scaffold_25	6343170	6343278	108	g_14008	g_14009
Super-Scaffold_25	6343568	6421955	78387	g_14009	g_14013
Super-Scaffold_25	6422905	6456749	33844	g_14013	g_14014
Super-Scaffold_25	6460564	6536706	76142	g_14014	g_14018
Super-Scaffold_25	6537014	6546433	9419	g_14018	g_44092
Super-Scaffold_25	6547603	6549033	1430	g_44092	g_14019
Super-Scaffold_25	6549519	6615088	65569	g_14019	g_14021
Super-Scaffold_25	6615960	6953103	337143	g_14021	g_14024
Super-Scaffold_25	6969124	6973284	4160	g_14024	g_44093
Super-Scaffold_25	6979058	6980323	1265	g_44093	g_44094
Super-Scaffold_25	6984484	6988425	3941	g_44094	g_14025
Super-Scaffold_25	6997862	7002011	4149	g_14025	g_14026
Super-Scaffold_25	7008977	7009900	923	g_14026	g_14027
Super-Scaffold_25	7013010	7038193	25183	g_14027	g_14029
Super-Scaffold_25	7059606	7070798	11192	g_14029	g_36385
Super-Scaffold_25	7071145	7106196	35051	g_36385	g_14032
Super-Scaffold_25	7110065	7131794	21729	g_14032	g_14035
Super-Scaffold_25	7136833	7172663	35830	g_14035	g_14036
Super-Scaffold_25	7186224	7301894	115670	g_14036	g_14037
Super-Scaffold_25	7302223	7317973	15750	g_14037	g_14038
Super-Scaffold_25	7318200	7423956	105756	g_14038	g_14040
Super-Scaffold_25	7424318	7425543	1225	g_14040	g_14041
Super-Scaffold_25	7431078	7441236	10158	g_14041	g_14044
Super-Scaffold_25	7441583	7469659	28076	g_14044	g_14046
Super-Scaffold_25	7469880	7486003	16123	g_14046	g_14047
Super-Scaffold_25	7486548	7489672	3124	g_14047	g_14048
Super-Scaffold_25	7494690	7505060	10370	g_14048	g_14049
Super-Scaffold_25	7533599	7540195	6596	g_14049	g_14050
Super-Scaffold_25	7544427	7558717	14290	g_14050	g_14051
Super-Scaffold_25	7561332	7577683	16351	g_14051	g_14052
Super-Scaffold_25	7578114	7624680	46566	g_14052	g_14054
Super-Scaffold_25	7626881	7629077	2196	g_14054	g_14055
Super-Scaffold_25	7638850	7646998	8148	g_14055	g_14056
Super-Scaffold_25	7647207	7683551	36344	g_14056	g_14057
Super-Scaffold_25	7703145	7773710	70565	g_14057	g_14059
Super-Scaffold_25	7774195	7931602	157407	g_14059	g_14063
Super-Scaffold_25	7937658	8182937	245279	g_14063	g_14064
Super-Scaffold_25	8184382	8185041	659	g_14064	g_14065
Super-Scaffold_25	8185718	8186456	738	g_14065	g_14066
Super-Scaffold_25	8186875	8201115	14240	g_14066	g_14067
Super-Scaffold_25	8202251	8390884	188633	g_14067	g_14069
Super-Scaffold_25	8395016	8401600	6584	g_14069	g_14070
Super-Scaffold_25	8402523	8402890	367	g_14070	g_14071
Super-Scaffold_25	8403839	8553507	149668	g_36398	g_14073
Super-Scaffold_25	8553770	8557139	3369	g_14073	g_14074
Super-Scaffold_25	8557855	8561067	3212	g_14074	g_44095
Super-Scaffold_25	8579158	8607665	28507	g_44095	g_14075
Super-Scaffold_25	8619159	8629570	10411	g_14075	g_44096
Super-Scaffold_25	8638805	8644985	6180	g_44096	g_14077
Super-Scaffold_25	8692500	8697926	5426	g_14077	g_14078
Super-Scaffold_25	8698537	8718888	20351	g_14078	g_14079
Super-Scaffold_25	8731442	8761502	30060	g_14079	g_14080
Super-Scaffold_25	8779279	8807020	27741	g_14080	g_14081
Super-Scaffold_25	8821552	8844869	23317	g_14081	g_14082
Super-Scaffold_25	8846071	8917293	71222	g_14082	g_14085
Super-Scaffold_25	8917679	8961452	43773	g_14085	g_14086
Super-Scaffold_25	8981854	9037293	55439	g_14086	g_14087
Super-Scaffold_25	9038900	9040991	2091	g_14087	g_14088
Super-Scaffold_25	9041227	9047305	6078	g_14088	g_44097
Super-Scaffold_25	9054465	9066686	12221	g_44097	g_14090
Super-Scaffold_25	9091137	9093537	2400	g_14090	g_14091
Super-Scaffold_25	9094130	9128125	33995	g_14091	g_14094
Super-Scaffold_25	9128325	9137411	9086	g_14094	g_14095
Super-Scaffold_25	9139360	9158897	19537	g_14095	g_14096
Super-Scaffold_25	9159142	9159212	70	g_14096	g_14097
Super-Scaffold_25	9159679	9159759	80	g_14097	g_14098
Super-Scaffold_25	9160295	9194051	33756	g_14098	g_14099
Super-Scaffold_25	9194359	9208268	13909	g_14099	g_14101
Super-Scaffold_25	9209233	9246225	36992	g_14101	g_14102
Super-Scaffold_25	9287891	9303689	15798	g_14102	g_14103
Super-Scaffold_25	9315582	9328836	13254	g_14103	g_14104
Super-Scaffold_25	9338554	9339760	1206	g_14104	g_14105
Super-Scaffold_25	9343241	9351869	8628	g_14105	g_14106
Super-Scaffold_25	9358918	9362404	3486	g_14106	g_14107
Super-Scaffold_25	9385485	9411153	25668	g_14107	g_14109
Super-Scaffold_25	9416551	9462876	46325	g_14109	g_14111
Super-Scaffold_25	9476628	9482103	5475	g_14111	g_14112
Super-Scaffold_25	9482477	9596744	114267	g_14112	g_14115
Super-Scaffold_25	9608682	9613297	4615	g_14115	g_14116
Super-Scaffold_25	9640759	9643748	2989	g_14116	g_14117
Super-Scaffold_25	9643951	9649246	5295	g_14117	g_44098
Super-Scaffold_25	9673621	9684587	10966	g_44098	g_14118
Super-Scaffold_25	9688019	9688985	966	g_14118	g_14119
Super-Scaffold_25	9693817	9698018	4201	g_14119	g_14120
Super-Scaffold_25	9705836	9712635	6799	g_14120	g_14121
Super-Scaffold_25	9723589	9725888	2299	g_14121	g_14122
Super-Scaffold_25	9730167	9731944	1777	g_14122	g_14123
Super-Scaffold_25	9736270	9738197	1927	g_14123	g_14124
Super-Scaffold_25	9757956	9785305	27349	g_14124	g_14127
Super-Scaffold_25	9797132	10079470	282338	g_14127	g_14132
Super-Scaffold_25	10079682	10145456	65774	g_14132	g_14135
Super-Scaffold_25	10190803	10190916	113	g_14136	g_14137
Super-Scaffold_25	10192150	10217632	25482	g_14137	g_14138
Super-Scaffold_25	10234267	10244318	10051	g_14138	g_44099
Super-Scaffold_25	10244814	10325996	81182	g_44099	g_14139
Super-Scaffold_25	10338546	10422524	83978	g_14139	g_14141
Super-Scaffold_25	10422982	10425497	2515	g_14141	g_14142
Super-Scaffold_25	10432484	10433215	731	g_14142	g_14143
Super-Scaffold_25	10438008	10443106	5098	g_14143	g_14144
Super-Scaffold_25	10461625	10620555	158930	g_14144	g_14150
Super-Scaffold_25	10633819	10642024	8205	g_14150	g_14152
Super-Scaffold_25	10645027	10676308	31281	g_14152	g_14153
Super-Scaffold_25	10676910	10685003	8093	g_14153	g_14154
Super-Scaffold_25	10685254	10723351	38097	g_14154	g_14155
Super-Scaffold_25	10732465	10760880	28415	g_14155	g_14156
Super-Scaffold_25	10777992	10781918	3926	g_14156	g_14157
Super-Scaffold_25	10791571	10813807	22236	g_14157	g_14158
Super-Scaffold_25	10814780	10818701	3921	g_14158	g_14159
Super-Scaffold_25	10819980	10829171	9191	g_14159	g_14160
Super-Scaffold_25	10844117	10845738	1621	g_14160	g_14161
Super-Scaffold_25	10848805	10850427	1622	g_14161	g_14162
Super-Scaffold_25	10852443	10863569	11126	g_14162	g_14163
Super-Scaffold_25	10883840	10917720	33880	g_14163	g_14165
Super-Scaffold_25	10917992	10926907	8915	g_14165	g_14166
Super-Scaffold_25	10941681	10942238	557	g_14166	g_14167
Super-Scaffold_25	10945122	10946849	1727	g_14167	g_14168
Super-Scaffold_25	10961123	10962091	968	g_14168	g_14169
Super-Scaffold_25	10975685	10989986	14301	g_14169	g_14170
Super-Scaffold_25	10999335	11043000	43665	g_14170	g_36417
Super-Scaffold_25	11043251	11089812	46561	g_36417	g_14175
Super-Scaffold_25	11120553	11244155	123602	g_14175	g_14177
Super-Scaffold_25	11244610	11244716	106	g_14177	g_14178
Super-Scaffold_25	11245285	11245313	28	g_14178	g_14179
Super-Scaffold_25	11245549	11245817	268	g_14179	g_14180
Super-Scaffold_25	11246053	11338295	92242	g_14180	g_14182
Super-Scaffold_25	11359232	11365492	6260	g_14182	g_14183
Super-Scaffold_25	11369527	11374631	5104	g_14183	g_14184
Super-Scaffold_25	11437143	11455280	18137	g_14184	g_14185
Super-Scaffold_25	11458126	11480260	22134	g_14185	g_14187
Super-Scaffold_25	11549107	11612133	63026	g_14187	g_14189
Super-Scaffold_25	11612390	11671365	58975	g_14189	g_14191
Super-Scaffold_25	11671625	11756763	85138	g_14191	g_36421
Super-Scaffold_25	11756993	11789927	32934	g_36421	g_14196
Super-Scaffold_25	11793097	11823312	30215	g_14196	g_14198
Super-Scaffold_25	11825330	11828172	2842	g_14198	g_14199
Super-Scaffold_25	11843433	11855735	12302	g_14199	g_14200
Super-Scaffold_25	11865228	11923171	57943	g_14200	g_14201
Super-Scaffold_25	11923491	11923627	136	g_14201	g_44100
Super-Scaffold_25	11927420	11929289	1869	g_44100	g_36424
Super-Scaffold_25	11929495	12003147	73652	g_36424	g_14202
Super-Scaffold_25	12006073	12038935	32862	g_14202	g_44101
Super-Scaffold_25	12050360	12062313	11953	g_44101	g_14203
Super-Scaffold_25	12063694	12071975	8281	g_14203	g_14204
Super-Scaffold_25	12073169	12078169	5000	g_14204	g_14205
Super-Scaffold_25	12088510	12089595	1085	g_14205	g_14206
Super-Scaffold_25	12091368	12091829	461	g_14206	g_14207
Super-Scaffold_25	12095344	12096814	1470	g_14207	g_14208
Super-Scaffold_25	12101256	12104185	2929	g_14208	g_14209
Super-Scaffold_25	12111439	12114993	3554	g_14209	g_14210
Super-Scaffold_25	12119177	12125750	6573	g_14210	g_14211
Super-Scaffold_25	12131553	12134181	2628	g_14211	g_14212
Super-Scaffold_25	12178524	12200808	22284	g_14212	g_14213
Super-Scaffold_25	12217938	12310895	92957	g_14213	g_14215
Super-Scaffold_25	12332944	12349422	16478	g_14215	g_14217
Super-Scaffold_25	12352414	12416660	64246	g_14217	g_14219
Super-Scaffold_25	12437960	12438975	1015	g_14219	g_14220
Super-Scaffold_25	12439499	12452148	12649	g_14220	g_14221
Super-Scaffold_25	12455080	12458572	3492	g_14221	g_14222
Super-Scaffold_25	12460535	12461243	708	g_14222	g_14223
Super-Scaffold_25	12463814	12466214	2400	g_14223	g_14224
Super-Scaffold_25	12471103	12475001	3898	g_14224	g_14225
Super-Scaffold_25	12485297	12558074	72777	g_14225	g_14226
Super-Scaffold_25	12565042	12569086	4044	g_14226	g_14227
Super-Scaffold_25	12570492	12571143	651	g_14227	g_14228
Super-Scaffold_25	12573841	12574737	896	g_14228	g_14229
Super-Scaffold_25	12587645	12591724	4079	g_14229	g_14230
Super-Scaffold_25	12592812	12596440	3628	g_14230	g_14231
Super-Scaffold_25	12600896	12601561	665	g_14231	g_14232
Super-Scaffold_25	12604013	12606076	2063	g_14232	g_14233
Super-Scaffold_25	12608220	12613232	5012	g_14233	g_14234
Super-Scaffold_25	12631647	12635009	3362	g_14234	g_14235
Super-Scaffold_25	12640808	12674481	33673	g_14235	g_14237
Super-Scaffold_25	12675966	12677281	1315	g_14237	g_14238
Super-Scaffold_25	12678643	12687836	9193	g_14238	g_14239
Super-Scaffold_25	12694340	12695532	1192	g_14239	g_44102
Super-Scaffold_25	12701761	12702280	519	g_44102	g_14240
Super-Scaffold_25	12709827	12713324	3497	g_14240	g_14241
Super-Scaffold_25	12716373	12729417	13044	g_14241	g_14243
Super-Scaffold_25	12732393	12736754	4361	g_14243	g_14244
Super-Scaffold_25	12738358	12741144	2786	g_14244	g_14245
Super-Scaffold_25	12745701	12751646	5945	g_14245	g_14246
Super-Scaffold_25	12757537	12770825	13288	g_14246	g_14248
Super-Scaffold_25	12771040	12779235	8195	g_14248	g_44103
Super-Scaffold_25	12785095	12786039	944	g_44103	g_44104
Super-Scaffold_25	12788095	12789274	1179	g_44104	g_14249
Super-Scaffold_25	12789755	12790715	960	g_14249	g_14250
Super-Scaffold_25	12796394	12799865	3471	g_14250	g_14251
Super-Scaffold_25	12813961	12815042	1081	g_14251	g_14252
Super-Scaffold_25	12815299	12817335	2036	g_14252	g_14253
Super-Scaffold_25	12819758	12820933	1175	g_14253	g_14254
Super-Scaffold_25	12827505	12862700	35195	g_14254	g_14257
Super-Scaffold_25	12881310	12894935	13625	g_14257	g_14258
Super-Scaffold_25	12895750	12898882	3132	g_14258	g_14259
Super-Scaffold_25	12908543	12908997	454	g_14259	g_14260
Super-Scaffold_25	12909323	12909398	75	g_14260	g_14261
Super-Scaffold_25	12912023	12912535	512	g_14261	g_14262
Super-Scaffold_25	12913050	12913894	844	g_14262	g_14263
Super-Scaffold_25	12924069	12927225	3156	g_14263	g_14264
Super-Scaffold_25	12930895	12980082	49187	g_14264	g_14267
Super-Scaffold_25	12998790	13075058	76268	g_14267	g_14269
Super-Scaffold_25	13075279	13085832	10553	g_14269	g_14270
Super-Scaffold_25	13086056	13172162	86106	g_14270	g_14273
Super-Scaffold_25	13172781	13215790	43009	g_14273	g_14275
Super-Scaffold_25	13225343	13237027	11684	g_14275	g_14276
Super-Scaffold_25	13244239	13246979	2740	g_14276	g_14277
Super-Scaffold_25	13270608	13302942	32334	g_14277	g_14279
Super-Scaffold_25	13308952	13327825	18873	g_14279	g_14280
Super-Scaffold_25	13331379	13345007	13628	g_14280	g_14281
Super-Scaffold_25	13354587	13529020	174433	g_14281	g_14284
Super-Scaffold_25	13530522	13537967	7445	g_14284	g_14285
Super-Scaffold_25	13548382	13587615	39233	g_14285	g_14286
Super-Scaffold_25	13587869	13623936	36067	g_14286	g_14287
Super-Scaffold_25	13626323	13631569	5246	g_14287	g_14288
Super-Scaffold_25	13634252	13636081	1829	g_14288	g_14289
Super-Scaffold_25	13656426	13663595	7169	g_14289	g_14290
Super-Scaffold_25	13667520	13668855	1335	g_14290	g_14291
Super-Scaffold_25	13672728	13749190	76462	g_14291	g_14293
Super-Scaffold_25	13749423	13763498	14075	g_14293	g_14296
Super-Scaffold_25	13763935	13809840	45905	g_14296	g_14297
Super-Scaffold_25	13810109	13915343	105234	g_14297	g_14299
Super-Scaffold_25	13925000	13941419	16419	g_14299	g_44105
Super-Scaffold_25	13954133	14000877	46744	g_44105	g_14301
Super-Scaffold_25	14003121	14007762	4641	g_14301	g_14302
Super-Scaffold_25	14009098	14019751	10653	g_14302	g_14303
Super-Scaffold_25	14020005	14038894	18889	g_14303	g_14304
Super-Scaffold_25	14041175	14065673	24498	g_14304	g_14305
Super-Scaffold_25	14065975	14085867	19892	g_14305	g_14306
Super-Scaffold_25	14113116	14123632	10516	g_14306	g_14307
Super-Scaffold_25	14174939	14196895	21956	g_14307	g_14310
Super-Scaffold_25	14197149	14359862	162713	g_14310	g_14315
Super-Scaffold_25	14364047	14455535	91488	g_14315	g_14317
Super-Scaffold_25	14465053	14477471	12418	g_14317	g_14318
Super-Scaffold_25	14478310	14481965	3655	g_14318	g_36450
Super-Scaffold_25	14482171	14488163	5992	g_36450	g_14319
Super-Scaffold_25	14489302	14491414	2112	g_14319	g_14320
Super-Scaffold_25	14503216	14507822	4606	g_14320	g_14321
Super-Scaffold_25	14508721	14662577	153856	g_14321	g_14327
Super-Scaffold_25	14669471	14675741	6270	g_14327	g_44106
Super-Scaffold_25	14687359	14695704	8345	g_44106	g_14328
Super-Scaffold_25	14697785	14698457	672	g_14328	g_14329
Super-Scaffold_25	14711468	14713533	2065	g_14329	g_14330
Super-Scaffold_25	14723643	14728988	5345	g_14330	g_14331
Super-Scaffold_25	14733123	14734389	1266	g_14331	g_14332
Super-Scaffold_25	14746636	14759463	12827	g_14332	g_14334
Super-Scaffold_25	14763226	14801279	38053	g_44107	g_44108
Super-Scaffold_25	14807392	14813081	5689	g_44108	g_14335
Super-Scaffold_25	14813692	14817411	3719	g_14335	g_14336
Super-Scaffold_25	14826481	14838874	12393	g_14336	g_14337
Super-Scaffold_25	14853963	14867281	13318	g_14337	g_14338
Super-Scaffold_25	14870833	14873012	2179	g_14338	g_14339
Super-Scaffold_25	14886390	14889244	2854	g_14339	g_14340
Super-Scaffold_25	14891540	14893314	1774	g_14340	g_14341
Super-Scaffold_25	14898903	14912437	13534	g_14341	g_14342
Super-Scaffold_25	14929366	14939977	10611	g_14342	g_14343
Super-Scaffold_25	14944932	14948535	3603	g_14343	g_14344
Super-Scaffold_25	14950653	14952268	1615	g_14344	g_14345
Super-Scaffold_25	14962018	14964694	2676	g_14345	g_14346
Super-Scaffold_25	14968541	14968576	35	g_14346	g_14347
Super-Scaffold_25	14974053	14975862	1809	g_14347	g_14348
Super-Scaffold_25	14993443	14996297	2854	g_14348	g_44109
Super-Scaffold_25	14998393	15000216	1823	g_44109	g_14349
Super-Scaffold_25	15000458	15014561	14103	g_14349	g_14350
Super-Scaffold_25	15037479	15041477	3998	g_14350	g_14351
Super-Scaffold_25	15045094	15049496	4402	g_14351	g_14352
Super-Scaffold_25	15050966	15084681	33715	g_14352	g_14353
Super-Scaffold_25	15089815	15091375	1560	g_14353	g_14354
Super-Scaffold_25	15092188	15096787	4599	g_14354	g_14355
Super-Scaffold_25	15099008	15102830	3822	g_14355	g_14356
Super-Scaffold_25	15113439	15116524	3085	g_14356	g_14357
Super-Scaffold_25	15128343	15129352	1009	g_14357	g_14358
Super-Scaffold_25	15133948	15136944	2996	g_14358	g_14359
Super-Scaffold_25	15146003	15148226	2223	g_14359	g_44110
Super-Scaffold_25	15172567	15178285	5718	g_44110	g_14360
Super-Scaffold_25	15178506	15202955	24449	g_14360	g_14361
Super-Scaffold_25	15233076	15239527	6451	g_14361	g_14362
Super-Scaffold_25	15243149	15294811	51662	g_14362	g_14363
Super-Scaffold_25	15300786	15307022	6236	g_14363	g_14364
Super-Scaffold_25	15314045	15317183	3138	g_14364	g_14365
Super-Scaffold_25	15324928	15327055	2127	g_14365	g_14366
Super-Scaffold_25	15344995	15356737	11742	g_14366	g_36456
Super-Scaffold_25	15357384	15418102	60718	g_36456	g_14368
Super-Scaffold_25	15430330	15454264	23934	g_14368	g_14369
Super-Scaffold_25	15485189	15496046	10857	g_14369	g_14370
Super-Scaffold_25	15504095	15506823	2728	g_14370	g_14371
Super-Scaffold_25	15520170	15521903	1733	g_14371	g_14372
Super-Scaffold_25	15534807	15535968	1161	g_14372	g_14373
Super-Scaffold_25	15539982	15540765	783	g_14373	g_14374
Super-Scaffold_25	15545080	15609202	64122	g_14374	g_14376
Super-Scaffold_25	15617627	15629532	11905	g_14376	g_14378
Super-Scaffold_25	15630131	15668412	38281	g_14378	g_36463
Super-Scaffold_25	15668624	15712691	44067	g_36463	g_14381
Super-Scaffold_25	15713047	15739021	25974	g_14381	g_14383
Super-Scaffold_25	15739317	15779908	40591	g_14383	g_14386
Super-Scaffold_25	15780336	15805711	25375	g_14386	g_36464
Super-Scaffold_25	15805911	15861652	55741	g_36464	g_14390
Super-Scaffold_25	15862038	15878390	16352	g_14390	g_14391
Super-Scaffold_25	15878647	15889470	10823	g_14391	g_14392
Super-Scaffold_25	15889673	15934707	45034	g_14392	g_36466
Super-Scaffold_25	15934907	16170854	235947	g_36466	g_14396
Super-Scaffold_25	16171189	16271148	99959	g_14396	g_36473
Super-Scaffold_25	16289586	16294155	4569	g_14401	g_14402
Super-Scaffold_25	16301702	16391231	89529	g_14402	g_14407
Super-Scaffold_25	16397613	16399817	2204	g_14407	g_14408
Super-Scaffold_25	16401203	16402314	1111	g_14408	g_14409
Super-Scaffold_25	16408855	16411478	2623	g_14409	g_14410
Super-Scaffold_25	16416354	16435031	18677	g_14410	g_14412
Super-Scaffold_25	16437413	16438230	817	g_14412	g_14413
Super-Scaffold_25	16441656	16449865	8209	g_14413	g_14414
Super-Scaffold_25	16453985	16466159	12174	g_14414	g_14415
Super-Scaffold_25	16466578	16470296	3718	g_14415	g_44111
Super-Scaffold_25	16496023	16507929	11906	g_44111	g_14416
Super-Scaffold_25	16509431	16543196	33765	g_14416	g_14417
Super-Scaffold_25	16555374	16600101	44727	g_14417	g_14418
Super-Scaffold_25	16606410	16613063	6653	g_14418	g_14419
Super-Scaffold_25	16622726	16628251	5525	g_14419	g_14420
Super-Scaffold_25	16653863	16675710	21847	g_14420	g_14421
Super-Scaffold_25	16687741	16690693	2952	g_14421	g_14422
Super-Scaffold_25	16701305	16702400	1095	g_14422	g_44112
Super-Scaffold_25	16705342	16705658	316	g_44112	g_14423
Super-Scaffold_25	16708144	16714052	5908	g_14423	g_14424
Super-Scaffold_25	16719388	16724221	4833	g_14424	g_14425
Super-Scaffold_25	16732072	16736164	4092	g_14425	g_14426
Super-Scaffold_25	16748128	16761281	13153	g_14426	g_14427
Super-Scaffold_25	16775405	16780688	5283	g_14427	g_14428
Super-Scaffold_25	16781131	16788655	7524	g_14428	g_14429
Super-Scaffold_25	16788912	16806369	17457	g_14429	g_14431
Super-Scaffold_25	16833295	16836464	3169	g_14431	g_14432
Super-Scaffold_25	16840651	16845293	4642	g_14432	g_14433
Super-Scaffold_25	16856614	16925234	68620	g_14433	g_14436
Super-Scaffold_25	16926538	16926963	425	g_14436	g_14437
Super-Scaffold_25	16928993	16937763	8770	g_14437	g_14440
Super-Scaffold_25	16942905	16963447	20542	g_14440	g_14441
Super-Scaffold_25	16964277	17017778	53501	g_14441	g_14442
Super-Scaffold_25	17018011	17044325	26314	g_14442	g_14443
Super-Scaffold_25	17049559	17051583	2024	g_14443	g_14444
Super-Scaffold_25	17060779	17061890	1111	g_14444	g_14445
Super-Scaffold_25	17066369	17068878	2509	g_14445	g_14446
Super-Scaffold_25	17088294	17089843	1549	g_14446	g_14447
Super-Scaffold_25	17092456	17093473	1017	g_14447	g_14448
Super-Scaffold_25	17098691	17104240	5549	g_14448	g_14449
Super-Scaffold_25	17122984	17129421	6437	g_14449	g_14450
Super-Scaffold_25	17134201	17136477	2276	g_14450	g_14451
Super-Scaffold_25	17143478	17146205	2727	g_14451	g_14452
Super-Scaffold_25	17153155	17156775	3620	g_14452	g_14453
Super-Scaffold_25	17160726	17162444	1718	g_14453	g_14454
Super-Scaffold_25	17166220	17178696	12476	g_14454	g_14455
Super-Scaffold_25	17189073	17192938	3865	g_14455	g_14456
Super-Scaffold_25	17200847	17201438	591	g_14456	g_14457
Super-Scaffold_25	17204489	17207534	3045	g_14457	g_44113
Super-Scaffold_25	17209952	17211014	1062	g_44113	g_14458
Super-Scaffold_25	17221908	17223766	1858	g_14458	g_14459
Super-Scaffold_25	17225149	17227060	1911	g_14459	g_14460
Super-Scaffold_25	17233392	17251982	18590	g_14460	g_14461
Super-Scaffold_25	17258430	17260872	2442	g_14461	g_14462
Super-Scaffold_25	17276584	17277912	1328	g_14462	g_14463
Super-Scaffold_25	17281617	17283674	2057	g_14463	g_14464
Super-Scaffold_25	17304666	17320317	15651	g_14464	g_14465
Super-Scaffold_25	17336678	17397649	60971	g_14465	g_14466
Super-Scaffold_25	17397963	17495839	97876	g_14466	g_14467
Super-Scaffold_25	17496057	17496370	313	g_14467	g_14468
Super-Scaffold_25	17511670	17515822	4152	g_14468	g_14469
Super-Scaffold_25	17516964	17599350	82386	g_14469	g_14473
Super-Scaffold_25	17599607	17601187	1580	g_14473	g_14474
Super-Scaffold_25	17611811	17617182	5371	g_14474	g_36480
Super-Scaffold_25	17618582	17626950	8368	g_36480	g_14477
Super-Scaffold_25	17635923	17638226	2303	g_14477	g_14478
Super-Scaffold_25	17639404	17644974	5570	g_14478	g_14479
Super-Scaffold_25	17652516	17658461	5945	g_14479	g_14480
Super-Scaffold_25	17658661	17658709	48	g_14480	g_14481
Super-Scaffold_25	17662321	17701503	39182	g_14481	g_14483
Super-Scaffold_25	17710400	17792256	81856	g_14483	g_36483
Super-Scaffold_25	17792519	17804617	12098	g_36483	g_14484
Super-Scaffold_25	17804838	17807835	2997	g_14484	g_14485
Super-Scaffold_25	17808044	17813496	5452	g_14485	g_14486
Super-Scaffold_25	17813750	17864852	51102	g_14486	g_14489
Super-Scaffold_25	17866782	17887143	20361	g_14489	g_14491
Super-Scaffold_25	17900175	17919558	19383	g_14491	g_14492
Super-Scaffold_25	17919761	17936141	16380	g_14492	g_36489
Super-Scaffold_25	17936344	17954558	18214	g_36489	g_14496
Super-Scaffold_25	17966758	17968897	2139	g_14496	g_14497
Super-Scaffold_25	17972125	17973754	1629	g_14497	g_14498
Super-Scaffold_25	17975644	17981401	5757	g_14498	g_14499
Super-Scaffold_25	17989247	17990070	823	g_14499	g_14500
Super-Scaffold_25	17991552	17992025	473	g_14500	g_14501
Super-Scaffold_25	17997418	17998297	879	g_14501	g_14502
Super-Scaffold_25	18001072	18010020	8948	g_14502	g_14503
Super-Scaffold_25	18017676	18021538	3862	g_14503	g_14504
Super-Scaffold_25	18044830	18072926	28096	g_14504	g_44114
Super-Scaffold_25	18073192	18089433	16241	g_44114	g_14506
Super-Scaffold_25	18090356	18099450	9094	g_14506	g_14507
Super-Scaffold_25	18103614	18117558	13944	g_14507	g_14508
Super-Scaffold_25	18142207	18145048	2841	g_14508	g_14509
Super-Scaffold_25	18150396	18151741	1345	g_14509	g_14510
Super-Scaffold_25	18161103	18162746	1643	g_14510	g_14511
Super-Scaffold_25	18173883	18180012	6129	g_14511	g_14512
Super-Scaffold_25	18184062	18193311	9249	g_14512	g_14513
Super-Scaffold_25	18212322	18212801	479	g_14513	g_14514
Super-Scaffold_25	18213040	18263715	50675	g_14514	g_14516
Super-Scaffold_25	18264122	18264504	382	g_14516	g_14517
Super-Scaffold_25	18264845	18267002	2157	g_14517	g_14518
Super-Scaffold_25	18270229	18320856	50627	g_14518	g_14521
Super-Scaffold_25	18321941	18358277	36336	g_14521	g_14524
Super-Scaffold_25	18361085	18363323	2238	g_14524	g_14525
Super-Scaffold_25	18369136	18371944	2808	g_14525	g_44115
Super-Scaffold_25	18388350	18391190	2840	g_44115	g_44116
Super-Scaffold_25	18399000	18401523	2523	g_44116	g_14526
Super-Scaffold_25	18407890	18408711	821	g_14526	g_14527
Super-Scaffold_25	18411744	18413420	1676	g_14527	g_14528
Super-Scaffold_25	18433627	18435352	1725	g_14528	g_14529
Super-Scaffold_25	18445633	18446393	760	g_14529	g_14530
Super-Scaffold_25	18447254	18447663	409	g_14530	g_14531
Super-Scaffold_25	18452555	18453527	972	g_14531	g_14532
Super-Scaffold_25	18481703	18641539	159836	g_14532	g_14534
Super-Scaffold_25	18649200	18652371	3171	g_14534	g_14535
Super-Scaffold_25	18652610	18657631	5021	g_14535	g_14536
Super-Scaffold_25	18657960	18667283	9323	g_14536	g_36496
Super-Scaffold_25	18667636	18672263	4627	g_36496	g_14538
Super-Scaffold_25	18672667	18717249	44582	g_14538	g_14540
Super-Scaffold_25	18717620	18749050	31430	g_14540	g_14543
Super-Scaffold_25	18761135	18763381	2246	g_14543	g_14544
Super-Scaffold_25	18770133	18773651	3518	g_14544	g_44117
Super-Scaffold_25	18774760	18779294	4534	g_44117	g_14545
Super-Scaffold_25	18787487	18791401	3914	g_14545	g_44118
Super-Scaffold_25	18803018	18812576	9558	g_44118	g_44119
Super-Scaffold_25	18823002	18838738	15736	g_44119	g_14547
Super-Scaffold_25	18841378	18842368	990	g_14547	g_14548
Super-Scaffold_25	18842613	18875918	33305	g_14548	g_44120
Super-Scaffold_25	18882308	18884469	2161	g_44120	g_14549
Super-Scaffold_25	18890153	18890967	814	g_14549	g_14550
Super-Scaffold_25	18902828	18918480	15652	g_14550	g_14551
Super-Scaffold_25	18941286	19005895	64609	g_14551	g_14552
Super-Scaffold_25	19029790	19047146	17356	g_14552	g_14553
Super-Scaffold_25	19049443	19049949	506	g_14553	g_14554
Super-Scaffold_25	19051088	19051840	752	g_14554	g_14555
Super-Scaffold_25	19053676	19054281	605	g_14555	g_14556
Super-Scaffold_25	19057943	19061032	3089	g_14556	g_14557
Super-Scaffold_25	19064640	19094875	30235	g_14557	g_14558
Super-Scaffold_25	19143882	19175583	31701	g_36500	g_14560
Super-Scaffold_25	19192419	19231923	39504	g_14560	g_14561
Super-Scaffold_25	19254690	19266208	11518	g_14561	g_14562
Super-Scaffold_25	19274331	19385733	111402	g_14562	g_36502
Super-Scaffold_25	19385978	19404073	18095	g_36502	g_14566
Super-Scaffold_25	19404711	19551453	146742	g_14566	g_14570
Super-Scaffold_25	19551737	19606601	54864	g_14570	g_14573
Super-Scaffold_25	19607455	19607507	52	g_14573	g_14574
Super-Scaffold_25	19608112	19629456	21344	g_14574	g_14576
Super-Scaffold_25	19636306	19673697	37391	g_14576	g_36508
Super-Scaffold_25	19673978	19696938	22960	g_36508	g_36510
Super-Scaffold_25	19697165	19772820	75655	g_36510	g_14579
Super-Scaffold_25	19773089	19801307	28218	g_14579	g_14580
Super-Scaffold_25	19812432	19822906	10474	g_14580	g_14581
Super-Scaffold_25	19827148	19827644	496	g_14581	g_14582
Super-Scaffold_25	19831388	19857572	26184	g_14582	g_14583
Super-Scaffold_25	19857865	19865238	7373	g_14583	g_14584
Super-Scaffold_25	19867839	19993771	125932	g_14584	g_14587
Super-Scaffold_25	20003915	20007901	3986	g_14587	g_14588
Super-Scaffold_25	20022399	20033595	11196	g_14588	g_14590
Super-Scaffold_25	20053479	20055997	2518	g_14590	g_14591
Super-Scaffold_25	20069157	20071641	2484	g_14591	g_44121
Super-Scaffold_25	20089396	20091064	1668	g_44121	g_44122
Super-Scaffold_25	20093102	20094620	1518	g_44122	g_14592
Super-Scaffold_25	20104589	20106324	1735	g_14592	g_14593
Super-Scaffold_25	20115455	20118358	2903	g_14593	g_14594
Super-Scaffold_25	20126897	20130335	3438	g_14594	g_14595
Super-Scaffold_25	20137132	20190870	53738	g_14595	g_14598
Super-Scaffold_25	20199140	20201047	1907	g_14598	g_44123
Super-Scaffold_25	20201937	20204450	2513	g_44123	g_14599
Super-Scaffold_25	20205535	20273208	67673	g_14599	g_14601
Super-Scaffold_25	20281969	20286355	4386	g_14601	g_14602
Super-Scaffold_25	20294084	20298309	4225	g_14602	g_14603
Super-Scaffold_25	20299027	20319119	20092	g_14603	g_14604
Super-Scaffold_25	20322866	20326095	3229	g_14604	g_14605
Super-Scaffold_25	20326640	20328621	1981	g_14605	g_14606
Super-Scaffold_25	20333224	20334950	1726	g_14606	g_44124
Super-Scaffold_25	20341710	20343286	1576	g_44124	g_14607
Super-Scaffold_25	20343645	20359072	15427	g_14607	g_14609
Super-Scaffold_25	20386310	20415840	29530	g_14609	g_14611
Super-Scaffold_25	20416468	20418755	2287	g_14611	g_14612
Super-Scaffold_25	20427906	20428908	1002	g_14612	g_14613
Super-Scaffold_25	20429503	20431460	1957	g_14613	g_14614
Super-Scaffold_25	20441085	20441971	886	g_14614	g_14615
Super-Scaffold_25	20454612	20454691	79	g_14615	g_44125
Super-Scaffold_25	20480740	20616200	135460	g_44125	g_14618
Super-Scaffold_25	20618323	20628430	10107	g_14618	g_36520
Super-Scaffold_25	20628687	20687687	59000	g_36520	g_14620
Super-Scaffold_25	20687998	20690946	2948	g_14620	g_14621
Super-Scaffold_25	20691275	20715289	24014	g_14621	g_14622
Super-Scaffold_25	20715594	20755740	40146	g_14622	g_14623
Super-Scaffold_25	20835051	20854994	19943	g_14623	g_36521
Super-Scaffold_25	20855245	20888210	32965	g_36521	g_14624
Super-Scaffold_25	20892842	20915994	23152	g_14624	g_14625
Super-Scaffold_25	20916251	20932933	16682	g_14625	g_14627
Super-Scaffold_25	20945162	21000762	55600	g_14627	g_14628
Super-Scaffold_25	21001895	21021544	19649	g_14628	g_14630
Super-Scaffold_25	21022974	21046911	23937	g_14630	g_14632
Super-Scaffold_25	21052755	21061814	9059	g_14632	g_44126
Super-Scaffold_25	21062074	21090168	28094	g_44126	g_14634
Super-Scaffold_25	21090452	21191856	101404	g_14634	g_36524
Super-Scaffold_25	21192083	21241656	49573	g_36524	g_14640
Super-Scaffold_25	21241961	21256924	14963	g_14640	g_14641
Super-Scaffold_25	21257127	21276439	19312	g_14641	g_14643
Super-Scaffold_25	21276684	21328077	51393	g_14643	g_36529
Super-Scaffold_25	21328358	21350633	22275	g_36529	g_14646
Super-Scaffold_25	21358654	21392166	33512	g_14646	g_14647
Super-Scaffold_25	21392402	21407656	15254	g_14647	g_14648
Super-Scaffold_25	21413659	21416461	2802	g_14648	g_14649
Super-Scaffold_25	21420612	21432743	12131	g_14649	g_14650
Super-Scaffold_25	21434724	21436319	1595	g_14650	g_14651
Super-Scaffold_25	21438798	21441675	2877	g_14651	g_14652
Super-Scaffold_25	21442715	21445550	2835	g_14652	g_14653
Super-Scaffold_25	21446062	21446947	885	g_14653	g_14654
Super-Scaffold_25	21454596	21496684	42088	g_14654	g_14655
Super-Scaffold_25	21514763	21514800	37	g_14655	g_36530
Super-Scaffold_25	21515018	21519621	4603	g_36530	g_14656
Super-Scaffold_25	21519827	21523122	3295	g_14656	g_14657
Super-Scaffold_25	21533476	21586443	52967	g_14657	g_14658
Super-Scaffold_25	21601609	21643490	41881	g_14658	g_14659
Super-Scaffold_25	21649757	21668725	18968	g_14659	g_14661
Super-Scaffold_25	21673175	21677954	4779	g_14661	g_14662
Super-Scaffold_25	21697926	21699588	1662	g_14662	g_14663
Super-Scaffold_25	21710909	21796007	85098	g_14663	g_14665
Super-Scaffold_25	21802423	21805011	2588	g_14665	g_14666
Super-Scaffold_25	21810223	21813749	3526	g_14666	g_14667
Super-Scaffold_25	21818741	21821112	2371	g_14667	g_14668
Super-Scaffold_25	21823710	21825946	2236	g_14668	g_14669
Super-Scaffold_25	21840807	21875832	35025	g_14669	g_14671
Super-Scaffold_25	21884448	21889833	5385	g_14671	g_14672
Super-Scaffold_25	21924580	21936646	12066	g_14672	g_14675
Super-Scaffold_25	21968831	21972286	3455	g_14675	g_14676
Super-Scaffold_25	21996495	22001361	4866	g_14676	g_14677
Super-Scaffold_25	22010450	22035644	25194	g_14677	g_14678
Super-Scaffold_25	22053114	22078538	25424	g_14678	g_14679
Super-Scaffold_25	22094519	22104210	9691	g_14679	g_14680
Super-Scaffold_25	22104530	22333970	229440	g_14680	g_14684
Super-Scaffold_25	22343720	22361251	17531	g_14684	g_44127
Super-Scaffold_25	22362329	22404545	42216	g_44127	g_14685
Super-Scaffold_25	22406870	22598117	191247	g_14685	g_14688
Super-Scaffold_25	22599184	22610276	11092	g_14688	g_14689
Super-Scaffold_25	22613675	22693608	79933	g_14689	g_14690
Super-Scaffold_25	22694678	22698639	3961	g_14690	g_14691
Super-Scaffold_25	22706308	22720647	14339	g_14691	g_14692
Super-Scaffold_25	22725453	22727409	1956	g_14692	g_14693
Super-Scaffold_25	22738708	22744783	6075	g_14693	g_14694
Super-Scaffold_25	22753092	22766165	13073	g_14694	g_14695
Super-Scaffold_25	22768581	22771838	3257	g_14695	g_14696
Super-Scaffold_25	22784683	22789489	4806	g_14696	g_14697
Super-Scaffold_25	22808584	22832849	24265	g_14697	g_14698
Super-Scaffold_25	22845242	22861591	16349	g_14698	g_14699
Super-Scaffold_25	22876697	22879641	2944	g_14699	g_44128
Super-Scaffold_25	22890978	22892683	1705	g_44128	g_44129
Super-Scaffold_25	22901779	22909889	8110	g_44129	g_14700
Super-Scaffold_25	22917016	22935514	18498	g_14700	g_14701
Super-Scaffold_25	22950128	22955509	5381	g_14701	g_14702
Super-Scaffold_25	22974510	22993061	18551	g_14702	g_14703
Super-Scaffold_25	23006806	23043523	36717	g_14703	g_14705
Super-Scaffold_25	23044098	23121791	77693	g_14705	g_14708
Super-Scaffold_25	23124385	23126784	2399	g_14708	g_14709
Super-Scaffold_25	23168030	23268717	100687	g_14709	g_14712
Super-Scaffold_25	23280509	23283793	3284	g_14712	g_14713
Super-Scaffold_25	23287574	23288115	541	g_14713	g_14714
Super-Scaffold_25	23301876	23317660	15784	g_14714	g_14715
Super-Scaffold_25	23317890	23329915	12025	g_14715	g_14716
Super-Scaffold_25	23338054	23343075	5021	g_14716	g_14717
Super-Scaffold_25	23363052	23444398	81346	g_14717	g_14718
Super-Scaffold_25	23451174	23513416	62242	g_14718	g_14719
Super-Scaffold_25	23524189	23526176	1987	g_14719	g_14720
Super-Scaffold_25	23539741	23541466	1725	g_14720	g_14721
Super-Scaffold_25	23545848	23554421	8573	g_14721	g_14722
Super-Scaffold_25	23561421	23655547	94126	g_14722	g_14724
Super-Scaffold_25	23664566	23680999	16433	g_14724	g_14725
Super-Scaffold_25	23702955	23709255	6300	g_14725	g_14726
Super-Scaffold_25	23714069	23718801	4732	g_14726	g_14727
Super-Scaffold_25	23737310	23769901	32591	g_14727	g_14729
Super-Scaffold_25	23791789	23792395	606	g_14729	g_14730
Super-Scaffold_25	23798556	23799214	658	g_14730	g_14731
Super-Scaffold_25	23816639	23816797	158	g_14731	g_14732
Super-Scaffold_25	23826584	23827861	1277	g_14732	g_14733
Super-Scaffold_25	23829069	23949324	120255	g_14733	g_14736
Super-Scaffold_25	23957902	23973739	15837	g_14736	g_14737
Super-Scaffold_25	23992530	24003254	10724	g_14737	g_44130
Super-Scaffold_25	24010153	24012812	2659	g_44130	g_14738
Super-Scaffold_25	24029513	24033677	4164	g_14738	g_44131
Super-Scaffold_25	24050860	24056844	5984	g_44131	g_14739
Super-Scaffold_25	24058032	24089279	31247	g_14739	g_14740
Super-Scaffold_25	24089560	24110905	21345	g_14740	g_14741
Super-Scaffold_25	24115307	24125282	9975	g_14741	g_14742
Super-Scaffold_25	24128210	24144176	15966	g_14742	g_14743
Super-Scaffold_25	24144487	24150106	5619	g_14743	g_14744
Super-Scaffold_25	24159471	24166361	6890	g_14744	g_14746
Super-Scaffold_25	24174609	24184893	10284	g_14746	g_14747
Super-Scaffold_25	24203380	24205739	2359	g_14747	g_14748
Super-Scaffold_25	24206587	24245198	38611	g_14748	g_14749
Super-Scaffold_25	24245509	24251156	5647	g_14749	g_14750
Super-Scaffold_25	24263829	24284451	20622	g_14750	g_14751
Super-Scaffold_25	24290951	24304420	13469	g_14751	g_14752
Super-Scaffold_25	24310419	24323205	12786	g_14752	g_14754
Super-Scaffold_25	24335777	24354976	19199	g_14754	g_14755
Super-Scaffold_25	24361467	24374875	13408	g_14755	g_14756
Super-Scaffold_25	24379271	24398165	18894	g_14756	g_14758
Super-Scaffold_25	24410535	24424926	14391	g_14758	g_44132
Super-Scaffold_25	24431418	24444479	13061	g_44132	g_14759
Super-Scaffold_25	24448875	24460859	11984	g_14759	g_14760
Super-Scaffold_25	24480327	24556572	76245	g_14760	g_14761
Super-Scaffold_25	24557048	24560057	3009	g_14761	g_14762
Super-Scaffold_25	24576228	24603519	27291	g_14762	g_14763
Super-Scaffold_25	24646518	24651141	4623	g_14763	g_14764
Super-Scaffold_25	24652707	24697218	44511	g_14765	g_14766
Super-Scaffold_25	24727554	24730699	3145	g_14766	g_14767
Super-Scaffold_25	24739804	24748002	8198	g_14767	g_44133
Super-Scaffold_25	24758850	24766938	8088	g_44133	g_14768
Super-Scaffold_25	24767174	25091667	324493	g_14768	g_14772
Super-Scaffold_25	25097943	25129076	31133	g_14772	g_44134
Super-Scaffold_25	25173010	25182647	9637	g_44134	g_14773
Super-Scaffold_25	25187379	25191113	3734	g_14773	g_14774
Super-Scaffold_25	25195643	25198846	3203	g_14774	g_14775
Super-Scaffold_25	25204622	25217066	12444	g_14775	g_14777
Super-Scaffold_25	25291915	25499570	207655	g_14777	g_14778
Super-Scaffold_25	25501074	25511260	10186	g_14778	g_14779
Super-Scaffold_25	25516830	25524787	7957	g_14779	g_14780
Super-Scaffold_25	25544431	25547227	2796	g_14780	g_14781
Super-Scaffold_25	25553388	25557875	4487	g_14781	g_14782
Super-Scaffold_25	25582940	25590660	7720	g_14782	g_14783
Super-Scaffold_25	25596164	25605202	9038	g_14783	g_14784
Super-Scaffold_25	25614056	25616979	2923	g_14784	g_14785
Super-Scaffold_25	25628358	25806669	178311	g_14785	g_14787
Super-Scaffold_25	25826642	25883988	57346	g_14787	g_14788
Super-Scaffold_25	25898307	25905278	6971	g_14788	g_44135
Super-Scaffold_25	25919702	25920883	1181	g_44135	g_14789
Super-Scaffold_25	25921935	25927899	5964	g_14789	g_14790
Super-Scaffold_25	25949194	26039232	90038	g_14790	g_14792
Super-Scaffold_25	26060710	26064696	3986	g_14792	g_14793
Super-Scaffold_25	26065094	26096608	31514	g_14793	g_36556
Super-Scaffold_25	26097609	26139994	42385	g_36556	g_14795
Super-Scaffold_25	26149199	26192344	43145	g_14795	g_14796
Super-Scaffold_25	26202500	26207326	4826	g_14796	g_14797
Super-Scaffold_25	26224914	26230852	5938	g_14797	g_14798
Super-Scaffold_25	26244214	26245139	925	g_14798	g_14799
Super-Scaffold_25	26246326	26256902	10576	g_14799	g_14800
Super-Scaffold_25	26259262	26270363	11101	g_14800	g_44136
Super-Scaffold_25	26281212	26297016	15804	g_44136	g_14801
Super-Scaffold_25	26301924	26312650	10726	g_14801	g_14802
Super-Scaffold_25	26316338	26330275	13937	g_14802	g_44137
Super-Scaffold_25	26330580	26331367	787	g_44137	g_14803
Super-Scaffold_25	26335997	26349044	13047	g_14803	g_14804
Super-Scaffold_25	26351802	26363185	11383	g_14804	g_14805
Super-Scaffold_25	26382422	26386911	4489	g_14805	g_14806
Super-Scaffold_25	26394392	26404332	9940	g_14806	g_14808
Super-Scaffold_25	26427181	26468846	41665	g_14808	g_36557
Super-Scaffold_25	26469094	26469310	216	g_36557	g_14810
Super-Scaffold_25	26497050	26503195	6145	g_14810	g_44138
Super-Scaffold_25	26507108	26509808	2700	g_44138	g_14811
Super-Scaffold_25	26519600	26528933	9333	g_14811	g_14813
Super-Scaffold_25	26547415	26570092	22677	g_14813	g_14815
Super-Scaffold_25	26570679	26571340	661	g_14815	g_14816
Super-Scaffold_25	26576412	26578647	2235	g_14816	g_14817
Super-Scaffold_25	26606248	26609705	3457	g_14817	g_14818
Super-Scaffold_25	26620262	26626741	6479	g_14818	g_44139
Super-Scaffold_25	26636679	26637452	773	g_44139	g_14819
Super-Scaffold_25	26641449	26643533	2084	g_14819	g_14820
Super-Scaffold_25	26662579	26680421	17842	g_14820	g_14821
Super-Scaffold_25	26703938	26709938	6000	g_14821	g_44140
Super-Scaffold_25	26710168	26712830	2662	g_44140	g_14822
Super-Scaffold_25	26720420	26729894	9474	g_14822	g_14823
Super-Scaffold_25	26758178	26764476	6298	g_14823	g_14824
Super-Scaffold_25	26771727	26779664	7937	g_14824	g_14825
Super-Scaffold_25	26795340	26801243	5903	g_14825	g_14826
Super-Scaffold_25	26838654	26854531	15877	g_14826	g_14827
Super-Scaffold_25	26856210	26859340	3130	g_14827	g_14828
Super-Scaffold_25	26862833	26885304	22471	g_14828	g_14829
Super-Scaffold_25	26895562	26907161	11599	g_14829	g_14830
Super-Scaffold_25	26907544	26911532	3988	g_14830	g_14831
Super-Scaffold_25	26911843	26913218	1375	g_14831	g_14832
Super-Scaffold_25	26913628	26919683	6055	g_14832	g_14833
Super-Scaffold_25	26920066	26921549	1483	g_14833	g_14834
Super-Scaffold_25	26922217	26935903	13686	g_14834	g_14835
Super-Scaffold_25	26936523	26939377	2854	g_14835	g_14836
Super-Scaffold_25	26939760	26941270	1510	g_14836	g_14837
Super-Scaffold_25	26941680	26942721	1041	g_14837	g_14838
Super-Scaffold_25	26943341	26951886	8545	g_14838	g_14839
Super-Scaffold_25	26952548	26953490	942	g_14839	g_14840
Super-Scaffold_25	26953873	26966791	12918	g_14840	g_14841
Super-Scaffold_25	26967174	26969373	2199	g_14841	g_14842
Super-Scaffold_25	26970168	26977815	7647	g_14842	g_14843
Super-Scaffold_25	26978192	26979340	1148	g_14843	g_14844
Super-Scaffold_25	26979723	26986219	6496	g_14844	g_14845
Super-Scaffold_25	26986629	26988165	1536	g_14845	g_14846
Super-Scaffold_25	26988548	26989663	1115	g_14846	g_14847
Super-Scaffold_25	26990040	26992120	2080	g_14847	g_14848
Super-Scaffold_25	26992431	27001242	8811	g_14848	g_14849
Super-Scaffold_25	27001874	27010985	9111	g_14849	g_14851
Super-Scaffold_25	27011770	27025513	13743	g_14851	g_14852
Super-Scaffold_25	27025896	27027024	1128	g_14852	g_14853
Super-Scaffold_25	27027401	27038763	11362	g_14853	g_14856
Super-Scaffold_25	27039401	27040492	1091	g_14856	g_14857
Super-Scaffold_25	27040902	27042141	1239	g_14857	g_14858
Super-Scaffold_25	27042524	27043502	978	g_14858	g_14859
Super-Scaffold_25	27045515	27051009	5494	g_14859	g_44141
Super-Scaffold_25	27051320	27052360	1040	g_44141	g_14860
Super-Scaffold_25	27052737	27108978	56241	g_14860	g_14861
Super-Scaffold_25	27110717	27147770	37053	g_14861	g_14863
Super-Scaffold_25	27149257	27189990	40733	g_14863	g_14864
Super-Scaffold_25	27190433	27196330	5897	g_14864	g_14865
Super-Scaffold_25	27197052	27231817	34765	g_14865	g_14866
Super-Scaffold_25	27249213	27259662	10449	g_14866	g_14867
Super-Scaffold_25	27279325	27848885	569560	g_14867	g_14870
Super-Scaffold_25	27855885	27861104	5219	g_14870	g_14871
Super-Scaffold_25	27864332	27870396	6064	g_14871	g_14872
Super-Scaffold_25	27873031	27884400	11369	g_14872	g_14873
Super-Scaffold_25	27885465	27889737	4272	g_14873	g_14875
Super-Scaffold_25	27913071	27913548	477	g_14875	g_14876
Super-Scaffold_25	27919554	27924986	5432	g_14876	g_14877
Super-Scaffold_25	27925780	27997224	71444	g_14877	g_14882
Super-Scaffold_25	27998516	27998950	434	g_14882	g_14883
Super-Scaffold_25	28000647	28003089	2442	g_14883	g_14884
Super-Scaffold_25	28003301	28005034	1733	g_14884	g_14885
Super-Scaffold_25	28006548	28006718	170	g_14885	g_14886
Super-Scaffold_25	28007674	28015535	7861	g_14886	g_14887
Super-Scaffold_25	28017241	28038175	20934	g_14887	g_14889
Super-Scaffold_25	28052169	28077677	25508	g_14889	g_14891
Super-Scaffold_25	28079574	28092568	12994	g_36570	g_14892
Super-Scaffold_25	28093479	28105991	12512	g_14892	g_14895
Super-Scaffold_25	28106422	28203006	96584	g_14895	g_14899
Super-Scaffold_25	28204628	28249705	45077	g_14899	g_14901
Super-Scaffold_25	28252845	28266708	13863	g_14901	g_14904
Super-Scaffold_25	28269470	28275572	6102	g_14904	g_14906
Super-Scaffold_25	28276687	28284941	8254	g_14906	g_36573
Super-Scaffold_25	28285612	28304386	18774	g_36573	g_14907
Super-Scaffold_25	28310559	28320779	10220	g_14907	g_14908
Super-Scaffold_25	28321508	28334117	12609	g_14908	g_14909
Super-Scaffold_25	28364050	28364998	948	g_14909	g_14911
Super-Scaffold_25	28374423	28425256	50833	g_14911	g_14913
Super-Scaffold_25	28450033	28450230	197	g_14913	g_14914
Super-Scaffold_25	28450601	28457412	6811	g_14914	g_14915
Super-Scaffold_25	28509627	28515182	5555	g_14915	g_14916
Super-Scaffold_25	28515871	28516178	307	g_14916	g_44142
Super-Scaffold_25	28517602	28521028	3426	g_44142	g_14918
Super-Scaffold_25	28522323	28523367	1044	g_14918	g_14919
Super-Scaffold_25	28538730	28539229	499	g_14919	g_14920
Super-Scaffold_25	28550651	28554096	3445	g_14920	g_44143
Super-Scaffold_25	28574201	28583654	9453	g_44143	g_14922
Super-Scaffold_25	28594735	28627482	32747	g_14922	g_14924
Super-Scaffold_25	28640261	28660064	19803	g_14924	g_44144
Super-Scaffold_25	28662449	28662520	71	g_44144	g_14925
Super-Scaffold_25	28662792	28664590	1798	g_14925	g_14926
Super-Scaffold_25	28678586	28679383	797	g_14926	g_14927
Super-Scaffold_25	28680061	28687612	7551	g_14927	g_14929
Super-Scaffold_25	28697500	28703652	6152	g_14929	g_14930
Super-Scaffold_25	28708401	28717653	9252	g_14930	g_14931
Super-Scaffold_3	36698	88106	51408	g_15100	g_15101
Super-Scaffold_3	115659	194537	78878	g_15101	g_15103
Super-Scaffold_3	194767	494582	299815	g_15103	g_15110
Super-Scaffold_3	504049	516312	12263	g_15110	g_15111
Super-Scaffold_3	538235	542516	4281	g_15111	g_15112
Super-Scaffold_3	544668	555831	11163	g_15112	g_15113
Super-Scaffold_3	594125	739469	145344	g_15113	g_15117
Super-Scaffold_3	742752	751723	8971	g_15117	g_15118
Super-Scaffold_3	771812	794662	22850	g_15118	g_15119
Super-Scaffold_3	812204	817399	5195	g_15119	g_15120
Super-Scaffold_3	819872	838715	18843	g_15120	g_15121
Super-Scaffold_3	864618	875595	10977	g_15121	g_15123
Super-Scaffold_3	876281	896569	20288	g_15123	g_15125
Super-Scaffold_3	907380	925876	18496	g_15125	g_15128
Super-Scaffold_3	938527	944580	6053	g_15128	g_15129
Super-Scaffold_3	945107	956629	11522	g_15129	g_44152
Super-Scaffold_3	969326	972837	3511	g_44152	g_15130
Super-Scaffold_3	979449	985178	5729	g_15130	g_15131
Super-Scaffold_3	997502	1013590	16088	g_15131	g_15132
Super-Scaffold_3	1013934	1017489	3555	g_15132	g_15133
Super-Scaffold_3	1058498	1073409	14911	g_15133	g_15134
Super-Scaffold_3	1094665	1127506	32841	g_15134	g_15135
Super-Scaffold_3	1188158	1234771	46613	g_15135	g_15137
Super-Scaffold_3	1247077	1311414	64337	g_15137	g_15138
Super-Scaffold_3	1328360	1379031	50671	g_15138	g_15141
Super-Scaffold_3	1403969	1412165	8196	g_15141	g_15142
Super-Scaffold_3	1418575	1462540	43965	g_15142	g_15144
Super-Scaffold_3	1470670	1481207	10537	g_15144	g_15145
Super-Scaffold_3	1481800	1508338	26538	g_15145	g_15146
Super-Scaffold_3	1508823	1509066	243	g_15146	g_15147
Super-Scaffold_3	1509527	1628041	118514	g_15147	g_15151
Super-Scaffold_3	1628640	1692941	64301	g_15151	g_15152
Super-Scaffold_3	1693381	1694288	907	g_15152	g_15153
Super-Scaffold_3	1696407	1878208	181801	g_15153	g_15155
Super-Scaffold_3	1880159	1893418	13259	g_15155	g_15156
Super-Scaffold_3	1908105	1927457	19352	g_15156	g_36597
Super-Scaffold_3	1927669	1930092	2423	g_36597	g_15158
Super-Scaffold_3	1930364	1938400	8036	g_15158	g_15159
Super-Scaffold_3	1953648	1955440	1792	g_15159	g_15160
Super-Scaffold_3	1971502	1979221	7719	g_15160	g_15161
Super-Scaffold_3	1980420	1985693	5273	g_15161	g_15162
Super-Scaffold_3	2009069	2020668	11599	g_15162	g_15164
Super-Scaffold_3	2036341	2041373	5032	g_15164	g_15166
Super-Scaffold_3	2045059	2077888	32829	g_15166	g_15168
Super-Scaffold_3	2088125	2092615	4490	g_15168	g_15169
Super-Scaffold_3	2107759	2107888	129	g_15169	g_36599
Super-Scaffold_3	2108379	2138140	29761	g_36599	g_44153
Super-Scaffold_3	2158686	2201132	42446	g_44153	g_15171
Super-Scaffold_3	2201548	2216039	14491	g_15171	g_15173
Super-Scaffold_3	2240349	2240450	101	g_15173	g_44154
Super-Scaffold_3	2255837	2265546	9709	g_44154	g_44155
Super-Scaffold_3	2271028	2294297	23269	g_44155	g_15174
Super-Scaffold_3	2312700	2313082	382	g_15174	g_15175
Super-Scaffold_3	2318156	2318931	775	g_15175	g_15176
Super-Scaffold_3	2325986	2330795	4809	g_15176	g_44156
Super-Scaffold_3	2381592	2384597	3005	g_44156	g_15177
Super-Scaffold_3	2402367	2461184	58817	g_15177	g_15178
Super-Scaffold_3	2475600	2475817	217	g_15178	g_36602
Super-Scaffold_3	2476419	2486709	10290	g_36602	g_15179
Super-Scaffold_3	2488606	2497670	9064	g_15179	g_15180
Super-Scaffold_3	2508227	2509291	1064	g_15180	g_15181
Super-Scaffold_3	2510022	2529229	19207	g_15181	g_15182
Super-Scaffold_3	2533340	2535398	2058	g_15182	g_15184
Super-Scaffold_3	2537588	2566505	28917	g_15184	g_15185
Super-Scaffold_3	2588485	2604128	15643	g_15185	g_15186
Super-Scaffold_3	2604340	2618893	14553	g_15186	g_15187
Super-Scaffold_3	2619180	2686520	67340	g_15187	g_15188
Super-Scaffold_3	2695079	2695247	168	g_15188	g_15189
Super-Scaffold_3	2695873	2700321	4448	g_15189	g_15190
Super-Scaffold_3	2708787	2722513	13726	g_15190	g_15191
Super-Scaffold_3	2746559	2757526	10967	g_15191	g_15192
Super-Scaffold_3	2759489	2770514	11025	g_15192	g_44157
Super-Scaffold_3	2785037	2793829	8792	g_44157	g_15193
Super-Scaffold_3	2799060	2801524	2464	g_15193	g_15194
Super-Scaffold_3	2809668	2821870	12202	g_15194	g_44158
Super-Scaffold_3	2834525	3039348	204823	g_44158	g_36603
Super-Scaffold_3	3039548	3048357	8809	g_36603	g_15195
Super-Scaffold_3	3055535	3158406	102871	g_15195	g_15196
Super-Scaffold_3	3171075	3176490	5415	g_36604	g_15197
Super-Scaffold_3	3183321	3232187	48866	g_15197	g_15199
Super-Scaffold_3	3232420	3296721	64301	g_15199	g_15202
Super-Scaffold_3	3318458	3420241	101783	g_15202	g_15204
Super-Scaffold_3	3450101	3467711	17610	g_15204	g_15205
Super-Scaffold_3	3496773	3510510	13737	g_15205	g_15206
Super-Scaffold_3	3516383	3528910	12527	g_15206	g_15207
Super-Scaffold_3	3531497	3541370	9873	g_15207	g_44159
Super-Scaffold_3	3548869	3552276	3407	g_44159	g_15208
Super-Scaffold_3	3558598	3568383	9785	g_15208	g_15209
Super-Scaffold_3	3582767	3589331	6564	g_15209	g_15210
Super-Scaffold_3	3597896	3602895	4999	g_15210	g_15211
Super-Scaffold_3	3609211	3617252	8041	g_15211	g_15212
Super-Scaffold_3	3622830	3633082	10252	g_15212	g_15213
Super-Scaffold_3	3641795	3659307	17512	g_15213	g_15215
Super-Scaffold_3	3676869	3700365	23496	g_15215	g_15216
Super-Scaffold_3	3711855	3749085	37230	g_15216	g_15217
Super-Scaffold_3	3765240	3767878	2638	g_15217	g_15218
Super-Scaffold_3	3785692	3808042	22350	g_15218	g_15219
Super-Scaffold_3	3808434	3808828	394	g_15219	g_15220
Super-Scaffold_3	3818908	3821734	2826	g_15220	g_15221
Super-Scaffold_3	3825371	3826495	1124	g_15221	g_15222
Super-Scaffold_3	3846795	3849536	2741	g_15222	g_15223
Super-Scaffold_3	3855813	3881690	25877	g_15223	g_15224
Super-Scaffold_3	3886646	3887457	811	g_15224	g_44160
Super-Scaffold_3	3907492	3908550	1058	g_44160	g_15225
Super-Scaffold_3	3908861	3911398	2537	g_15225	g_15226
Super-Scaffold_3	3911664	4008450	96786	g_15226	g_15232
Super-Scaffold_3	4009220	4071632	62412	g_15232	g_15234
Super-Scaffold_3	4093804	4109790	15986	g_15234	g_15235
Super-Scaffold_3	4115750	4122160	6410	g_15235	g_44161
Super-Scaffold_3	4140139	4145215	5076	g_44161	g_44162
Super-Scaffold_3	4149614	4151162	1548	g_44162	g_44163
Super-Scaffold_3	4158407	4162824	4417	g_44163	g_15236
Super-Scaffold_3	4163024	4184282	21258	g_15236	g_44164
Super-Scaffold_3	4218366	4224278	5912	g_44164	g_15237
Super-Scaffold_3	4241854	4244297	2443	g_15237	g_15238
Super-Scaffold_3	4251803	4253291	1488	g_15238	g_15239
Super-Scaffold_3	4261975	4266339	4364	g_15239	g_15240
Super-Scaffold_3	4283992	4286909	2917	g_15240	g_15241
Super-Scaffold_3	4290770	4296731	5961	g_15241	g_15242
Super-Scaffold_3	4306194	4308614	2420	g_15242	g_15243
Super-Scaffold_3	4316717	4318902	2185	g_15243	g_15244
Super-Scaffold_3	4321553	4391511	69958	g_15244	g_15246
Super-Scaffold_3	4405753	4417593	11840	g_15246	g_15247
Super-Scaffold_3	4432524	4440510	7986	g_15247	g_15248
Super-Scaffold_3	4444208	4460834	16626	g_15248	g_15249
Super-Scaffold_3	4474167	4506967	32800	g_15249	g_15251
Super-Scaffold_3	4510137	4512361	2224	g_15251	g_15252
Super-Scaffold_3	4513179	4624620	111441	g_15252	g_15254
Super-Scaffold_3	4630983	4632516	1533	g_15254	g_15255
Super-Scaffold_3	4638167	4641093	2926	g_15255	g_15256
Super-Scaffold_3	4647705	4668961	21256	g_15256	g_15257
Super-Scaffold_3	4669194	4694546	25352	g_15257	g_15259
Super-Scaffold_3	4703023	4710895	7872	g_15259	g_15260
Super-Scaffold_3	4727816	4769995	42179	g_15260	g_15263
Super-Scaffold_3	4771243	4773861	2618	g_15263	g_15264
Super-Scaffold_3	4779235	4785741	6506	g_15264	g_15265
Super-Scaffold_3	4819771	4830735	10964	g_15265	g_15266
Super-Scaffold_3	4834306	4871304	36998	g_15266	g_36613
Super-Scaffold_3	4872591	4894438	21847	g_15267	g_15268
Super-Scaffold_3	4896480	4903863	7383	g_15268	g_15269
Super-Scaffold_3	4910176	4927527	17351	g_15269	g_15270
Super-Scaffold_3	4932272	4935121	2849	g_15270	g_15271
Super-Scaffold_3	4940217	4941700	1483	g_15271	g_15272
Super-Scaffold_3	4947458	4958125	10667	g_15272	g_15273
Super-Scaffold_3	4961744	4973095	11351	g_15273	g_15274
Super-Scaffold_3	4973301	5020416	47115	g_15274	g_15277
Super-Scaffold_3	5020772	5023307	2535	g_15277	g_15278
Super-Scaffold_3	5023555	5069923	46368	g_15278	g_15279
Super-Scaffold_3	5070144	5111623	41479	g_15279	g_15280
Super-Scaffold_3	5114165	5149023	34858	g_15280	g_15281
Super-Scaffold_3	5154724	5206091	51367	g_15281	g_15283
Super-Scaffold_3	5222257	5265626	43369	g_15283	g_15284
Super-Scaffold_3	5271716	5295182	23466	g_15284	g_15285
Super-Scaffold_3	5304076	5310775	6699	g_15285	g_15286
Super-Scaffold_3	5331123	5340383	9260	g_15286	g_15287
Super-Scaffold_3	5340862	5342793	1931	g_15287	g_44165
Super-Scaffold_3	5356562	5360254	3692	g_44165	g_15288
Super-Scaffold_3	5360872	5361849	977	g_15288	g_15289
Super-Scaffold_3	5367395	5367726	331	g_15289	g_15290
Super-Scaffold_3	5370044	5371062	1018	g_15290	g_15291
Super-Scaffold_3	5375968	5377312	1344	g_15291	g_15292
Super-Scaffold_3	5383824	5386797	2973	g_15292	g_15293
Super-Scaffold_3	5401206	5402887	1681	g_15293	g_44166
Super-Scaffold_3	5413191	5421157	7966	g_44166	g_15294
Super-Scaffold_3	5422767	5432777	10010	g_15294	g_15295
Super-Scaffold_3	5433761	5439837	6076	g_15295	g_15296
Super-Scaffold_3	5440814	5457743	16929	g_15296	g_15297
Super-Scaffold_3	5457943	5475138	17195	g_15297	g_15298
Super-Scaffold_3	5476118	5477081	963	g_15298	g_15299
Super-Scaffold_3	5478052	5480242	2190	g_15299	g_44167
Super-Scaffold_3	5485803	5504578	18775	g_44167	g_15300
Super-Scaffold_3	5518184	5520862	2678	g_15300	g_15301
Super-Scaffold_3	5522596	5549803	27207	g_15301	g_15302
Super-Scaffold_3	5555772	5557842	2070	g_15302	g_15303
Super-Scaffold_3	5562777	5577821	15044	g_15303	g_15305
Super-Scaffold_3	5584240	5592021	7781	g_15305	g_15306
Super-Scaffold_3	5595145	5599388	4243	g_15306	g_15307
Super-Scaffold_3	5613716	5615673	1957	g_15307	g_15308
Super-Scaffold_3	5619708	5631248	11540	g_15308	g_44168
Super-Scaffold_3	5636711	5639143	2432	g_44168	g_15309
Super-Scaffold_3	5642525	5644532	2007	g_15309	g_15310
Super-Scaffold_3	5647301	5648612	1311	g_15310	g_15311
Super-Scaffold_3	5651661	5656019	4358	g_15311	g_15313
Super-Scaffold_3	5658742	5661335	2593	g_15313	g_15314
Super-Scaffold_3	5664004	5667069	3065	g_15314	g_44169
Super-Scaffold_3	5667296	5672584	5288	g_44169	g_15316
Super-Scaffold_3	5685187	5707310	22123	g_15316	g_15317
Super-Scaffold_3	5711845	5715260	3415	g_15317	g_15318
Super-Scaffold_3	5720661	5724324	3663	g_15318	g_15319
Super-Scaffold_3	5732750	5767996	35246	g_15319	g_15321
Super-Scaffold_3	5780151	5783767	3616	g_15321	g_15322
Super-Scaffold_3	5788853	5793311	4458	g_15322	g_44170
Super-Scaffold_3	5800676	5806858	6182	g_44170	g_15323
Super-Scaffold_3	5823227	5825939	2712	g_15323	g_15324
Super-Scaffold_3	5843188	5853299	10111	g_15324	g_15325
Super-Scaffold_3	5859526	5865735	6209	g_15325	g_15327
Super-Scaffold_3	5866289	5866949	660	g_15327	g_15328
Super-Scaffold_3	5887870	5891238	3368	g_15328	g_44171
Super-Scaffold_3	5896840	5901661	4821	g_44171	g_15329
Super-Scaffold_3	5902749	5911308	8559	g_15329	g_15331
Super-Scaffold_3	5916706	5921145	4439	g_15331	g_15333
Super-Scaffold_3	5922233	5928715	6482	g_15333	g_15335
Super-Scaffold_3	5929785	5936296	6511	g_15335	g_15336
Super-Scaffold_3	5937366	5946053	8687	g_15336	g_15337
Super-Scaffold_3	5950414	5954953	4539	g_15337	g_15339
Super-Scaffold_3	5956041	5962715	6674	g_15339	g_15340
Super-Scaffold_3	5970314	5977809	7495	g_15340	g_15341
Super-Scaffold_3	5980275	5985031	4756	g_15341	g_15342
Super-Scaffold_3	5992043	6042207	50164	g_15342	g_15345
Super-Scaffold_3	6060636	6096040	35404	g_15345	g_15347
Super-Scaffold_3	6110636	6116567	5931	g_15347	g_15348
Super-Scaffold_3	6122542	6129262	6720	g_15348	g_15349
Super-Scaffold_3	6131754	6141016	9262	g_15349	g_15350
Super-Scaffold_3	6141243	6142169	926	g_15350	g_15351
Super-Scaffold_3	6161093	6172610	11517	g_15351	g_15353
Super-Scaffold_3	6177757	6179360	1603	g_15353	g_36618
Super-Scaffold_3	6179794	6204473	24679	g_36618	g_15356
Super-Scaffold_3	6208770	6214264	5494	g_15356	g_15357
Super-Scaffold_3	6217091	6234420	17329	g_15357	g_15358
Super-Scaffold_3	6242424	6254980	12556	g_15358	g_44172
Super-Scaffold_3	6258158	6259932	1774	g_44172	g_44173
Super-Scaffold_3	6266490	6282769	16279	g_44173	g_15359
Super-Scaffold_3	6291371	6301359	9988	g_15359	g_44174
Super-Scaffold_3	6305215	6317788	12573	g_44174	g_15360
Super-Scaffold_3	6332876	6349298	16422	g_15360	g_44175
Super-Scaffold_3	6349885	6352677	2792	g_44175	g_15361
Super-Scaffold_3	6364636	6426210	61574	g_15361	g_15363
Super-Scaffold_3	6426809	6451003	24194	g_15363	g_15364
Super-Scaffold_3	6452595	6483866	31271	g_15364	g_15365
Super-Scaffold_3	6485322	6513185	27863	g_15365	g_15367
Super-Scaffold_3	6516667	6556659	39992	g_15367	g_15368
Super-Scaffold_3	6565524	6569957	4433	g_15368	g_15369
Super-Scaffold_3	6573025	6573316	291	g_15369	g_15370
Super-Scaffold_3	6574659	6579667	5008	g_15370	g_15371
Super-Scaffold_3	6588391	6626017	37626	g_15371	g_15372
Super-Scaffold_3	6627676	6648757	21081	g_15372	g_15373
Super-Scaffold_3	6652556	6672965	20409	g_15373	g_15374
Super-Scaffold_3	6694477	6736143	41666	g_15374	g_15375
Super-Scaffold_3	6736346	6815333	78987	g_15375	g_15376
Super-Scaffold_3	6815794	6830467	14673	g_15376	g_15377
Super-Scaffold_3	6831483	6940978	109495	g_15377	g_15378
Super-Scaffold_3	6941694	7000069	58375	g_15378	g_15379
Super-Scaffold_3	7003676	7006720	3044	g_15379	g_15380
Super-Scaffold_3	7009798	7018248	8450	g_15380	g_15381
Super-Scaffold_3	7019394	7037511	18117	g_15381	g_15382
Super-Scaffold_3	7055068	7081204	26136	g_15382	g_15384
Super-Scaffold_3	7082640	7082778	138	g_15384	g_15385
Super-Scaffold_3	7083419	7112575	29156	g_15385	g_15387
Super-Scaffold_3	7115422	7129073	13651	g_15387	g_15388
Super-Scaffold_3	7129423	7157849	28426	g_15388	g_15389
Super-Scaffold_3	7219424	7221571	2147	g_15389	g_15390
Super-Scaffold_3	7229628	7248061	18433	g_15390	g_15391
Super-Scaffold_3	7252471	7261888	9417	g_15391	g_15392
Super-Scaffold_3	7275934	7281453	5519	g_15392	g_15393
Super-Scaffold_3	7287941	7311701	23760	g_15393	g_15395
Super-Scaffold_3	7315619	7323231	7612	g_15395	g_15396
Super-Scaffold_3	7326666	7340643	13977	g_15396	g_15397
Super-Scaffold_3	7354758	7359533	4775	g_15397	g_44176
Super-Scaffold_3	7375465	7388531	13066	g_36623	g_15398
Super-Scaffold_3	7396779	7552517	155738	g_15398	g_15407
Super-Scaffold_3	7560339	7566629	6290	g_15407	g_15408
Super-Scaffold_3	7589770	7596657	6887	g_15408	g_15409
Super-Scaffold_3	7610490	7615473	4983	g_15409	g_15410
Super-Scaffold_3	7621169	7630080	8911	g_15410	g_15411
Super-Scaffold_3	7652445	7677343	24898	g_15411	g_36625
Super-Scaffold_3	7678046	7698957	20911	g_36625	g_36626
Super-Scaffold_3	7699660	7702698	3038	g_36626	g_15412
Super-Scaffold_3	7708117	7710763	2646	g_15412	g_15413
Super-Scaffold_3	7713665	7721912	8247	g_15413	g_15414
Super-Scaffold_3	7736335	7774036	37701	g_15414	g_15415
Super-Scaffold_3	7789216	7792950	3734	g_15415	g_44177
Super-Scaffold_3	7794317	7795226	909	g_44177	g_15416
Super-Scaffold_3	7803467	7805619	2152	g_15416	g_15417
Super-Scaffold_3	7830551	7836335	5784	g_15417	g_15418
Super-Scaffold_3	7838323	7841164	2841	g_15418	g_15419
Super-Scaffold_3	7862708	7866379	3671	g_15419	g_15420
Super-Scaffold_3	7867530	7873019	5489	g_15420	g_15421
Super-Scaffold_3	7881394	7958645	77251	g_15421	g_36633
Super-Scaffold_3	7958851	8028872	70021	g_36633	g_36636
Super-Scaffold_3	8029072	8035171	6099	g_36636	g_36637
Super-Scaffold_3	8035437	8049655	14218	g_36637	g_15432
Super-Scaffold_3	8052010	8052601	591	g_15432	g_15433
Super-Scaffold_3	8054115	8162433	108318	g_15433	g_15437
Super-Scaffold_3	8172792	8175701	2909	g_15437	g_44178
Super-Scaffold_3	8177354	8178853	1499	g_44178	g_44179
Super-Scaffold_3	8182587	8185390	2803	g_44179	g_15438
Super-Scaffold_3	8188605	8192042	3437	g_15438	g_44180
Super-Scaffold_3	8193373	8195844	2471	g_44180	g_15439
Super-Scaffold_3	8199203	8199848	645	g_15439	g_15440
Super-Scaffold_3	8202592	8215841	13249	g_15440	g_15441
Super-Scaffold_3	8221210	8221856	646	g_15441	g_44181
Super-Scaffold_3	8228403	8229565	1162	g_44181	g_15442
Super-Scaffold_3	8230761	8234074	3313	g_15442	g_15443
Super-Scaffold_3	8235294	8260013	24719	g_15443	g_15447
Super-Scaffold_3	8264133	8274498	10365	g_15447	g_15448
Super-Scaffold_3	8277357	8283376	6019	g_15448	g_36641
Super-Scaffold_3	8284021	8287947	3926	g_36641	g_15449
Super-Scaffold_3	8293133	8296455	3322	g_15449	g_15450
Super-Scaffold_3	8306528	8311934	5406	g_15450	g_15451
Super-Scaffold_3	8316003	8328716	12713	g_15451	g_15452
Super-Scaffold_3	8331522	8392258	60736	g_15452	g_15455
Super-Scaffold_3	8394194	8396449	2255	g_44182	g_15456
Super-Scaffold_3	8401957	8402829	872	g_15456	g_15457
Super-Scaffold_3	8406133	8407928	1795	g_15457	g_15458
Super-Scaffold_3	8410228	8413084	2856	g_15458	g_15459
Super-Scaffold_3	8425007	8437185	12178	g_15459	g_15460
Super-Scaffold_3	8437454	8446280	8826	g_15460	g_15463
Super-Scaffold_3	8467359	8474396	7037	g_15463	g_15464
Super-Scaffold_3	8477895	8479315	1420	g_15464	g_44183
Super-Scaffold_3	8489493	8495380	5887	g_44183	g_15465
Super-Scaffold_3	8497843	8498938	1095	g_15465	g_15466
Super-Scaffold_3	8502849	8507806	4957	g_15466	g_15467
Super-Scaffold_3	8509296	8554160	44864	g_15467	g_15470
Super-Scaffold_3	8563487	8572589	9102	g_15470	g_15471
Super-Scaffold_3	8584636	8594588	9952	g_15471	g_44184
Super-Scaffold_3	8598934	8600579	1645	g_44184	g_44185
Super-Scaffold_3	8615733	8848999	233266	g_44185	g_15474
Super-Scaffold_3	8849283	8856555	7272	g_15474	g_15475
Super-Scaffold_3	8859700	8869095	9395	g_15475	g_15476
Super-Scaffold_3	8872056	8881571	9515	g_15476	g_15477
Super-Scaffold_3	8884535	8894944	10409	g_15477	g_15478
Super-Scaffold_3	8897921	8911134	13213	g_15478	g_15480
Super-Scaffold_3	8911631	8919984	8353	g_15480	g_15481
Super-Scaffold_3	8929079	8933230	4151	g_15481	g_15482
Super-Scaffold_3	8936729	8945578	8849	g_15482	g_15483
Super-Scaffold_3	8950110	8951984	1874	g_15483	g_15484
Super-Scaffold_3	8973347	8976548	3201	g_15484	g_15485
Super-Scaffold_3	8977566	8996760	19194	g_15485	g_15488
Super-Scaffold_3	9040176	9047136	6960	g_15488	g_15489
Super-Scaffold_3	9050227	9130707	80480	g_15489	g_15492
Super-Scaffold_3	9135152	9138426	3274	g_15492	g_44186
Super-Scaffold_3	9149826	9156003	6177	g_44186	g_15493
Super-Scaffold_3	9175597	9239634	64037	g_15493	g_15496
Super-Scaffold_3	9243889	9247719	3830	g_15496	g_15497
Super-Scaffold_3	9255309	9258906	3597	g_15497	g_15498
Super-Scaffold_3	9264818	9267508	2690	g_15498	g_15499
Super-Scaffold_3	9288716	9297858	9142	g_15499	g_15501
Super-Scaffold_3	9310056	9312679	2623	g_15501	g_15502
Super-Scaffold_3	9314638	9353168	38530	g_15502	g_15504
Super-Scaffold_3	9357022	9361804	4782	g_15504	g_44187
Super-Scaffold_3	9367109	9370569	3460	g_44187	g_15505
Super-Scaffold_3	9383192	9386951	3759	g_15505	g_15506
Super-Scaffold_3	9388289	9392098	3809	g_15506	g_15507
Super-Scaffold_3	9405203	9424491	19288	g_15507	g_15508
Super-Scaffold_3	9426221	9435540	9319	g_15508	g_15511
Super-Scaffold_3	9453557	9457746	4189	g_15511	g_15512
Super-Scaffold_3	9468696	9480867	12171	g_15512	g_15513
Super-Scaffold_3	9487581	9493106	5525	g_15513	g_15514
Super-Scaffold_3	9495845	9496034	189	g_15514	g_44188
Super-Scaffold_3	9498581	9519807	21226	g_44188	g_15515
Super-Scaffold_3	9536310	9549429	13119	g_15515	g_15516
Super-Scaffold_3	9552252	9556630	4378	g_15516	g_15517
Super-Scaffold_3	9558021	9571371	13350	g_15517	g_15518
Super-Scaffold_3	9574698	9580069	5371	g_15518	g_44189
Super-Scaffold_3	9596150	9649343	53193	g_44189	g_15520
Super-Scaffold_3	9654147	9660350	6203	g_15520	g_15521
Super-Scaffold_3	9671603	9686462	14859	g_15521	g_15522
Super-Scaffold_3	9699407	9699489	82	g_15522	g_15523
Super-Scaffold_3	9699749	9701202	1453	g_15523	g_15524
Super-Scaffold_3	9701447	9706118	4671	g_15524	g_15525
Super-Scaffold_3	9709982	9711581	1599	g_15525	g_15526
Super-Scaffold_3	9727689	9730452	2763	g_15526	g_44190
Super-Scaffold_3	9735163	9740855	5692	g_44190	g_15527
Super-Scaffold_3	9742366	9788337	45971	g_15527	g_36654
Super-Scaffold_3	9788582	9871961	83379	g_36654	g_15529
Super-Scaffold_3	9872194	10026436	154242	g_15529	g_15532
Super-Scaffold_3	10026645	10088072	61427	g_15532	g_15533
Super-Scaffold_3	10088380	10176100	87720	g_15533	g_15537
Super-Scaffold_3	10185618	10189817	4199	g_15537	g_15538
Super-Scaffold_3	10192125	10200968	8843	g_15538	g_15539
Super-Scaffold_3	10207388	10209868	2480	g_15539	g_44191
Super-Scaffold_3	10212267	10216128	3861	g_44191	g_15540
Super-Scaffold_3	10220233	10221088	855	g_15540	g_15541
Super-Scaffold_3	10221880	10222054	174	g_15541	g_15542
Super-Scaffold_3	10223307	10233533	10226	g_15542	g_15543
Super-Scaffold_3	10242079	10259506	17427	g_15543	g_15545
Super-Scaffold_3	10259760	10281601	21841	g_15545	g_15546
Super-Scaffold_3	10283921	10285591	1670	g_15546	g_15547
Super-Scaffold_3	10289714	10292302	2588	g_15547	g_15548
Super-Scaffold_3	10298655	10317515	18860	g_15548	g_15550
Super-Scaffold_3	10323211	10325692	2481	g_15550	g_15551
Super-Scaffold_3	10329074	10334812	5738	g_15551	g_15552
Super-Scaffold_3	10337644	10348689	11045	g_15552	g_15553
Super-Scaffold_3	10351952	10372964	21012	g_15553	g_15554
Super-Scaffold_3	10378858	10394389	15531	g_15554	g_15556
Super-Scaffold_3	10399741	10404730	4989	g_15556	g_36665
Super-Scaffold_3	10404978	10405078	100	g_36665	g_15557
Super-Scaffold_3	10413715	10418046	4331	g_15557	g_44192
Super-Scaffold_3	10418246	10420892	2646	g_44192	g_15558
Super-Scaffold_3	10429389	10436393	7004	g_15558	g_15559
Super-Scaffold_3	10437536	10438913	1377	g_15559	g_15560
Super-Scaffold_3	10439161	10439223	62	g_15560	g_15561
Super-Scaffold_3	10442113	10444444	2331	g_15561	g_15562
Super-Scaffold_3	10445181	10449375	4194	g_15562	g_15563
Super-Scaffold_3	10468218	10497750	29532	g_15563	g_36666
Super-Scaffold_3	10498058	10537181	39123	g_36666	g_15566
Super-Scaffold_3	10537444	10543356	5912	g_15566	g_15567
Super-Scaffold_3	10573969	10580177	6208	g_15567	g_15568
Super-Scaffold_3	10600090	10610070	9980	g_15568	g_15569
Super-Scaffold_3	10612189	10629061	16872	g_15569	g_15570
Super-Scaffold_3	10635408	10636454	1046	g_15570	g_15571
Super-Scaffold_3	10640418	10640969	551	g_15571	g_15572
Super-Scaffold_3	10644354	10676067	31713	g_15572	g_15574
Super-Scaffold_3	10685863	10724895	39032	g_15574	g_15575
Super-Scaffold_3	10744142	10760342	16200	g_15575	g_15576
Super-Scaffold_3	10764354	10765526	1172	g_15576	g_44193
Super-Scaffold_3	10769429	10772423	2994	g_44193	g_15577
Super-Scaffold_3	10780157	10781689	1532	g_15577	g_15578
Super-Scaffold_3	10782336	10793266	10930	g_15578	g_15579
Super-Scaffold_3	10817648	10821871	4223	g_15579	g_15580
Super-Scaffold_3	10833809	10837688	3879	g_15580	g_15581
Super-Scaffold_3	10842612	10846543	3931	g_15581	g_44194
Super-Scaffold_3	10852810	10855067	2257	g_44194	g_44195
Super-Scaffold_3	10858321	10860179	1858	g_44195	g_15582
Super-Scaffold_3	10861413	10862072	659	g_15582	g_44196
Super-Scaffold_3	10864957	10866115	1158	g_44196	g_15583
Super-Scaffold_3	10888415	10889758	1343	g_15583	g_15584
Super-Scaffold_3	10893033	10986849	93816	g_15584	g_15588
Super-Scaffold_3	10987568	11004143	16575	g_15588	g_36673
Super-Scaffold_3	11004394	11029355	24961	g_36673	g_15589
Super-Scaffold_3	11030589	11037542	6953	g_15589	g_15590
Super-Scaffold_3	11041396	11043907	2511	g_15590	g_15591
Super-Scaffold_3	11045810	11049389	3579	g_15591	g_15592
Super-Scaffold_3	11059870	11064080	4210	g_15592	g_15593
Super-Scaffold_3	11065192	11069087	3895	g_15593	g_15594
Super-Scaffold_3	11077033	11078669	1636	g_15594	g_15595
Super-Scaffold_3	11081126	11083158	2032	g_15595	g_15596
Super-Scaffold_3	11085656	11087687	2031	g_15596	g_15597
Super-Scaffold_3	11090183	11100854	10671	g_15597	g_15598
Super-Scaffold_3	11103460	11106599	3139	g_15598	g_15599
Super-Scaffold_3	11112744	11124627	11883	g_15599	g_15600
Super-Scaffold_3	11127559	11133940	6381	g_15600	g_15601
Super-Scaffold_3	11139652	11141724	2072	g_15601	g_15602
Super-Scaffold_3	11148268	11149842	1574	g_15602	g_15603
Super-Scaffold_3	11153052	11158114	5062	g_15603	g_15604
Super-Scaffold_3	11163615	11167278	3663	g_15604	g_15605
Super-Scaffold_3	11176460	11201374	24914	g_15605	g_15606
Super-Scaffold_3	11201766	11229354	27588	g_15606	g_15607
Super-Scaffold_3	11230412	11234619	4207	g_15607	g_15608
Super-Scaffold_3	11240263	11315096	74833	g_15608	g_15610
Super-Scaffold_3	11315413	11331909	16496	g_15610	g_15611
Super-Scaffold_3	11335349	11339644	4295	g_15611	g_15612
Super-Scaffold_3	11346461	11349242	2781	g_15612	g_15613
Super-Scaffold_3	11351429	11354666	3237	g_15613	g_44197
Super-Scaffold_3	11358686	11370120	11434	g_44197	g_15614
Super-Scaffold_3	11378336	11424770	46434	g_15614	g_15615
Super-Scaffold_3	11430643	11434750	4107	g_15615	g_15616
Super-Scaffold_3	11436174	11442485	6311	g_15616	g_15617
Super-Scaffold_3	11447555	11449914	2359	g_15617	g_15618
Super-Scaffold_3	11458020	11461012	2992	g_15618	g_15619
Super-Scaffold_3	11462300	11465800	3500	g_15619	g_15620
Super-Scaffold_3	11466369	11470338	3969	g_15620	g_15621
Super-Scaffold_3	11471549	11472779	1230	g_15621	g_15622
Super-Scaffold_3	11475741	11480420	4679	g_15622	g_15623
Super-Scaffold_3	11489266	11492792	3526	g_15623	g_15624
Super-Scaffold_3	11498147	11499078	931	g_15624	g_15625
Super-Scaffold_3	11502442	11503689	1247	g_15625	g_44198
Super-Scaffold_3	11506455	11507742	1287	g_44198	g_15626
Super-Scaffold_3	11512318	11515866	3548	g_15626	g_44199
Super-Scaffold_3	11522622	11535744	13122	g_44199	g_15627
Super-Scaffold_3	11547576	11584498	36922	g_15627	g_15629
Super-Scaffold_3	11586440	11587870	1430	g_15629	g_15630
Super-Scaffold_3	11592043	11595099	3056	g_15630	g_15631
Super-Scaffold_3	11607048	11612987	5939	g_15631	g_15632
Super-Scaffold_3	11634404	11636664	2260	g_15632	g_44200
Super-Scaffold_3	11655964	11661012	5048	g_44200	g_15633
Super-Scaffold_3	11679766	11685625	5859	g_15633	g_15634
Super-Scaffold_3	11685864	11710236	24372	g_15634	g_15635
Super-Scaffold_3	11714064	11788330	74266	g_15635	g_15637
Super-Scaffold_3	11788845	11814563	25718	g_15637	g_15638
Super-Scaffold_3	11815900	11823344	7444	g_15638	g_15639
Super-Scaffold_3	11835785	11854038	18253	g_15639	g_15641
Super-Scaffold_3	11856650	11858571	1921	g_15641	g_44201
Super-Scaffold_3	11883759	11885270	1511	g_44201	g_15642
Super-Scaffold_3	11886479	11888541	2062	g_15642	g_44202
Super-Scaffold_3	11895269	11924602	29333	g_44202	g_15645
Super-Scaffold_3	11925288	11960456	35168	g_15645	g_15647
Super-Scaffold_3	11960764	11978962	18198	g_15647	g_15648
Super-Scaffold_3	11983918	11986732	2814	g_15648	g_15649
Super-Scaffold_3	11990335	12063521	73186	g_15649	g_15651
Super-Scaffold_3	12073079	12077480	4401	g_15651	g_15652
Super-Scaffold_3	12110987	12125141	14154	g_15652	g_15653
Super-Scaffold_3	12135164	12155637	20473	g_15653	g_44203
Super-Scaffold_3	12157006	12179749	22743	g_44203	g_36684
Super-Scaffold_3	12180225	12197293	17068	g_36684	g_15658
Super-Scaffold_3	12210843	12218938	8095	g_15658	g_15659
Super-Scaffold_3	12230524	12299571	69047	g_15659	g_15662
Super-Scaffold_3	12311615	12316106	4491	g_15662	g_15663
Super-Scaffold_3	12317841	12383237	65396	g_15663	g_15665
Super-Scaffold_3	12386751	12395878	9127	g_15665	g_15666
Super-Scaffold_3	12403623	12432189	28566	g_15666	g_15667
Super-Scaffold_3	12456318	12528625	72307	g_15667	g_36686
Super-Scaffold_3	12529002	12594820	65818	g_36686	g_44204
Super-Scaffold_3	12596086	12597623	1537	g_15668	g_15669
Super-Scaffold_3	12608823	12671111	62288	g_15669	g_15670
Super-Scaffold_3	12673231	12676695	3464	g_15670	g_15671
Super-Scaffold_3	12679611	12719377	39766	g_15671	g_15674
Super-Scaffold_3	12720570	12735079	14509	g_15674	g_15676
Super-Scaffold_3	12735360	12873838	138478	g_15676	g_15682
Super-Scaffold_3	12874969	12896328	21359	g_15682	g_36693
Super-Scaffold_3	12896684	12898912	2228	g_36693	g_15685
Super-Scaffold_3	12899202	12913805	14603	g_15685	g_15686
Super-Scaffold_3	12921543	12923995	2452	g_15686	g_44205
Super-Scaffold_3	12926180	12936468	10288	g_44205	g_15687
Super-Scaffold_3	12940869	12946423	5554	g_15687	g_15688
Super-Scaffold_3	12972292	12976391	4099	g_15688	g_15689
Super-Scaffold_3	12989120	12989865	745	g_15689	g_44206
Super-Scaffold_3	13000778	13004111	3333	g_44206	g_15690
Super-Scaffold_3	13010536	13015993	5457	g_15690	g_15691
Super-Scaffold_3	13017822	13034839	17017	g_15691	g_15692
Super-Scaffold_3	13036318	13041736	5418	g_15692	g_15693
Super-Scaffold_3	13042038	13052205	10167	g_15693	g_15694
Super-Scaffold_3	13062059	13086397	24338	g_15694	g_15695
Super-Scaffold_3	13092459	13106812	14353	g_15695	g_15696
Super-Scaffold_3	13112729	13132256	19527	g_15696	g_15697
Super-Scaffold_3	13132591	13134534	1943	g_15697	g_15698
Super-Scaffold_3	13135996	13138691	2695	g_15698	g_44207
Super-Scaffold_3	13141849	13153808	11959	g_44207	g_44208
Super-Scaffold_3	13155284	13157165	1881	g_44208	g_15699
Super-Scaffold_3	13163931	13168270	4339	g_15699	g_15700
Super-Scaffold_3	13183978	13209801	25823	g_15700	g_15701
Super-Scaffold_3	13217263	13229875	12612	g_15701	g_15702
Super-Scaffold_3	13240458	13241374	916	g_15702	g_15703
Super-Scaffold_3	13244838	13248750	3912	g_15703	g_15704
Super-Scaffold_3	13258464	13260548	2084	g_15704	g_15705
Super-Scaffold_3	13272945	13275758	2813	g_15705	g_15706
Super-Scaffold_3	13279676	13282192	2516	g_15706	g_15707
Super-Scaffold_3	13283987	13284398	411	g_15707	g_15708
Super-Scaffold_3	13285687	13303261	17574	g_15708	g_15709
Super-Scaffold_3	13318700	13323406	4706	g_15709	g_15710
Super-Scaffold_3	13325587	13327576	1989	g_15710	g_15711
Super-Scaffold_3	13333300	13333989	689	g_15711	g_15712
Super-Scaffold_3	13340714	13379798	39084	g_15712	g_15715
Super-Scaffold_3	13380064	13437927	57863	g_15715	g_15716
Super-Scaffold_3	13439033	13588819	149786	g_15716	g_15717
Super-Scaffold_3	13594304	13599996	5692	g_15717	g_15718
Super-Scaffold_3	13611744	13614221	2477	g_15718	g_15719
Super-Scaffold_3	13617328	13618262	934	g_15719	g_15720
Super-Scaffold_3	13628650	13630102	1452	g_15720	g_15721
Super-Scaffold_3	13633133	13637252	4119	g_15721	g_15722
Super-Scaffold_3	13643102	13650639	7537	g_15722	g_44209
Super-Scaffold_3	13668066	13679646	11580	g_44209	g_15723
Super-Scaffold_3	13680002	13692765	12763	g_15723	g_15724
Super-Scaffold_3	13727500	13747284	19784	g_15724	g_15725
Super-Scaffold_3	13756424	13795289	38865	g_15725	g_15726
Super-Scaffold_3	13801799	13829194	27395	g_15726	g_15727
Super-Scaffold_3	13842273	13846579	4306	g_15727	g_15728
Super-Scaffold_3	13850911	13954081	103170	g_15728	g_15730
Super-Scaffold_3	13964416	13970815	6399	g_15730	g_15731
Super-Scaffold_3	13981744	13982169	425	g_15731	g_15732
Super-Scaffold_3	13982964	13984883	1919	g_15732	g_15733
Super-Scaffold_3	13991418	14002396	10978	g_15733	g_15734
Super-Scaffold_3	14013841	14016711	2870	g_15734	g_15735
Super-Scaffold_3	14023655	14026178	2523	g_15735	g_15736
Super-Scaffold_3	14030719	14032301	1582	g_15736	g_15737
Super-Scaffold_3	14040588	14043568	2980	g_15737	g_15738
Super-Scaffold_3	14044977	14047527	2550	g_15738	g_44210
Super-Scaffold_3	14053647	14054865	1218	g_44210	g_15739
Super-Scaffold_3	14060796	14062480	1684	g_15739	g_44211
Super-Scaffold_3	14072202	14077226	5024	g_44211	g_15740
Super-Scaffold_3	14085510	14143138	57628	g_15740	g_15742
Super-Scaffold_3	14144601	14146092	1491	g_15742	g_44212
Super-Scaffold_3	14150095	14154421	4326	g_44212	g_15743
Super-Scaffold_3	14157871	14169518	11647	g_15743	g_15744
Super-Scaffold_3	14170393	14233853	63460	g_15744	g_15745
Super-Scaffold_3	14235448	14247287	11839	g_15745	g_15746
Super-Scaffold_3	14247535	14248538	1003	g_15746	g_15747
Super-Scaffold_3	14250040	14280422	30382	g_15747	g_15748
Super-Scaffold_3	14282164	14293837	11673	g_15748	g_15749
Super-Scaffold_3	14296753	14299699	2946	g_15749	g_15750
Super-Scaffold_3	14302964	14309656	6692	g_15750	g_15751
Super-Scaffold_3	14310628	14311406	778	g_15751	g_44213
Super-Scaffold_3	14314270	14315616	1346	g_44213	g_15752
Super-Scaffold_3	14337554	14366969	29415	g_15752	g_15754
Super-Scaffold_3	14369275	14370646	1371	g_15754	g_15755
Super-Scaffold_3	14371867	14391458	19591	g_15755	g_15756
Super-Scaffold_3	14402787	14408653	5866	g_15756	g_15757
Super-Scaffold_3	14425102	14428342	3240	g_15757	g_15758
Super-Scaffold_3	14436436	14437603	1167	g_15758	g_44214
Super-Scaffold_3	14444075	14450174	6099	g_44214	g_15759
Super-Scaffold_3	14451893	14461729	9836	g_15759	g_15760
Super-Scaffold_3	14462160	14469407	7247	g_15760	g_15761
Super-Scaffold_3	14473572	14478678	5106	g_15761	g_15762
Super-Scaffold_3	14481631	14537852	56221	g_15762	g_15763
Super-Scaffold_3	14563837	14566666	2829	g_15763	g_15764
Super-Scaffold_3	14581257	14586181	4924	g_15764	g_44215
Super-Scaffold_3	14596888	14598055	1167	g_44215	g_15765
Super-Scaffold_3	14600564	14603143	2579	g_15765	g_15766
Super-Scaffold_3	14607074	14608453	1379	g_15766	g_44216
Super-Scaffold_3	14610903	14615924	5021	g_44216	g_15767
Super-Scaffold_3	14616877	14619269	2392	g_15767	g_15768
Super-Scaffold_3	14621310	14640742	19432	g_15768	g_36702
Super-Scaffold_3	14640942	14641325	383	g_36702	g_15769
Super-Scaffold_3	14650029	14663443	13414	g_15769	g_15770
Super-Scaffold_3	14673386	14675486	2100	g_15770	g_44217
Super-Scaffold_3	14684416	14686406	1990	g_44217	g_15771
Super-Scaffold_3	14690397	14712101	21704	g_15771	g_44218
Super-Scaffold_3	14712355	14734441	22086	g_44218	g_15773
Super-Scaffold_3	14734716	14932485	197769	g_15773	g_15775
Super-Scaffold_3	14933474	14934919	1445	g_15775	g_44219
Super-Scaffold_3	14938208	14941681	3473	g_44219	g_15776
Super-Scaffold_3	14943845	14955463	11618	g_15776	g_15777
Super-Scaffold_3	14959207	14966324	7117	g_15777	g_15778
Super-Scaffold_3	14968579	14970196	1617	g_15778	g_15779
Super-Scaffold_3	14972592	14973922	1330	g_15779	g_15780
Super-Scaffold_3	14977718	15018531	40813	g_15780	g_15784
Super-Scaffold_3	15022816	15032647	9831	g_15784	g_15785
Super-Scaffold_3	15034763	15043398	8635	g_15785	g_15786
Super-Scaffold_3	15044698	15054120	9422	g_15786	g_15787
Super-Scaffold_3	15056045	15057729	1684	g_15787	g_15788
Super-Scaffold_3	15058892	15069438	10546	g_15788	g_15789
Super-Scaffold_3	15071511	15075844	4333	g_15789	g_44220
Super-Scaffold_3	15077679	15084673	6994	g_44220	g_15790
Super-Scaffold_3	15084885	15085667	782	g_15790	g_44221
Super-Scaffold_3	15088392	15096643	8251	g_44221	g_15791
Super-Scaffold_3	15098916	15110004	11088	g_15791	g_15792
Super-Scaffold_3	15111914	15119733	7819	g_15792	g_44222
Super-Scaffold_3	15122899	15148591	25692	g_44222	g_15793
Super-Scaffold_3	15151584	15169770	18186	g_15793	g_15794
Super-Scaffold_3	15179438	15186821	7383	g_15794	g_15795
Super-Scaffold_3	15196307	15216701	20394	g_15795	g_15796
Super-Scaffold_3	15216907	15220072	3165	g_15796	g_15797
Super-Scaffold_3	15220500	15238032	17532	g_15797	g_15798
Super-Scaffold_3	15238286	15240148	1862	g_15798	g_15799
Super-Scaffold_3	15245047	15247977	2930	g_15799	g_15800
Super-Scaffold_3	15249248	15250832	1584	g_36707	g_15801
Super-Scaffold_3	15254500	15256720	2220	g_15801	g_15802
Super-Scaffold_3	15263154	15267076	3922	g_15802	g_15803
Super-Scaffold_3	15282245	15345045	62800	g_15803	g_15805
Super-Scaffold_3	15346082	15347537	1455	g_15805	g_15806
Super-Scaffold_3	15371114	15376072	4958	g_15806	g_15807
Super-Scaffold_3	15389947	15408003	18056	g_15807	g_15809
Super-Scaffold_3	15421212	15425048	3836	g_15809	g_15810
Super-Scaffold_3	15425368	15427943	2575	g_15810	g_15811
Super-Scaffold_3	15435433	15437291	1858	g_15811	g_36710
Super-Scaffold_3	15450007	15451729	1722	g_15812	g_15813
Super-Scaffold_3	15451980	15454587	2607	g_15813	g_15814
Super-Scaffold_3	15455639	15460946	5307	g_15814	g_15815
Super-Scaffold_3	15463115	15466401	3286	g_15815	g_15816
Super-Scaffold_3	15469396	15482579	13183	g_15816	g_15819
Super-Scaffold_3	15486108	15488485	2377	g_15819	g_15820
Super-Scaffold_3	15489763	15493352	3589	g_15820	g_15821
Super-Scaffold_3	15505186	15556242	51056	g_15821	g_15822
Super-Scaffold_3	15563396	15572571	9175	g_15822	g_15823
Super-Scaffold_3	15578372	15578587	215	g_15823	g_15824
Super-Scaffold_3	15578886	15587756	8870	g_15824	g_15825
Super-Scaffold_3	15589773	15597141	7368	g_15825	g_15826
Super-Scaffold_3	15598682	15622504	23822	g_15826	g_15827
Super-Scaffold_3	15638579	15642139	3560	g_15827	g_15828
Super-Scaffold_3	15643626	15663486	19860	g_15828	g_15830
Super-Scaffold_3	15669165	15672578	3413	g_15830	g_15831
Super-Scaffold_3	15677009	15682875	5866	g_15831	g_15832
Super-Scaffold_3	15686276	15687447	1171	g_15832	g_15833
Super-Scaffold_3	15688674	15706898	18224	g_15833	g_15834
Super-Scaffold_3	15727978	15768761	40783	g_15834	g_15835
Super-Scaffold_3	15772413	15779462	7049	g_15835	g_15836
Super-Scaffold_3	15780529	15792285	11756	g_15836	g_15837
Super-Scaffold_3	15800131	15804387	4256	g_15837	g_15838
Super-Scaffold_3	15812330	15832553	20223	g_15838	g_15840
Super-Scaffold_3	15834509	15837231	2722	g_15840	g_15841
Super-Scaffold_3	15856914	15859289	2375	g_15841	g_15842
Super-Scaffold_3	15868459	15869510	1051	g_15842	g_15843
Super-Scaffold_3	15872594	15875420	2826	g_15843	g_15844
Super-Scaffold_3	15895422	16003619	108197	g_15844	g_15848
Super-Scaffold_3	16003945	16023788	19843	g_15848	g_15849
Super-Scaffold_3	16024042	16030465	6423	g_15849	g_15850
Super-Scaffold_3	16035210	16038360	3150	g_15850	g_15851
Super-Scaffold_3	16043125	16074650	31525	g_15851	g_15852
Super-Scaffold_3	16078998	16092488	13490	g_15852	g_15853
Super-Scaffold_3	16095220	16103428	8208	g_15853	g_15854
Super-Scaffold_3	16110519	16113758	3239	g_15854	g_15855
Super-Scaffold_3	16115867	16117782	1915	g_15855	g_15856
Super-Scaffold_3	16125157	16126688	1531	g_15856	g_15857
Super-Scaffold_3	16130412	16131613	1201	g_15857	g_15858
Super-Scaffold_3	16138174	16143752	5578	g_15858	g_15859
Super-Scaffold_3	16156644	16161785	5141	g_15859	g_36718
Super-Scaffold_3	16162039	16172803	10764	g_36718	g_15860
Super-Scaffold_3	16173759	16189033	15274	g_15860	g_15861
Super-Scaffold_3	16199226	16199329	103	g_15861	g_44223
Super-Scaffold_3	16199535	16206027	6492	g_44223	g_15862
Super-Scaffold_3	16213714	16228350	14636	g_15862	g_15863
Super-Scaffold_3	16230289	16233143	2854	g_15863	g_15864
Super-Scaffold_3	16235997	16239794	3797	g_15864	g_15865
Super-Scaffold_3	16245099	16248567	3468	g_15865	g_15866
Super-Scaffold_3	16249852	16253717	3865	g_15866	g_15867
Super-Scaffold_3	16259913	16278498	18585	g_15867	g_15868
Super-Scaffold_3	16280513	16338380	57867	g_15868	g_15871
Super-Scaffold_3	16340111	16340209	98	g_15871	g_44224
Super-Scaffold_3	16364228	16370194	5966	g_44224	g_15872
Super-Scaffold_3	16370472	16374207	3735	g_15872	g_15873
Super-Scaffold_3	16374509	16378626	4117	g_15873	g_15874
Super-Scaffold_3	16382702	16386539	3837	g_15874	g_15875
Super-Scaffold_3	16408638	16434066	25428	g_15875	g_15876
Super-Scaffold_3	16443411	16452772	9361	g_15876	g_15878
Super-Scaffold_3	16454266	16459041	4775	g_15878	g_15879
Super-Scaffold_3	16470173	16473160	2987	g_15879	g_15880
Super-Scaffold_3	16482792	16490830	8038	g_15880	g_15881
Super-Scaffold_3	16495453	16499551	4098	g_15881	g_15882
Super-Scaffold_3	16507726	16511746	4020	g_15882	g_15883
Super-Scaffold_3	16517190	16519599	2409	g_15883	g_15884
Super-Scaffold_3	16522693	16523906	1213	g_15884	g_15885
Super-Scaffold_3	16528174	16529306	1132	g_15885	g_15886
Super-Scaffold_3	16531654	16533319	1665	g_15886	g_15887
Super-Scaffold_3	16538511	16540450	1939	g_15887	g_15888
Super-Scaffold_3	16545873	16552892	7019	g_15888	g_15891
Super-Scaffold_3	16556226	16561535	5309	g_15891	g_15892
Super-Scaffold_3	16584399	16585117	718	g_15892	g_15893
Super-Scaffold_3	16586134	16586970	836	g_15893	g_15894
Super-Scaffold_3	16598026	16600723	2697	g_15894	g_15895
Super-Scaffold_3	16610685	16612970	2285	g_15895	g_15896
Super-Scaffold_3	16624688	16626638	1950	g_15896	g_15897
Super-Scaffold_3	16629310	16651435	22125	g_15897	g_15898
Super-Scaffold_3	16669374	16722474	53100	g_15898	g_15900
Super-Scaffold_3	16722701	16730817	8116	g_15900	g_15901
Super-Scaffold_3	16733313	16775509	42196	g_15901	g_15902
Super-Scaffold_3	16778195	16793591	15396	g_15902	g_15903
Super-Scaffold_3	16797687	16800658	2971	g_15903	g_15904
Super-Scaffold_3	16811984	16813546	1562	g_15904	g_15905
Super-Scaffold_3	16815506	16816689	1183	g_15905	g_15906
Super-Scaffold_3	16819248	16820978	1730	g_15906	g_44225
Super-Scaffold_3	16822627	16825292	2665	g_44225	g_15907
Super-Scaffold_3	16827441	16836584	9143	g_15907	g_15908
Super-Scaffold_3	16848530	16856540	8010	g_15908	g_15909
Super-Scaffold_3	16859092	16862426	3334	g_15909	g_15910
Super-Scaffold_3	16869177	16871101	1924	g_15910	g_15911
Super-Scaffold_3	16871316	16892282	20966	g_15911	g_15913
Super-Scaffold_3	16892542	16893998	1456	g_15913	g_44226
Super-Scaffold_3	16905003	16929905	24902	g_44226	g_15914
Super-Scaffold_3	16948973	16961809	12836	g_15914	g_15915
Super-Scaffold_3	16963728	16966135	2407	g_15915	g_15916
Super-Scaffold_3	16980938	16983559	2621	g_15916	g_15917
Super-Scaffold_3	16990495	16992511	2016	g_15917	g_15918
Super-Scaffold_3	16994333	16996618	2285	g_15918	g_15919
Super-Scaffold_3	17010777	17015237	4460	g_15919	g_15920
Super-Scaffold_3	17017860	17020515	2655	g_15920	g_15921
Super-Scaffold_3	17025432	17030932	5500	g_15921	g_15922
Super-Scaffold_3	17032476	17045397	12921	g_15922	g_36728
Super-Scaffold_3	17046062	17060419	14357	g_36728	g_15924
Super-Scaffold_3	17061837	17067138	5301	g_15924	g_15925
Super-Scaffold_3	17080095	17086334	6239	g_15925	g_15926
Super-Scaffold_3	17092180	17117887	25707	g_15926	g_15927
Super-Scaffold_3	17139345	17141937	2592	g_15927	g_15928
Super-Scaffold_3	17145720	17146450	730	g_15928	g_15929
Super-Scaffold_3	17154227	17155764	1537	g_15929	g_15930
Super-Scaffold_3	17159844	17162167	2323	g_15930	g_15931
Super-Scaffold_3	17167282	17169189	1907	g_15931	g_15932
Super-Scaffold_3	17170859	17171424	565	g_15932	g_15933
Super-Scaffold_3	17174267	17175265	998	g_15933	g_15934
Super-Scaffold_3	17177368	17179175	1807	g_15934	g_15935
Super-Scaffold_3	17182847	17191108	8261	g_15935	g_15936
Super-Scaffold_3	17198180	17202844	4664	g_15936	g_15937
Super-Scaffold_3	17206318	17215891	9573	g_15937	g_44227
Super-Scaffold_3	17218013	17234715	16702	g_44227	g_15939
Super-Scaffold_3	17241641	17246290	4649	g_15939	g_15940
Super-Scaffold_3	17254492	17255463	971	g_15940	g_15941
Super-Scaffold_3	17259957	17267850	7893	g_15941	g_15942
Super-Scaffold_3	17274860	17329444	54584	g_15942	g_15943
Super-Scaffold_3	17329827	17360403	30576	g_15943	g_15945
Super-Scaffold_3	17377206	17379936	2730	g_15945	g_15946
Super-Scaffold_3	17396070	17428852	32782	g_15946	g_36737
Super-Scaffold_3	17429112	17458895	29783	g_36737	g_15952
Super-Scaffold_3	17459251	17489447	30196	g_15952	g_15954
Super-Scaffold_3	17508035	17511120	3085	g_15954	g_15955
Super-Scaffold_3	17520188	17528215	8027	g_15955	g_44228
Super-Scaffold_3	17540622	17542631	2009	g_44228	g_15956
Super-Scaffold_3	17547995	17565655	17660	g_15956	g_15957
Super-Scaffold_3	17565888	17578849	12961	g_15957	g_15958
Super-Scaffold_3	17579259	17601870	22611	g_15958	g_15959
Super-Scaffold_3	17603077	17640071	36994	g_15959	g_15963
Super-Scaffold_3	17640856	17643829	2973	g_15963	g_15964
Super-Scaffold_3	17654658	17658989	4331	g_15964	g_15965
Super-Scaffold_3	17659336	17660542	1206	g_15965	g_15966
Super-Scaffold_3	17679348	17689769	10421	g_15967	g_15968
Super-Scaffold_3	17693240	17750227	56987	g_15968	g_15970
Super-Scaffold_3	17772388	17777994	5606	g_15970	g_15971
Super-Scaffold_3	17779310	17780894	1584	g_15971	g_15972
Super-Scaffold_3	17785217	17787767	2550	g_15972	g_15973
Super-Scaffold_3	17789209	17790852	1643	g_15973	g_15974
Super-Scaffold_3	17807773	17824306	16533	g_15974	g_15975
Super-Scaffold_3	17844229	17848354	4125	g_15975	g_44229
Super-Scaffold_3	17867543	17871839	4296	g_44229	g_15976
Super-Scaffold_3	17877842	17880594	2752	g_15976	g_15977
Super-Scaffold_3	17882744	17888257	5513	g_15977	g_15978
Super-Scaffold_3	17892851	17962556	69705	g_15978	g_15979
Super-Scaffold_3	17962822	18111263	148441	g_15979	g_15981
Super-Scaffold_3	18131405	18156230	24825	g_15981	g_15982
Super-Scaffold_3	18159623	18163241	3618	g_15982	g_15983
Super-Scaffold_3	18167306	18187661	20355	g_15983	g_15984
Super-Scaffold_3	18190973	18192648	1675	g_15984	g_15985
Super-Scaffold_3	18204893	18209971	5078	g_15985	g_44230
Super-Scaffold_3	18236942	18237576	634	g_44230	g_36749
Super-Scaffold_3	18237797	18240244	2447	g_36749	g_15986
Super-Scaffold_3	18240564	18518250	277686	g_15986	g_15991
Super-Scaffold_3	18518531	18539231	20700	g_15991	g_15993
Super-Scaffold_3	18539651	18546881	7230	g_15993	g_15994
Super-Scaffold_3	18550938	18552612	1674	g_15994	g_15995
Super-Scaffold_3	18554716	18555939	1223	g_15995	g_15996
Super-Scaffold_3	18556862	18558532	1670	g_15996	g_15997
Super-Scaffold_3	18559055	18559130	75	g_15997	g_15998
Super-Scaffold_3	18581808	18582840	1032	g_15998	g_15999
Super-Scaffold_3	18584568	18584817	249	g_15999	g_16000
Super-Scaffold_3	18585083	18588740	3657	g_16000	g_44231
Super-Scaffold_3	18595639	18613233	17594	g_44231	g_16001
Super-Scaffold_3	18619129	18621323	2194	g_16001	g_16003
Super-Scaffold_3	18622212	18718183	95971	g_16003	g_16008
Super-Scaffold_3	18723699	18732175	8476	g_16008	g_16009
Super-Scaffold_3	18745905	18754692	8787	g_16009	g_16010
Super-Scaffold_3	18774075	18779182	5107	g_16010	g_16011
Super-Scaffold_3	18787241	18787915	674	g_16011	g_16012
Super-Scaffold_3	18792930	18795845	2915	g_16012	g_16013
Super-Scaffold_3	18804008	18807530	3522	g_16013	g_16014
Super-Scaffold_3	18813178	18817131	3953	g_16014	g_16015
Super-Scaffold_3	18834943	18838090	3147	g_16015	g_16016
Super-Scaffold_3	18839733	18840532	799	g_16016	g_44232
Super-Scaffold_3	18847527	18852348	4821	g_44232	g_16017
Super-Scaffold_3	18867199	18936488	69289	g_16017	g_16021
Super-Scaffold_3	18938025	18949294	11269	g_16021	g_16024
Super-Scaffold_3	18953373	18961451	8078	g_16024	g_16025
Super-Scaffold_3	18961798	18978119	16321	g_16025	g_36753
Super-Scaffold_3	18978322	19026385	48063	g_36753	g_16027
Super-Scaffold_3	19026585	19037128	10543	g_16027	g_16028
Super-Scaffold_3	19037502	19093713	56211	g_16028	g_16030
Super-Scaffold_3	19093955	19139070	45115	g_16030	g_16031
Super-Scaffold_3	19145189	19150698	5509	g_16031	g_44233
Super-Scaffold_3	19156040	19159439	3399	g_44233	g_36754
Super-Scaffold_3	19161151	19161235	84	g_36754	g_36755
Super-Scaffold_3	19161477	19167489	6012	g_36755	g_16032
Super-Scaffold_3	19169247	19172342	3095	g_16032	g_16033
Super-Scaffold_3	19180605	19180962	357	g_16033	g_44234
Super-Scaffold_3	19184123	19185651	1528	g_44234	g_16034
Super-Scaffold_3	19188623	19283051	94428	g_16034	g_16037
Super-Scaffold_3	19283392	19396316	112924	g_16037	g_16041
Super-Scaffold_3	19396525	19407175	10650	g_16041	g_16042
Super-Scaffold_3	19407396	19411030	3634	g_16042	g_44235
Super-Scaffold_3	19427875	19452780	24905	g_44235	g_16043
Super-Scaffold_3	19455073	19463145	8072	g_16043	g_16044
Super-Scaffold_3	19466481	19468494	2013	g_16044	g_16045
Super-Scaffold_3	19474447	19485980	11533	g_16045	g_44236
Super-Scaffold_3	19487804	19497379	9575	g_44236	g_16047
Super-Scaffold_3	19511701	19537743	26042	g_16047	g_16049
Super-Scaffold_3	19540663	19545153	4490	g_16049	g_16050
Super-Scaffold_3	19549246	19552435	3189	g_16050	g_44237
Super-Scaffold_3	19556255	19576224	19969	g_44237	g_16051
Super-Scaffold_3	19580272	19587437	7165	g_16051	g_16052
Super-Scaffold_3	19588470	19594850	6380	g_16052	g_16053
Super-Scaffold_3	19610594	19628272	17678	g_16053	g_16054
Super-Scaffold_3	19647237	19657415	10178	g_16054	g_44238
Super-Scaffold_3	19676208	19680694	4486	g_44238	g_44239
Super-Scaffold_3	19681630	19693192	11562	g_44239	g_44240
Super-Scaffold_3	19694012	19707216	13204	g_44240	g_16055
Super-Scaffold_3	19712387	19742156	29769	g_16055	g_44241
Super-Scaffold_3	19744204	19756498	12294	g_44241	g_16056
Super-Scaffold_3	19767137	19768658	1521	g_16056	g_16057
Super-Scaffold_3	19772523	19774996	2473	g_16057	g_16058
Super-Scaffold_3	19788152	19788999	847	g_16058	g_16059
Super-Scaffold_3	19792115	19793651	1536	g_16059	g_16060
Super-Scaffold_3	19800506	19801302	796	g_16060	g_16061
Super-Scaffold_3	19807854	19822402	14548	g_16061	g_16063
Super-Scaffold_3	19825271	19827686	2415	g_16063	g_16064
Super-Scaffold_3	19838272	19889352	51080	g_16064	g_36760
Super-Scaffold_3	19889603	19889741	138	g_36760	g_16067
Super-Scaffold_3	19890328	19894847	4519	g_16067	g_44242
Super-Scaffold_3	19895417	19897123	1706	g_44242	g_16068
Super-Scaffold_3	19897672	19900411	2739	g_16068	g_44243
Super-Scaffold_3	19904941	19906928	1987	g_44243	g_16069
Super-Scaffold_3	19911855	19914298	2443	g_16069	g_16070
Super-Scaffold_3	19918173	19919067	894	g_16070	g_16071
Super-Scaffold_3	19928239	19930991	2752	g_16071	g_44244
Super-Scaffold_3	19956166	19973495	17329	g_44244	g_16073
Super-Scaffold_3	19989174	19989368	194	g_16073	g_16074
Super-Scaffold_3	19989601	19989630	29	g_16074	g_16075
Super-Scaffold_3	19989950	19992246	2296	g_16075	g_16076
Super-Scaffold_3	20003151	20009010	5859	g_16076	g_16077
Super-Scaffold_3	20013502	20018026	4524	g_16077	g_44245
Super-Scaffold_3	20024770	20025401	631	g_44245	g_16078
Super-Scaffold_3	20033140	20037007	3867	g_16078	g_16079
Super-Scaffold_3	20042843	20047980	5137	g_16079	g_44246
Super-Scaffold_3	20052663	20065924	13261	g_44246	g_16080
Super-Scaffold_3	20068233	20070121	1888	g_16080	g_16081
Super-Scaffold_3	20077578	20080280	2702	g_16081	g_16082
Super-Scaffold_3	20084271	20087674	3403	g_16082	g_16083
Super-Scaffold_3	20122073	20131939	9866	g_16083	g_16085
Super-Scaffold_3	20152975	20157548	4573	g_16085	g_16086
Super-Scaffold_3	20165388	20175714	10326	g_16086	g_16087
Super-Scaffold_3	20180623	20183406	2783	g_16087	g_16088
Super-Scaffold_3	20187670	20190491	2821	g_16088	g_16089
Super-Scaffold_3	20193954	20197030	3076	g_16089	g_16090
Super-Scaffold_3	20219418	20224115	4697	g_16090	g_44247
Super-Scaffold_3	20231229	20247470	16241	g_44247	g_16091
Super-Scaffold_3	20255329	20257195	1866	g_16091	g_16092
Super-Scaffold_3	20260272	20262363	2091	g_16092	g_16093
Super-Scaffold_3	20263559	20264747	1188	g_16093	g_16094
Super-Scaffold_3	20267405	20270985	3580	g_16094	g_16095
Super-Scaffold_3	20284902	20290070	5168	g_16095	g_16096
Super-Scaffold_3	20298788	20300614	1826	g_16096	g_16097
Super-Scaffold_3	20304301	20393669	89368	g_16097	g_16100
Super-Scaffold_3	20408274	20408680	406	g_16100	g_16101
Super-Scaffold_3	20411463	20413646	2183	g_16101	g_16102
Super-Scaffold_3	20417557	20418498	941	g_16102	g_16103
Super-Scaffold_3	20423366	20424503	1137	g_16103	g_16104
Super-Scaffold_3	20426312	20470266	43954	g_16104	g_16105
Super-Scaffold_3	20473729	20551883	78154	g_16105	g_16107
Super-Scaffold_3	20552896	20557688	4792	g_16107	g_16106
Super-Scaffold_3	20583942	20605499	21557	g_16106	g_16108
Super-Scaffold_3	20628568	20663659	35091	g_16108	g_16109
Super-Scaffold_3	20665233	20742861	77628	g_16109	g_16110
Super-Scaffold_3	20754970	20757428	2458	g_16110	g_44248
Super-Scaffold_3	20767536	20769459	1923	g_44248	g_16111
Super-Scaffold_3	20775941	20778470	2529	g_16111	g_16112
Super-Scaffold_3	20780193	20780927	734	g_16112	g_16113
Super-Scaffold_3	20784105	20794860	10755	g_16113	g_16115
Super-Scaffold_3	20838131	20885998	47867	g_16115	g_16117
Super-Scaffold_3	20886285	20890022	3737	g_16117	g_16118
Super-Scaffold_3	20906974	20912297	5323	g_16118	g_44249
Super-Scaffold_3	20924991	20926515	1524	g_44249	g_16119
Super-Scaffold_3	20930024	20933114	3090	g_16119	g_44250
Super-Scaffold_3	20938478	20939419	941	g_44250	g_16120
Super-Scaffold_3	20942978	21020220	77242	g_16120	g_16122
Super-Scaffold_3	21024781	21041987	17206	g_16122	g_44251
Super-Scaffold_3	21050997	21086179	35182	g_44251	g_16123
Super-Scaffold_3	21095826	21106057	10231	g_16123	g_16125
Super-Scaffold_3	21116135	21116192	57	g_16125	g_44252
Super-Scaffold_3	21116407	21120210	3803	g_44252	g_16126
Super-Scaffold_3	21129045	21135042	5997	g_16126	g_16127
Super-Scaffold_3	21154039	21214320	60281	g_16127	g_16129
Super-Scaffold_3	21220190	21225600	5410	g_16129	g_16130
Super-Scaffold_3	21231321	21242429	11108	g_16130	g_16132
Super-Scaffold_3	21286519	21317106	30587	g_16132	g_16133
Super-Scaffold_3	21317348	21321856	4508	g_16133	g_16134
Super-Scaffold_3	21325882	21340275	14393	g_16134	g_44253
Super-Scaffold_3	21345258	21350754	5496	g_44253	g_44254
Super-Scaffold_3	21372907	21470862	97955	g_44254	g_16138
Super-Scaffold_3	21471293	21498210	26917	g_16138	g_16139
Super-Scaffold_3	21498818	21539245	40427	g_16139	g_16140
Super-Scaffold_3	21540957	21630886	89929	g_16140	g_16142
Super-Scaffold_3	21641801	21866500	224699	g_16142	g_16145
Super-Scaffold_3	21872039	21873026	987	g_16145	g_16146
Super-Scaffold_3	21876899	21884814	7915	g_16146	g_36772
Super-Scaffold_3	21896715	21913099	16384	g_36772	g_16147
Super-Scaffold_3	21917346	21922333	4987	g_16147	g_16149
Super-Scaffold_3	21923448	21956857	33409	g_16149	g_16152
Super-Scaffold_3	21968496	22008093	39597	g_16152	g_16153
Super-Scaffold_3	22012349	22053873	41524	g_16153	g_16155
Super-Scaffold_3	22055108	22061691	6583	g_16155	g_16156
Super-Scaffold_3	22064147	22065185	1038	g_16156	g_16157
Super-Scaffold_3	22069151	22070367	1216	g_16157	g_16158
Super-Scaffold_3	22073043	22104506	31463	g_16158	g_16159
Super-Scaffold_3	22109954	22128721	18767	g_16159	g_16160
Super-Scaffold_3	22129881	22208753	78872	g_16160	g_44255
Super-Scaffold_3	22275433	22498144	222711	g_44255	g_16161
Super-Scaffold_3	22501722	22549472	47750	g_16161	g_16162
Super-Scaffold_3	22550116	22578003	27887	g_16162	g_16163
Super-Scaffold_3	22579265	22615142	35877	g_16163	g_36774
Super-Scaffold_3	22615426	22617721	2295	g_36774	g_16164
Super-Scaffold_3	22620590	22620626	36	g_16164	g_16165
Super-Scaffold_3	22622767	22623240	473	g_16165	g_16166
Super-Scaffold_3	22625099	22732518	107419	g_16166	g_16168
Super-Scaffold_3	22751210	22792387	41177	g_16168	g_16169
Super-Scaffold_3	22793613	22866261	72648	g_16169	g_16170
Super-Scaffold_3	22866863	22868185	1322	g_16170	g_16172
Super-Scaffold_3	22870578	22903287	32709	g_16172	g_16173
Super-Scaffold_3	22906960	22908883	1923	g_16173	g_16174
Super-Scaffold_3	22909164	22914886	5722	g_16174	g_16175
Super-Scaffold_3	22924317	22935646	11329	g_16175	g_36775
Super-Scaffold_3	22935909	22939199	3290	g_36775	g_16176
Super-Scaffold_3	23011311	23036612	25301	g_16176	g_16177
Super-Scaffold_3	23048068	23053649	5581	g_16177	g_16178
Super-Scaffold_3	23073918	23077066	3148	g_16178	g_16179
Super-Scaffold_3	23089597	23109215	19618	g_16179	g_16180
Super-Scaffold_3	23114915	23118563	3648	g_16180	g_36777
Super-Scaffold_3	23123690	23126723	3033	g_16181	g_16182
Super-Scaffold_3	23130815	23132407	1592	g_16182	g_44256
Super-Scaffold_3	23137528	23141699	4171	g_44256	g_44257
Super-Scaffold_3	23161617	23162648	1031	g_44257	g_16183
Super-Scaffold_3	23165036	23188255	23219	g_16183	g_16184
Super-Scaffold_3	23209053	23225041	15988	g_16184	g_16185
Super-Scaffold_3	23242116	23276169	34053	g_16185	g_16186
Super-Scaffold_3	23277266	23286929	9663	g_16186	g_16187
Super-Scaffold_3	23290392	23293902	3510	g_16187	g_16188
Super-Scaffold_3	23304285	23305644	1359	g_16188	g_16189
Super-Scaffold_3	23309875	23311803	1928	g_16189	g_16190
Super-Scaffold_3	23326063	23340249	14186	g_16190	g_16191
Super-Scaffold_3	23361954	23383574	21620	g_16191	g_16192
Super-Scaffold_3	23396246	23399267	3021	g_16192	g_16193
Super-Scaffold_3	23407945	23408957	1012	g_16193	g_16194
Super-Scaffold_3	23416800	23458048	41248	g_16194	g_16195
Super-Scaffold_3	23480302	23486439	6137	g_16195	g_44258
Super-Scaffold_3	23493203	23502585	9382	g_44258	g_16197
Super-Scaffold_3	23504884	23508775	3891	g_16197	g_16199
Super-Scaffold_3	23516762	23519110	2348	g_16199	g_16200
Super-Scaffold_3	23533758	23543549	9791	g_16200	g_16201
Super-Scaffold_3	23544498	23554687	10189	g_16201	g_44259
Super-Scaffold_3	23555632	23559203	3571	g_44259	g_16202
Super-Scaffold_3	23561552	23561660	108	g_16202	g_16203
Super-Scaffold_3	23561902	23567292	5390	g_16203	g_16204
Super-Scaffold_3	23580494	23592127	11633	g_16204	g_44260
Super-Scaffold_3	23595873	23597712	1839	g_44260	g_16205
Super-Scaffold_3	23605394	23607753	2359	g_16205	g_16206
Super-Scaffold_3	23621363	23626388	5025	g_16206	g_16207
Super-Scaffold_3	23631736	23634498	2762	g_16207	g_16208
Super-Scaffold_3	23637581	23640061	2480	g_16208	g_16209
Super-Scaffold_3	23640777	23699593	58816	g_16209	g_44261
Super-Scaffold_3	23703554	23710866	7312	g_44261	g_16210
Super-Scaffold_3	23722312	23722959	647	g_16210	g_16211
Super-Scaffold_3	23723768	23723835	67	g_16211	g_16212
Super-Scaffold_3	23724728	23724879	151	g_16212	g_16213
Super-Scaffold_3	23725742	23726170	428	g_16213	g_44262
Super-Scaffold_3	23734235	23736348	2113	g_44262	g_16214
Super-Scaffold_3	23745699	23748525	2826	g_16214	g_16215
Super-Scaffold_3	23758672	23789157	30485	g_16215	g_36780
Super-Scaffold_3	23789474	23789565	91	g_36780	g_16216
Super-Scaffold_3	23789855	23794869	5014	g_16216	g_16217
Super-Scaffold_3	23795162	23897305	102143	g_16217	g_16220
Super-Scaffold_3	23897619	23899060	1441	g_16220	g_16221
Super-Scaffold_3	23962652	23981217	18565	g_16221	g_16222
Super-Scaffold_3	23983958	24083164	99206	g_16222	g_16224
Super-Scaffold_3	24085197	24159634	74437	g_16224	g_16225
Super-Scaffold_3	24159837	24163545	3708	g_16225	g_16226
Super-Scaffold_3	24163748	24170037	6289	g_16226	g_16227
Super-Scaffold_3	24170294	24176064	5770	g_16227	g_16228
Super-Scaffold_3	24180595	24211335	30740	g_16228	g_16229
Super-Scaffold_3	24211769	24257986	46217	g_16229	g_16232
Super-Scaffold_3	24334195	24353522	19327	g_16232	g_16233
Super-Scaffold_3	24377782	24385386	7604	g_16233	g_16234
Super-Scaffold_3	24386099	24401815	15716	g_16234	g_16236
Super-Scaffold_3	24402033	24402147	114	g_16236	g_16237
Super-Scaffold_3	24402452	24413196	10744	g_16237	g_16238
Super-Scaffold_3	24433443	24440636	7193	g_36788	g_16239
Super-Scaffold_3	24452654	24468127	15473	g_16239	g_16240
Super-Scaffold_3	24469652	24471930	2278	g_16240	g_16241
Super-Scaffold_3	24485870	24491625	5755	g_16241	g_16242
Super-Scaffold_3	24493631	24498731	5100	g_16242	g_16243
Super-Scaffold_3	24503963	24504716	753	g_16243	g_16244
Super-Scaffold_3	24515512	24530877	15365	g_16244	g_16245
Super-Scaffold_3	24547913	24551708	3795	g_16245	g_16246
Super-Scaffold_3	24576749	24598511	21762	g_16246	g_16248
Super-Scaffold_3	24676959	24679933	2974	g_16248	g_16249
Super-Scaffold_3	24680639	24685025	4386	g_16249	g_44263
Super-Scaffold_3	24706697	24745478	38781	g_44263	g_16250
Super-Scaffold_3	24745684	24748891	3207	g_16250	g_16251
Super-Scaffold_3	24755995	24767097	11102	g_16251	g_16252
Super-Scaffold_3	24770732	24772849	2117	g_16252	g_16253
Super-Scaffold_3	24797212	24813928	16716	g_16253	g_16254
Super-Scaffold_3	24819460	24877813	58353	g_16254	g_16256
Super-Scaffold_3	24886478	24897862	11384	g_16256	g_44264
Super-Scaffold_3	24900942	25006946	106004	g_44264	g_16259
Super-Scaffold_3	25007203	25052158	44955	g_16259	g_16260
Super-Scaffold_3	25061948	25076419	14471	g_16260	g_16261
Super-Scaffold_3	25085428	25109985	24557	g_16261	g_16262
Super-Scaffold_3	25113510	25114156	646	g_16262	g_16263
Super-Scaffold_3	25116066	25120419	4353	g_16263	g_16264
Super-Scaffold_3	25133923	25139812	5889	g_16264	g_16265
Super-Scaffold_3	25140024	25165639	25615	g_16265	g_16266
Super-Scaffold_3	25186939	25208467	21528	g_16266	g_16267
Super-Scaffold_3	25230236	25267637	37401	g_16267	g_16268
Super-Scaffold_3	25268104	25376986	108882	g_16268	g_16270
Super-Scaffold_3	25395758	25437725	41967	g_16270	g_16271
Super-Scaffold_3	25438396	25488379	49983	g_16271	g_16272
Super-Scaffold_3	25519117	25526106	6989	g_16272	g_16273
Super-Scaffold_3	25526732	25527088	356	g_16273	g_36794
Super-Scaffold_3	25527402	25539456	12054	g_36794	g_16274
Super-Scaffold_3	25540319	25559494	19175	g_16274	g_16275
Super-Scaffold_3	25564610	25565891	1281	g_16275	g_16276
Super-Scaffold_3	25572924	25764303	191379	g_16276	g_16279
Super-Scaffold_3	25765490	25853030	87540	g_16279	g_16281
Super-Scaffold_3	25853278	25898761	45483	g_16281	g_36797
Super-Scaffold_3	25899006	25908864	9858	g_36797	g_16284
Super-Scaffold_3	25912711	25918003	5292	g_16284	g_16285
Super-Scaffold_3	26010725	26140679	129954	g_16285	g_16286
Super-Scaffold_3	26141422	26359381	217959	g_16286	g_16289
Super-Scaffold_3	26364219	26412504	48285	g_16289	g_16290
Super-Scaffold_3	26435430	26439965	4535	g_16290	g_16291
Super-Scaffold_3	26451577	26453398	1821	g_16291	g_16292
Super-Scaffold_3	26456737	26472744	16007	g_16292	g_16293
Super-Scaffold_3	26496552	26501867	5315	g_16293	g_16294
Super-Scaffold_3	26503481	26538105	34624	g_16294	g_16296
Super-Scaffold_3	26550571	26552133	1562	g_16296	g_16297
Super-Scaffold_3	26555108	26557281	2173	g_16297	g_16298
Super-Scaffold_3	26564814	26573578	8764	g_16298	g_16299
Super-Scaffold_3	26584052	26584529	477	g_16299	g_36802
Super-Scaffold_3	26584798	26669402	84604	g_36802	g_16301
Super-Scaffold_3	26672394	26674593	2199	g_16301	g_16302
Super-Scaffold_3	26681210	26736824	55614	g_16302	g_16303
Super-Scaffold_3	26741611	26779270	37659	g_16303	g_16304
Super-Scaffold_3	26783655	26802365	18710	g_16304	g_16305
Super-Scaffold_3	26804701	26812772	8071	g_16305	g_16306
Super-Scaffold_3	26826893	26866809	39916	g_16306	g_16307
Super-Scaffold_3	26905388	26922043	16655	g_16307	g_16308
Super-Scaffold_3	26931805	26936500	4695	g_16308	g_16309
Super-Scaffold_3	26937996	26953373	15377	g_16309	g_16310
Super-Scaffold_3	26954050	26954301	251	g_16310	g_16311
Super-Scaffold_3	26955299	26959796	4497	g_16311	g_36804
Super-Scaffold_3	26960014	26998296	38282	g_36804	g_16313
Super-Scaffold_3	26998712	27198260	199548	g_16313	g_16317
Super-Scaffold_3	27205761	27232756	26995	g_16317	g_16318
Super-Scaffold_3	27236539	27300201	63662	g_16318	g_16319
Super-Scaffold_3	27300530	27313067	12537	g_16319	g_16320
Super-Scaffold_3	27331807	27360990	29183	g_16320	g_16321
Super-Scaffold_3	27361343	27418872	57529	g_16321	g_16322
Super-Scaffold_3	27421011	27431234	10223	g_16322	g_16324
Super-Scaffold_3	27431608	27568949	137341	g_16324	g_16325
Super-Scaffold_3	27569194	27654868	85674	g_16325	g_16328
Super-Scaffold_3	27659635	27667352	7717	g_16328	g_16329
Super-Scaffold_3	27686130	27779021	92891	g_16329	g_16331
Super-Scaffold_3	27786884	27901117	114233	g_16331	g_16333
Super-Scaffold_3	27904084	28007897	103813	g_16333	g_16334
Super-Scaffold_3	28017188	28070882	53694	g_16334	g_16337
Super-Scaffold_3	28071379	28071444	65	g_16337	g_16338
Super-Scaffold_3	28071785	28071951	166	g_16338	g_16339
Super-Scaffold_3	28072151	28139330	67179	g_16339	g_16342
Super-Scaffold_3	28185235	28208560	23325	g_16342	g_16343
Super-Scaffold_3	28227236	28264995	37759	g_16343	g_16344
Super-Scaffold_3	28266163	28274304	8141	g_16344	g_16345
Super-Scaffold_3	28285056	28286912	1856	g_16345	g_16346
Super-Scaffold_3	28289691	28289792	101	g_16346	g_36812
Super-Scaffold_3	28290001	28291416	1415	g_36812	g_16347
Super-Scaffold_3	28291790	28293508	1718	g_16347	g_16348
Super-Scaffold_3	28301446	28308893	7447	g_16348	g_16350
Super-Scaffold_3	28319967	28323154	3187	g_16350	g_44265
Super-Scaffold_3	28346590	28348043	1453	g_44265	g_16351
Super-Scaffold_3	28351019	28358486	7467	g_16351	g_16353
Super-Scaffold_3	28363239	28365733	2494	g_16353	g_16354
Super-Scaffold_3	28366122	28389546	23424	g_16354	g_16356
Super-Scaffold_3	28390025	28443725	53700	g_16356	g_16359
Super-Scaffold_3	28468083	28474480	6397	g_16359	g_16360
Super-Scaffold_3	28478387	28522456	44069	g_16360	g_16362
Super-Scaffold_3	28522752	28533532	10780	g_16362	g_16363
Super-Scaffold_3	28534923	28594930	60007	g_16363	g_16366
Super-Scaffold_3	28598384	28602346	3962	g_16366	g_36816
Super-Scaffold_3	28603233	28604744	1511	g_36816	g_16367
Super-Scaffold_3	28609117	28623119	14002	g_16367	g_16368
Super-Scaffold_3	28623433	28627988	4555	g_16368	g_16369
Super-Scaffold_3	28630950	28633183	2233	g_16369	g_16370
Super-Scaffold_3	28645952	28655594	9642	g_16370	g_44266
Super-Scaffold_3	28661023	28669964	8941	g_44266	g_44267
Super-Scaffold_3	28685741	28694343	8602	g_44267	g_16371
Super-Scaffold_3	28712443	28876371	163928	g_16371	g_16373
Super-Scaffold_3	28877822	28902541	24719	g_16373	g_16374
Super-Scaffold_3	28907372	28907764	392	g_16374	g_16375
Super-Scaffold_3	28908024	28923324	15300	g_16375	g_16376
Super-Scaffold_3	28923608	28935380	11772	g_16376	g_16377
Super-Scaffold_3	28935595	28982343	46748	g_16377	g_16378
Super-Scaffold_3	28983152	29074069	90917	g_16378	g_16381
Super-Scaffold_3	29075283	29147320	72037	g_16381	g_16383
Super-Scaffold_3	29151657	29223234	71577	g_16383	g_16384
Super-Scaffold_3	29224952	29227864	2912	g_16384	g_16385
Super-Scaffold_3	29233901	29239512	5611	g_16385	g_16386
Super-Scaffold_3	29243608	29248295	4687	g_16386	g_16387
Super-Scaffold_3	29253642	29274754	21112	g_16387	g_16388
Super-Scaffold_3	29284139	29286937	2798	g_16388	g_16389
Super-Scaffold_3	29297912	29298159	247	g_16389	g_16390
Super-Scaffold_3	29298920	29299334	414	g_16390	g_16391
Super-Scaffold_3	29308786	29310538	1752	g_16391	g_16392
Super-Scaffold_3	29317243	29320954	3711	g_16392	g_16393
Super-Scaffold_3	29328370	29333551	5181	g_16393	g_16394
Super-Scaffold_3	29342812	29346314	3502	g_16394	g_16395
Super-Scaffold_3	29357296	29361783	4487	g_16395	g_16396
Super-Scaffold_3	29383801	29446654	62853	g_16396	g_16397
Super-Scaffold_3	29447188	29489839	42651	g_16397	g_16398
Super-Scaffold_3	29494369	29521980	27611	g_16398	g_16399
Super-Scaffold_3	29525069	29529839	4770	g_16399	g_16400
Super-Scaffold_3	29532958	29541462	8504	g_16400	g_16401
Super-Scaffold_3	29549389	29552847	3458	g_16401	g_44268
Super-Scaffold_3	29556511	29562167	5656	g_44268	g_16402
Super-Scaffold_3	29574314	29653663	79349	g_16402	g_16406
Super-Scaffold_3	29654631	29662516	7885	g_16406	g_36821
Super-Scaffold_3	29662740	29784608	121868	g_36821	g_16409
Super-Scaffold_3	29835855	29842946	7091	g_16409	g_16410
Super-Scaffold_3	29855430	29874646	19216	g_16410	g_16411
Super-Scaffold_3	29875588	30165650	290062	g_16411	g_16416
Super-Scaffold_3	30166486	30257636	91150	g_16416	g_16419
Super-Scaffold_3	30268790	30345707	76917	g_16419	g_16422
Super-Scaffold_3	30355184	30519456	164272	g_16422	g_16426
Super-Scaffold_3	30528266	30538255	9989	g_16426	g_16427
Super-Scaffold_3	30541828	30605635	63807	g_16427	g_16429
Super-Scaffold_3	30633584	30634452	868	g_16429	g_16430
Super-Scaffold_3	30640106	30645740	5634	g_16430	g_16431
Super-Scaffold_3	30651082	30652954	1872	g_16431	g_16432
Super-Scaffold_3	30663855	30665611	1756	g_16432	g_16433
Super-Scaffold_3	30674264	30698197	23933	g_16433	g_16435
Super-Scaffold_3	30698700	30713004	14304	g_16435	g_16436
Super-Scaffold_3	30715136	30717832	2696	g_16436	g_16437
Super-Scaffold_3	30718617	30731107	12490	g_16437	g_16439
Super-Scaffold_3	30731598	30781753	50155	g_16439	g_44269
Super-Scaffold_3	30781986	30785157	3171	g_44269	g_16440
Super-Scaffold_3	30785519	30811684	26165	g_16440	g_16442
Super-Scaffold_3	30824179	30824828	649	g_16442	g_16443
Super-Scaffold_3	30825788	30827096	1308	g_16443	g_16444
Super-Scaffold_3	30831059	30870041	38982	g_16444	g_16446
Super-Scaffold_3	30906308	30908830	2522	g_16446	g_16447
Super-Scaffold_3	30912359	30948582	36223	g_16447	g_16449
Super-Scaffold_3	30950611	30983241	32630	g_36836	g_16450
Super-Scaffold_3	30988673	31046907	58234	g_16450	g_16451
Super-Scaffold_3	31051701	31105485	53784	g_16451	g_16452
Super-Scaffold_3	31106559	31160055	53496	g_16452	g_16453
Super-Scaffold_3	31170095	31197661	27566	g_16453	g_16454
Super-Scaffold_3	31197921	31230555	32634	g_16454	g_16456
Super-Scaffold_3	31231460	31251056	19596	g_16456	g_16457
Super-Scaffold_3	31251406	31258514	7108	g_16457	g_16458
Super-Scaffold_3	31258984	31261946	2962	g_16458	g_16460
Super-Scaffold_3	31264985	31311722	46737	g_16460	g_16461
Super-Scaffold_3	31316073	31329334	13261	g_16461	g_44270
Super-Scaffold_3	31339537	31365501	25964	g_44270	g_16462
Super-Scaffold_3	31376733	31379026	2293	g_16462	g_16463
Super-Scaffold_3	31401127	31423588	22461	g_16463	g_16464
Super-Scaffold_3	31424134	31436883	12749	g_16464	g_16465
Super-Scaffold_3	31437806	31450988	13182	g_16465	g_16466
Super-Scaffold_3	31452264	31452375	111	g_16466	g_44271
Super-Scaffold_3	31452710	31474621	21911	g_44271	g_16467
Super-Scaffold_3	31475565	31489689	14124	g_16467	g_16468
Super-Scaffold_3	31491324	31544763	53439	g_16468	g_16469
Super-Scaffold_3	31548828	31552604	3776	g_16469	g_44272
Super-Scaffold_3	31553071	31555459	2388	g_44272	g_16470
Super-Scaffold_3	31555944	31556143	199	g_16470	g_16471
Super-Scaffold_3	31576036	31682744	106708	g_16471	g_16476
Super-Scaffold_3	31767853	31788340	20487	g_16476	g_16477
Super-Scaffold_3	31799995	31808221	8226	g_16477	g_16478
Super-Scaffold_3	31845971	31924435	78464	g_16478	g_16480
Super-Scaffold_3	31925139	31936896	11757	g_16480	g_16481
Super-Scaffold_3	31943841	31986292	42451	g_16481	g_16482
Super-Scaffold_3	31996634	32006659	10025	g_16482	g_16483
Super-Scaffold_3	32014854	32016727	1873	g_16483	g_16484
Super-Scaffold_3	32017437	32063873	46436	g_16484	g_16485
Super-Scaffold_3	32064160	32069726	5566	g_16485	g_16487
Super-Scaffold_3	32069965	32073663	3698	g_16487	g_16486
Super-Scaffold_3	32074844	32098675	23831	g_16486	g_16488
Super-Scaffold_3	32109165	32112362	3197	g_16488	g_16490
Super-Scaffold_3	32112610	32119202	6592	g_16490	g_16491
Super-Scaffold_3	32119753	32122218	2465	g_16491	g_16493
Super-Scaffold_3	32123027	32133148	10121	g_16493	g_16495
Super-Scaffold_3	32133453	32134267	814	g_16495	g_16496
Super-Scaffold_3	32134683	32139183	4500	g_16496	g_16497
Super-Scaffold_3	32147735	32150548	2813	g_16497	g_44273
Super-Scaffold_3	32169863	32197110	27247	g_44273	g_36838
Super-Scaffold_3	32197493	32232516	35023	g_36838	g_16500
Super-Scaffold_3	32248616	32262151	13535	g_16500	g_16501
Super-Scaffold_3	32263440	32267232	3792	g_16501	g_16502
Super-Scaffold_3	32267489	32273645	6156	g_16502	g_16503
Super-Scaffold_3	32291889	32317155	25266	g_16503	g_16504
Super-Scaffold_3	32319257	32339035	19778	g_16504	g_16505
Super-Scaffold_3	32339651	32341894	2243	g_16505	g_16506
Super-Scaffold_3	32366172	32400192	34020	g_16506	g_16507
Super-Scaffold_3	32400503	32470386	69883	g_16507	g_16508
Super-Scaffold_3	32470712	32498101	27389	g_16508	g_16509
Super-Scaffold_3	32505590	32525279	19689	g_16509	g_16510
Super-Scaffold_3	32528017	32540229	12212	g_16510	g_16511
Super-Scaffold_3	32547032	32555856	8824	g_16511	g_16513
Super-Scaffold_3	32560241	32574606	14365	g_16513	g_16514
Super-Scaffold_3	32586010	32587980	1970	g_16514	g_16515
Super-Scaffold_3	32595589	32600298	4709	g_16515	g_16516
Super-Scaffold_3	32602238	32658366	56128	g_16516	g_16517
Super-Scaffold_3	32661357	32669044	7687	g_16517	g_16518
Super-Scaffold_3	32691319	32704458	13139	g_16518	g_16519
Super-Scaffold_3	32723885	32730825	6940	g_16519	g_16520
Super-Scaffold_3	32733011	32733293	282	g_16520	g_16521
Super-Scaffold_3	32734161	32755530	21369	g_16521	g_16522
Super-Scaffold_3	32760698	32782115	21417	g_16522	g_44274
Super-Scaffold_3	32784806	32788074	3268	g_44274	g_44275
Super-Scaffold_3	32795227	32854645	59418	g_44275	g_16525
Super-Scaffold_3	32856049	32858769	2720	g_16525	g_16526
Super-Scaffold_3	32859845	32885198	25353	g_16526	g_16530
Super-Scaffold_3	32885917	32892385	6468	g_16530	g_16531
Super-Scaffold_3	32893296	32908034	14738	g_16531	g_16533
Super-Scaffold_3	32908771	32917459	8688	g_16533	g_16534
Super-Scaffold_3	32928887	32949912	21025	g_16534	g_36842
Super-Scaffold_3	32950211	32951229	1018	g_36842	g_16536
Super-Scaffold_3	32955853	32999533	43680	g_16536	g_16537
Super-Scaffold_3	32999958	33000015	57	g_16537	g_44276
Super-Scaffold_3	33002225	33026994	24769	g_44276	g_36843
Super-Scaffold_3	33027281	33040467	13186	g_36843	g_16538
Super-Scaffold_3	33040691	33050357	9666	g_16538	g_16539
Super-Scaffold_3	33050560	33192716	142156	g_16539	g_16541
Super-Scaffold_3	33192934	33240261	47327	g_16541	g_16544
Super-Scaffold_3	33241759	33244821	3062	g_16544	g_16545
Super-Scaffold_3	33247899	33250290	2391	g_16545	g_16546
Super-Scaffold_3	33252121	33263194	11073	g_16546	g_16547
Super-Scaffold_3	33266775	33272891	6116	g_16547	g_16549
Super-Scaffold_3	33277422	33315171	37749	g_16549	g_16550
Super-Scaffold_3	33318301	33318484	183	g_16550	g_16551
Super-Scaffold_3	33320187	33336959	16772	g_16551	g_16553
Super-Scaffold_3	33337402	33349870	12468	g_16553	g_16555
Super-Scaffold_3	33350187	33432979	82792	g_16555	g_16557
Super-Scaffold_3	33435407	33435766	359	g_16557	g_16558
Super-Scaffold_3	33437560	33475776	38216	g_16558	g_16559
Super-Scaffold_3	33476087	33579249	103162	g_16559	g_16563
Super-Scaffold_3	33588532	33610764	22232	g_16563	g_16564
Super-Scaffold_3	33612521	33683696	71175	g_16564	g_16565
Super-Scaffold_3	33699654	33706831	7177	g_16565	g_16566
Super-Scaffold_3	33731794	33735194	3400	g_16566	g_16567
Super-Scaffold_3	33753477	33767353	13876	g_16567	g_16568
Super-Scaffold_3	33769338	33817266	47928	g_16568	g_16569
Super-Scaffold_3	33817508	33836283	18775	g_16569	g_16570
Super-Scaffold_3	33839900	33889649	49749	g_16570	g_16572
Super-Scaffold_3	33907560	33909944	2384	g_16572	g_16573
Super-Scaffold_3	33926084	33939982	13898	g_16573	g_16574
Super-Scaffold_3	33943538	33953979	10441	g_16574	g_16575
Super-Scaffold_3	33954197	34006299	52102	g_16575	g_16577
Super-Scaffold_3	34006556	34049633	43077	g_16577	g_16578
Super-Scaffold_3	34050040	34113973	63933	g_16578	g_16579
Super-Scaffold_3	34120965	34121467	502	g_16579	g_16580
Super-Scaffold_3	34121766	34150251	28485	g_16580	g_16581
Super-Scaffold_3	34151843	34153766	1923	g_16581	g_16582
Super-Scaffold_3	34156613	34171047	14434	g_16582	g_16583
Super-Scaffold_3	34176799	34190781	13982	g_16583	g_16585
Super-Scaffold_3	34191380	34191497	117	g_16585	g_16586
Super-Scaffold_3	34192000	34202691	10691	g_16586	g_16587
Super-Scaffold_3	34204473	34204528	55	g_16587	g_16588
Super-Scaffold_31	51142	108250	57108	g_18280	g_18281
Super-Scaffold_31	118904	128629	9725	g_42494	g_18283
Super-Scaffold_31	146393	149037	2644	g_18283	g_18284
Super-Scaffold_31	174658	177442	2784	g_18284	g_18285
Super-Scaffold_31	179230	185404	6174	g_18285	g_18286
Super-Scaffold_31	209195	279284	70089	g_18286	g_18290
Super-Scaffold_31	284575	299044	14469	g_18290	g_18291
Super-Scaffold_31	300169	305144	4975	g_18291	g_18292
Super-Scaffold_31	312439	316906	4467	g_18292	g_18293
Super-Scaffold_31	322110	330961	8851	g_18293	g_18294
Super-Scaffold_31	339140	342637	3497	g_18294	g_18295
Super-Scaffold_31	359234	415580	56346	g_18295	g_18299
Super-Scaffold_31	420535	422654	2119	g_18299	g_18300
Super-Scaffold_31	433960	450494	16534	g_18300	g_18302
Super-Scaffold_31	465672	476840	11168	g_18302	g_18303
Super-Scaffold_31	483418	485081	1663	g_18303	g_18304
Super-Scaffold_31	492821	495280	2459	g_18304	g_18305
Super-Scaffold_31	512570	521777	9207	g_18305	g_18306
Super-Scaffold_31	525376	554903	29527	g_18306	g_18307
Super-Scaffold_31	559089	567505	8416	g_18307	g_18308
Super-Scaffold_31	590989	595640	4651	g_18308	g_18309
Super-Scaffold_31	598834	604611	5777	g_18309	g_18311
Super-Scaffold_31	605093	608375	3282	g_18311	g_18312
Super-Scaffold_31	610719	612898	2179	g_18312	g_18313
Super-Scaffold_31	616765	634137	17372	g_18313	g_18315
Super-Scaffold_31	644723	645225	502	g_18315	g_18316
Super-Scaffold_31	651334	654591	3257	g_18316	g_18317
Super-Scaffold_31	674688	779819	105131	g_18317	g_18320
Super-Scaffold_31	780838	817705	36867	g_18320	g_18321
Super-Scaffold_31	835233	840022	4789	g_18321	g_18322
Super-Scaffold_31	866052	870414	4362	g_18322	g_18323
Super-Scaffold_31	879864	889476	9612	g_18323	g_18324
Super-Scaffold_31	897647	901679	4032	g_18324	g_18325
Super-Scaffold_31	904381	908853	4472	g_18325	g_18326
Super-Scaffold_31	916766	947091	30325	g_18326	g_18327
Super-Scaffold_31	969039	974324	5285	g_18327	g_18328
Super-Scaffold_31	975272	1032448	57176	g_42500	g_18329
Super-Scaffold_31	1037718	1096387	58669	g_18329	g_18332
Super-Scaffold_31	1101565	1124431	22866	g_18332	g_18333
Super-Scaffold_31	1144493	1144542	49	g_18333	g_18334
Super-Scaffold_31	1144781	1170531	25750	g_18334	g_18335
Super-Scaffold_31	1172714	1179433	6719	g_18335	g_44434
Super-Scaffold_31	1181751	1190108	8357	g_44434	g_18337
Super-Scaffold_31	1190413	1191210	797	g_18337	g_18338
Super-Scaffold_31	1192214	1193989	1775	g_18338	g_18339
Super-Scaffold_31	1222300	1232507	10207	g_42502	g_18340
Super-Scaffold_31	1234909	1239673	4764	g_18340	g_18341
Super-Scaffold_31	1240371	1245326	4955	g_18341	g_18342
Super-Scaffold_31	1252500	1266335	13835	g_18342	g_18343
Super-Scaffold_31	1271363	1275214	3851	g_18343	g_18344
Super-Scaffold_31	1282826	1284750	1924	g_18344	g_18345
Super-Scaffold_31	1290863	1334482	43619	g_18345	g_18346
Super-Scaffold_31	1337326	1350785	13459	g_18346	g_44435
Super-Scaffold_31	1360392	1364796	4404	g_44435	g_18347
Super-Scaffold_31	1388815	1414347	25532	g_18347	g_18348
Super-Scaffold_31	1425516	1426568	1052	g_18348	g_18349
Super-Scaffold_31	1435860	1464683	28823	g_18349	g_18351
Super-Scaffold_31	1469557	1520210	50653	g_18351	g_18355
Super-Scaffold_31	1520593	1554066	33473	g_18355	g_18356
Super-Scaffold_31	1554416	1554858	442	g_18356	g_18357
Super-Scaffold_31	1562484	1582866	20382	g_18357	g_18358
Super-Scaffold_31	1585501	1596390	10889	g_18358	g_18359
Super-Scaffold_31	1598180	1625646	27466	g_18359	g_18360
Super-Scaffold_31	1626971	1629837	2866	g_18360	g_18361
Super-Scaffold_31	1634735	1641272	6537	g_18361	g_44436
Super-Scaffold_31	1643035	1648426	5391	g_44436	g_44437
Super-Scaffold_31	1649506	1673551	24045	g_44437	g_18362
Super-Scaffold_31	1677720	1731964	54244	g_18362	g_18365
Super-Scaffold_31	1739366	1756936	17570	g_18365	g_18367
Super-Scaffold_31	1757769	1793250	35481	g_18367	g_18369
Super-Scaffold_31	1802897	1803528	631	g_18369	g_18370
Super-Scaffold_31	1803761	1805378	1617	g_18370	g_18371
Super-Scaffold_31	1805578	1805871	293	g_18371	g_18372
Super-Scaffold_31	1806629	1808427	1798	g_18372	g_18373
Super-Scaffold_31	1808690	1810399	1709	g_18373	g_18374
Super-Scaffold_31	1817462	1818405	943	g_18374	g_18375
Super-Scaffold_31	1831779	1890254	58475	g_18375	g_18376
Super-Scaffold_31	1899882	1930617	30735	g_18376	g_18379
Super-Scaffold_31	1947051	1953418	6367	g_18379	g_18380
Super-Scaffold_31	1968171	2020610	52439	g_18380	g_18381
Super-Scaffold_31	2039211	2043263	4052	g_18381	g_18382
Super-Scaffold_31	2047744	2088383	40639	g_18382	g_18384
Super-Scaffold_31	2089148	2089993	845	g_18384	g_18385
Super-Scaffold_31	2090484	2100867	10383	g_18385	g_18386
Super-Scaffold_31	2102110	2102882	772	g_18386	g_18387
Super-Scaffold_31	2103217	2103274	57	g_18387	g_42507
Super-Scaffold_31	2103501	2103812	311	g_42507	g_18389
Super-Scaffold_31	2104039	2104833	794	g_18389	g_18390
Super-Scaffold_31	2130018	2138690	8672	g_18390	g_18391
Super-Scaffold_31	2149410	2160429	11019	g_18391	g_18392
Super-Scaffold_31	2160713	2199410	38697	g_18392	g_18395
Super-Scaffold_31	2222451	2231499	9048	g_18395	g_18396
Super-Scaffold_31	2247704	2288050	40346	g_18396	g_18399
Super-Scaffold_31	2289084	2307815	18731	g_18399	g_18401
Super-Scaffold_31	2308303	2308328	25	g_18401	g_18402
Super-Scaffold_31	2309209	2331421	22212	g_18402	g_18404
Super-Scaffold_31	2332836	2359215	26379	g_18404	g_18406
Super-Scaffold_31	2360288	2360568	280	g_18406	g_18407
Super-Scaffold_31	2360924	2366314	5390	g_18407	g_18408
Super-Scaffold_31	2366628	2382713	16085	g_18408	g_18409
Super-Scaffold_31	2383423	2383569	146	g_18409	g_18410
Super-Scaffold_31	2384087	2384471	384	g_18410	g_44438
Super-Scaffold_31	2385085	2389860	4775	g_44438	g_18411
Super-Scaffold_31	2396255	2412964	16709	g_18411	g_18412
Super-Scaffold_31	2413311	2449357	36046	g_18412	g_18414
Super-Scaffold_31	2465491	2487562	22071	g_18414	g_44439
Super-Scaffold_31	2491926	2492838	912	g_44439	g_18416
Super-Scaffold_31	2493944	2495001	1057	g_18416	g_18417
Super-Scaffold_31	2574356	2575653	1297	g_18417	g_44440
Super-Scaffold_31	2586250	2591948	5698	g_44440	g_18418
Super-Scaffold_31	2611432	2612855	1423	g_18418	g_18419
Super-Scaffold_31	2614600	2615246	646	g_18419	g_18420
Super-Scaffold_31	2615467	2615675	208	g_18420	g_18421
Super-Scaffold_31	2617693	2619902	2209	g_18421	g_18422
Super-Scaffold_31	2620234	2634090	13856	g_18422	g_18423
Super-Scaffold_31	2639504	2680656	41152	g_18423	g_18426
Super-Scaffold_31	2690678	2702482	11804	g_18426	g_18427
Super-Scaffold_31	2703028	2703699	671	g_18427	g_18428
Super-Scaffold_31	2706051	2708212	2161	g_18428	g_18429
Super-Scaffold_31	2717243	2724839	7596	g_18429	g_18432
Super-Scaffold_31	2726272	2726477	205	g_18432	g_18433
Super-Scaffold_31	2729384	2740350	10966	g_42513	g_18434
Super-Scaffold_31	2741150	2769354	28204	g_18434	g_18435
Super-Scaffold_31	2771444	2776429	4985	g_18435	g_18436
Super-Scaffold_31	2776722	2777358	636	g_18436	g_18437
Super-Scaffold_31	2777963	2778135	172	g_18437	g_18438
Super-Scaffold_31	2778350	2778855	505	g_18438	g_18439
Super-Scaffold_31	2789076	2876491	87415	g_18439	g_18446
Super-Scaffold_31	2877584	2878302	718	g_18446	g_18447
Super-Scaffold_31	2878580	2890194	11614	g_18447	g_44441
Super-Scaffold_31	2917211	2917339	128	g_44441	g_18448
Super-Scaffold_31	2922594	2922631	37	g_18448	g_18449
Super-Scaffold_31	2927562	2927599	37	g_18449	g_18450
Super-Scaffold_31	2929671	2930082	411	g_18450	g_44442
Super-Scaffold_31	2934755	2942057	7302	g_44442	g_44443
Super-Scaffold_31	2954932	2988960	34028	g_44443	g_18451
Super-Scaffold_31	2989346	2991455	2109	g_18451	g_18452
Super-Scaffold_31	3014775	3038577	23802	g_18452	g_18453
Super-Scaffold_31	3039898	3040664	766	g_18453	g_18454
Super-Scaffold_31	3048845	3078845	30000	g_18454	g_18455
Super-Scaffold_31	3079204	3079806	602	g_18455	g_18456
Super-Scaffold_31	3088667	3095575	6908	g_18456	g_18457
Super-Scaffold_31	3101961	3121673	19712	g_18457	g_18458
Super-Scaffold_31	3138357	3165723	27366	g_18458	g_18461
Super-Scaffold_31	3178847	3186251	7404	g_18462	g_18463
Super-Scaffold_31	3187336	3187468	132	g_18463	g_18464
Super-Scaffold_31	3187845	3193754	5909	g_18464	g_18466
Super-Scaffold_31	3194008	3216293	22285	g_18466	g_18467
Super-Scaffold_31	3218188	3248086	29898	g_18467	g_18471
Super-Scaffold_31	3276687	3279922	3235	g_18471	g_42519
Super-Scaffold_31	3280212	3281129	917	g_42519	g_18473
Super-Scaffold_31	3281587	3283016	1429	g_18473	g_18474
Super-Scaffold_31	3283321	3306257	22936	g_18474	g_18476
Super-Scaffold_31	3306664	3306809	145	g_18476	g_18477
Super-Scaffold_31	3307276	3307666	390	g_18477	g_18478
Super-Scaffold_31	3309096	3317681	8585	g_18478	g_18479
Super-Scaffold_31	3318430	3319856	1426	g_18479	g_18480
Super-Scaffold_31	3321235	3321616	381	g_18480	g_18481
Super-Scaffold_31	3322575	3328586	6011	g_18481	g_18482
Super-Scaffold_347	20691	42727	22036	g_38027	g_27085
Super-Scaffold_347	50803	66081	15278	g_27085	g_38028
Super-Scaffold_347	66323	96017	29694	g_38028	g_27087
Super-Scaffold_347	96262	103391	7129	g_27087	g_45097
Super-Scaffold_347	109457	111472	2015	g_45097	g_45098
Super-Scaffold_347	114114	117634	3520	g_45098	g_27088
Super-Scaffold_347	129741	132191	2450	g_27088	g_27089
Super-Scaffold_347	135364	144083	8719	g_27089	g_27090
Super-Scaffold_347	156224	158419	2195	g_27090	g_27091
Super-Scaffold_347	163624	176525	12901	g_27091	g_27093
Super-Scaffold_347	177607	189132	11525	g_27093	g_27094
Super-Scaffold_347	190280	203789	13509	g_27094	g_45099
Super-Scaffold_347	209398	216925	7527	g_45099	g_27096
Super-Scaffold_347	218319	224026	5707	g_27096	g_27097
Super-Scaffold_347	232010	240445	8435	g_27097	g_27098
Super-Scaffold_347	247030	262672	15642	g_27098	g_27099
Super-Scaffold_347	269367	272569	3202	g_27099	g_45100
Super-Scaffold_347	280501	299524	19023	g_45100	g_27101
Super-Scaffold_347	301305	301981	676	g_27101	g_45101
Super-Scaffold_347	308374	318606	10232	g_45101	g_27102
Super-Scaffold_347	323085	324215	1130	g_27102	g_27103
Super-Scaffold_347	331900	344771	12871	g_27103	g_27105
Super-Scaffold_347	352244	371380	19136	g_27105	g_27106
Super-Scaffold_347	380334	387373	7039	g_27106	g_27107
Super-Scaffold_347	396286	399619	3333	g_27107	g_27108
Super-Scaffold_347	409261	410594	1333	g_27108	g_27109
Super-Scaffold_347	412329	413397	1068	g_27109	g_27110
Super-Scaffold_347	415510	420175	4665	g_27110	g_27111
Super-Scaffold_347	420513	439570	19057	g_27111	g_27114
Super-Scaffold_347	439908	542506	102598	g_27114	g_27116
Super-Scaffold_347	543712	561379	17667	g_27116	g_27117
Super-Scaffold_347	562587	591915	29328	g_27117	g_27119
Super-Scaffold_347	595107	610200	15093	g_27119	g_27121
Super-Scaffold_347	615366	640599	25233	g_27121	g_27123
Super-Scaffold_347	647840	649194	1354	g_27123	g_45102
Super-Scaffold_347	650628	654908	4280	g_45102	g_27124
Super-Scaffold_347	655303	666075	10772	g_27124	g_27127
Super-Scaffold_347	667471	673672	6201	g_27127	g_45103
Super-Scaffold_347	679158	681102	1944	g_45103	g_27129
Super-Scaffold_347	686002	688217	2215	g_27129	g_27130
Super-Scaffold_347	698789	699650	861	g_27130	g_27131
Super-Scaffold_347	699976	700200	224	g_27131	g_27132
Super-Scaffold_347	700496	700540	44	g_27132	g_27133
Super-Scaffold_347	700896	746013	45117	g_27133	g_27134
Super-Scaffold_347	746582	748010	1428	g_27134	g_27136
Super-Scaffold_347	755153	762469	7316	g_27136	g_27137
Super-Scaffold_347	771432	773897	2465	g_27137	g_27138
Super-Scaffold_347	782439	793928	11489	g_27138	g_27140
Super-Scaffold_347	804259	804330	71	g_27140	g_45104
Super-Scaffold_347	809012	809678	666	g_45104	g_27141
Super-Scaffold_347	828525	829939	1414	g_27141	g_27142
Super-Scaffold_347	838615	839074	459	g_27142	g_27143
Super-Scaffold_347	842585	843156	571	g_27143	g_45105
Super-Scaffold_347	843809	845854	2045	g_45105	g_27144
Super-Scaffold_347	852241	853713	1472	g_27144	g_27148
Super-Scaffold_347	854036	854251	215	g_27146	g_27147
Super-Scaffold_347	854544	867506	12962	g_27147	g_27149
Super-Scaffold_347	884055	885690	1635	g_27149	g_27150
Super-Scaffold_347	899786	907964	8178	g_27150	g_27151
Super-Scaffold_347	915792	921269	5477	g_27151	g_27152
Super-Scaffold_347	923985	925797	1812	g_27152	g_27153
Super-Scaffold_347	933768	939613	5845	g_27153	g_45106
Super-Scaffold_347	945444	951025	5581	g_45106	g_27154
Super-Scaffold_347	957733	973577	15844	g_27154	g_27155
Super-Scaffold_347	974600	978807	4207	g_27155	g_27157
Super-Scaffold_347	988379	991672	3293	g_27157	g_27158
Super-Scaffold_347	992076	1008268	16192	g_27158	g_27160
Super-Scaffold_347	1020953	1028205	7252	g_27160	g_27161
Super-Scaffold_347	1031056	1034551	3495	g_27161	g_27162
Super-Scaffold_347	1035933	1043016	7083	g_27162	g_27163
Super-Scaffold_347	1059520	1063986	4466	g_27163	g_27164
Super-Scaffold_347	1071302	1073175	1873	g_27164	g_27165
Super-Scaffold_347	1074028	1083149	9121	g_27165	g_27166
Super-Scaffold_347	1084912	1118265	33353	g_27166	g_27168
Super-Scaffold_347	1119989	1133899	13910	g_27168	g_27169
Super-Scaffold_347	1151500	1161256	9756	g_27169	g_38033
Super-Scaffold_347	1161543	1162059	516	g_38033	g_27171
Super-Scaffold_347	1168975	1169179	204	g_27171	g_27172
Super-Scaffold_347	1169844	1172902	3058	g_27172	g_27174
Super-Scaffold_347	1175529	1191639	16110	g_27174	g_27175
Super-Scaffold_347	1195799	1196298	499	g_27175	g_27176
Super-Scaffold_347	1197572	1197886	314	g_27176	g_27177
Super-Scaffold_347	1198254	1200220	1966	g_27177	g_27178
Super-Scaffold_347	1201538	1212720	11182	g_38034	g_27179
Super-Scaffold_347	1220450	1229127	8677	g_27179	g_27180
Super-Scaffold_347	1235567	1247912	12345	g_27180	g_27181
Super-Scaffold_347	1253812	1258202	4390	g_27181	g_27182
Super-Scaffold_347	1259098	1259124	26	g_27182	g_45107
Super-Scaffold_347	1261196	1300053	38857	g_45107	g_27183
Super-Scaffold_347	1300295	1301242	947	g_27183	g_45108
Super-Scaffold_347	1315141	1325195	10054	g_45108	g_27184
Super-Scaffold_347	1348718	1350503	1785	g_27184	g_27185
Super-Scaffold_347	1380691	1477136	96445	g_27185	g_27186
Super-Scaffold_347	1508817	1578130	69313	g_27186	g_27187
Super-Scaffold_347	1610349	1623056	12707	g_27187	g_27188
Super-Scaffold_347	1640196	1653932	13736	g_27188	g_27189
Super-Scaffold_347	1661565	1666290	4725	g_27189	g_27190
Super-Scaffold_347	1666979	1672523	5544	g_27190	g_27191
Super-Scaffold_347	1673853	1678342	4489	g_27191	g_27192
Super-Scaffold_347	1680186	1683017	2831	g_27192	g_45109
Super-Scaffold_347	1684853	1703206	18353	g_45109	g_27193
Super-Scaffold_347	1704135	1713506	9371	g_27193	g_27194
Super-Scaffold_347	1715282	1718699	3417	g_27194	g_27195
Super-Scaffold_347	1720888	1730674	9786	g_27195	g_27196
Super-Scaffold_347	1733003	1754510	21507	g_27196	g_27197
Super-Scaffold_347	1756286	1759682	3396	g_27197	g_27198
Super-Scaffold_347	1761300	1771076	9776	g_27198	g_45110
Super-Scaffold_347	1773372	1786264	12892	g_45110	g_27199
Super-Scaffold_347	1788040	1791436	3396	g_27199	g_27200
Super-Scaffold_347	1793054	1802830	9776	g_27200	g_45111
Super-Scaffold_347	1805126	1818726	13600	g_45111	g_27201
Super-Scaffold_347	1819745	1819826	81	g_27201	g_27202
Super-Scaffold_347	1827822	1831824	4002	g_27202	g_27203
Super-Scaffold_347	1832943	1833175	232	g_38039	g_38040
Super-Scaffold_347	1833762	1837070	3308	g_38040	g_27204
Super-Scaffold_347	1838471	1850246	11775	g_27204	g_27206
Super-Scaffold_347	1851600	1855740	4140	g_27206	g_27207
Super-Scaffold_347	1856021	1856068	47	g_27207	g_27208
Super-Scaffold_347	1856379	1871524	15145	g_27208	g_38041
Super-Scaffold_347	1872384	1875206	2822	g_38041	g_27210
Super-Scaffold_347	1875845	1877191	1346	g_27210	g_27211
Super-Scaffold_347	1881474	1892884	11410	g_27211	g_45112
Super-Scaffold_347	1900764	1900949	185	g_45112	g_27212
Super-Scaffold_347	1901167	1907420	6253	g_27212	g_27214
Super-Scaffold_347	1929630	1941697	12067	g_27214	g_27215
Super-Scaffold_347	1943078	1988955	45877	g_27215	g_27218
Super-Scaffold_347	1989233	1989330	97	g_27218	g_27219
Super-Scaffold_347	1989704	1989820	116	g_27219	g_27220
Super-Scaffold_347	1990056	2006695	16639	g_27220	g_27221
Super-Scaffold_347	2007516	2116380	108864	g_27221	g_27223
Super-Scaffold_347	2120557	2223014	102457	g_27223	g_27225
Super-Scaffold_347	2223631	2258499	34868	g_27225	g_27227
Super-Scaffold_347	2267351	2269426	2075	g_27227	g_27228
Super-Scaffold_347	2283108	2308001	24893	g_27228	g_27229
Super-Scaffold_347	2315393	2321659	6266	g_27229	g_27230
Super-Scaffold_347	2331720	2332714	994	g_27230	g_27231
Super-Scaffold_347	2336300	2345656	9356	g_27231	g_45113
Super-Scaffold_347	2359975	2363912	3937	g_45113	g_27232
Super-Scaffold_347	2364558	2389460	24902	g_27232	g_27234
Super-Scaffold_347	2394954	2457029	62075	g_27234	g_27236
Super-Scaffold_347	2462920	2465857	2937	g_27236	g_27237
Super-Scaffold_347	2476415	2509261	32846	g_27237	g_27238
Super-Scaffold_347	2511358	2517819	6461	g_27238	g_27240
Super-Scaffold_347	2518484	2519408	924	g_27240	g_27241
Super-Scaffold_347	2520636	2528515	7879	g_27241	g_27243
Super-Scaffold_347	2530690	2535492	4802	g_27243	g_27244
Super-Scaffold_347	2544006	2550957	6951	g_27244	g_27245
Super-Scaffold_347	2551172	2551903	731	g_27245	g_27246
Super-Scaffold_347	2563102	2565790	2688	g_27246	g_27247
Super-Scaffold_347	2583627	2599396	15769	g_27247	g_27248
Super-Scaffold_347	2611052	2618196	7144	g_27248	g_45114
Super-Scaffold_347	2623009	2624266	1257	g_45114	g_27249
Super-Scaffold_347	2626401	2626646	245	g_27249	g_27250
Super-Scaffold_347	2634965	2636331	1366	g_27250	g_45115
Super-Scaffold_347	2694291	2747710	53419	g_45115	g_27254
Super-Scaffold_347	2780139	2877316	97177	g_27254	g_27256
Super-Scaffold_347	2877999	2962856	84857	g_27256	g_27257
Super-Scaffold_347	3043135	3050721	7586	g_27257	g_27258
Super-Scaffold_347	3052877	3068569	15692	g_27258	g_27259
Super-Scaffold_347	3070676	3073729	3053	g_38049	g_38050
Super-Scaffold_347	3075661	3080645	4984	g_27260	g_27261
Super-Scaffold_347	3082586	3083928	1342	g_38051	g_27262
Super-Scaffold_347	3093690	3103944	10254	g_27262	g_27264
Super-Scaffold_347	3104201	3106098	1897	g_27264	g_27265
Super-Scaffold_347	3114037	3121530	7493	g_27265	g_45116
Super-Scaffold_347	3128117	3141251	13134	g_45116	g_27266
Super-Scaffold_347	3142338	3148488	6150	g_27266	g_38054
Super-Scaffold_347	3149195	3151394	2199	g_38054	g_27268
Super-Scaffold_347	3152332	3153612	1280	g_27268	g_45117
Super-Scaffold_347	3154667	3157578	2911	g_45117	g_45118
Super-Scaffold_347	3158633	3159773	1140	g_45118	g_27269
Super-Scaffold_347	3160000	3160517	517	g_27269	g_45119
Super-Scaffold_347	3161572	3164343	2771	g_45119	g_27270
Super-Scaffold_347	3164570	3165087	517	g_27270	g_45120
Super-Scaffold_347	3166142	3171261	5119	g_45120	g_27271
Super-Scaffold_347	3171488	3172005	517	g_27271	g_45121
Super-Scaffold_347	3173060	3186523	13463	g_45121	g_45122
Super-Scaffold_347	3187578	3189994	2416	g_45122	g_27272
Super-Scaffold_347	3190470	3192956	2486	g_27272	g_27273
Super-Scaffold_347	3193429	3200296	6867	g_27273	g_27274
Super-Scaffold_347	3204036	3206890	2854	g_27274	g_45123
Super-Scaffold_347	3207746	3215477	7731	g_45123	g_27275
Super-Scaffold_347	3216432	3219192	2760	g_27275	g_27276
Super-Scaffold_347	3221037	3224894	3857	g_27276	g_27277
Super-Scaffold_347	3226892	3243054	16162	g_27277	g_27278
Super-Scaffold_347	3247455	3402111	154656	g_27278	g_27280
Super-Scaffold_347	3402341	3458091	55750	g_27280	g_27281
Super-Scaffold_347	3466532	3527365	60833	g_27281	g_27284
Super-Scaffold_347	3546978	3559409	12431	g_27284	g_27285
Super-Scaffold_347	3569025	3579642	10617	g_27285	g_27286
Super-Scaffold_347	3581125	3599590	18465	g_38057	g_27287
Super-Scaffold_347	3606531	3675651	69120	g_27287	g_27288
Super-Scaffold_347	3699990	3806172	106182	g_27288	g_27289
Super-Scaffold_347	3806471	3817567	11096	g_27289	g_27290
Super-Scaffold_347	3825650	3836220	10570	g_27290	g_27291
Super-Scaffold_347	3836783	3872854	36071	g_27291	g_38061
Super-Scaffold_347	3873078	3873909	831	g_38061	g_27292
Super-Scaffold_347	3886246	3893046	6800	g_27292	g_27293
Super-Scaffold_347	3894953	3894999	46	g_27293	g_27294
Super-Scaffold_347	3896125	3901952	5827	g_27294	g_27295
Super-Scaffold_347	3936298	3962173	25875	g_27295	g_27296
Super-Scaffold_347	3962693	3963314	621	g_27296	g_27297
Super-Scaffold_347	3964939	3970550	5611	g_27297	g_27298
Super-Scaffold_347	3971070	3976930	5860	g_27298	g_27300
Super-Scaffold_347	3979713	3984212	4499	g_27301	g_27302
Super-Scaffold_347	3984741	3992440	7699	g_27302	g_27304
Super-Scaffold_347	3994104	3996446	2342	g_27304	g_27306
Super-Scaffold_347	3998063	4083378	85315	g_27306	g_27310
Super-Scaffold_347	4087820	4098544	10724	g_27310	g_27311
Super-Scaffold_347	4101894	4153504	51610	g_27311	g_27312
Super-Scaffold_347	4172430	4183309	10879	g_27312	g_27313
Super-Scaffold_347	4214452	4308407	93955	g_27313	g_38062
Super-Scaffold_347	4309487	4315532	6045	g_27316	g_27317
Super-Scaffold_347	4321245	4324199	2954	g_27317	g_45124
Super-Scaffold_347	4325508	4351913	26405	g_45124	g_27318
Super-Scaffold_347	4355779	4359150	3371	g_27318	g_45125
Super-Scaffold_347	4363598	4373026	9428	g_45125	g_27319
Super-Scaffold_347	4378206	4379615	1409	g_27319	g_27320
Super-Scaffold_347	4384799	4386208	1409	g_27320	g_27321
Super-Scaffold_347	4390500	4403825	13325	g_27321	g_27322
Super-Scaffold_347	4410726	4417737	7011	g_27322	g_45126
Super-Scaffold_347	4422549	4429548	6999	g_45126	g_27323
Super-Scaffold_347	4434366	4444004	9638	g_27323	g_27324
Super-Scaffold_347	4445158	4447102	1944	g_27324	g_27325
Super-Scaffold_347	4448190	4452016	3826	g_27325	g_45127
Super-Scaffold_347	4458376	4474082	15706	g_45127	g_27327
Super-Scaffold_347	4480550	4491571	11021	g_27327	g_27328
Super-Scaffold_347	4497021	4507807	10786	g_27328	g_45128
Super-Scaffold_347	4508855	4510454	1599	g_45128	g_27329
Super-Scaffold_347	4511363	4517111	5748	g_27329	g_45129
Super-Scaffold_347	4518103	4520809	2706	g_45129	g_27330
Super-Scaffold_347	4521087	4523447	2360	g_27330	g_27332
Super-Scaffold_347	4527539	4531416	3877	g_27332	g_27333
Super-Scaffold_347	4536031	4669565	133534	g_27333	g_27335
Super-Scaffold_347	4669822	4675926	6104	g_27335	g_27336
Super-Scaffold_347	4677599	4680940	3341	g_27336	g_27337
Super-Scaffold_347	4681494	4777502	96008	g_27337	g_27339
Super-Scaffold_347	4785427	4798097	12670	g_27339	g_38066
Super-Scaffold_347	4798993	4799588	595	g_38066	g_27340
Super-Scaffold_347	4804927	4809904	4977	g_27340	g_27341
Super-Scaffold_347	4810224	4813255	3031	g_27341	g_38068
Super-Scaffold_347	4813458	4832054	18596	g_38068	g_27342
Super-Scaffold_347	4845928	4903561	57633	g_27342	g_27345
Super-Scaffold_347	4904983	4946216	41233	g_27345	g_27347
Super-Scaffold_347	4948609	4957768	9159	g_27347	g_27348
Super-Scaffold_347	4958028	4975429	17401	g_27348	g_27350
Super-Scaffold_347	4977299	5048192	70893	g_27350	g_27352
Super-Scaffold_347	5059275	5074695	15420	g_27352	g_27354
Super-Scaffold_347	5074901	5146649	71748	g_27354	g_27356
Super-Scaffold_347	5146951	5165233	18282	g_27356	g_27358
Super-Scaffold_347	5171846	5176141	4295	g_27358	g_27359
Super-Scaffold_347	5183369	5190338	6969	g_27359	g_27360
Super-Scaffold_347	5194024	5195669	1645	g_27360	g_45130
Super-Scaffold_347	5202864	5203854	990	g_45130	g_45131
Super-Scaffold_347	5207695	5217200	9505	g_45131	g_27361
Super-Scaffold_347	5223580	5227354	3774	g_27361	g_27362
Super-Scaffold_347	5231010	5236330	5320	g_27362	g_27363
Super-Scaffold_347	5245715	5250753	5038	g_27363	g_27364
Super-Scaffold_347	5264159	5267063	2904	g_27364	g_27365
Super-Scaffold_347	5269122	5280444	11322	g_27365	g_27366
Super-Scaffold_347	5306142	5308050	1908	g_27366	g_27367
Super-Scaffold_347	5323645	5326017	2372	g_27367	g_27368
Super-Scaffold_347	5331133	5334065	2932	g_27368	g_45132
Super-Scaffold_347	5344007	5344810	803	g_45132	g_27369
Super-Scaffold_347	5351808	5394363	42555	g_27369	g_27370
Super-Scaffold_347	5395629	5403306	7677	g_27370	g_27371
Super-Scaffold_347	5405389	5407927	2538	g_38070	g_27372
Super-Scaffold_347	5408712	5413107	4395	g_38071	g_27373
Super-Scaffold_347	5425415	5428039	2624	g_27373	g_27374
Super-Scaffold_347	5431755	5432808	1053	g_27374	g_27375
Super-Scaffold_347	5453019	5466584	13565	g_27375	g_27376
Super-Scaffold_347	5468976	5469025	49	g_27376	g_45133
Super-Scaffold_347	5469761	5472484	2723	g_45133	g_45134
Super-Scaffold_347	5476421	5478207	1786	g_45134	g_45135
Super-Scaffold_347	5483702	5488188	4486	g_45135	g_27378
Super-Scaffold_347	5491691	5504871	13180	g_27378	g_27379
Super-Scaffold_347	5506964	5515863	8899	g_27379	g_27380
Super-Scaffold_347	5517944	5537113	19169	g_27380	g_27381
Super-Scaffold_347	5542640	5544448	1808	g_27381	g_27382
Super-Scaffold_347	5545268	5546366	1098	g_27382	g_45136
Super-Scaffold_347	5547496	5604842	57346	g_45136	g_27385
Super-Scaffold_347	5606830	5614286	7456	g_27385	g_27386
Super-Scaffold_347	5617248	5621571	4323	g_27386	g_45137
Super-Scaffold_347	5627106	5628908	1802	g_45137	g_45138
Super-Scaffold_347	5629728	5630834	1106	g_45138	g_45139
Super-Scaffold_347	5631964	5652156	20192	g_45139	g_45140
Super-Scaffold_347	5658124	5689325	31201	g_45140	g_27389
Super-Scaffold_347	5691418	5699796	8378	g_27389	g_45141
Super-Scaffold_347	5707010	5708884	1874	g_45141	g_45142
Super-Scaffold_347	5713494	5714485	991	g_45142	g_27390
Super-Scaffold_347	5718473	5723913	5440	g_27390	g_27391
Super-Scaffold_347	5724701	5724712	11	g_27391	g_27392
Super-Scaffold_347	5725065	5725918	853	g_27392	g_27393
Super-Scaffold_347	5726771	5728111	1340	g_27393	g_27394
Super-Scaffold_347	5735450	5745503	10053	g_27394	g_27395
Super-Scaffold_347	5747434	5801887	54453	g_27395	g_27397
Super-Scaffold_347	5819221	5821869	2648	g_27397	g_27398
Super-Scaffold_347	5823011	5836266	13255	g_27398	g_27399
Super-Scaffold_347	5840202	5843700	3498	g_27399	g_27400
Super-Scaffold_347	5844849	5849566	4717	g_27400	g_27401
Super-Scaffold_347	5853591	5856451	2860	g_27401	g_27402
Super-Scaffold_347	5857459	5868378	10919	g_27402	g_27404
Super-Scaffold_347	5869335	5871468	2133	g_27404	g_27405
Super-Scaffold_347	5875310	5884863	9553	g_27405	g_45143
Super-Scaffold_347	5892735	5896884	4149	g_45143	g_45144
Super-Scaffold_347	5899321	5907691	8370	g_45144	g_27406
Super-Scaffold_347	5908884	5909007	123	g_27406	g_27407
Super-Scaffold_347	5909264	5912309	3045	g_27407	g_45145
Super-Scaffold_347	5914755	5919911	5156	g_45145	g_45146
Super-Scaffold_347	5925105	5937725	12620	g_45146	g_45147
Super-Scaffold_347	5942308	5943914	1606	g_45147	g_27408
Super-Scaffold_347	5956277	5995382	39105	g_27408	g_27410
Super-Scaffold_347	6001200	6021195	19995	g_27410	g_27411
Super-Scaffold_347	6049307	6060476	11169	g_27411	g_27412
Super-Scaffold_347	6067606	6076953	9347	g_27412	g_27413
Super-Scaffold_347	6079148	6084518	5370	g_27413	g_45148
Super-Scaffold_347	6086286	6090719	4433	g_45148	g_45149
Super-Scaffold_347	6092463	6102303	9840	g_45149	g_27414
Super-Scaffold_347	6114875	6117980	3105	g_27414	g_45150
Super-Scaffold_347	6130888	6134043	3155	g_45150	g_27415
Super-Scaffold_347	6137228	6141531	4303	g_27415	g_27416
Super-Scaffold_347	6149609	6182332	32723	g_27416	g_27418
Super-Scaffold_347	6185511	6191622	6111	g_27418	g_45151
Super-Scaffold_347	6196352	6200162	3810	g_45151	g_27419
Super-Scaffold_347	6204205	6208063	3858	g_27419	g_27420
Super-Scaffold_347	6211267	6211860	593	g_27420	g_27421
Super-Scaffold_347	6213776	6216777	3001	g_27421	g_27422
Super-Scaffold_347	6220755	6221875	1120	g_27422	g_27423
Super-Scaffold_347	6223424	6224652	1228	g_27423	g_27424
Super-Scaffold_347	6236084	6245158	9074	g_27424	g_27425
Super-Scaffold_347	6248106	6252566	4460	g_27425	g_27426
Super-Scaffold_347	6270843	6284217	13374	g_27426	g_27427
Super-Scaffold_347	6286879	6308560	21681	g_27427	g_27428
Super-Scaffold_347	6311181	6318314	7133	g_27428	g_27429
Super-Scaffold_347	6320830	6334982	14152	g_27429	g_45152
Super-Scaffold_347	6337007	6343214	6207	g_45152	g_45153
Super-Scaffold_347	6343981	6347608	3627	g_45153	g_27430
Super-Scaffold_347	6358493	6364014	5521	g_27430	g_45154
Super-Scaffold_347	6370350	6387762	17412	g_45154	g_27431
Super-Scaffold_347	6389521	6413289	23768	g_27431	g_27433
Super-Scaffold_347	6413876	6414873	997	g_27433	g_27434
Super-Scaffold_347	6415352	6415575	223	g_27434	g_27435
Super-Scaffold_347	6417146	6418423	1277	g_27435	g_27436
Super-Scaffold_347	6418920	6423714	4794	g_27436	g_38074
Super-Scaffold_347	6424841	6435687	10846	g_38074	g_27438
Super-Scaffold_347	6436538	6441505	4967	g_27438	g_27439
Super-Scaffold_347	6463449	6469896	6447	g_27439	g_27440
Super-Scaffold_347	6470159	6470263	104	g_27440	g_27441
Super-Scaffold_347	6477762	6485150	7388	g_27441	g_27442
Super-Scaffold_347	6489636	6490695	1059	g_27442	g_27443
Super-Scaffold_347	6495124	6505078	9954	g_27443	g_45155
Super-Scaffold_347	6510957	6602377	91420	g_45155	g_27444
Super-Scaffold_347	6609982	6611059	1077	g_27444	g_27445
Super-Scaffold_347	6611571	6617401	5830	g_27445	g_27447
Super-Scaffold_347	6618048	6671612	53564	g_27447	g_27449
Super-Scaffold_347	6673201	6702662	29461	g_27449	g_27450
Super-Scaffold_347	6708764	6752828	44064	g_27450	g_27451
Super-Scaffold_347	6758927	6853374	94447	g_27451	g_27452
Super-Scaffold_347	6860975	6862088	1113	g_27452	g_27453
Super-Scaffold_347	6862621	6868446	5825	g_27453	g_27455
Super-Scaffold_347	6869093	6906262	37169	g_27455	g_27456
Super-Scaffold_347	6909048	6911960	2912	g_27456	g_45156
Super-Scaffold_347	6917413	6937454	20041	g_45156	g_27457
Super-Scaffold_347	6939788	6942481	2693	g_27457	g_27458
Super-Scaffold_347	6966927	6971296	4369	g_27458	g_27459
Super-Scaffold_36	53726	65806	12080	g_4635	g_4637
Super-Scaffold_36	66765	75246	8481	g_4637	g_4638
Super-Scaffold_36	76196	119521	43325	g_4638	g_4640
Super-Scaffold_36	121374	121419	45	g_4640	g_4641
Super-Scaffold_36	122690	122730	40	g_4641	g_4642
Super-Scaffold_36	122990	123127	137	g_4642	g_41844
Super-Scaffold_36	123997	124197	200	g_4644	g_4645
Super-Scaffold_36	124487	124758	271	g_4645	g_4646
Super-Scaffold_36	125186	125233	47	g_4646	g_4647
Super-Scaffold_36	125755	126028	273	g_4648	g_4649
Super-Scaffold_36	126438	126485	47	g_4649	g_4650
Super-Scaffold_36	126733	126798	65	g_4650	g_4651
Super-Scaffold_36	127172	127446	274	g_4651	g_4652
Super-Scaffold_36	127877	127917	40	g_4652	g_4653
Super-Scaffold_36	128300	130057	1757	g_4653	g_4655
Super-Scaffold_36	138161	176705	38544	g_4655	g_4658
Super-Scaffold_36	177751	221803	44052	g_4658	g_4659
Super-Scaffold_36	234987	242776	7789	g_4660	g_4661
Super-Scaffold_36	255263	270122	14859	g_4661	g_4663
Super-Scaffold_36	271695	286370	14675	g_4663	g_43230
Super-Scaffold_36	303337	309649	6312	g_43230	g_4666
Super-Scaffold_36	321876	334309	12433	g_4666	g_4668
Super-Scaffold_36	337574	338962	1388	g_4668	g_4669
Super-Scaffold_36	339387	346974	7587	g_4669	g_4670
Super-Scaffold_36	347312	390830	43518	g_4670	g_4671
Super-Scaffold_36	394322	423251	28929	g_4671	g_4672
Super-Scaffold_36	426111	457447	31336	g_4672	g_4674
Super-Scaffold_36	462024	472270	10246	g_4674	g_4676
Super-Scaffold_36	474992	508563	33571	g_4676	g_4678
Super-Scaffold_36	519667	537298	17631	g_4678	g_4680
Super-Scaffold_36	549722	582827	33105	g_4680	g_4681
Super-Scaffold_36	583309	661526	78217	g_4681	g_4684
Super-Scaffold_36	672797	691023	18226	g_4684	g_4686
Super-Scaffold_36	708570	715347	6777	g_4686	g_4687
Super-Scaffold_36	722995	727202	4207	g_4687	g_43231
Super-Scaffold_36	739170	740056	886	g_43231	g_43232
Super-Scaffold_36	748226	753495	5269	g_43232	g_4689
Super-Scaffold_36	754628	755435	807	g_4689	g_41852
Super-Scaffold_36	756013	757542	1529	g_41852	g_4690
Super-Scaffold_36	762363	765141	2778	g_4690	g_4691
Super-Scaffold_36	765620	784290	18670	g_4691	g_4693
Super-Scaffold_36	784616	814702	30086	g_4693	g_4696
Super-Scaffold_36	815838	821412	5574	g_4696	g_4698
Super-Scaffold_36	832395	836174	3779	g_41853	g_41854
Super-Scaffold_36	836686	859527	22841	g_41854	g_4699
Super-Scaffold_36	860957	861002	45	g_4699	g_4700
Super-Scaffold_36	861691	861736	45	g_4700	g_4701
Super-Scaffold_36	862074	918576	56502	g_4701	g_4703
Super-Scaffold_36	931843	936844	5001	g_4703	g_43233
Super-Scaffold_36	946539	956506	9967	g_43233	g_4705
Super-Scaffold_36	957129	959023	1894	g_4705	g_4706
Super-Scaffold_36	959610	1009135	49525	g_4706	g_4708
Super-Scaffold_36	1017254	1023907	6653	g_4708	g_4710
Super-Scaffold_36	1025473	1025538	65	g_4710	g_43234
Super-Scaffold_36	1027439	1070224	42785	g_43234	g_4713
Super-Scaffold_36	1076290	1101226	24936	g_4713	g_4715
Super-Scaffold_36	1116389	1145222	28833	g_4715	g_4716
Super-Scaffold_36	1151309	1151806	497	g_4716	g_43235
Super-Scaffold_36	1162863	1166020	3157	g_43235	g_43236
Super-Scaffold_36	1170009	1175256	5247	g_43236	g_4718
Super-Scaffold_36	1177447	1187486	10039	g_4718	g_4719
Super-Scaffold_36	1187968	1198396	10428	g_4719	g_4720
Super-Scaffold_36	1205060	1227714	22654	g_4720	g_4722
Super-Scaffold_36	1236335	1258220	21885	g_4722	g_4725
Super-Scaffold_36	1258471	1286526	28055	g_4725	g_4727
Super-Scaffold_36	1287404	1335949	48545	g_4727	g_4729
Super-Scaffold_36	1349592	1359709	10117	g_4729	g_4730
Super-Scaffold_36	1366201	1456007	89806	g_4730	g_4732
Super-Scaffold_36	1530354	1543735	13381	g_4732	g_4734
Super-Scaffold_36	1545651	1547752	2101	g_4734	g_43237
Super-Scaffold_36	1554164	1580088	25924	g_43237	g_4737
Super-Scaffold_36	1581080	1604510	23430	g_4737	g_4738
Super-Scaffold_36	1604740	1608059	3319	g_4738	g_43238
Super-Scaffold_36	1608829	1703823	94994	g_43238	g_4740
Super-Scaffold_36	1704848	1927562	222714	g_4740	g_4747
Super-Scaffold_36	1937583	1962771	25188	g_4747	g_4748
Super-Scaffold_36	1965941	1974527	8586	g_4748	g_4749
Super-Scaffold_36	1978772	1979712	940	g_4749	g_4750
Super-Scaffold_36	1979942	1980091	149	g_4750	g_4751
Super-Scaffold_36	1980393	1980662	269	g_4751	g_4752
Super-Scaffold_36	1980916	1980949	33	g_4752	g_4753
Super-Scaffold_36	1981203	1981307	104	g_4753	g_4754
Super-Scaffold_36	1982017	1983928	1911	g_4754	g_4755
Super-Scaffold_36	1988752	2011749	22997	g_4755	g_4756
Super-Scaffold_36	2038872	2044354	5482	g_4756	g_4757
Super-Scaffold_36	2050267	2067935	17668	g_4757	g_4759
Super-Scaffold_36	2077250	2080047	2797	g_4759	g_4760
Super-Scaffold_36	2087824	2132375	44551	g_4760	g_4762
Super-Scaffold_36	2137569	2156813	19244	g_4762	g_4764
Super-Scaffold_36	2164125	2174891	10766	g_4764	g_4765
Super-Scaffold_36	2197928	2200617	2689	g_4765	g_4766
Super-Scaffold_388	32160	35932	3772	g_4586	g_4587
Super-Scaffold_388	36351	66867	30516	g_4587	g_4589
Super-Scaffold_388	68128	90756	22628	g_4589	g_4590
Super-Scaffold_388	121185	133038	11853	g_4590	g_4591
Super-Scaffold_388	139000	198308	59308	g_4591	g_4594
Super-Scaffold_388	198550	237573	39023	g_4594	g_4595
Super-Scaffold_388	238034	255571	17537	g_4595	g_4596
Super-Scaffold_388	260201	272029	11828	g_40102	g_4597
Super-Scaffold_388	274025	300051	26026	g_4597	g_4600
Super-Scaffold_388	306606	306949	343	g_4600	g_40103
Super-Scaffold_388	308073	320903	12830	g_40103	g_40104
Super-Scaffold_388	321112	323658	2546	g_40104	g_4602
Super-Scaffold_388	339126	348296	9170	g_4602	g_43227
Super-Scaffold_388	391516	421086	29570	g_43227	g_4603
Super-Scaffold_388	422474	433615	11141	g_4603	g_4604
Super-Scaffold_388	441719	450333	8614	g_4604	g_4605
Super-Scaffold_388	450821	473162	22341	g_4605	g_4607
Super-Scaffold_388	478091	480588	2497	g_4607	g_4608
Super-Scaffold_388	481241	493619	12378	g_4608	g_4609
Super-Scaffold_388	498564	509002	10438	g_4609	g_4611
Super-Scaffold_53	53196	54462	1266	g_18493	g_18494
Super-Scaffold_53	64240	65434	1194	g_18494	g_18495
Super-Scaffold_53	85579	98581	13002	g_18495	g_18496
Super-Scaffold_53	114468	141430	26962	g_18496	g_18497
Super-Scaffold_53	144772	322272	177500	g_18497	g_18499
Super-Scaffold_53	324919	331567	6648	g_18499	g_44444
Super-Scaffold_53	351669	359527	7858	g_44444	g_44445
Super-Scaffold_53	364233	373723	9490	g_44445	g_44446
Super-Scaffold_53	391616	412932	21316	g_44446	g_44447
Super-Scaffold_53	431183	452244	21061	g_44447	g_18502
Super-Scaffold_53	453836	467367	13531	g_18502	g_18503
Super-Scaffold_53	485830	491932	6102	g_18503	g_18504
Super-Scaffold_53	495478	536840	41362	g_18504	g_37164
Super-Scaffold_53	538210	577561	39351	g_37164	g_18507
Super-Scaffold_53	580137	586694	6557	g_18507	g_18508
Super-Scaffold_53	587023	590133	3110	g_18508	g_18509
Super-Scaffold_53	591602	593441	1839	g_18509	g_18510
Super-Scaffold_53	625974	638404	12430	g_18510	g_18512
Super-Scaffold_53	638640	694913	56273	g_18512	g_37167
Super-Scaffold_53	696043	717388	21345	g_37167	g_18517
Super-Scaffold_53	717642	726577	8935	g_18517	g_18518
Super-Scaffold_53	729866	740036	10170	g_18518	g_18520
Super-Scaffold_53	740410	783646	43236	g_18520	g_18521
Super-Scaffold_53	787523	807546	20023	g_18521	g_37169
Super-Scaffold_53	807746	890612	82866	g_37169	g_18524
Super-Scaffold_53	905445	906824	1379	g_18524	g_44448
Super-Scaffold_53	917998	928961	10963	g_44448	g_18525
Super-Scaffold_53	948059	954238	6179	g_18525	g_18527
Super-Scaffold_53	957409	1010431	53022	g_18527	g_18528
Super-Scaffold_53	1010670	1016146	5476	g_18528	g_18530
Super-Scaffold_53	1017136	1053252	36116	g_18530	g_18532
Super-Scaffold_53	1054682	1054721	39	g_18532	g_18531
Super-Scaffold_53	1055230	1063492	8262	g_18531	g_18534
Super-Scaffold_53	1064444	1069141	4697	g_18534	g_18536
Super-Scaffold_53	1074469	1081079	6610	g_18536	g_18538
Super-Scaffold_53	1094958	1098873	3915	g_18538	g_18539
Super-Scaffold_53	1100607	1100794	187	g_18539	g_44449
Super-Scaffold_53	1101234	1103636	2402	g_44449	g_18540
Super-Scaffold_53	1107781	1111929	4148	g_18540	g_44450
Super-Scaffold_53	1125818	1140609	14791	g_44450	g_18541
Super-Scaffold_53	1141496	1142386	890	g_18541	g_18542
Super-Scaffold_53	1142793	1146043	3250	g_18542	g_18543
Super-Scaffold_53	1146562	1146731	169	g_18543	g_18544
Super-Scaffold_54	42196	56687	14491	g_1195	g_1196
Super-Scaffold_54	73697	74510	813	g_1196	g_1197
Super-Scaffold_54	90839	92091	1252	g_1197	g_1198
Super-Scaffold_54	93887	94011	124	g_1198	g_1199
Super-Scaffold_54	94718	97905	3187	g_1199	g_40056
Super-Scaffold_54	98330	99741	1411	g_40056	g_40057
Super-Scaffold_54	100166	142209	42043	g_40057	g_1201
Super-Scaffold_54	156911	181306	24395	g_1201	g_42990
Super-Scaffold_54	187282	187801	519	g_42990	g_1202
Super-Scaffold_54	198026	261732	63706	g_1202	g_1206
Super-Scaffold_54	280294	286474	6180	g_1206	g_1207
Super-Scaffold_54	286992	319822	32830	g_1207	g_1209
Super-Scaffold_54	327244	329430	2186	g_1209	g_1210
Super-Scaffold_54	333026	333750	724	g_1210	g_1211
Super-Scaffold_54	334116	336219	2103	g_1211	g_42991
Super-Scaffold_54	340387	347117	6730	g_42991	g_1212
Super-Scaffold_54	356656	357288	632	g_40058	g_1213
Super-Scaffold_54	357533	378945	21412	g_1213	g_1214
Super-Scaffold_54	380418	386451	6033	g_1214	g_1215
Super-Scaffold_54	390572	390778	206	g_1215	g_40059
Super-Scaffold_54	390990	391237	247	g_40059	g_1216
Super-Scaffold_54	395082	395872	790	g_1216	g_1217
Super-Scaffold_54	405619	412829	7210	g_1217	g_1218
Super-Scaffold_54	413056	510764	97708	g_1218	g_1221
Super-Scaffold_54	511270	511995	725	g_1221	g_1222
Super-Scaffold_54	513174	522831	9657	g_1222	g_1223
Super-Scaffold_54	537161	538321	1160	g_1223	g_1224
Super-Scaffold_54	548389	549019	630	g_1224	g_1226
Super-Scaffold_54	550983	554266	3283	g_1226	g_1227
Super-Scaffold_54	554640	567008	12368	g_1227	g_1228
Super-Scaffold_54	574555	575770	1215	g_1228	g_1229
Super-Scaffold_54	576078	576401	323	g_1229	g_42992
Super-Scaffold_54	576646	577137	491	g_42992	g_1230
Super-Scaffold_54	577343	577365	22	g_1230	g_1231
Super-Scaffold_54	577616	602675	25059	g_1231	g_1234
Super-Scaffold_54	618454	620216	1762	g_1234	g_1235
Super-Scaffold_54	625195	626959	1764	g_40063	g_40064
Super-Scaffold_54	627870	647304	19434	g_40064	g_1236
Super-Scaffold_54	651923	652093	170	g_1236	g_1237
Super-Scaffold_54	659132	662223	3091	g_1237	g_42993
Super-Scaffold_54	681037	681227	190	g_40065	g_40066
Super-Scaffold_54	681913	729133	47220	g_40066	g_1238
Super-Scaffold_54	733859	745977	12118	g_1238	g_1239
Super-Scaffold_54	746416	756665	10249	g_1239	g_1240
Super-Scaffold_54	762368	769055	6687	g_1240	g_42994
Super-Scaffold_54	785606	819783	34177	g_42994	g_1241
Super-Scaffold_54	822214	838714	16500	g_40070	g_1242
Super-Scaffold_54	839538	841630	2092	g_1242	g_1243
Super-Scaffold_54	842148	844143	1995	g_1243	g_1244
Super-Scaffold_54	859951	862946	2995	g_1244	g_1245
Super-Scaffold_54	863830	870884	7054	g_1245	g_1247
Super-Scaffold_54	874290	874299	9	g_1247	g_1248
Super-Scaffold_54	874670	875872	1202	g_1248	g_1250
Super-Scaffold_54	881990	892951	10961	g_1250	g_1252
Super-Scaffold_54	898984	898995	11	g_1252	g_40073
Super-Scaffold_54	899216	899436	220	g_40073	g_1253
Super-Scaffold_54	899801	930600	30799	g_1253	g_40074
Super-Scaffold_54	930803	936584	5781	g_40074	g_1256
Super-Scaffold_54	937278	964211	26933	g_1256	g_1257
Super-Scaffold_54	965323	969566	4243	g_1257	g_1258
Super-Scaffold_54	969895	972297	2402	g_1258	g_1259
Super-Scaffold_54	972899	1035724	62825	g_1259	g_1263
Super-Scaffold_54	1035993	1037106	1113	g_1263	g_1264
Super-Scaffold_54	1037375	1037840	465	g_1264	g_1265
Super-Scaffold_54	1040260	1060979	20719	g_1265	g_1266
Super-Scaffold_54	1061377	1061547	170	g_1266	g_1267
Super-Scaffold_54	1061897	1061951	54	g_1267	g_1268
Super-Scaffold_54	1062379	1077643	15264	g_1268	g_1269
Super-Scaffold_54	1078968	1139033	60065	g_1269	g_1270
Super-Scaffold_54	1142474	1162813	20339	g_1270	g_1271
Super-Scaffold_54	1174924	1182124	7200	g_1271	g_1272
Super-Scaffold_54	1194976	1204517	9541	g_1272	g_1274
Super-Scaffold_54	1213234	1247501	34267	g_1274	g_1277
Super-Scaffold_54	1269579	1273076	3497	g_1277	g_1278
Super-Scaffold_54	1278373	1282879	4506	g_1278	g_1280
Super-Scaffold_54	1297022	1297085	63	g_1280	g_1281
Super-Scaffold_54	1298878	1306379	7501	g_1281	g_1282
Super-Scaffold_54	1308289	1340033	31744	g_1282	g_1285
Super-Scaffold_54	1340368	1344088	3720	g_1285	g_1286
Super-Scaffold_54	1344411	1345771	1360	g_1286	g_1287
Super-Scaffold_54	1362293	1363535	1242	g_1287	g_1288
Super-Scaffold_54	1378684	1384670	5986	g_1288	g_1290
Super-Scaffold_54	1386578	1387680	1102	g_1290	g_1291
Super-Scaffold_54	1389874	1391641	1767	g_1291	g_1292
Super-Scaffold_54	1397359	1427072	29713	g_1292	g_1294
Super-Scaffold_54	1433065	1437664	4599	g_1294	g_1295
Super-Scaffold_54	1437903	1438513	610	g_1295	g_1296
Super-Scaffold_54	1438752	1439257	505	g_1296	g_1297
Super-Scaffold_54	1439469	1624103	184634	g_1297	g_1300
Super-Scaffold_54	1624762	1723200	98438	g_1300	g_1303
Super-Scaffold_54	1723556	1746366	22810	g_1303	g_1304
Super-Scaffold_54	1746725	1761047	14322	g_1304	g_1306
Super-Scaffold_54	1761262	1761429	167	g_1306	g_1307
Super-Scaffold_54	1761728	1761809	81	g_1307	g_1308
Super-Scaffold_54	1762150	1762596	446	g_1308	g_1309
Super-Scaffold_54	1768564	1826847	58283	g_1309	g_1311
Super-Scaffold_54	1833557	1834307	750	g_1311	g_1312
Super-Scaffold_54	1840572	1911076	70504	g_1312	g_1315
Super-Scaffold_54	1916319	1935241	18922	g_1315	g_1316
Super-Scaffold_54	1946883	1949194	2311	g_1316	g_1317
Super-Scaffold_54	1956077	1959414	3337	g_1317	g_1318
Super-Scaffold_54	1967193	1983433	16240	g_1318	g_1320
Super-Scaffold_54	1995328	2001172	5844	g_1320	g_1321
Super-Scaffold_54	2006016	2013123	7107	g_1321	g_1322
Super-Scaffold_54	2032730	2039361	6631	g_1322	g_1323
Super-Scaffold_54	2061504	2067205	5701	g_1323	g_1324
Super-Scaffold_54	2072711	2073622	911	g_1324	g_1325
Super-Scaffold_54	2074476	2074895	419	g_1325	g_1326
Super-Scaffold_54	2078446	2102514	24068	g_1326	g_40090
Super-Scaffold_54	2103023	2120764	17741	g_40090	g_1327
Super-Scaffold_54	2122134	2122450	316	g_1327	g_1328
Super-Scaffold_54	2122740	2138541	15801	g_1328	g_1329
Super-Scaffold_54	2140762	2149871	9109	g_1329	g_1330
Super-Scaffold_54	2155934	2159737	3803	g_1330	g_1331
Super-Scaffold_54	2161998	2257803	95805	g_1331	g_1334
Super-Scaffold_54	2277170	2287527	10357	g_1334	g_40091
Super-Scaffold_54	2287763	2287788	25	g_40091	g_1336
Super-Scaffold_54	2288024	2288049	25	g_1336	g_1337
Super-Scaffold_54	2288507	2295553	7046	g_1337	g_1338
Super-Scaffold_54	2300812	2840715	539903	g_40092	g_1340
Super-Scaffold_54	2843000	2846103	3103	g_1340	g_1341
Super-Scaffold_54	2854600	2860703	6103	g_1341	g_40094
Super-Scaffold_54	2867041	2868524	1483	g_40094	g_40095
Super-Scaffold_54	2903383	2917805	14422	g_1342	g_1343
Super-Scaffold_54	2927343	2934632	7289	g_1343	g_1344
Super-Scaffold_54	2936545	2939268	2723	g_1344	g_1345
Super-Scaffold_54	2963312	2980889	17577	g_1345	g_1346
Super-Scaffold_54	3005664	3018561	12897	g_1346	g_1347
Super-Scaffold_54	3026284	3030220	3936	g_1347	g_1348
Super-Scaffold_54	3056165	3063702	7537	g_1348	g_1349
Super-Scaffold_54	3066054	3086783	20729	g_1349	g_1350
Super-Scaffold_54	3091726	3138750	47024	g_1350	g_1351
Super-Scaffold_54	3143920	3151047	7127	g_1351	g_1352
Super-Scaffold_54	3171362	3180093	8731	g_1352	g_1353
Super-Scaffold_54	3181310	3198658	17348	g_1353	g_1354
Super-Scaffold_54	3206281	3213764	7483	g_1354	g_1355
Super-Scaffold_54	3217995	3224394	6399	g_1355	g_42995
Super-Scaffold_54	3249981	3250608	627	g_42995	g_1356
Super-Scaffold_54	3292570	3293954	1384	g_1356	g_1357
Super-Scaffold_54	3314146	3317817	3671	g_1357	g_1358
Super-Scaffold_54	3332617	3336207	3590	g_1358	g_42996
Super-Scaffold_545	8365	36929	28564	g_6558	g_6559
Super-Scaffold_545	43726	61457	17731	g_6559	g_6563
Super-Scaffold_545	63672	63720	48	g_6563	g_6564
Super-Scaffold_545	64427	64535	108	g_6564	g_6565
Super-Scaffold_545	65617	68275	2658	g_6565	g_6566
Super-Scaffold_545	77754	101791	24037	g_6566	g_6567
Super-Scaffold_545	102390	104880	2490	g_6567	g_6568
Super-Scaffold_545	105179	105587	408	g_6568	g_43366
Super-Scaffold_545	109771	132590	22819	g_43366	g_6570
Super-Scaffold_545	145746	160623	14877	g_6570	g_6572
Super-Scaffold_545	161305	170824	9519	g_6572	g_6573
Super-Scaffold_545	172499	188814	16315	g_6573	g_6574
Super-Scaffold_545	189194	211227	22033	g_6574	g_43367
Super-Scaffold_545	214249	219034	4785	g_43367	g_6575
Super-Scaffold_545	223993	227501	3508	g_6575	g_6576
Super-Scaffold_545	229604	234926	5322	g_6576	g_6577
Super-Scaffold_545	235465	240252	4787	g_6577	g_36035
Super-Scaffold_545	240761	248578	7817	g_36035	g_6578
Super-Scaffold_545	248925	250005	1080	g_6578	g_6579
Super-Scaffold_545	250385	250878	493	g_6579	g_36036
Super-Scaffold_545	251165	252614	1449	g_36036	g_6580
Super-Scaffold_545	254017	256294	2277	g_6580	g_6581
Super-Scaffold_545	258072	284261	26189	g_6581	g_6582
Super-Scaffold_545	296873	298206	1333	g_6582	g_6584
Super-Scaffold_545	298550	298872	322	g_6584	g_6585
Super-Scaffold_545	299720	299754	34	g_6585	g_6586
Super-Scaffold_545	302000	302461	461	g_6586	g_43368
Super-Scaffold_545	304224	310059	5835	g_43368	g_6587
Super-Scaffold_545	323077	349821	26744	g_6587	g_6589
Super-Scaffold_545	367856	381597	13741	g_6589	g_6591
Super-Scaffold_545	383678	383854	176	g_6591	g_6592
Super-Scaffold_545	397783	400809	3026	g_6592	g_6593
Super-Scaffold_62	10741	10797	56	g_41517	g_41518
Super-Scaffold_62	11885	11909	24	g_41518	g_41519
Super-Scaffold_62	12289	57294	45005	g_41519	g_34357
Super-Scaffold_62	71227	73244	2017	g_34357	g_34358
Super-Scaffold_62	75434	82611	7177	g_34358	g_34360
Super-Scaffold_62	83387	88124	4737	g_34360	g_34361
Super-Scaffold_62	105241	109137	3896	g_34361	g_34362
Super-Scaffold_62	109421	136778	27357	g_34362	g_34363
Super-Scaffold_62	144124	146676	2552	g_34363	g_34364
Super-Scaffold_62	147320	149242	1922	g_34364	g_41522
Super-Scaffold_62	149907	150013	106	g_41522	g_34366
Super-Scaffold_62	157303	161216	3913	g_34366	g_34367
Super-Scaffold_62	168757	208242	39485	g_34367	g_34369
Super-Scaffold_62	213082	226230	13148	g_34369	g_34370
Super-Scaffold_62	245631	262904	17273	g_34370	g_34372
Super-Scaffold_62	284294	285291	997	g_34372	g_34373
Super-Scaffold_62	314138	318079	3941	g_34373	g_45625
Super-Scaffold_62	351108	353382	2274	g_45625	g_41525
Super-Scaffold_62	355262	361990	6728	g_41525	g_34375
Super-Scaffold_62	380288	387592	7304	g_34375	g_45626
Super-Scaffold_62	397307	400113	2806	g_45626	g_34377
Super-Scaffold_62	406486	415714	9228	g_34377	g_34379
Super-Scaffold_62	417441	418732	1291	g_34379	g_34380
Super-Scaffold_62	424389	440080	15691	g_34380	g_34381
Super-Scaffold_62	449579	533051	83472	g_34381	g_34383
Super-Scaffold_62	558880	630260	71380	g_34383	g_34384
Super-Scaffold_62	645604	647336	1732	g_34384	g_34385
Super-Scaffold_62	647743	687717	39974	g_34385	g_34387
Super-Scaffold_62	690656	716908	26252	g_34387	g_34388
Super-Scaffold_62	718668	719081	413	g_34388	g_34389
Super-Scaffold_66	24285	135872	111587	g_10871	g_10874
Super-Scaffold_66	136099	136226	127	g_10874	g_10875
Super-Scaffold_66	139457	145501	6044	g_10875	g_43858
Super-Scaffold_66	158770	159377	607	g_43858	g_10876
Super-Scaffold_66	173739	206188	32449	g_10876	g_10877
Super-Scaffold_66	211304	213369	2065	g_10877	g_10878
Super-Scaffold_66	213698	215843	2145	g_10878	g_10879
Super-Scaffold_66	217717	227707	9990	g_10879	g_40448
Super-Scaffold_66	227946	238550	10604	g_40448	g_43859
Super-Scaffold_66	238864	240138	1274	g_43859	g_10880
Super-Scaffold_66	240395	241660	1265	g_10880	g_10881
Super-Scaffold_66	241950	242040	90	g_10881	g_10882
Super-Scaffold_66	244905	308422	63517	g_10882	g_10885
Super-Scaffold_66	310136	322378	12242	g_40450	g_10886
Super-Scaffold_66	328173	330959	2786	g_10886	g_10887
Super-Scaffold_66	334409	336892	2483	g_10887	g_10888
Super-Scaffold_66	338892	355565	16673	g_10888	g_10889
Super-Scaffold_66	357848	361153	3305	g_10889	g_10891
Super-Scaffold_66	371799	394902	23103	g_10891	g_10893
Super-Scaffold_66	395528	458027	62499	g_10893	g_10899
Super-Scaffold_66	458740	465163	6423	g_10899	g_10902
Super-Scaffold_66	465816	2081113	1615297	g_10902	g_10905
Super-Scaffold_66	2087515	2089210	1695	g_10905	g_10908
Super-Scaffold_66	2113367	2140317	26950	g_10908	g_43860
Super-Scaffold_66	2160201	2182008	21807	g_43860	g_10910
Super-Scaffold_66	2241411	2248129	6718	g_10910	g_10911
Super-Scaffold_66	2278462	2290755	12293	g_10911	g_10912
Super-Scaffold_66	2291036	2291113	77	g_10912	g_10913
Super-Scaffold_66	2291424	2375639	84215	g_10913	g_10917
Super-Scaffold_66	2378355	2393729	15374	g_10917	g_10918
Super-Scaffold_66	2394523	2401891	7368	g_10918	g_10919
Super-Scaffold_66	2426507	2486043	59536	g_10919	g_10922
Super-Scaffold_66	2486453	2511833	25380	g_10922	g_10923
Super-Scaffold_66	2512084	2521170	9086	g_10923	g_10924
Super-Scaffold_66	2524170	2534792	10622	g_10924	g_10925
Super-Scaffold_66	2535262	2559776	24514	g_10925	g_10927
Super-Scaffold_66	2597016	2607330	10314	g_10927	g_10928
Super-Scaffold_66	2619449	2622116	2667	g_10928	g_10929
Super-Scaffold_66	2628577	2634717	6140	g_10929	g_10930
Super-Scaffold_66	2638090	2647939	9849	g_10930	g_10931
Super-Scaffold_66	2728356	2731006	2650	g_10931	g_43861
Super-Scaffold_66	2818261	2840394	22133	g_43861	g_10932
Super-Scaffold_66	2843430	2977988	134558	g_10932	g_10935
Super-Scaffold_66	3012089	3017212	5123	g_10935	g_10936
Super-Scaffold_66	3028767	3029073	306	g_10936	g_10937
Super-Scaffold_66	3049423	3100928	51505	g_10937	g_10939
Super-Scaffold_66	3102250	3189029	86779	g_10939	g_10942
Super-Scaffold_66	3190668	3208531	17863	g_10942	g_10943
Super-Scaffold_66	3238907	3263837	24930	g_10943	g_10945
Super-Scaffold_66	3268580	3276950	8370	g_10945	g_10946
Super-Scaffold_66	3277354	3278148	794	g_10946	g_10947
Super-Scaffold_66	3285369	3301098	15729	g_10947	g_10949
Super-Scaffold_66	3304328	3318451	14123	g_10949	g_10950
Super-Scaffold_66	3322621	3329276	6655	g_10950	g_10951
Super-Scaffold_66	3331672	3363038	31366	g_10951	g_10952
Super-Scaffold_66	3369363	3381818	12455	g_10952	g_10953
Super-Scaffold_66	3385298	3385347	49	g_10953	g_10954
Super-Scaffold_66	3407993	3408693	700	g_10954	g_10955
Super-Scaffold_66	3417777	3421586	3809	g_10955	g_10956
Super-Scaffold_66	3452800	3457374	4574	g_10956	g_10957
Super-Scaffold_66	3460955	3462993	2038	g_10957	g_43862
Super-Scaffold_66	3467137	3520806	53669	g_43862	g_10960
Super-Scaffold_66	3522830	3524443	1613	g_10960	g_43863
Super-Scaffold_66	3526944	3532448	5504	g_43863	g_10961
Super-Scaffold_66	3538759	3542750	3991	g_10961	g_10962
Super-Scaffold_66	3544512	3551916	7404	g_10962	g_10963
Super-Scaffold_66	3556614	3558335	1721	g_10963	g_10964
Super-Scaffold_66	3561308	3562938	1630	g_10964	g_10965
Super-Scaffold_66	3565903	3720748	154845	g_10965	g_10970
Super-Scaffold_66	3742742	3806796	64054	g_10970	g_10971
Super-Scaffold_66	3807002	3807111	109	g_10971	g_10972
Super-Scaffold_66	3807440	3811307	3867	g_10972	g_10973
Super-Scaffold_66	3811774	3838373	26599	g_10973	g_10975
Super-Scaffold_66	3852748	3856168	3420	g_10975	g_40461
Super-Scaffold_66	3856422	3861312	4890	g_40461	g_10976
Super-Scaffold_66	3865515	3868512	2997	g_10976	g_43864
Super-Scaffold_66	3871578	3872513	935	g_43864	g_10977
Super-Scaffold_66	3879798	3887296	7498	g_10977	g_10978
Super-Scaffold_66	3887721	3906578	18857	g_10978	g_10979
Super-Scaffold_66	3907096	3929740	22644	g_10979	g_10981
Super-Scaffold_66	3932880	3955266	22386	g_10981	g_10982
Super-Scaffold_66	3955772	3960176	4404	g_10982	g_10983
Super-Scaffold_66	3964748	3964954	206	g_10983	g_10984
Super-Scaffold_66	3971495	3974315	2820	g_10984	g_10985
Super-Scaffold_66	3975123	3977710	2587	g_10985	g_10986
Super-Scaffold_66	3996084	4001120	5036	g_10986	g_43865
Super-Scaffold_66	4005122	4011370	6248	g_43865	g_10987
Super-Scaffold_66	4014155	4015731	1576	g_10987	g_10988
Super-Scaffold_66	4019463	4023806	4343	g_10988	g_10989
Super-Scaffold_66	4024625	4024877	252	g_10989	g_43866
Super-Scaffold_66	4025344	4028055	2711	g_43866	g_10990
Super-Scaffold_66	4031304	4037791	6487	g_10990	g_10991
Super-Scaffold_66	4039606	4042727	3121	g_10991	g_43867
Super-Scaffold_66	4046483	4048154	1671	g_43867	g_43868
Super-Scaffold_66	4052752	4055557	2805	g_43868	g_10992
Super-Scaffold_66	4066580	4088379	21799	g_10992	g_10994
Super-Scaffold_66	4099222	4115584	16362	g_43869	g_10995
Super-Scaffold_66	4122742	4314167	191425	g_10995	g_10999
Super-Scaffold_66	4314412	4320090	5678	g_10999	g_11000
Super-Scaffold_66	4332290	4335505	3215	g_11000	g_11001
Super-Scaffold_66	4350439	4358923	8484	g_11001	g_11002
Super-Scaffold_66	4361329	4366374	5045	g_11002	g_11003
Super-Scaffold_66	4368096	4381215	13119	g_11003	g_11004
Super-Scaffold_66	4386190	4427706	41516	g_11004	g_11005
Super-Scaffold_66	4441159	4443289	2130	g_11005	g_11006
Super-Scaffold_66	4457944	4468486	10542	g_11006	g_11007
Super-Scaffold_66	4472361	4472404	43	g_11007	g_43870
Super-Scaffold_66	4475714	4487753	12039	g_43870	g_11008
Super-Scaffold_66	4488539	4524943	36404	g_11008	g_11010
Super-Scaffold_66	4538869	4566984	28115	g_11010	g_43871
Super-Scaffold_66	4576298	4600757	24459	g_43871	g_11011
Super-Scaffold_66	4603967	4650954	46987	g_11011	g_11012
Super-Scaffold_66	4652462	4665879	13417	g_11012	g_40463
Super-Scaffold_66	4666088	4666715	627	g_40463	g_11014
Super-Scaffold_66	4669968	4672771	2803	g_11014	g_11015
Super-Scaffold_66	4674621	4676759	2138	g_11015	g_11016
Super-Scaffold_66	4687846	4746414	58568	g_11016	g_11019
Super-Scaffold_66	4774917	4793600	18683	g_11019	g_43872
Super-Scaffold_66	4804710	4818339	13629	g_43872	g_43873
Super-Scaffold_66	4821680	4823921	2241	g_43873	g_43874
Super-Scaffold_66	4845238	4849702	4464	g_43874	g_43875
Super-Scaffold_66	4871026	4875678	4652	g_43875	g_11020
Super-Scaffold_66	4877015	4877309	294	g_11020	g_11021
Super-Scaffold_66	4877761	4885430	7669	g_11021	g_11022
Super-Scaffold_66	4889684	4893760	4076	g_11022	g_43876
Super-Scaffold_66	4904748	4931353	26605	g_43876	g_11023
Super-Scaffold_66	4945462	4945636	174	g_11023	g_43877
Super-Scaffold_66	4958496	4961738	3242	g_43877	g_11024
Super-Scaffold_66	4961995	4963025	1030	g_11024	g_11025
Super-Scaffold_66	4972032	4978091	6059	g_11025	g_11026
Super-Scaffold_66	4995000	4996310	1310	g_11026	g_11027
Super-Scaffold_66	4997497	4999466	1969	g_11027	g_11028
Super-Scaffold_66	5013584	5020565	6981	g_11028	g_11029
Super-Scaffold_66	5031502	5076143	44641	g_11029	g_11031
Super-Scaffold_66	5093198	5097632	4434	g_11031	g_43878
Super-Scaffold_66	5098060	5103114	5054	g_43878	g_11032
Super-Scaffold_66	5107574	5118802	11228	g_11032	g_43879
Super-Scaffold_66	5122038	5125609	3571	g_43879	g_43880
Super-Scaffold_66	5128136	5129460	1324	g_43880	g_43881
Super-Scaffold_66	5133187	5134843	1656	g_43881	g_11033
Super-Scaffold_66	5142049	5158998	16949	g_11034	g_11035
Super-Scaffold_66	5163142	5261905	98763	g_11035	g_11038
Super-Scaffold_66	5280240	5289709	9469	g_11038	g_40465
Super-Scaffold_66	5289975	5303630	13655	g_40465	g_11041
Super-Scaffold_66	5323119	5327560	4441	g_11041	g_11042
Super-Scaffold_66	5353007	5355840	2833	g_11042	g_11043
Super-Scaffold_66	5356088	5359330	3242	g_11043	g_11044
Super-Scaffold_66	5369372	5392742	23370	g_11044	g_11046
Super-Scaffold_66	5395078	5404094	9016	g_11046	g_43882
Super-Scaffold_66	5407845	5424514	16669	g_43882	g_11047
Super-Scaffold_66	5426318	5438301	11983	g_11047	g_11048
Super-Scaffold_66	5441973	5443927	1954	g_11048	g_11049
Super-Scaffold_66	5447330	5448881	1551	g_11049	g_11050
Super-Scaffold_66	5511820	5532999	21179	g_11050	g_11051
Super-Scaffold_66	5540243	5543842	3599	g_11051	g_11052
Super-Scaffold_66	5564827	5565188	361	g_11052	g_11053
Super-Scaffold_66	5582957	5599731	16774	g_11053	g_11054
Super-Scaffold_66	5611765	5645905	34140	g_11054	g_11055
Super-Scaffold_66	5659051	5683122	24071	g_11055	g_11057
Super-Scaffold_66	5706854	5709437	2583	g_11057	g_11058
Super-Scaffold_66	5767097	5826491	59394	g_11058	g_11060
Super-Scaffold_66	5840597	5851748	11151	g_11060	g_11061
Super-Scaffold_66	5884300	5929831	45531	g_11061	g_11062
Super-Scaffold_66	5931744	5933427	1683	g_11062	g_11063
Super-Scaffold_66	5945342	5972417	27075	g_11063	g_11064
Super-Scaffold_66	6043245	6122373	79128	g_11064	g_11066
Super-Scaffold_66	6122759	6201009	78250	g_11066	g_11068
Super-Scaffold_66	6201242	6278877	77635	g_11068	g_11070
Super-Scaffold_66	6279398	6577308	297910	g_11070	g_11074
Super-Scaffold_66	6577913	6769108	191195	g_11074	g_11075
Super-Scaffold_66	6850760	6852415	1655	g_11075	g_11076
Super-Scaffold_66	6854935	6858649	3714	g_11076	g_43883
Super-Scaffold_66	6862107	6865573	3466	g_43883	g_11077
Super-Scaffold_66	6866445	6869346	2901	g_11077	g_11078
Super-Scaffold_66	6870911	6872458	1547	g_11078	g_11079
Super-Scaffold_66	6880133	6886475	6342	g_11079	g_43884
Super-Scaffold_66	6890466	6893173	2707	g_43884	g_11080
Super-Scaffold_66	6896739	6900929	4190	g_11080	g_43885
Super-Scaffold_66	6907051	6919924	12873	g_43885	g_11082
Super-Scaffold_66	6921139	6926328	5189	g_11082	g_11083
Super-Scaffold_66	6951429	6952033	604	g_11083	g_11084
Super-Scaffold_66	6955887	6967724	11837	g_11084	g_11085
Super-Scaffold_66	6972301	6980894	8593	g_11085	g_11086
Super-Scaffold_66	6991995	6992936	941	g_11086	g_11087
Super-Scaffold_66	6996973	7054998	58025	g_11087	g_11089
Super-Scaffold_66	7060074	7066327	6253	g_11089	g_11090
Super-Scaffold_66	7069691	7069990	299	g_11090	g_11091
Super-Scaffold_66	7084641	7096538	11897	g_11091	g_11092
Super-Scaffold_66	7098962	7112624	13662	g_11092	g_11093
Super-Scaffold_66	7112827	7216812	103985	g_11093	g_11095
Super-Scaffold_66	7217673	7224371	6698	g_11095	g_11096
Super-Scaffold_66	7225042	7227872	2830	g_11096	g_11097
Super-Scaffold_66	7228598	7230522	1924	g_11097	g_11098
Super-Scaffold_66	7232464	7316751	84287	g_11098	g_11099
Super-Scaffold_66	7318222	7320537	2315	g_11099	g_11100
Super-Scaffold_66	7321263	7322957	1694	g_11100	g_11101
Super-Scaffold_66	7325110	7459012	133902	g_11101	g_11106
Super-Scaffold_66	7459673	7578089	118416	g_11106	g_11107
Super-Scaffold_66	7579852	7581130	1278	g_11107	g_43886
Super-Scaffold_66	7581354	7604252	22898	g_43886	g_11109
Super-Scaffold_66	7608002	7694576	86574	g_11109	g_11110
Super-Scaffold_66	7700331	7707790	7459	g_11110	g_11111
Super-Scaffold_66	7723173	7724924	1751	g_11111	g_11112
Super-Scaffold_66	7734247	7762884	28637	g_11112	g_11113
Super-Scaffold_66	7781136	7784031	2895	g_11113	g_11114
Super-Scaffold_66	7790426	7802884	12458	g_11114	g_43887
Super-Scaffold_66	7815836	7829262	13426	g_43887	g_11115
Super-Scaffold_66	7874792	7884983	10191	g_11115	g_11116
Super-Scaffold_66	7899261	7912511	13250	g_11116	g_11117
Super-Scaffold_66	7915032	7920714	5682	g_11117	g_11118
Super-Scaffold_66	7942648	7946924	4276	g_11118	g_11119
Super-Scaffold_66	7962001	7967805	5804	g_11119	g_11120
Super-Scaffold_66	7975149	7977369	2220	g_11120	g_43888
Super-Scaffold_66	7981821	7982644	823	g_43888	g_11121
Super-Scaffold_66	7988553	7992115	3562	g_11121	g_11122
Super-Scaffold_66	8000286	8003274	2988	g_11122	g_11123
Super-Scaffold_66	8048118	8082185	34067	g_11123	g_11124
Super-Scaffold_66	8083760	8136168	52408	g_11124	g_11127
Super-Scaffold_66	8150027	8158958	8931	g_11127	g_11128
Super-Scaffold_66	8174783	8177690	2907	g_11128	g_11129
Super-Scaffold_66	8177953	8188558	10605	g_11129	g_11130
Super-Scaffold_66	8188788	8211155	22367	g_11130	g_11132
Super-Scaffold_66	8211547	8267413	55866	g_11132	g_11136
Super-Scaffold_66	8273183	8278239	5056	g_11136	g_11137
Super-Scaffold_66	8289632	8295781	6149	g_11137	g_11138
Super-Scaffold_66	8373008	8376083	3075	g_11138	g_11139
Super-Scaffold_66	8384890	8387279	2389	g_11139	g_11140
Super-Scaffold_66	8387635	8404581	16946	g_11140	g_40481
Super-Scaffold_66	8404793	8438772	33979	g_40481	g_11142
Super-Scaffold_66	8470396	8534917	64521	g_11142	g_11145
Super-Scaffold_66	8549301	8552395	3094	g_11145	g_11146
Super-Scaffold_66	8555391	8556219	828	g_11146	g_11147
Super-Scaffold_66	8570773	8573526	2753	g_11147	g_11148
Super-Scaffold_66	8576205	8577976	1771	g_11148	g_11149
Super-Scaffold_66	8590731	8595443	4712	g_11149	g_11150
Super-Scaffold_66	8596221	8600273	4052	g_11150	g_11151
Super-Scaffold_66	8620410	8626085	5675	g_11151	g_11152
Super-Scaffold_66	8631003	8640131	9128	g_11152	g_11153
Super-Scaffold_66	8658129	8675903	17774	g_11153	g_11154
Super-Scaffold_66	8682603	8690530	7927	g_11154	g_11155
Super-Scaffold_66	8694537	8695712	1175	g_11155	g_11156
Super-Scaffold_66	8699914	8700852	938	g_11156	g_43889
Super-Scaffold_66	8703602	8704510	908	g_43889	g_11157
Super-Scaffold_66	8705034	8705972	938	g_11157	g_11158
Super-Scaffold_66	8721306	8742445	21139	g_11158	g_11161
Super-Scaffold_66	8851476	8887297	35821	g_11161	g_11164
Super-Scaffold_66	8888832	8891483	2651	g_11164	g_11165
Super-Scaffold_66	8894427	8896345	1918	g_11165	g_43890
Super-Scaffold_66	8899609	8919567	19958	g_43890	g_11166
Super-Scaffold_66	8919827	9016338	96511	g_11166	g_11168
Super-Scaffold_66	9027695	9054541	26846	g_11168	g_11169
Super-Scaffold_66	9054846	9082646	27800	g_11169	g_11171
Super-Scaffold_66	9098690	9102796	4106	g_11171	g_43891
Super-Scaffold_66	9104738	9114863	10125	g_43891	g_11172
Super-Scaffold_66	9135696	9142236	6540	g_11173	g_11174
Super-Scaffold_66	9146249	9152315	6066	g_11174	g_11175
Super-Scaffold_66	9165179	9165217	38	g_40492	g_11176
Super-Scaffold_66	9165471	9169962	4491	g_11176	g_11177
Super-Scaffold_66	9187505	9196464	8959	g_11177	g_11178
Super-Scaffold_66	9201847	9217299	15452	g_11178	g_11179
Super-Scaffold_66	9217538	9227991	10453	g_11179	g_11180
Super-Scaffold_66	9228218	9366433	138215	g_11180	g_11184
Super-Scaffold_66	9366753	9370136	3383	g_11184	g_11185
Super-Scaffold_66	9392237	9395485	3248	g_11185	g_11186
Super-Scaffold_66	9478958	9498089	19131	g_11186	g_11187
Super-Scaffold_66	9546621	9585313	38692	g_11187	g_11188
Super-Scaffold_66	9599833	9683948	84115	g_11188	g_11189
Super-Scaffold_66	9684202	9684611	409	g_11189	g_11190
Super-Scaffold_66	9749579	9762708	13129	g_11190	g_11191
Super-Scaffold_66	9769318	9782432	13114	g_11191	g_43892
Super-Scaffold_66	9802173	9813174	11001	g_43892	g_11192
Super-Scaffold_66	9816187	9845562	29375	g_11192	g_40495
Super-Scaffold_66	9845792	9862005	16213	g_40495	g_11194
Super-Scaffold_66	9868182	9869368	1186	g_11194	g_11195
Super-Scaffold_66	9870579	9871811	1232	g_11195	g_11196
Super-Scaffold_66	9872751	9874869	2118	g_11196	g_43893
Super-Scaffold_66	9878266	9880145	1879	g_43893	g_11197
Super-Scaffold_66	9886640	9891798	5158	g_11197	g_11198
Super-Scaffold_66	9898041	9899091	1050	g_11198	g_11199
Super-Scaffold_66	9923640	9934456	10816	g_11199	g_11200
Super-Scaffold_66	9935696	9937355	1659	g_11200	g_11201
Super-Scaffold_66	9943996	9945926	1930	g_11201	g_11202
Super-Scaffold_66	9955760	9964198	8438	g_11202	g_11203
Super-Scaffold_66	9965607	10001836	36229	g_11203	g_11205
Super-Scaffold_66	10050096	10058597	8501	g_11205	g_11206
Super-Scaffold_66	10063342	10080818	17476	g_11206	g_11207
Super-Scaffold_66	10093859	10095413	1554	g_11207	g_43894
Super-Scaffold_66	10104606	10107659	3053	g_43894	g_11208
Super-Scaffold_66	10109173	10112385	3212	g_11208	g_11209
Super-Scaffold_66	10125330	10156707	31377	g_11209	g_11211
Super-Scaffold_66	10157251	10161190	3939	g_11211	g_11212
Super-Scaffold_66	10165758	10185913	20155	g_11212	g_11213
Super-Scaffold_66	10192603	10197337	4734	g_11213	g_11215
Super-Scaffold_66	10203955	10220271	16316	g_11215	g_40499
Super-Scaffold_66	10220546	10226539	5993	g_40499	g_11216
Super-Scaffold_66	10231464	10235553	4089	g_11216	g_11217
Super-Scaffold_66	10251412	10259285	7873	g_11217	g_11218
Super-Scaffold_66	10259713	10278144	18431	g_11218	g_11219
Super-Scaffold_66	10295093	10311580	16487	g_11219	g_11220
Super-Scaffold_66	10312518	10313110	592	g_11220	g_11221
Super-Scaffold_66	10313376	10384928	71552	g_11221	g_40504
Super-Scaffold_66	10385134	10469268	84134	g_40504	g_11227
Super-Scaffold_66	10469555	10470623	1068	g_11227	g_40506
Super-Scaffold_66	10470826	10478074	7248	g_40506	g_11228
Super-Scaffold_66	10478346	10481880	3534	g_11228	g_11229
Super-Scaffold_66	10482086	10501157	19071	g_11229	g_11232
Super-Scaffold_66	10501408	10502285	877	g_11232	g_11231
Super-Scaffold_66	10518271	10604296	86025	g_11231	g_11238
Super-Scaffold_66	10604529	10637715	33186	g_11238	g_11241
Super-Scaffold_66	10638101	10638688	587	g_11241	g_11242
Super-Scaffold_66	10655784	10661617	5833	g_11242	g_11243
Super-Scaffold_66	10674823	10676420	1597	g_11243	g_11244
Super-Scaffold_66	10678697	10680644	1947	g_11244	g_11245
Super-Scaffold_66	10684503	10686255	1752	g_11245	g_11246
Super-Scaffold_66	10700881	10706838	5957	g_11246	g_11247
Super-Scaffold_66	10711629	10717667	6038	g_11247	g_11248
Super-Scaffold_66	10722009	10728846	6837	g_11248	g_43895
Super-Scaffold_66	10735273	10741128	5855	g_43895	g_11249
Super-Scaffold_66	10745914	10750304	4390	g_11249	g_11250
Super-Scaffold_66	10754416	10758468	4052	g_11250	g_11251
Super-Scaffold_66	10766207	10767190	983	g_11251	g_11252
Super-Scaffold_66	10770920	10774629	3709	g_11252	g_11253
Super-Scaffold_66	10791678	10793722	2044	g_11253	g_11254
Super-Scaffold_66	10797084	10816101	19017	g_11254	g_11255
Super-Scaffold_66	10816355	10818054	1699	g_11255	g_11256
Super-Scaffold_66	10824594	10900340	75746	g_11256	g_11258
Super-Scaffold_66	10903423	10912721	9298	g_11258	g_11259
Super-Scaffold_66	10919525	11001664	82139	g_11259	g_11263
Super-Scaffold_66	11003490	11003673	183	g_11263	g_11264
Super-Scaffold_66	11005780	11005894	114	g_11264	g_11265
Super-Scaffold_66	11006634	11006785	151	g_11265	g_11262
Super-Scaffold_66	11018822	11021380	2558	g_11262	g_11266
Super-Scaffold_66	11021613	11024320	2707	g_11266	g_43896
Super-Scaffold_66	11031571	11035544	3973	g_43896	g_11267
Super-Scaffold_66	11052852	11070523	17671	g_11267	g_11268
Super-Scaffold_66	11074403	11078609	4206	g_11268	g_11270
Super-Scaffold_66	11101001	11101048	47	g_11270	g_11271
Super-Scaffold_66	11101359	11114382	13023	g_11271	g_11272
Super-Scaffold_66	11120962	11125641	4679	g_11272	g_11273
Super-Scaffold_66	11142502	11174419	31917	g_11273	g_11275
Super-Scaffold_66	11180466	11181552	1086	g_11275	g_11276
Super-Scaffold_66	11192357	11197213	4856	g_11276	g_11277
Super-Scaffold_66	11230629	11240532	9903	g_11277	g_11278
Super-Scaffold_66	11241635	11249203	7568	g_11278	g_11280
Super-Scaffold_66	11252239	11254205	1966	g_11280	g_11281
Super-Scaffold_66	11257241	11257373	132	g_11281	g_40513
Super-Scaffold_66	11257636	11279013	21377	g_40513	g_11283
Super-Scaffold_66	11283050	11290267	7217	g_11283	g_11284
Super-Scaffold_66	11297506	11323333	25827	g_11284	g_11286
Super-Scaffold_66	11331413	11334928	3515	g_11286	g_11287
Super-Scaffold_66	11342638	11345600	2962	g_11287	g_11288
Super-Scaffold_66	11358041	11359767	1726	g_11288	g_11289
Super-Scaffold_66	11367738	11368727	989	g_11289	g_11290
Super-Scaffold_66	11371536	11380411	8875	g_11290	g_11291
Super-Scaffold_66	11387741	11391236	3495	g_11291	g_11292
Super-Scaffold_66	11401907	11420384	18477	g_11292	g_11293
Super-Scaffold_66	11421883	11427401	5518	g_11293	g_11294
Super-Scaffold_66	11433641	11442366	8725	g_11294	g_43897
Super-Scaffold_66	11464458	11474094	9636	g_43897	g_43898
Super-Scaffold_66	11495728	11512694	16966	g_43898	g_43899
Super-Scaffold_66	11518937	11535213	16276	g_43899	g_43900
Super-Scaffold_66	11543022	11546802	3780	g_43900	g_40515
Super-Scaffold_66	11549914	11599397	49483	g_40515	g_11296
Super-Scaffold_66	11601217	11650073	48856	g_11296	g_11297
Super-Scaffold_66	11655081	11662504	7423	g_11297	g_11298
Super-Scaffold_66	11664093	11780819	116726	g_11298	g_11301
Super-Scaffold_66	11786249	11787920	1671	g_11301	g_11302
Super-Scaffold_66	11795674	11803776	8102	g_11302	g_11303
Super-Scaffold_66	11816889	11819169	2280	g_11303	g_11304
Super-Scaffold_66	11819759	11823132	3373	g_11304	g_11305
Super-Scaffold_66	11837297	11853027	15730	g_11305	g_43901
Super-Scaffold_66	11867618	11874359	6741	g_43901	g_43902
Super-Scaffold_66	11889375	11916975	27600	g_43902	g_11306
Super-Scaffold_66	11932646	11961001	28355	g_11306	g_11307
Super-Scaffold_66	11965148	11966236	1088	g_11307	g_11308
Super-Scaffold_66	11974131	11976491	2360	g_11308	g_11309
Super-Scaffold_66	11977990	11992345	14355	g_11309	g_11310
Super-Scaffold_66	11993340	11994733	1393	g_11310	g_11311
Super-Scaffold_66	11995731	11999906	4175	g_11311	g_11312
Super-Scaffold_66	12023566	12037618	14052	g_11312	g_11313
Super-Scaffold_66	12045495	12063789	18294	g_11313	g_11316
Super-Scaffold_66	12071233	12072336	1103	g_11316	g_11317
Super-Scaffold_66	12095152	12099260	4108	g_11317	g_11318
Super-Scaffold_66	12100902	12111816	10914	g_11318	g_11320
Super-Scaffold_66	12114145	12126246	12101	g_11320	g_11321
Super-Scaffold_66	12126803	12150586	23783	g_11321	g_11325
Super-Scaffold_66	12159116	12172719	13603	g_11325	g_40521
Super-Scaffold_66	12172928	12207401	34473	g_40521	g_11327
Super-Scaffold_66	12212177	12224600	12423	g_11327	g_43903
Super-Scaffold_66	12226968	12262013	35045	g_43903	g_11331
Super-Scaffold_66	12262354	12298079	35725	g_11331	g_11332
Super-Scaffold_66	12313652	12326773	13121	g_11332	g_11333
Super-Scaffold_66	12331885	12356457	24572	g_11333	g_11336
Super-Scaffold_66	12366352	12378549	12197	g_11336	g_11337
Super-Scaffold_66	12386748	12388242	1494	g_11337	g_43904
Super-Scaffold_66	12392308	12394562	2254	g_43904	g_11338
Super-Scaffold_66	12402268	12403446	1178	g_11338	g_11339
Super-Scaffold_66	12409473	12483097	73624	g_11339	g_11344
Super-Scaffold_66	12483342	12484285	943	g_11344	g_11345
Super-Scaffold_66	12486826	12496637	9811	g_11345	g_11347
Super-Scaffold_66	12496921	12546256	49335	g_11347	g_11352
Super-Scaffold_66	12549971	12565296	15325	g_11352	g_11353
Super-Scaffold_66	12565598	12568457	2859	g_11353	g_40526
Super-Scaffold_66	12568684	12582271	13587	g_40526	g_11355
Super-Scaffold_66	12582720	12598903	16183	g_11355	g_11356
Super-Scaffold_66	12599115	12616079	16964	g_11356	g_11357
Super-Scaffold_66	12616309	12634449	18140	g_11357	g_11359
Super-Scaffold_66	12644719	12646604	1885	g_11359	g_11360
Super-Scaffold_66	12648027	12649645	1618	g_11360	g_11361
Super-Scaffold_66	12654163	12656217	2054	g_11361	g_11362
Super-Scaffold_66	12656600	12705453	48853	g_11362	g_11363
Super-Scaffold_66	12706040	12711292	5252	g_11363	g_11364
Super-Scaffold_66	12711492	12721125	9633	g_11364	g_11365
Super-Scaffold_66	12744081	12747887	3806	g_11365	g_11366
Super-Scaffold_66	12752887	12753852	965	g_11366	g_11367
Super-Scaffold_66	12757408	12758482	1074	g_11367	g_11368
Super-Scaffold_66	12763721	12765582	1861	g_11368	g_11369
Super-Scaffold_66	12769014	12855836	86822	g_11369	g_11372
Super-Scaffold_66	12868553	12874395	5842	g_11372	g_11373
Super-Scaffold_66	12904718	12909440	4722	g_11373	g_11375
Super-Scaffold_66	12916818	12924875	8057	g_11375	g_11376
Super-Scaffold_66	12933505	12937632	4127	g_11376	g_11377
Super-Scaffold_66	12937988	12942233	4245	g_11377	g_43905
Super-Scaffold_66	12942547	12949452	6905	g_43905	g_11378
Super-Scaffold_66	12955779	12958320	2541	g_11378	g_11379
Super-Scaffold_66	12970523	12971360	837	g_11379	g_11380
Super-Scaffold_66	12983352	12986833	3481	g_11380	g_11381
Super-Scaffold_66	12987141	12988830	1689	g_11381	g_11382
Super-Scaffold_66	12995418	13000498	5080	g_11382	g_11383
Super-Scaffold_66	13039477	13060985	21508	g_11383	g_11385
Super-Scaffold_66	13084177	13087718	3541	g_11385	g_11386
Super-Scaffold_66	13091340	13134483	43143	g_11386	g_11389
Super-Scaffold_66	13134779	13137809	3030	g_11389	g_11390
Super-Scaffold_66	13141377	13148120	6743	g_11390	g_11391
Super-Scaffold_66	13156798	13158188	1390	g_11391	g_43906
Super-Scaffold_66	13160680	13161127	447	g_43906	g_11392
Super-Scaffold_66	13168180	13169949	1769	g_11392	g_11393
Super-Scaffold_66	13170380	13173342	2962	g_11393	g_11394
Super-Scaffold_66	13175117	13178181	3064	g_11394	g_11395
Super-Scaffold_66	13180076	13182897	2821	g_11395	g_11396
Super-Scaffold_66	13184199	13192655	8456	g_11396	g_43907
Super-Scaffold_66	13205442	13209360	3918	g_43907	g_11397
Super-Scaffold_66	13215903	13217228	1325	g_11397	g_11398
Super-Scaffold_66	13218492	13242899	24407	g_11398	g_11400
Super-Scaffold_66	13243972	13277258	33286	g_11400	g_11402
Super-Scaffold_66	13277497	13314799	37302	g_11402	g_11403
Super-Scaffold_66	13315659	13329502	13843	g_11403	g_11404
Super-Scaffold_66	13329771	13335469	5698	g_11404	g_11405
Super-Scaffold_66	13335839	13337372	1533	g_11405	g_11406
Super-Scaffold_66	13343176	13345657	2481	g_11406	g_11407
Super-Scaffold_66	13347143	13372823	25680	g_11407	g_11408
Super-Scaffold_66	13482154	13485106	2952	g_11408	g_11409
Super-Scaffold_66	13496579	13499255	2676	g_11409	g_11410
Super-Scaffold_66	13501593	13502810	1217	g_11410	g_11411
Super-Scaffold_66	13503115	13508077	4962	g_11411	g_11413
Super-Scaffold_66	13510169	13560989	50820	g_11413	g_11416
Super-Scaffold_66	13570203	13601961	31758	g_40535	g_11417
Super-Scaffold_66	13602857	13605660	2803	g_11417	g_11418
Super-Scaffold_66	13606562	13630477	23915	g_11418	g_11419
Super-Scaffold_66	13675522	13711751	36229	g_11419	g_11421
Super-Scaffold_66	13712086	13722501	10415	g_11421	g_11422
Super-Scaffold_66	13780132	13821234	41102	g_11422	g_11423
Super-Scaffold_66	13827221	13828185	964	g_11423	g_11424
Super-Scaffold_66	13833180	13834982	1802	g_11424	g_43908
Super-Scaffold_66	13840163	13841803	1640	g_43908	g_11425
Super-Scaffold_66	13844465	13849561	5096	g_11425	g_11426
Super-Scaffold_66	13853240	13868255	15015	g_11426	g_43909
Super-Scaffold_66	13878248	13880931	2683	g_43909	g_43910
Super-Scaffold_66	13892234	13906116	13882	g_43910	g_11427
Super-Scaffold_66	13937660	13947887	10227	g_11427	g_11428
Super-Scaffold_66	13948192	14098685	150493	g_11428	g_11432
Super-Scaffold_66	14099919	14135180	35261	g_11432	g_11433
Super-Scaffold_66	14135485	14200459	64974	g_11433	g_11435
Super-Scaffold_66	14252473	14309365	56892	g_11435	g_11438
Super-Scaffold_66	14317365	14339843	22478	g_11438	g_11440
Super-Scaffold_66	14351849	14353355	1506	g_11440	g_11441
Super-Scaffold_66	14368741	14428894	60153	g_11441	g_11444
Super-Scaffold_66	14437086	14437872	786	g_11444	g_11445
Super-Scaffold_66	14439540	14449761	10221	g_11445	g_11446
Super-Scaffold_66	14450768	14456655	5887	g_11446	g_11447
Super-Scaffold_66	14497503	14498279	776	g_11447	g_11448
Super-Scaffold_66	14509420	14515578	6158	g_11448	g_11449
Super-Scaffold_66	14525197	14525757	560	g_11449	g_11450
Super-Scaffold_66	14527404	14528936	1532	g_11450	g_43911
Super-Scaffold_66	14530745	14583540	52795	g_43911	g_11451
Super-Scaffold_66	14584701	14588043	3342	g_11451	g_11452
Super-Scaffold_66	14596479	14621316	24837	g_11452	g_11453
Super-Scaffold_66	14622374	14626532	4158	g_11453	g_43912
Super-Scaffold_66	14638124	14640448	2324	g_43912	g_11454
Super-Scaffold_66	14652607	14660824	8217	g_11454	g_11455
Super-Scaffold_66	14662110	14668093	5983	g_11455	g_11456
Super-Scaffold_66	14676269	14678432	2163	g_11456	g_11457
Super-Scaffold_66	14681088	14689273	8185	g_11457	g_11458
Super-Scaffold_66	14708675	14747197	38522	g_11458	g_11460
Super-Scaffold_66	14747490	14788018	40528	g_11460	g_11461
Super-Scaffold_66	14788365	14792809	4444	g_11461	g_11462
Super-Scaffold_66	14802774	14806967	4193	g_11462	g_11463
Super-Scaffold_66	14808833	14809896	1063	g_11463	g_11464
Super-Scaffold_66	14817619	14819017	1398	g_11464	g_11465
Super-Scaffold_66	14827339	14832195	4856	g_11466	g_11467
Super-Scaffold_66	14846278	14890222	43944	g_11467	g_11469
Super-Scaffold_66	14892174	14923517	31343	g_11469	g_11470
Super-Scaffold_66	14946546	14948725	2179	g_11470	g_11471
Super-Scaffold_66	14956871	15001159	44288	g_11471	g_11473
Super-Scaffold_66	15003228	15093133	89905	g_11473	g_11477
Super-Scaffold_66	15114272	15114964	692	g_11477	g_43913
Super-Scaffold_66	15119793	15120103	310	g_43913	g_11478
Super-Scaffold_66	15133897	15136902	3005	g_11478	g_11479
Super-Scaffold_66	15141893	15209524	67631	g_11479	g_11481
Super-Scaffold_66	15218167	15223670	5503	g_11481	g_11482
Super-Scaffold_66	15228032	15232293	4261	g_11482	g_43914
Super-Scaffold_66	15237898	15247992	10094	g_43914	g_11483
Super-Scaffold_66	15250524	15252073	1549	g_40557	g_11484
Super-Scaffold_66	15258975	15263895	4920	g_11484	g_11485
Super-Scaffold_66	15264338	15281068	16730	g_11485	g_11486
Super-Scaffold_66	15292451	15305604	13153	g_11486	g_11487
Super-Scaffold_66	15305813	15308035	2222	g_11487	g_11488
Super-Scaffold_66	15331350	15338939	7589	g_11488	g_11489
Super-Scaffold_66	15339208	15341080	1872	g_11489	g_11490
Super-Scaffold_66	15341349	15372331	30982	g_11490	g_11492
Super-Scaffold_66	15391568	15393151	1583	g_11492	g_11493
Super-Scaffold_66	15395347	15398656	3309	g_11493	g_11494
Super-Scaffold_66	15412729	15414925	2196	g_11494	g_11495
Super-Scaffold_66	15420061	15423824	3763	g_11495	g_11496
Super-Scaffold_66	15431608	15432142	534	g_11496	g_11497
Super-Scaffold_66	15442749	15444073	1324	g_11497	g_11498
Super-Scaffold_66	15449498	15463737	14239	g_11498	g_11500
Super-Scaffold_66	15464006	15465096	1090	g_11500	g_11499
Super-Scaffold_66	15468163	15476549	8386	g_11499	g_11501
Super-Scaffold_66	15481135	15486619	5484	g_11501	g_11502
Super-Scaffold_66	15488380	15493325	4945	g_11502	g_11503
Super-Scaffold_66	15495785	15512001	16216	g_11503	g_11504
Super-Scaffold_66	15513785	15516171	2386	g_11504	g_11505
Super-Scaffold_66	15520119	15524286	4167	g_11505	g_11506
Super-Scaffold_66	15530117	15532659	2542	g_11506	g_11507
Super-Scaffold_66	15538276	15541764	3488	g_11507	g_11508
Super-Scaffold_66	15562177	15582512	20335	g_11508	g_11509
Super-Scaffold_66	15605481	15643304	37823	g_11509	g_11510
Super-Scaffold_66	15643666	15651782	8116	g_11510	g_11511
Super-Scaffold_66	15660033	15708178	48145	g_11511	g_11512
Super-Scaffold_66	15722719	15736099	13380	g_11512	g_11513
Super-Scaffold_66	15736746	15738335	1589	g_11513	g_11514
Super-Scaffold_66	15741890	15748331	6441	g_11514	g_43915
Super-Scaffold_66	15748600	15752525	3925	g_43915	g_11515
Super-Scaffold_66	15778157	15779567	1410	g_11515	g_11516
Super-Scaffold_66	15781401	15782883	1482	g_11516	g_11517
Super-Scaffold_66	15789835	15803817	13982	g_11517	g_11518
Super-Scaffold_66	15806496	15807345	849	g_11518	g_11519
Super-Scaffold_66	15810301	15889062	78761	g_11519	g_11520
Super-Scaffold_66	15890510	15892653	2143	g_11520	g_11521
Super-Scaffold_66	15901473	15903268	1795	g_11521	g_11522
Super-Scaffold_66	15915461	15938495	23034	g_11522	g_40562
Super-Scaffold_66	15938977	15947926	8949	g_40562	g_11524
Super-Scaffold_66	15953269	15997958	44689	g_11524	g_11525
Super-Scaffold_66	16003296	16005821	2525	g_11525	g_11526
Super-Scaffold_66	16006090	16020638	14548	g_11526	g_11530
Super-Scaffold_66	16020901	16028038	7137	g_11530	g_11532
Super-Scaffold_66	16036167	16046720	10553	g_11532	g_11534
Super-Scaffold_66	16058606	16110049	51443	g_11534	g_11535
Super-Scaffold_66	16129103	16139778	10675	g_11535	g_11536
Super-Scaffold_66	16145236	16155231	9995	g_11536	g_11537
Super-Scaffold_66	16160303	16179812	19509	g_11537	g_11539
Super-Scaffold_66	16180087	16187362	7275	g_11539	g_11540
Super-Scaffold_66	16189588	16201375	11787	g_11540	g_11542
Super-Scaffold_66	16201590	16204859	3269	g_11542	g_11543
Super-Scaffold_66	16213315	16230287	16972	g_11543	g_11544
Super-Scaffold_66	16233675	16239444	5769	g_11544	g_11545
Super-Scaffold_66	16246949	16270496	23547	g_11545	g_40568
Super-Scaffold_66	16270735	16294336	23601	g_40568	g_11547
Super-Scaffold_66	16296241	16307054	10813	g_11547	g_11548
Super-Scaffold_66	16311009	16318725	7716	g_11548	g_11549
Super-Scaffold_66	16320495	16325682	5187	g_11549	g_11550
Super-Scaffold_66	16331115	16337084	5969	g_11550	g_11551
Super-Scaffold_66	16362844	16366556	3712	g_11551	g_11552
Super-Scaffold_66	16369107	16370735	1628	g_11552	g_11553
Super-Scaffold_66	16393113	16423127	30014	g_11553	g_11555
Super-Scaffold_66	16425397	16443150	17753	g_11555	g_11556
Super-Scaffold_66	16443461	16448360	4899	g_11556	g_11557
Super-Scaffold_66	16449591	16470432	20841	g_11557	g_11558
Super-Scaffold_66	16473789	16476135	2346	g_11558	g_11559
Super-Scaffold_66	16483038	16493418	10380	g_11559	g_11560
Super-Scaffold_66	16507396	16577412	70016	g_11560	g_11564
Super-Scaffold_66	16583479	16587064	3585	g_11564	g_11565
Super-Scaffold_66	16608959	16614362	5403	g_11565	g_11566
Super-Scaffold_66	16622319	16658042	35723	g_11566	g_11567
Super-Scaffold_66	16668599	16698486	29887	g_11567	g_11568
Super-Scaffold_66	16702255	16704181	1926	g_11568	g_11569
Super-Scaffold_66	16705798	16707674	1876	g_11569	g_11570
Super-Scaffold_66	16731072	16768367	37295	g_11570	g_11573
Super-Scaffold_66	16770621	16772295	1674	g_11573	g_11574
Super-Scaffold_66	16782963	16789836	6873	g_11574	g_11575
Super-Scaffold_66	16790060	16793991	3931	g_11575	g_11576
Super-Scaffold_66	16803267	16898989	95722	g_11576	g_11577
Super-Scaffold_66	16899777	16989211	89434	g_11577	g_11580
Super-Scaffold_66	17098941	17103626	4685	g_11580	g_11582
Super-Scaffold_66	17113871	17114286	415	g_11582	g_11583
Super-Scaffold_66	17118755	17119154	399	g_11583	g_43916
Super-Scaffold_66	17120047	17143855	23808	g_43916	g_11584
Super-Scaffold_66	17144262	17146898	2636	g_11584	g_11587
Super-Scaffold_66	17147713	17151255	3542	g_11587	g_11588
Super-Scaffold_66	17154073	17204756	50683	g_11588	g_11590
Super-Scaffold_66	17207419	17250527	43108	g_11590	g_11592
Super-Scaffold_66	17256359	17287431	31072	g_11592	g_11593
Super-Scaffold_66	17310288	17310807	519	g_11593	g_11594
Super-Scaffold_66	17314632	17316540	1908	g_11594	g_11595
Super-Scaffold_66	17317922	17318590	668	g_11595	g_11596
Super-Scaffold_66	17323807	17323904	97	g_11596	g_43917
Super-Scaffold_66	17324988	17328641	3653	g_43917	g_11597
Super-Scaffold_66	17337928	17346234	8306	g_11597	g_11598
Super-Scaffold_66	17354292	17364715	10423	g_11598	g_11599
Super-Scaffold_66	17373880	17374370	490	g_11599	g_11600
Super-Scaffold_66	17382706	17393356	10650	g_11600	g_11602
Super-Scaffold_66	17395811	17399748	3937	g_11602	g_11603
Super-Scaffold_66	17409813	17414271	4458	g_11603	g_11604
Super-Scaffold_66	17426479	17427761	1282	g_11604	g_43918
Super-Scaffold_66	17439588	17440794	1206	g_43918	g_11605
Super-Scaffold_66	17443146	17446697	3551	g_11605	g_11606
Super-Scaffold_66	17450489	17477971	27482	g_11606	g_11607
Super-Scaffold_66	17489511	17543389	53878	g_11607	g_11608
Super-Scaffold_66	17546427	17546970	543	g_11608	g_11609
Super-Scaffold_66	17551556	17559229	7673	g_11609	g_11610
Super-Scaffold_66	17568635	17603622	34987	g_11610	g_11611
Super-Scaffold_66	17604998	17612552	7554	g_11611	g_11612
Super-Scaffold_66	17618170	17621003	2833	g_11612	g_43919
Super-Scaffold_66	17627080	17627740	660	g_43919	g_11613
Super-Scaffold_66	17632281	17633186	905	g_11613	g_11614
Super-Scaffold_66	17636891	17639086	2195	g_11614	g_11615
Super-Scaffold_66	17651502	17652038	536	g_11615	g_11616
Super-Scaffold_66	17660324	17664821	4497	g_11616	g_40574
Super-Scaffold_66	17666844	17677655	10811	g_11617	g_11618
Super-Scaffold_66	17678563	17685682	7119	g_11618	g_11619
Super-Scaffold_66	17686590	17688310	1720	g_11619	g_11620
Super-Scaffold_66	17689218	17690642	1424	g_11620	g_11621
Super-Scaffold_66	17691550	17728043	36493	g_11621	g_11623
Super-Scaffold_66	17730363	17766442	36079	g_11623	g_11624
Super-Scaffold_66	17770119	17773882	3763	g_11624	g_11625
Super-Scaffold_66	17778637	17783853	5216	g_11625	g_11626
Super-Scaffold_66	17787044	17797628	10584	g_11626	g_11627
Super-Scaffold_66	17798698	17799790	1092	g_11627	g_11628
Super-Scaffold_66	17802059	17808516	6457	g_11628	g_11629
Super-Scaffold_66	17810593	17812861	2268	g_11629	g_11630
Super-Scaffold_66	17826510	17832136	5626	g_11630	g_11631
Super-Scaffold_66	17841144	17947239	106095	g_11631	g_11633
Super-Scaffold_66	17957687	17970223	12536	g_11633	g_11634
Super-Scaffold_66	17974493	17989216	14723	g_11634	g_43920
Super-Scaffold_66	18002962	18053962	51000	g_43920	g_11636
Super-Scaffold_66	18056396	18056680	284	g_11636	g_11637
Super-Scaffold_66	18072667	18073884	1217	g_11637	g_11638
Super-Scaffold_66	18079762	18082907	3145	g_11638	g_11639
Super-Scaffold_66	18096124	18112145	16021	g_11639	g_11640
Super-Scaffold_66	18112387	18146313	33926	g_11640	g_11641
Super-Scaffold_66	18159553	18177072	17519	g_11641	g_11642
Super-Scaffold_66	18199059	18227031	27972	g_11642	g_11643
Super-Scaffold_66	18253131	18255367	2236	g_11643	g_43921
Super-Scaffold_66	18264398	18269611	5213	g_43921	g_11644
Super-Scaffold_66	18272390	18317430	45040	g_11644	g_11645
Super-Scaffold_66	18320750	18347627	26877	g_11645	g_11646
Super-Scaffold_66	18351115	18354624	3509	g_11646	g_11647
Super-Scaffold_66	18357347	18362234	4887	g_11647	g_11648
Super-Scaffold_66	18381543	18384799	3256	g_11648	g_43922
Super-Scaffold_66	18394850	18396713	1863	g_43922	g_11649
Super-Scaffold_66	18408465	18412485	4020	g_11649	g_11650
Super-Scaffold_66	18419307	18422675	3368	g_11650	g_11651
Super-Scaffold_66	18424255	18452653	28398	g_11651	g_11652
Super-Scaffold_66	18458426	18462813	4387	g_11652	g_11653
Super-Scaffold_66	18465065	18465131	66	g_11653	g_11654
Super-Scaffold_66	18465604	18469205	3601	g_11654	g_11655
Super-Scaffold_66	18485982	18491029	5047	g_11655	g_11656
Super-Scaffold_66	18503458	18505182	1724	g_11656	g_11657
Super-Scaffold_66	18515645	18517167	1522	g_11657	g_11658
Super-Scaffold_66	18519046	18535120	16074	g_11658	g_11659
Super-Scaffold_66	18536664	18539774	3110	g_11659	g_11660
Super-Scaffold_66	18545231	18593537	48306	g_11660	g_11661
Super-Scaffold_66	18594434	18600950	6516	g_11661	g_11662
Super-Scaffold_66	18608727	18669657	60930	g_11662	g_40578
Super-Scaffold_66	18669887	18926431	256544	g_40578	g_11664
Super-Scaffold_66	18928911	18935104	6193	g_11664	g_43923
Super-Scaffold_66	18937429	18941262	3833	g_43923	g_11665
Super-Scaffold_66	18945363	18946457	1094	g_11665	g_11666
Super-Scaffold_66	18949941	19039678	89737	g_11666	g_11667
Super-Scaffold_66	19040484	19100663	60179	g_11667	g_11669
Super-Scaffold_66	19105304	19108008	2704	g_11669	g_11670
Super-Scaffold_66	19112426	19115527	3101	g_11670	g_11671
Super-Scaffold_66	19120374	19127797	7423	g_11671	g_11672
Super-Scaffold_66	19129200	19146063	16863	g_11672	g_40582
Super-Scaffold_66	19146404	19146845	441	g_40582	g_11673
Super-Scaffold_66	19147216	19164261	17045	g_11673	g_11674
Super-Scaffold_66	19164902	19164945	43	g_11674	g_40583
Super-Scaffold_66	19165553	19165579	26	g_40583	g_11675
Super-Scaffold_66	19165980	19183228	17248	g_11675	g_11677
Super-Scaffold_66	19184777	19299396	114619	g_11677	g_11679
Super-Scaffold_66	19299872	19300070	198	g_11679	g_11680
Super-Scaffold_66	19300327	19334595	34268	g_11680	g_11682
Super-Scaffold_66	19334843	19355054	20211	g_11682	g_11683
Super-Scaffold_66	19357572	19433745	76173	g_11683	g_40587
Super-Scaffold_66	19433975	19444536	10561	g_40587	g_11686
Super-Scaffold_66	19461014	19478988	17974	g_11686	g_11687
Super-Scaffold_66	19479350	19484788	5438	g_11687	g_43924
Super-Scaffold_66	19486962	19548266	61304	g_43924	g_11689
Super-Scaffold_66	19548574	19570269	21695	g_11689	g_11690
Super-Scaffold_66	19572095	19573105	1010	g_11690	g_11691
Super-Scaffold_66	19574041	19576142	2101	g_11691	g_43925
Super-Scaffold_66	19583799	19586712	2913	g_43925	g_11692
Super-Scaffold_66	19587239	19599245	12006	g_11692	g_11693
Super-Scaffold_66	19607367	19632924	25557	g_11693	g_11695
Super-Scaffold_66	19634501	19647508	13007	g_11695	g_11697
Super-Scaffold_66	19647816	19651430	3614	g_11697	g_11698
Super-Scaffold_66	19655829	19661269	5440	g_11698	g_11699
Super-Scaffold_66	19667144	19669285	2141	g_11699	g_11700
Super-Scaffold_66	19676464	19683531	7067	g_11700	g_11702
Super-Scaffold_66	19684421	19689391	4970	g_11702	g_11703
Super-Scaffold_66	19692160	19703007	10847	g_11703	g_11704
Super-Scaffold_66	19715316	19716006	690	g_11704	g_11705
Super-Scaffold_66	19722419	19726667	4248	g_11705	g_11706
Super-Scaffold_66	19734782	19735321	539	g_11706	g_11707
Super-Scaffold_66	19736671	19738189	1518	g_11707	g_43926
Super-Scaffold_66	19738419	19743732	5313	g_43926	g_11708
Super-Scaffold_66	19748777	19761928	13151	g_11708	g_11709
Super-Scaffold_66	19766690	19773039	6349	g_11709	g_11710
Super-Scaffold_66	19787501	19807691	20190	g_11710	g_11712
Super-Scaffold_66	19807936	19824276	16340	g_11712	g_11714
Super-Scaffold_66	19829736	19842116	12380	g_11714	g_11716
Super-Scaffold_66	19847703	19872477	24774	g_11716	g_11717
Super-Scaffold_66	19873394	19878681	5287	g_11717	g_11718
Super-Scaffold_66	19894929	19926925	31996	g_11718	g_11720
Super-Scaffold_66	19930211	19962980	32769	g_11720	g_11721
Super-Scaffold_66	19963261	19963900	639	g_11721	g_11722
Super-Scaffold_66	19971084	19979002	7918	g_40592	g_11723
Super-Scaffold_66	19979316	19988987	9671	g_11723	g_11724
Super-Scaffold_66	19989448	19993179	3731	g_11724	g_11725
Super-Scaffold_66	20007863	20014413	6550	g_11725	g_11726
Super-Scaffold_66	20018517	20019957	1440	g_11726	g_11727
Super-Scaffold_66	20021417	20025100	3683	g_11727	g_11728
Super-Scaffold_66	20055293	20243471	188178	g_11728	g_11733
Super-Scaffold_66	20247762	20273903	26141	g_11733	g_11734
Super-Scaffold_66	20282496	20285162	2666	g_11734	g_11736
Super-Scaffold_66	20289826	20290602	776	g_11736	g_11737
Super-Scaffold_66	20295499	20317594	22095	g_11737	g_11738
Super-Scaffold_66	20323897	20328638	4741	g_11738	g_43927
Super-Scaffold_66	20339738	20345249	5511	g_43927	g_11739
Super-Scaffold_66	20347460	20348209	749	g_11739	g_11740
Super-Scaffold_66	20350515	20351933	1418	g_11741	g_11742
Super-Scaffold_66	20354584	20356816	2232	g_11742	g_11743
Super-Scaffold_66	20360703	20378557	17854	g_11743	g_11745
Super-Scaffold_66	20378889	20400844	21955	g_11745	g_11746
Super-Scaffold_66	20405601	20489223	83622	g_11746	g_11748
Super-Scaffold_66	20489516	20561763	72247	g_11748	g_11750
Super-Scaffold_66	20561999	20570201	8202	g_11750	g_11751
Super-Scaffold_66	20570419	20628316	57897	g_11751	g_11755
Super-Scaffold_66	20628660	20678029	49369	g_11755	g_11757
Super-Scaffold_66	20700621	20703495	2874	g_11757	g_11758
Super-Scaffold_66	20709438	20713789	4351	g_11758	g_11759
Super-Scaffold_66	20732042	20733127	1085	g_11759	g_11760
Super-Scaffold_66	20736310	20745757	9447	g_11760	g_11761
Super-Scaffold_66	20746619	20770886	24267	g_11761	g_11762
Super-Scaffold_66	20779817	20787501	7684	g_11762	g_11763
Super-Scaffold_66	20790894	20826489	35595	g_11763	g_11765
Super-Scaffold_66	20826830	20930370	103540	g_11765	g_11766
Super-Scaffold_66	20930666	20963583	32917	g_11766	g_11769
Super-Scaffold_66	20983295	20993736	10441	g_11769	g_11770
Super-Scaffold_66	21001329	21005581	4252	g_11770	g_11771
Super-Scaffold_66	21006429	21009318	2889	g_11771	g_11772
Super-Scaffold_66	21012267	21029928	17661	g_11772	g_11773
Super-Scaffold_66	21036470	21041828	5358	g_11773	g_11774
Super-Scaffold_66	21080640	21092434	11794	g_11774	g_11775
Super-Scaffold_66	21094088	21094664	576	g_11775	g_11776
Super-Scaffold_66	21095976	21185457	89481	g_11776	g_11780
Super-Scaffold_66	21192731	21227880	35149	g_11780	g_11781
Super-Scaffold_66	21243832	21255036	11204	g_11781	g_11782
Super-Scaffold_66	21265142	21268243	3101	g_11782	g_11783
Super-Scaffold_66	21274446	21277848	3402	g_11783	g_11784
Super-Scaffold_66	21285085	21359259	74174	g_11784	g_40607
Super-Scaffold_66	21359531	21373716	14185	g_40607	g_11788
Super-Scaffold_66	21374051	21391544	17493	g_11788	g_11789
Super-Scaffold_66	21391861	21402518	10657	g_11789	g_11790
Super-Scaffold_66	21402841	21447905	45064	g_11790	g_11791
Super-Scaffold_66	21450093	21466279	16186	g_11791	g_43928
Super-Scaffold_66	21474091	21479582	5491	g_43928	g_11792
Super-Scaffold_66	21485697	21489525	3828	g_11792	g_11793
Super-Scaffold_66	21506466	21533634	27168	g_11793	g_11794
Super-Scaffold_66	21534410	21536715	2305	g_11794	g_11795
Super-Scaffold_66	21541424	21557803	16379	g_11795	g_11796
Super-Scaffold_66	21563316	21570148	6832	g_11796	g_11797
Super-Scaffold_66	21589360	21599952	10592	g_11797	g_40610
Super-Scaffold_66	21600170	21605762	5592	g_40610	g_11798
Super-Scaffold_66	21616215	21713713	97498	g_11798	g_11799
Super-Scaffold_66	21714165	21845503	131338	g_11799	g_11802
Super-Scaffold_66	21845730	21883404	37674	g_11802	g_11804
Super-Scaffold_66	21897605	21950488	52883	g_11804	g_11805
Super-Scaffold_66	21950799	22078520	127721	g_11805	g_11808
Super-Scaffold_66	22078774	22088026	9252	g_11808	g_11809
Super-Scaffold_66	22141739	22147259	5520	g_11809	g_11810
Super-Scaffold_66	22168998	22176409	7411	g_11810	g_11811
Super-Scaffold_66	22187546	22204311	16765	g_11811	g_11812
Super-Scaffold_66	22215642	22237796	22154	g_11812	g_11813
Super-Scaffold_66	22238416	22266204	27788	g_11813	g_11814
Super-Scaffold_66	22266623	22352110	85487	g_11814	g_40620
Super-Scaffold_66	22352328	22374674	22346	g_40620	g_11816
Super-Scaffold_66	22383827	22388078	4251	g_11816	g_11817
Super-Scaffold_66	22397636	22403395	5759	g_11817	g_11818
Super-Scaffold_66	22414162	22442158	27996	g_11818	g_11820
Super-Scaffold_66	22443820	22443852	32	g_11820	g_43929
Super-Scaffold_66	22447220	22459843	12623	g_43929	g_11821
Super-Scaffold_66	22461763	22463630	1867	g_11821	g_11822
Super-Scaffold_66	22468720	22498107	29387	g_11822	g_11824
Super-Scaffold_66	22501619	22683523	181904	g_11824	g_11826
Super-Scaffold_66	22683891	22689180	5289	g_11826	g_11827
Super-Scaffold_66	22689632	22843110	153478	g_11827	g_11830
Super-Scaffold_66	22843433	22895144	51711	g_11830	g_11831
Super-Scaffold_66	22897126	22960441	63315	g_11831	g_40623
Super-Scaffold_66	22960650	23211960	251310	g_40623	g_40627
Super-Scaffold_66	23212226	23382609	170383	g_40627	g_11839
Super-Scaffold_66	23384435	23388889	4454	g_11839	g_11840
Super-Scaffold_66	23390698	23391896	1198	g_11840	g_40631
Super-Scaffold_66	23392141	23398164	6023	g_40631	g_11841
Super-Scaffold_66	23401786	23403918	2132	g_11841	g_11842
Super-Scaffold_66	23405332	23406825	1493	g_11842	g_11843
Super-Scaffold_66	23420146	23424194	4048	g_11843	g_11844
Super-Scaffold_66	23424763	23425199	436	g_11844	g_11845
Super-Scaffold_66	23427102	23430528	3426	g_11845	g_11846
Super-Scaffold_66	23441265	23444670	3405	g_11846	g_11847
Super-Scaffold_66	23462461	23469053	6592	g_11847	g_11850
Super-Scaffold_66	23469925	23474408	4483	g_11850	g_11849
Super-Scaffold_66	23485979	23507650	21671	g_11849	g_11851
Super-Scaffold_66	23520087	23522329	2242	g_11851	g_11852
Super-Scaffold_66	23525347	23569172	43825	g_11852	g_11854
Super-Scaffold_66	23575036	23585250	10214	g_11854	g_11855
Super-Scaffold_66	23586323	23651192	64869	g_11855	g_11856
Super-Scaffold_66	23651476	23690865	39389	g_11856	g_11857
Super-Scaffold_66	23691659	23760217	68558	g_11857	g_11859
Super-Scaffold_66	23760465	23783568	23103	g_11859	g_11860
Super-Scaffold_66	23791445	23795229	3784	g_11860	g_11861
Super-Scaffold_66	23810587	23815018	4431	g_11861	g_11862
Super-Scaffold_66	23815251	23823444	8193	g_11862	g_11863
Super-Scaffold_66	23836373	23839945	3572	g_11863	g_11864
Super-Scaffold_66	23889900	23932361	42461	g_11864	g_11866
Super-Scaffold_66	23934286	23941169	6883	g_11866	g_11867
Super-Scaffold_66	23948892	23951035	2143	g_11867	g_11868
Super-Scaffold_66	23976474	23999552	23078	g_11868	g_11869
Super-Scaffold_66	24015603	24017973	2370	g_11869	g_11870
Super-Scaffold_66	24031500	24046237	14737	g_11870	g_11871
Super-Scaffold_66	24067599	24107650	40051	g_11871	g_11872
Super-Scaffold_66	24114558	24141129	26571	g_11872	g_11873
Super-Scaffold_66	24152902	24157385	4483	g_11873	g_11874
Super-Scaffold_66	24173382	24240674	67292	g_11874	g_11875
Super-Scaffold_66	24245362	24257727	12365	g_11875	g_11877
Super-Scaffold_66	24269426	24284831	15405	g_11877	g_11878
Super-Scaffold_66	24288012	24300392	12380	g_11878	g_11879
Super-Scaffold_66	24301423	24316134	14711	g_11879	g_11881
Super-Scaffold_66	24316430	24319010	2580	g_11881	g_11880
Super-Scaffold_66	24327778	24331589	3811	g_11880	g_11882
Super-Scaffold_66	24337979	24362495	24516	g_11882	g_11883
Super-Scaffold_66	24367563	24371491	3928	g_11883	g_11884
Super-Scaffold_66	24381553	24421293	39740	g_11884	g_11885
Super-Scaffold_66	24451836	24457670	5834	g_11885	g_11886
Super-Scaffold_66	24467909	24550918	83009	g_11887	g_11888
Super-Scaffold_66	24551529	24568673	17144	g_11888	g_11891
Super-Scaffold_66	24579077	24584696	5619	g_11891	g_11892
Super-Scaffold_66	24589222	24594243	5021	g_11892	g_11893
Super-Scaffold_66	24595967	24598660	2693	g_11893	g_11894
Super-Scaffold_66	24601018	24644502	43484	g_11894	g_40636
Super-Scaffold_66	24644738	24682736	37998	g_40636	g_11895
Super-Scaffold_66	24683995	24686780	2785	g_11895	g_11896
Super-Scaffold_66	24695043	24697984	2941	g_11896	g_11897
Super-Scaffold_66	24701346	24708136	6790	g_11897	g_43930
Super-Scaffold_66	24717838	24722904	5066	g_43930	g_43931
Super-Scaffold_66	24730383	24732065	1682	g_43931	g_11898
Super-Scaffold_66	24750726	24758572	7846	g_11898	g_11899
Super-Scaffold_66	24761839	24763658	1819	g_11899	g_43932
Super-Scaffold_66	24765746	24804718	38972	g_43932	g_11900
Super-Scaffold_66	24813722	24848259	34537	g_11900	g_11901
Super-Scaffold_66	24848930	24851061	2131	g_11901	g_11902
Super-Scaffold_66	24851645	25126939	275294	g_11902	g_11903
Super-Scaffold_66	25127286	25137375	10089	g_11903	g_43933
Super-Scaffold_66	25138932	25179113	40181	g_43933	g_11904
Super-Scaffold_66	25180135	25246200	66065	g_11904	g_11905
Super-Scaffold_66	25247538	25314439	66901	g_11905	g_11906
Super-Scaffold_66	25314672	25351586	36914	g_11906	g_11907
Super-Scaffold_66	25351870	25500011	148141	g_11907	g_11911
Super-Scaffold_66	25500421	25511904	11483	g_11911	g_40640
Super-Scaffold_66	25513799	25513824	25	g_40640	g_11913
Super-Scaffold_66	25515359	25560974	45615	g_11913	g_11914
Super-Scaffold_66	25564284	25716915	152631	g_11914	g_11915
Super-Scaffold_66	25720061	25738569	18508	g_11915	g_11916
Super-Scaffold_66	25754141	25771796	17655	g_11916	g_11918
Super-Scaffold_66	25772920	25816323	43403	g_11918	g_11919
Super-Scaffold_66	25818461	25840117	21656	g_11919	g_11920
Super-Scaffold_66	25840548	25858704	18156	g_11920	g_11921
Super-Scaffold_66	25858943	25868345	9402	g_11921	g_11922
Super-Scaffold_66	25927061	25966424	39363	g_11922	g_11923
Super-Scaffold_66	25980856	25980994	138	g_11923	g_11924
Super-Scaffold_66	25981368	25981492	124	g_11924	g_11925
Super-Scaffold_66	25981746	25989495	7749	g_11925	g_11926
Super-Scaffold_66	25999885	26016501	16616	g_11926	g_11927
Super-Scaffold_66	26040152	26069145	28993	g_11927	g_11929
Super-Scaffold_66	26073262	26122829	49567	g_11929	g_11931
Super-Scaffold_66	26123035	26124506	1471	g_11931	g_11932
Super-Scaffold_66	26129521	26164215	34694	g_11932	g_11933
Super-Scaffold_66	26167502	26214087	46585	g_11933	g_11936
Super-Scaffold_66	26220540	26230123	9583	g_11936	g_11937
Super-Scaffold_66	26243620	26244491	871	g_11937	g_11938
Super-Scaffold_66	26250917	26253173	2256	g_11938	g_11939
Super-Scaffold_66	26261473	26276425	14952	g_11939	g_11940
Super-Scaffold_66	26277054	26295009	17955	g_11940	g_11941
Super-Scaffold_66	26297018	26330794	33776	g_11941	g_11942
Super-Scaffold_66	26334405	26348366	13961	g_11942	g_11943
Super-Scaffold_66	26349250	26360038	10788	g_11943	g_11944
Super-Scaffold_66	26360787	26362298	1511	g_11944	g_11945
Super-Scaffold_66	26376399	26381279	4880	g_11945	g_11946
Super-Scaffold_66	26400360	26409826	9466	g_11946	g_11948
Super-Scaffold_66	26423617	26434022	10405	g_11948	g_11949
Super-Scaffold_66	26435116	26438721	3605	g_11949	g_43934
Super-Scaffold_66	26457800	26519586	61786	g_43934	g_40645
Super-Scaffold_66	26520038	26520065	27	g_40645	g_40646
Super-Scaffold_66	26520475	26560323	39848	g_40646	g_11950
Super-Scaffold_66	26564593	26631030	66437	g_11950	g_11951
Super-Scaffold_66	26632636	26682506	49870	g_11951	g_11953
Super-Scaffold_66	26693088	26764487	71399	g_11953	g_40647
Super-Scaffold_66	26764693	27089664	324971	g_40647	g_11955
Super-Scaffold_66	27090581	27108003	17422	g_11955	g_11956
Super-Scaffold_66	27109639	27123591	13952	g_11956	g_11957
Super-Scaffold_66	27125673	27129817	4144	g_11957	g_11958
Super-Scaffold_66	27130698	27143310	12612	g_11958	g_11959
Super-Scaffold_66	27152738	27178403	25665	g_11959	g_11960
Super-Scaffold_66	27180952	27249661	68709	g_11960	g_11961
Super-Scaffold_66	27250491	27250853	362	g_11961	g_11962
Super-Scaffold_66	27252088	27291768	39680	g_11962	g_11963
Super-Scaffold_66	27292907	27324408	31501	g_11963	g_11964
Super-Scaffold_66	27346839	27350600	3761	g_40650	g_11965
Super-Scaffold_66	27351376	27357985	6609	g_11965	g_11966
Super-Scaffold_66	27359130	27363345	4215	g_11966	g_11967
Super-Scaffold_66	27384258	27384895	637	g_11967	g_11968
Super-Scaffold_66	27406520	27467957	61437	g_11968	g_11970
Super-Scaffold_66	27476977	27479488	2511	g_11970	g_11971
Super-Scaffold_66	27490424	27496514	6090	g_11971	g_11972
Super-Scaffold_66	27526347	27528773	2426	g_11972	g_11973
Super-Scaffold_66	27529052	27529127	75	g_11973	g_11974
Super-Scaffold_66	27530311	27531441	1130	g_11974	g_11975
Super-Scaffold_66	27533195	27539033	5838	g_11975	g_11976
Super-Scaffold_66	27561641	27565142	3501	g_11976	g_11977
Super-Scaffold_66	27581844	27640162	58318	g_11977	g_11978
Super-Scaffold_66	27641049	27681745	40696	g_11978	g_11979
Super-Scaffold_66	27682068	27710349	28281	g_11979	g_11981
Super-Scaffold_66	27712165	27750129	37964	g_11981	g_11982
Super-Scaffold_66	27754484	27761161	6677	g_11982	g_11983
Super-Scaffold_66	27761391	27774167	12776	g_11983	g_11984
Super-Scaffold_66	27788211	27842936	54725	g_11984	g_11985
Super-Scaffold_66	27868469	27871042	2573	g_11985	g_11986
Super-Scaffold_66	27873528	27877268	3740	g_11986	g_11987
Super-Scaffold_66	27977279	27984174	6895	g_11987	g_11988
Super-Scaffold_66	27994906	28017908	23002	g_40654	g_11989
Super-Scaffold_66	28021328	28027580	6252	g_11989	g_11990
Super-Scaffold_66	28028396	28029988	1592	g_11990	g_43935
Super-Scaffold_66	28030230	28068927	38697	g_43935	g_11994
Super-Scaffold_66	28069244	28143151	73907	g_11994	g_11997
Super-Scaffold_66	28150185	28153148	2963	g_11997	g_43936
Super-Scaffold_66	28168255	28240455	72200	g_43936	g_11998
Super-Scaffold_66	28243030	28251194	8164	g_11998	g_11999
Super-Scaffold_66	28254596	28300444	45848	g_11999	g_12000
Super-Scaffold_66	28301139	28302246	1107	g_12000	g_43937
Super-Scaffold_66	28302864	28308037	5173	g_43937	g_43938
Super-Scaffold_66	28308435	28353910	45475	g_43938	g_12001
Super-Scaffold_66	28354191	28366661	12470	g_12001	g_12003
Super-Scaffold_66	28367245	28481860	114615	g_12003	g_12005
Super-Scaffold_66	28482378	28482424	46	g_12005	g_12006
Super-Scaffold_66	28482984	28558790	75806	g_12006	g_12009
Super-Scaffold_66	28560334	28690884	130550	g_12009	g_12011
Super-Scaffold_66	28691183	28716271	25088	g_12011	g_40659
Super-Scaffold_66	28716474	28766697	50223	g_40659	g_40660
Super-Scaffold_66	28767438	28798510	31072	g_40660	g_12013
Super-Scaffold_66	28816374	28862334	45960	g_12013	g_12014
Super-Scaffold_66	28862657	28868850	6193	g_12014	g_12015
Super-Scaffold_66	28869098	28925394	56296	g_12015	g_12017
Super-Scaffold_66	28925612	28992396	66784	g_12017	g_40664
Super-Scaffold_66	28992644	28994793	2149	g_40664	g_12020
Super-Scaffold_66	28995269	29046272	51003	g_12020	g_12022
Super-Scaffold_66	29047801	29160463	112662	g_12022	g_12023
Super-Scaffold_66	29160663	29177389	16726	g_12023	g_12024
Super-Scaffold_66	29193869	29205291	11422	g_12024	g_12026
Super-Scaffold_66	29206505	29223439	16934	g_12026	g_12027
Super-Scaffold_66	29226666	29229099	2433	g_12027	g_40669
Super-Scaffold_66	29229341	29264009	34668	g_40669	g_12028
Super-Scaffold_66	29273352	29281088	7736	g_12028	g_12030
Super-Scaffold_66	29285557	29354102	68545	g_12030	g_12031
Super-Scaffold_66	29357953	29358067	114	g_40670	g_40671
Super-Scaffold_66	29358537	29358996	459	g_40671	g_12032
Super-Scaffold_66	29365009	29369820	4811	g_12032	g_12033
Super-Scaffold_66	29380310	29385563	5253	g_12033	g_12034
Super-Scaffold_66	29394075	29497168	103093	g_12034	g_40672
Super-Scaffold_66	29497455	29511445	13990	g_40672	g_12036
Super-Scaffold_66	29511912	29512054	142	g_12036	g_12037
Super-Scaffold_66	29512419	29552062	39643	g_12037	g_12040
Super-Scaffold_66	29552358	29566398	14040	g_12040	g_12041
Super-Scaffold_66	29574203	29579310	5107	g_12041	g_12042
Super-Scaffold_66	29584744	29610383	25639	g_12042	g_40673
Super-Scaffold_66	29610619	29613355	2736	g_40673	g_12045
Super-Scaffold_66	29613681	29622913	9232	g_12045	g_12047
Super-Scaffold_66	29623191	29641431	18240	g_12047	g_12048
Super-Scaffold_66	29647141	29690784	43643	g_40675	g_12051
Super-Scaffold_66	29691002	29727610	36608	g_12051	g_12056
Super-Scaffold_66	29737542	29738656	1114	g_12056	g_12057
Super-Scaffold_66	29740917	29755803	14886	g_12057	g_12058
Super-Scaffold_66	29762513	29767392	4879	g_12058	g_12060
Super-Scaffold_66	29775642	29794238	18596	g_12060	g_12062
Super-Scaffold_66	29794945	29795344	399	g_12062	g_12063
Super-Scaffold_66	29795943	29857369	61426	g_12063	g_12065
Super-Scaffold_66	29857698	29878934	21236	g_12065	g_12066
Super-Scaffold_66	29879548	29895423	15875	g_12066	g_12067
Super-Scaffold_66	29918889	29942117	23228	g_12067	g_12068
Super-Scaffold_66	29947150	29947620	470	g_12068	g_12069
Super-Scaffold_66	29957825	29973497	15672	g_12069	g_12070
Super-Scaffold_66	29995218	29997444	2226	g_12070	g_12071
Super-Scaffold_66	29999361	30000585	1224	g_12071	g_12072
Super-Scaffold_66	30011639	30072393	60754	g_12072	g_12073
Super-Scaffold_66	30073169	30147726	74557	g_12073	g_12074
Super-Scaffold_66	30149301	30274784	125483	g_12074	g_12077
Super-Scaffold_66	30275848	30275930	82	g_12077	g_12078
Super-Scaffold_66	30276754	30277327	573	g_12078	g_12079
Super-Scaffold_66	30278965	30312147	33182	g_12079	g_12080
Super-Scaffold_66	30314890	30352862	37972	g_12080	g_12081
Super-Scaffold_66	30353134	30412452	59318	g_12081	g_40680
Super-Scaffold_66	30412697	30453324	40627	g_40680	g_12083
Super-Scaffold_66	30456243	30470723	14480	g_12083	g_12085
Super-Scaffold_66	30472534	30489266	16732	g_12085	g_12086
Super-Scaffold_66	30490387	30491418	1031	g_12086	g_12087
Super-Scaffold_66	30491672	30503475	11803	g_12087	g_12089
Super-Scaffold_66	30503681	30505147	1466	g_12089	g_12090
Super-Scaffold_66	30506052	30506175	123	g_12090	g_12092
Super-Scaffold_66	30506736	30519233	12497	g_12092	g_12093
Super-Scaffold_66	30525059	30525519	460	g_12093	g_12094
Super-Scaffold_66	30525893	30544323	18430	g_12094	g_12096
Super-Scaffold_66	30546925	30553321	6396	g_12096	g_12098
Super-Scaffold_66	30553656	30554345	689	g_12098	g_12097
Super-Scaffold_66	30558079	30560226	2147	g_12097	g_43939
Super-Scaffold_66	30562087	30566485	4398	g_43939	g_12099
Super-Scaffold_66	30566736	30566797	61	g_12099	g_43940
Super-Scaffold_66	30567009	30571920	4911	g_43940	g_12100
Super-Scaffold_66	30572411	30609205	36794	g_12100	g_40683
Super-Scaffold_66	30609483	30665428	55945	g_40683	g_12101
Super-Scaffold_66	30667330	30842184	174854	g_12101	g_12104
Super-Scaffold_66	30844593	30860689	16096	g_12104	g_12105
Super-Scaffold_66	30860904	30909800	48896	g_12105	g_12106
Super-Scaffold_66	30910402	30922474	12072	g_12106	g_12107
Super-Scaffold_66	30932545	30947122	14577	g_12107	g_12108
Super-Scaffold_66	30947346	30994830	47484	g_12108	g_12111
Super-Scaffold_66	31003839	31036284	32445	g_12111	g_12112
Super-Scaffold_66	31038803	31040894	2091	g_12112	g_12113
Super-Scaffold_66	31048152	31048292	140	g_12113	g_12114
Super-Scaffold_66	31051833	31054883	3050	g_12114	g_12115
Super-Scaffold_66	31064192	31092287	28095	g_12115	g_12117
Super-Scaffold_66	31092641	31099978	7337	g_12117	g_12118
Super-Scaffold_66	31100259	31103455	3196	g_12118	g_12119
Super-Scaffold_66	31110986	31121207	10221	g_12119	g_12120
Super-Scaffold_66	31127069	31129406	2337	g_12120	g_12121
Super-Scaffold_66	31139342	31212064	72722	g_12121	g_12122
Super-Scaffold_66	31213459	31214332	873	g_12122	g_40687
Super-Scaffold_66	31214592	31291052	76460	g_40687	g_12125
Super-Scaffold_66	31291631	31292594	963	g_12125	g_12126
Super-Scaffold_66	31293340	31405729	112389	g_12126	g_12127
Super-Scaffold_66	31406892	31412140	5248	g_12127	g_12128
Super-Scaffold_66	31428228	31449574	21346	g_12128	g_12129
Super-Scaffold_66	31451313	31451343	30	g_12129	g_12130
Super-Scaffold_66	31452446	31452601	155	g_12130	g_12131
Super-Scaffold_66	31453947	31454222	275	g_12131	g_12132
Super-Scaffold_66	31455238	31581055	125817	g_12132	g_12135
Super-Scaffold_66	31581740	31586246	4506	g_12135	g_43941
Super-Scaffold_66	31594258	31596292	2034	g_43941	g_12136
Super-Scaffold_66	31596534	31596918	384	g_12136	g_43942
Super-Scaffold_66	31604713	31608315	3602	g_43942	g_43943
Super-Scaffold_66	31612439	31656107	43668	g_43943	g_12137
Super-Scaffold_66	31666020	31685100	19080	g_12137	g_12139
Super-Scaffold_66	31685510	31701894	16384	g_12139	g_12140
Super-Scaffold_66	31703716	31703771	55	g_12140	g_12141
Super-Scaffold_70	3009	3069	60	g_15058	g_15059
Super-Scaffold_70	3488	5141	1653	g_15059	g_15061
Super-Scaffold_70	5365	5439	74	g_15061	g_15062
Super-Scaffold_70	6038	6339	301	g_15062	g_15063
Super-Scaffold_70	6746	9424	2678	g_15063	g_15064
Super-Scaffold_70	11787	64390	52603	g_15064	g_15068
Super-Scaffold_70	64779	64838	59	g_15068	g_15069
Super-Scaffold_70	65227	76005	10778	g_15069	g_15070
Super-Scaffold_70	76359	76520	161	g_15070	g_36042
Super-Scaffold_70	76735	94582	17847	g_36042	g_15071
Super-Scaffold_70	118382	120955	2573	g_15071	g_15072
Super-Scaffold_70	122272	123076	804	g_15072	g_15073
Super-Scaffold_70	123438	123490	52	g_15073	g_15074
Super-Scaffold_70	124011	124383	372	g_15074	g_15075
Super-Scaffold_70	125722	210370	84648	g_15075	g_15077
Super-Scaffold_70	211716	253199	41483	g_15077	g_15079
Super-Scaffold_70	271664	274269	2605	g_15079	g_36043
Super-Scaffold_70	274592	274789	197	g_36043	g_15081
Super-Scaffold_70	274992	275029	37	g_15081	g_15082
Super-Scaffold_70	275232	275269	37	g_15082	g_15083
Super-Scaffold_70	275649	276961	1312	g_15083	g_15084
Super-Scaffold_70	278319	284564	6245	g_15084	g_15087
Super-Scaffold_70	285479	334646	49167	g_36045	g_15091
Super-Scaffold_74	247	52318	52071	g_37250	g_6607
Super-Scaffold_74	68175	185634	117459	g_6607	g_6609
Super-Scaffold_74	217545	354654	137109	g_6609	g_6610
Super-Scaffold_74	364984	372444	7460	g_6610	g_6611
Super-Scaffold_74	373736	380366	6630	g_6611	g_6612
Super-Scaffold_74	381717	390019	8302	g_6612	g_6614
Super-Scaffold_74	403791	405687	1896	g_37253	g_6615
Super-Scaffold_74	406121	484450	78329	g_6615	g_37255
Super-Scaffold_74	484830	489082	4252	g_37255	g_6621
Super-Scaffold_74	496558	502112	5554	g_6621	g_6623
Super-Scaffold_74	505791	508942	3151	g_6623	g_37256
Super-Scaffold_74	509847	510688	841	g_37256	g_6624
Super-Scaffold_74	511053	523429	12376	g_6624	g_6626
Super-Scaffold_74	527481	527485	4	g_6626	g_6627
Super-Scaffold_74	527775	567028	39253	g_6627	g_6630
Super-Scaffold_74	567663	601093	33430	g_6630	g_6635
Super-Scaffold_74	603262	605372	2110	g_6635	g_6637
Super-Scaffold_74	607072	624731	17659	g_6637	g_6638
Super-Scaffold_74	647039	648622	1583	g_6638	g_6640
Super-Scaffold_74	648852	651830	2978	g_6640	g_6641
Super-Scaffold_74	652231	659225	6994	g_6641	g_6644
Super-Scaffold_74	679054	691680	12626	g_6644	g_6646
Super-Scaffold_74	692258	732813	40555	g_6646	g_6647
Super-Scaffold_74	744333	773091	28758	g_6647	g_6649
Super-Scaffold_74	773414	779181	5767	g_6649	g_6651
Super-Scaffold_74	797571	817832	20261	g_6651	g_6652
Super-Scaffold_74	818527	818797	270	g_6652	g_6653
Super-Scaffold_74	822450	823414	964	g_6653	g_6654
Super-Scaffold_74	824801	828845	4044	g_6654	g_6655
Super-Scaffold_74	829114	866299	37185	g_6655	g_6656
Super-Scaffold_74	878798	884049	5251	g_6656	g_6658
Super-Scaffold_74	884429	885047	618	g_6658	g_6659
Super-Scaffold_74	885400	915949	30549	g_6659	g_6661
Super-Scaffold_74	923094	929205	6111	g_6661	g_6662
Super-Scaffold_74	938559	945203	6644	g_6662	g_6663
Super-Scaffold_74	949828	959442	9614	g_6663	g_6664
Super-Scaffold_74	961260	966653	5393	g_6664	g_6666
Super-Scaffold_74	971057	977473	6416	g_6666	g_6667
Super-Scaffold_74	1006943	1012921	5978	g_6667	g_6670
Super-Scaffold_74	1015401	1018632	3231	g_6670	g_6673
Super-Scaffold_74	1026097	1053499	27402	g_6673	g_6674
Super-Scaffold_74	1055343	1055816	473	g_6674	g_6675
Super-Scaffold_74	1056016	1060207	4191	g_6675	g_6677
Super-Scaffold_74	1064337	1064902	565	g_6677	g_37262
Super-Scaffold_74	1067337	1070646	3309	g_37262	g_6679
Super-Scaffold_74	1076794	1078180	1386	g_6679	g_6680
Super-Scaffold_74	1100838	1104839	4001	g_6680	g_6681
Super-Scaffold_74	1114692	1118165	3473	g_6681	g_6683
Super-Scaffold_74	1126967	1136016	9049	g_6683	g_43369
Super-Scaffold_74	1143817	1316661	172844	g_43369	g_6687
Super-Scaffold_74	1317516	1402208	84692	g_6687	g_6688
Super-Scaffold_74	1417081	1424001	6920	g_6688	g_43370
Super-Scaffold_74	1430183	1445410	15227	g_43370	g_6690
Super-Scaffold_74	1448950	1449675	725	g_6690	g_6691
Super-Scaffold_74	1453296	1464909	11613	g_6691	g_6693
Super-Scaffold_74	1486665	1488170	1505	g_6693	g_6694
Super-Scaffold_74	1502100	1507451	5351	g_6694	g_6695
Super-Scaffold_74	1510667	1518886	8219	g_6695	g_6696
Super-Scaffold_74	1532134	1534958	2824	g_6696	g_6697
Super-Scaffold_74	1540692	1541983	1291	g_6697	g_6698
Super-Scaffold_74	1542333	1550956	8623	g_6698	g_6700
Super-Scaffold_74	1555077	1561462	6385	g_6700	g_6701
Super-Scaffold_74	1564046	1567694	3648	g_6701	g_6702
Super-Scaffold_74	1588365	1607072	18707	g_6702	g_6703
Super-Scaffold_74	1616711	1622648	5937	g_6703	g_37268
Super-Scaffold_74	1623118	1634862	11744	g_37268	g_6705
Super-Scaffold_74	1635122	1640916	5794	g_6705	g_6707
Super-Scaffold_74	1645221	1647489	2268	g_6707	g_6708
Super-Scaffold_74	1649778	1669914	20136	g_6708	g_6710
Super-Scaffold_74	1675786	1684768	8982	g_6710	g_6711
Super-Scaffold_74	1693232	1696765	3533	g_6711	g_43371
Super-Scaffold_74	1697655	1707173	9518	g_43371	g_6713
Super-Scaffold_74	1708111	1715785	7674	g_6713	g_6714
Super-Scaffold_74	1719455	1733809	14354	g_6714	g_6716
Super-Scaffold_74	1737798	1740792	2994	g_37270	g_6717
Super-Scaffold_74	1743189	1760922	17733	g_6717	g_6718
Super-Scaffold_74	1761564	1781362	19798	g_6718	g_6720
Super-Scaffold_74	1781943	1791992	10049	g_6720	g_6722
Super-Scaffold_74	1794463	1801739	7276	g_6722	g_6724
Super-Scaffold_74	1805797	1805862	65	g_6724	g_6725
Super-Scaffold_74	1808672	1808805	133	g_6725	g_6726
Super-Scaffold_74	1812863	1812928	65	g_6726	g_6727
Super-Scaffold_74	1813305	1823610	10305	g_6727	g_6729
Super-Scaffold_74	1834599	1837982	3383	g_6729	g_43372
Super-Scaffold_74	1840548	1856898	16350	g_43372	g_6730
Super-Scaffold_74	1857540	1877168	19628	g_6730	g_6732
Super-Scaffold_74	1877749	1888206	10457	g_6732	g_6734
Super-Scaffold_74	1890473	1897579	7106	g_6734	g_6736
Super-Scaffold_74	1898694	1905437	6743	g_6736	g_6738
Super-Scaffold_74	1907704	1915014	7310	g_6738	g_6740
Super-Scaffold_74	1919078	1929860	10782	g_6740	g_6742
Super-Scaffold_74	1939607	1960451	20844	g_6742	g_6744
Super-Scaffold_74	1968603	1973805	5202	g_6744	g_6745
Super-Scaffold_74	1986646	1995186	8540	g_6745	g_6746
Super-Scaffold_74	1995809	1999774	3965	g_6746	g_6747
Super-Scaffold_74	2002056	2007583	5527	g_6747	g_6748
Super-Scaffold_74	2008268	2034081	25813	g_6748	g_6751
Super-Scaffold_74	2034626	2035203	577	g_6751	g_6752
Super-Scaffold_74	2046728	2050622	3894	g_6752	g_43373
Super-Scaffold_74	2057680	2058961	1281	g_43373	g_6753
Super-Scaffold_74	2059635	2059670	35	g_6753	g_6754
Super-Scaffold_74	2060065	2068894	8829	g_6754	g_43374
Super-Scaffold_74	2090998	2093405	2407	g_43374	g_6755
Super-Scaffold_74	2113251	2115707	2456	g_6755	g_6756
Super-Scaffold_74	2121299	2126548	5249	g_6756	g_6757
Super-Scaffold_74	2137471	2141986	4515	g_6757	g_6758
Super-Scaffold_74	2150205	2155161	4956	g_6758	g_6759
Super-Scaffold_74	2156781	2164069	7288	g_6759	g_6760
Super-Scaffold_74	2173060	2175265	2205	g_6760	g_43375
Super-Scaffold_74	2179965	2181908	1943	g_43375	g_6761
Super-Scaffold_74	2199360	2208751	9391	g_6761	g_6762
Super-Scaffold_74	2222586	2240777	18191	g_6762	g_6763
Super-Scaffold_74	2241457	2244981	3524	g_6763	g_6765
Super-Scaffold_74	2249506	2251120	1614	g_6765	g_6766
Super-Scaffold_74	2258276	2265262	6986	g_6766	g_6767
Super-Scaffold_74	2270276	2270887	611	g_6767	g_6768
Super-Scaffold_74	2271829	2275905	4076	g_6768	g_6769
Super-Scaffold_74	2277676	2283693	6017	g_6769	g_6770
Super-Scaffold_74	2288753	2290188	1435	g_6770	g_6771
Super-Scaffold_74	2306568	2313032	6464	g_6771	g_43376
Super-Scaffold_74	2329675	2330813	1138	g_43376	g_43377
Super-Scaffold_74	2345433	2347392	1959	g_43377	g_43378
Super-Scaffold_74	2352403	2354035	1632	g_43378	g_6772
Super-Scaffold_74	2364705	2385475	20770	g_6772	g_6774
Super-Scaffold_74	2389687	2392481	2794	g_6774	g_6775
Super-Scaffold_74	2393912	2427484	33572	g_6775	g_6777
Super-Scaffold_74	2428314	2457760	29446	g_6777	g_6778
Super-Scaffold_74	2458317	2459605	1288	g_6778	g_6779
Super-Scaffold_74	2460099	2482428	22329	g_6779	g_6780
Super-Scaffold_74	2491853	2540795	48942	g_6780	g_6782
Super-Scaffold_74	2544972	2550998	6026	g_6782	g_37275
Super-Scaffold_74	2552737	2636015	83278	g_37275	g_6787
Super-Scaffold_74	2636374	2636507	133	g_6787	g_37276
Super-Scaffold_74	2637142	9303625	6666483	g_37276	g_6788
Super-Scaffold_74	9325685	9332776	7091	g_6788	g_6789
Super-Scaffold_74	9339963	9353627	13664	g_6789	g_6790
Super-Scaffold_74	9367142	9368216	1074	g_6790	g_6791
Super-Scaffold_74	9397692	9402394	4702	g_6791	g_6792
Super-Scaffold_74	9402783	9405359	2576	g_6792	g_6793
Super-Scaffold_74	9407968	9412348	4380	g_6793	g_6794
Super-Scaffold_74	9418186	9450161	31975	g_6794	g_6796
Super-Scaffold_74	9452500	9465022	12522	g_6796	g_6797
Super-Scaffold_74	9465231	9490568	25337	g_6797	g_6800
Super-Scaffold_74	9502964	9506075	3111	g_6800	g_6801
Super-Scaffold_74	9511850	9515058	3208	g_6801	g_6802
Super-Scaffold_74	9517198	9550947	33749	g_6802	g_6803
Super-Scaffold_74	9553025	9555394	2369	g_6803	g_6804
Super-Scaffold_74	9557936	9558869	933	g_6804	g_6805
Super-Scaffold_74	9561072	9568869	7797	g_6805	g_6806
Super-Scaffold_74	9569177	9581298	12121	g_6806	g_6807
Super-Scaffold_74	9601380	9605925	4545	g_6807	g_6808
Super-Scaffold_74	9611373	9620345	8972	g_6808	g_6809
Super-Scaffold_74	9627107	9629344	2237	g_6809	g_6810
Super-Scaffold_74	9631794	9632616	822	g_6810	g_6811
Super-Scaffold_74	9650633	9661235	10602	g_6811	g_6812
Super-Scaffold_74	9661486	9680545	19059	g_6812	g_6813
Super-Scaffold_74	9683579	9688148	4569	g_6813	g_6814
Super-Scaffold_74	9691866	9703098	11232	g_6814	g_6815
Super-Scaffold_74	9710528	9722853	12325	g_6815	g_6816
Super-Scaffold_74	9728970	9731743	2773	g_6816	g_6817
Super-Scaffold_74	9740197	9746608	6411	g_6817	g_6818
Super-Scaffold_74	9753500	9778568	25068	g_6818	g_6820
Super-Scaffold_74	9780849	9782892	2043	g_6820	g_6821
Super-Scaffold_74	9787172	9789369	2197	g_6821	g_6822
Super-Scaffold_74	9797773	9844691	46918	g_6822	g_6823
Super-Scaffold_74	9845032	9849467	4435	g_6823	g_6824
Super-Scaffold_74	9870336	9879301	8965	g_6824	g_6826
Super-Scaffold_74	9899876	9899937	61	g_6826	g_37279
Super-Scaffold_74	9902867	9909270	6403	g_37279	g_6827
Super-Scaffold_74	9909530	9910209	679	g_6827	g_6828
Super-Scaffold_74	9913003	9962285	49282	g_6828	g_6829
Super-Scaffold_74	9963511	10012756	49245	g_6829	g_6830
Super-Scaffold_74	10025275	10027149	1874	g_6830	g_6831
Super-Scaffold_74	10030688	10031608	920	g_6831	g_6832
Super-Scaffold_74	10032779	10035731	2952	g_6832	g_6834
Super-Scaffold_74	10047539	10051158	3619	g_6834	g_6835
Super-Scaffold_74	10055268	10057055	1787	g_6835	g_6836
Super-Scaffold_74	10079099	10084190	5091	g_6836	g_6837
Super-Scaffold_74	10084498	10090428	5930	g_6837	g_6838
Super-Scaffold_74	10096914	10099774	2860	g_6838	g_6839
Super-Scaffold_74	10106419	10107626	1207	g_6839	g_6840
Super-Scaffold_74	10109804	10119301	9497	g_6840	g_6841
Super-Scaffold_74	10134268	10143685	9417	g_37283	g_6842
Super-Scaffold_74	10193136	10193624	488	g_6842	g_6843
Super-Scaffold_74	10197566	10199369	1803	g_6843	g_6844
Super-Scaffold_74	10202466	10205155	2689	g_6844	g_6845
Super-Scaffold_74	10208581	10210390	1809	g_6845	g_6846
Super-Scaffold_74	10210749	10211055	306	g_6846	g_6847
Super-Scaffold_74	10213822	10214393	571	g_6847	g_6848
Super-Scaffold_74	10254241	10308697	54456	g_6848	g_6852
Super-Scaffold_74	10324709	10328092	3383	g_6852	g_6853
Super-Scaffold_74	10328741	10329809	1068	g_6853	g_6854
Super-Scaffold_74	10334758	10336078	1320	g_6854	g_6855
Super-Scaffold_74	10339846	10344318	4472	g_6856	g_6857
Super-Scaffold_74	10344878	10346879	2001	g_6857	g_6858
Super-Scaffold_74	10348414	10352256	3842	g_6858	g_6859
Super-Scaffold_74	10353644	10356373	2729	g_6859	g_6860
Super-Scaffold_74	10357761	10358350	589	g_6860	g_6861
Super-Scaffold_74	10360451	10361494	1043	g_6861	g_6862
Super-Scaffold_74	10368198	10369176	978	g_6862	g_6863
Super-Scaffold_74	10372244	10373310	1066	g_6863	g_6864
Super-Scaffold_74	10381735	10384161	2426	g_6864	g_6865
Super-Scaffold_74	10404409	10406069	1660	g_6865	g_6866
Super-Scaffold_74	10412252	10415602	3350	g_6866	g_6867
Super-Scaffold_74	10417452	10426736	9284	g_6867	g_6868
Super-Scaffold_74	10437733	10440832	3099	g_6868	g_6869
Super-Scaffold_74	10448876	10451246	2370	g_6869	g_6870
Super-Scaffold_74	10456723	10463049	6326	g_6870	g_6871
Super-Scaffold_74	10467285	10471505	4220	g_6871	g_6874
Super-Scaffold_74	10473674	10485931	12257	g_6874	g_6875
Super-Scaffold_74	10488206	10499914	11708	g_6875	g_43379
Super-Scaffold_74	10502206	10505001	2795	g_43379	g_6876
Super-Scaffold_74	10511308	10524202	12894	g_6876	g_6877
Super-Scaffold_74	10526929	10528139	1210	g_6877	g_6878
Super-Scaffold_74	10528914	10530123	1209	g_6878	g_6879
Super-Scaffold_74	10533972	10547260	13288	g_6879	g_43380
Super-Scaffold_74	10549719	10550693	974	g_43380	g_6880
Super-Scaffold_74	10550986	10561189	10203	g_6880	g_6883
Super-Scaffold_74	10562487	10568051	5564	g_6883	g_6884
Super-Scaffold_74	10572998	10575530	2532	g_6884	g_6885
Super-Scaffold_74	10576348	10577561	1213	g_6885	g_6886
Super-Scaffold_74	10582114	10591406	9292	g_6886	g_6887
Super-Scaffold_74	10593857	10596956	3099	g_6888	g_6889
Super-Scaffold_74	10598741	10598931	190	g_6889	g_43381
Super-Scaffold_74	10600159	10602866	2707	g_43381	g_6890
Super-Scaffold_74	10606574	10607527	953	g_6890	g_6891
Super-Scaffold_74	10608579	10610099	1520	g_6891	g_6892
Super-Scaffold_74	10613092	10634410	21318	g_6892	g_6893
Super-Scaffold_74	10639476	10647011	7535	g_6893	g_6894
Super-Scaffold_74	10652574	10653311	737	g_6894	g_43382
Super-Scaffold_74	10654152	10658044	3892	g_43382	g_6895
Super-Scaffold_74	10665920	10672686	6766	g_6895	g_6896
Super-Scaffold_74	10678126	10680940	2814	g_6896	g_6897
Super-Scaffold_74	10682813	10684345	1532	g_6897	g_6898
Super-Scaffold_74	10687808	10688548	740	g_6898	g_6899
Super-Scaffold_74	10693322	10694300	978	g_6899	g_6900
Super-Scaffold_74	10694648	10706439	11791	g_6900	g_6901
Super-Scaffold_74	10712077	10717967	5890	g_6901	g_6902
Super-Scaffold_74	10720467	10726397	5930	g_6902	g_6903
Super-Scaffold_74	10728642	10730338	1696	g_6903	g_6904
Super-Scaffold_74	10736206	10738180	1974	g_6904	g_6905
Super-Scaffold_74	10739447	10744283	4836	g_6905	g_6906
Super-Scaffold_74	10782120	10794907	12787	g_6906	g_6907
Super-Scaffold_74	10799750	10803226	3476	g_6907	g_6908
Super-Scaffold_74	10806893	10821968	15075	g_6908	g_6909
Super-Scaffold_74	10825105	10827041	1936	g_6909	g_6910
Super-Scaffold_74	10830826	10832649	1823	g_6910	g_6911
Super-Scaffold_74	10840060	10847702	7642	g_6911	g_6912
Super-Scaffold_74	10847959	10878030	30071	g_6912	g_6913
Super-Scaffold_74	10910766	10916183	5417	g_6913	g_6914
Super-Scaffold_74	10921750	10923307	1557	g_6914	g_6915
Super-Scaffold_74	10937722	10974624	36902	g_6915	g_6917
Super-Scaffold_74	10983801	10987504	3703	g_6917	g_6918
Super-Scaffold_74	10991712	10999145	7433	g_6918	g_43383
Super-Scaffold_74	11003413	11008822	5409	g_43383	g_6919
Super-Scaffold_74	11015924	11017233	1309	g_6919	g_43384
Super-Scaffold_74	11021473	11025543	4070	g_43384	g_6920
Super-Scaffold_74	11029461	11030070	609	g_6920	g_6921
Super-Scaffold_74	11036178	11038828	2650	g_6921	g_6922
Super-Scaffold_74	11039771	11042018	2247	g_6922	g_6923
Super-Scaffold_74	11047480	11053805	6325	g_6923	g_6924
Super-Scaffold_74	11057170	11062744	5574	g_6924	g_6925
Super-Scaffold_74	11067248	11068973	1725	g_6925	g_6926
Super-Scaffold_74	11088382	11092407	4025	g_6926	g_6927
Super-Scaffold_74	11104138	11108140	4002	g_6927	g_6928
Super-Scaffold_74	11121976	11139500	17524	g_6928	g_37291
Super-Scaffold_74	11139781	11158351	18570	g_37291	g_6929
Super-Scaffold_74	11161451	11162228	777	g_6929	g_6930
Super-Scaffold_74	11163519	11167416	3897	g_6930	g_6931
Super-Scaffold_74	11168066	11170145	2079	g_6931	g_6932
Super-Scaffold_74	11189227	11193597	4370	g_6932	g_6933
Super-Scaffold_74	11205839	11208895	3056	g_6933	g_6934
Super-Scaffold_74	11210844	11214985	4141	g_6934	g_6935
Super-Scaffold_74	11217892	11221676	3784	g_6935	g_6936
Super-Scaffold_74	11231783	11235153	3370	g_6936	g_37293
Super-Scaffold_74	11235431	11239119	3688	g_37293	g_6937
Super-Scaffold_74	11247803	11248913	1110	g_6937	g_43385
Super-Scaffold_74	11249329	11253647	4318	g_43385	g_37294
Super-Scaffold_74	11253865	11260294	6429	g_37294	g_6938
Super-Scaffold_74	11263254	11267049	3795	g_6938	g_6939
Super-Scaffold_74	11282069	11286601	4532	g_6939	g_6940
Super-Scaffold_74	11287620	11290014	2394	g_6940	g_43386
Super-Scaffold_74	11293514	11297470	3956	g_43386	g_6941
Super-Scaffold_74	11304583	11307963	3380	g_6941	g_43387
Super-Scaffold_74	11315406	11325283	9877	g_43387	g_6942
Super-Scaffold_74	11351042	11357327	6285	g_6942	g_6943
Super-Scaffold_74	11357581	11359891	2310	g_6943	g_37295
Super-Scaffold_74	11364864	11438451	73587	g_6944	g_6946
Super-Scaffold_74	11439584	11503640	64056	g_6946	g_37297
Super-Scaffold_74	11503876	11505292	1416	g_37297	g_6947
Super-Scaffold_74	11514317	11520003	5686	g_6947	g_6948
Super-Scaffold_74	11619664	11666477	46813	g_6948	g_37299
Super-Scaffold_74	11666734	11905174	238440	g_37299	g_6953
Super-Scaffold_74	11905572	11913376	7804	g_6953	g_6954
Super-Scaffold_74	11913750	11925006	11256	g_6954	g_6955
Super-Scaffold_74	11925209	12074074	148865	g_6955	g_6959
Super-Scaffold_74	12074277	12149857	75580	g_6959	g_6962
Super-Scaffold_74	12150057	12263129	113072	g_6962	g_6965
Super-Scaffold_74	12263428	12360184	96756	g_6965	g_6967
Super-Scaffold_74	12363224	12364301	1077	g_6967	g_6968
Super-Scaffold_74	12375848	12385670	9822	g_6968	g_6969
Super-Scaffold_74	12397876	12401911	4035	g_6969	g_6970
Super-Scaffold_74	12415053	12418454	3401	g_6970	g_6971
Super-Scaffold_74	12418756	12419899	1143	g_6971	g_6972
Super-Scaffold_74	12423552	12427937	4385	g_6972	g_6973
Super-Scaffold_74	12433270	12452451	19181	g_6973	g_6975
Super-Scaffold_74	12462731	12471524	8793	g_6975	g_6976
Super-Scaffold_74	12479080	12482862	3782	g_6976	g_6977
Super-Scaffold_74	12487487	12488023	536	g_6977	g_6978
Super-Scaffold_74	12492378	12493583	1205	g_6978	g_6979
Super-Scaffold_74	12499887	12502114	2227	g_6979	g_43388
Super-Scaffold_74	12506963	12512079	5116	g_43388	g_6980
Super-Scaffold_74	12522360	12524634	2274	g_6980	g_6981
Super-Scaffold_74	12527558	12531376	3818	g_6981	g_6982
Super-Scaffold_74	12533660	12536443	2783	g_6982	g_6983
Super-Scaffold_74	12540589	12544754	4165	g_6983	g_6984
Super-Scaffold_74	12546584	12550046	3462	g_6984	g_6985
Super-Scaffold_74	12555830	12556529	699	g_6985	g_6986
Super-Scaffold_74	12556915	12560848	3933	g_6986	g_6987
Super-Scaffold_74	12562785	12563746	961	g_6987	g_6988
Super-Scaffold_74	12566627	12569255	2628	g_6988	g_6989
Super-Scaffold_74	12569830	12575447	5617	g_6989	g_6990
Super-Scaffold_74	12581351	12583662	2311	g_6990	g_6991
Super-Scaffold_74	12591377	12596932	5555	g_6991	g_6992
Super-Scaffold_74	12610144	12628950	18806	g_6992	g_6993
Super-Scaffold_74	12631690	12636294	4604	g_6993	g_6994
Super-Scaffold_74	12643694	12687400	43706	g_6994	g_6995
Super-Scaffold_74	12688645	12690432	1787	g_6995	g_43389
Super-Scaffold_74	12692354	12719183	26829	g_43389	g_6996
Super-Scaffold_74	12720481	12753348	32867	g_6996	g_6997
Super-Scaffold_74	12782214	12784054	1840	g_6997	g_43390
Super-Scaffold_74	12797701	12803343	5642	g_43390	g_6999
Super-Scaffold_74	12803660	12806396	2736	g_6999	g_7000
Super-Scaffold_74	12822826	12843076	20250	g_7000	g_7002
Super-Scaffold_74	12844530	12848623	4093	g_7002	g_7003
Super-Scaffold_74	12853548	12858090	4542	g_7003	g_7004
Super-Scaffold_74	12860946	12863158	2212	g_7004	g_7005
Super-Scaffold_74	12863772	12869172	5400	g_7005	g_43391
Super-Scaffold_74	12875554	12881688	6134	g_43391	g_7006
Super-Scaffold_74	12890688	12893773	3085	g_7006	g_7007
Super-Scaffold_74	12897001	12899033	2032	g_7007	g_7008
Super-Scaffold_74	12902532	12905112	2580	g_7008	g_7009
Super-Scaffold_74	12915163	12938627	23464	g_7009	g_7010
Super-Scaffold_74	12941757	12941940	183	g_7010	g_7011
Super-Scaffold_74	12943664	12967850	24186	g_7011	g_7012
Super-Scaffold_74	12968210	12984953	16743	g_7012	g_7014
Super-Scaffold_74	12986981	13015136	28155	g_7014	g_7015
Super-Scaffold_74	13017074	13035772	18698	g_7015	g_7016
Super-Scaffold_74	13038169	13108846	70677	g_7016	g_37316
Super-Scaffold_74	13111467	13288319	176852	g_37316	g_7022
Super-Scaffold_74	13293125	13581681	288556	g_7022	g_7029
Super-Scaffold_74	13582211	13588102	5891	g_7029	g_7030
Super-Scaffold_74	13663557	13707046	43489	g_7030	g_7031
Super-Scaffold_74	13708634	13710164	1530	g_7031	g_7032
Super-Scaffold_74	13715540	13715603	63	g_37318	g_7033
Super-Scaffold_74	13715824	13718146	2322	g_7033	g_7034
Super-Scaffold_74	13721466	13728562	7096	g_7034	g_7036
Super-Scaffold_74	13733067	13733925	858	g_7036	g_7037
Super-Scaffold_74	13738866	13741351	2485	g_7037	g_7038
Super-Scaffold_74	13743492	13749699	6207	g_7038	g_7040
Super-Scaffold_74	13764873	13792197	27324	g_7040	g_7042
Super-Scaffold_74	13793719	13794188	469	g_7042	g_7043
Super-Scaffold_74	13801810	13826564	24754	g_7043	g_7045
Super-Scaffold_74	13844728	13856803	12075	g_7045	g_7046
Super-Scaffold_74	13857063	13867074	10011	g_7046	g_7047
Super-Scaffold_74	13883012	13945864	62852	g_7047	g_7048
Super-Scaffold_74	13946130	14004279	58149	g_7048	g_7049
Super-Scaffold_74	14007553	14036612	29059	g_7049	g_7050
Super-Scaffold_74	14075094	14090819	15725	g_7050	g_7051
Super-Scaffold_74	14161037	14259746	98709	g_7051	g_7054
Super-Scaffold_74	14268417	14356994	88577	g_7054	g_7056
Super-Scaffold_74	14357194	14420233	63039	g_7056	g_7058
Super-Scaffold_74	14421657	14422183	526	g_7058	g_7057
Super-Scaffold_74	14454464	14472908	18444	g_7057	g_7059
Super-Scaffold_74	14476037	14477723	1686	g_7059	g_7060
Super-Scaffold_74	14482048	14893684	411636	g_7060	g_7063
Super-Scaffold_74	14898388	14904137	5749	g_7063	g_7064
Super-Scaffold_74	14904577	14947583	43006	g_7064	g_7065
Super-Scaffold_74	14947834	14977346	29512	g_7065	g_7067
Super-Scaffold_74	14977597	14989023	11426	g_7067	g_7068
Super-Scaffold_74	14989229	15007456	18227	g_7068	g_7069
Super-Scaffold_74	15032711	15054252	21541	g_7069	g_7070
Super-Scaffold_74	15061702	15065466	3764	g_7070	g_7071
Super-Scaffold_74	15066014	15068761	2747	g_7071	g_43392
Super-Scaffold_74	15069714	15069746	32	g_43392	g_7072
Super-Scaffold_74	15070012	15085128	15116	g_7072	g_7074
Super-Scaffold_74	15098177	15102453	4276	g_7074	g_7075
Super-Scaffold_74	15111486	15231875	120389	g_7075	g_7082
Super-Scaffold_74	15246745	15261873	15128	g_7082	g_7083
Super-Scaffold_74	15262085	15264376	2291	g_7083	g_7084
Super-Scaffold_74	15269898	15272227	2329	g_7084	g_7085
Super-Scaffold_74	15272454	15343987	71533	g_7085	g_7087
Super-Scaffold_74	15344205	15372099	27894	g_7087	g_7089
Super-Scaffold_74	15393576	15426728	33152	g_7089	g_7090
Super-Scaffold_74	15427024	15475013	47989	g_7090	g_7092
Super-Scaffold_74	15475240	15491420	16180	g_7092	g_7093
Super-Scaffold_74	15491758	15558236	66478	g_7093	g_7097
Super-Scaffold_74	15558475	15573954	15479	g_7097	g_7098
Super-Scaffold_74	15574157	15620364	46207	g_7098	g_7099
Super-Scaffold_74	15620678	15627418	6740	g_7099	g_7100
Super-Scaffold_74	15654843	15660963	6120	g_7100	g_7101
Super-Scaffold_74	15673340	15674546	1206	g_7101	g_7102
Super-Scaffold_74	15678766	15683329	4563	g_7102	g_7103
Super-Scaffold_74	15685005	15693080	8075	g_7103	g_7104
Super-Scaffold_74	15694501	15697558	3057	g_7104	g_7105
Super-Scaffold_74	15700383	15708335	7952	g_7105	g_7106
Super-Scaffold_74	15710653	15718599	7946	g_7106	g_7107
Super-Scaffold_74	15723364	15726407	3043	g_7107	g_43393
Super-Scaffold_74	15739969	15790525	50556	g_43393	g_7108
Super-Scaffold_74	15791424	15807029	15605	g_7108	g_7109
Super-Scaffold_74	15808605	15809938	1333	g_7109	g_43394
Super-Scaffold_74	15811242	15839477	28235	g_43394	g_7110
Super-Scaffold_74	15850029	15921807	71778	g_7110	g_7114
Super-Scaffold_74	15922583	15922905	322	g_7114	g_7115
Super-Scaffold_74	15923204	15923232	28	g_7115	g_7116
Super-Scaffold_74	15924446	15987631	63185	g_7116	g_7117
Super-Scaffold_74	15994180	15996586	2406	g_7117	g_7118
Super-Scaffold_74	15999063	15999787	724	g_7118	g_7119
Super-Scaffold_74	16005304	16007055	1751	g_7119	g_43395
Super-Scaffold_74	16011974	16014127	2153	g_43395	g_43396
Super-Scaffold_74	16048218	16078508	30290	g_43396	g_37356
Super-Scaffold_74	16078771	16113162	34391	g_37356	g_7121
Super-Scaffold_74	16113479	16119512	6033	g_7121	g_7122
Super-Scaffold_74	16124183	16124818	635	g_7122	g_7123
Super-Scaffold_74	16128401	16130968	2567	g_7123	g_7124
Super-Scaffold_74	16151962	16163782	11820	g_7124	g_7126
Super-Scaffold_74	16170472	16172297	1825	g_7126	g_43397
Super-Scaffold_74	16178100	16180515	2415	g_43397	g_7127
Super-Scaffold_74	16184445	16191417	6972	g_7127	g_43398
Super-Scaffold_74	16205289	16209315	4026	g_43398	g_7128
Super-Scaffold_74	16209590	16279393	69803	g_7128	g_7135
Super-Scaffold_74	16279602	16291816	12214	g_7135	g_7136
Super-Scaffold_74	16308762	16335486	26724	g_7136	g_7138
Super-Scaffold_74	16355793	16356653	860	g_37360	g_7139
Super-Scaffold_74	16357075	16359644	2569	g_7139	g_7140
Super-Scaffold_74	16377285	16380662	3377	g_7140	g_7141
Super-Scaffold_74	16389037	16398889	9852	g_7141	g_7143
Super-Scaffold_74	16405345	16405667	322	g_7144	g_7145
Super-Scaffold_74	16407031	16407225	194	g_7145	g_7146
Super-Scaffold_74	16408796	16428142	19346	g_7146	g_7148
Super-Scaffold_74	16444174	16446761	2587	g_7149	g_7150
Super-Scaffold_74	16447309	16460824	13515	g_7150	g_7151
Super-Scaffold_74	16462130	16475522	13392	g_7151	g_7152
Super-Scaffold_74	16478732	16510879	32147	g_7152	g_7154
Super-Scaffold_74	16529805	16530994	1189	g_7154	g_7156
Super-Scaffold_74	16546310	16558268	11958	g_7156	g_7157
Super-Scaffold_74	16558669	16594201	35532	g_7157	g_7158
Super-Scaffold_74	16663492	16682296	18804	g_7158	g_37363
Super-Scaffold_74	16682541	16700221	17680	g_37363	g_7160
Super-Scaffold_74	16709819	16851905	142086	g_7160	g_7164
Super-Scaffold_74	16871470	16889679	18209	g_7164	g_7165
Super-Scaffold_74	16896567	16909120	12553	g_7165	g_7166
Super-Scaffold_74	16913626	16921844	8218	g_7166	g_7167
Super-Scaffold_74	16928536	16940359	11823	g_7167	g_7169
Super-Scaffold_74	16942191	16942293	102	g_7169	g_43399
Super-Scaffold_74	16946747	16950828	4081	g_43399	g_7170
Super-Scaffold_74	16954954	16961316	6362	g_7170	g_7171
Super-Scaffold_74	16963199	16968401	5202	g_7171	g_7172
Super-Scaffold_74	16989704	16998278	8574	g_7172	g_7173
Super-Scaffold_74	17011176	17022736	11560	g_7173	g_7174
Super-Scaffold_74	17043441	17056476	13035	g_7174	g_7176
Super-Scaffold_74	17066820	17081216	14396	g_7176	g_7177
Super-Scaffold_74	17081494	17092005	10511	g_7177	g_7178
Super-Scaffold_74	17101660	17164213	62553	g_7178	g_7179
Super-Scaffold_74	17165799	17168727	2928	g_7179	g_7180
Super-Scaffold_74	17171889	17173816	1927	g_7180	g_43400
Super-Scaffold_74	17175293	17202344	27051	g_43400	g_7181
Super-Scaffold_74	17207600	17214180	6580	g_7181	g_7182
Super-Scaffold_74	17214866	17217086	2220	g_7182	g_7183
Super-Scaffold_74	17218478	17224832	6354	g_7183	g_7184
Super-Scaffold_74	17241453	17266523	25070	g_7184	g_7185
Super-Scaffold_74	17270780	17272289	1509	g_7185	g_7186
Super-Scaffold_74	17274632	17296105	21473	g_7186	g_7189
Super-Scaffold_74	17298758	17301545	2787	g_7189	g_7190
Super-Scaffold_74	17302678	17302784	106	g_7190	g_7191
Super-Scaffold_74	17303128	17303343	215	g_7191	g_7192
Super-Scaffold_74	17304008	17306407	2399	g_7192	g_7193
Super-Scaffold_74	17306691	17315780	9089	g_7193	g_7194
Super-Scaffold_74	17318230	17322479	4249	g_7194	g_7195
Super-Scaffold_74	17328184	17337873	9689	g_7195	g_7196
Super-Scaffold_74	17346126	17365467	19341	g_7196	g_7197
Super-Scaffold_74	17383629	17408450	24821	g_7197	g_7198
Super-Scaffold_74	17413400	17417664	4264	g_7198	g_7199
Super-Scaffold_74	17419498	17420617	1119	g_7199	g_7200
Super-Scaffold_74	17425028	17426784	1756	g_7200	g_7201
Super-Scaffold_74	17437248	17450844	13596	g_7201	g_7202
Super-Scaffold_74	17457389	17461339	3950	g_7202	g_7203
Super-Scaffold_74	17464042	17464888	846	g_7203	g_43401
Super-Scaffold_74	17467977	17471458	3481	g_43401	g_7204
Super-Scaffold_74	17485443	17491363	5920	g_7204	g_7205
Super-Scaffold_74	17499424	17631399	131975	g_7205	g_7206
Super-Scaffold_74	17639387	17640959	1572	g_7206	g_7207
Super-Scaffold_74	17647590	17649307	1717	g_7207	g_43402
Super-Scaffold_74	17650959	17660246	9287	g_43402	g_43403
Super-Scaffold_74	17661334	17673857	12523	g_43403	g_7209
Super-Scaffold_74	17674870	17691316	16446	g_7209	g_7210
Super-Scaffold_74	17694370	17696004	1634	g_7210	g_7211
Super-Scaffold_74	17697017	17744899	47882	g_7211	g_7214
Super-Scaffold_74	17751427	17767779	16352	g_7214	g_7215
Super-Scaffold_74	17784549	17788633	4084	g_7215	g_7216
Super-Scaffold_74	17801239	17808597	7358	g_7216	g_7217
Super-Scaffold_74	17818014	17820570	2556	g_7217	g_7218
Super-Scaffold_74	17824538	17826881	2343	g_7218	g_7219
Super-Scaffold_74	17837668	17841647	3979	g_7219	g_7220
Super-Scaffold_74	17854484	17856598	2114	g_7220	g_7221
Super-Scaffold_74	17858931	17878584	19653	g_7221	g_7222
Super-Scaffold_74	17882581	17891231	8650	g_7222	g_7223
Super-Scaffold_74	17905966	17990573	84607	g_7223	g_7228
Super-Scaffold_74	18035268	18041835	6567	g_7228	g_7229
Super-Scaffold_74	18042164	18110599	68435	g_7229	g_7232
Super-Scaffold_74	18110832	18179198	68366	g_7232	g_7234
Super-Scaffold_74	18192059	18205793	13734	g_7234	g_7235
Super-Scaffold_74	18206152	18218273	12121	g_7235	g_37377
Super-Scaffold_74	18218683	18288916	70233	g_37377	g_7238
Super-Scaffold_74	18289287	18390501	101214	g_7238	g_7244
Super-Scaffold_74	18400768	18407108	6340	g_7244	g_7245
Super-Scaffold_74	18422169	18427116	4947	g_7245	g_7246
Super-Scaffold_74	18428889	18430029	1140	g_7246	g_7247
Super-Scaffold_74	18431065	18432150	1085	g_7247	g_43404
Super-Scaffold_74	18433454	18434393	939	g_43404	g_7248
Super-Scaffold_74	18435142	18435697	555	g_7248	g_7249
Super-Scaffold_74	18438611	18446173	7562	g_7249	g_43405
Super-Scaffold_74	18450987	18452994	2007	g_43405	g_7250
Super-Scaffold_74	18453449	18462460	9011	g_7250	g_7251
Super-Scaffold_74	18464039	18477187	13148	g_7251	g_7252
Super-Scaffold_74	18486521	18519369	32848	g_7252	g_7253
Super-Scaffold_74	18528497	18561273	32776	g_7253	g_7254
Super-Scaffold_74	18570401	18592070	21669	g_7254	g_7255
Super-Scaffold_74	18602247	18634796	32549	g_7255	g_7256
Super-Scaffold_74	18643941	18672564	28623	g_7256	g_37386
Super-Scaffold_74	18672773	18839295	166522	g_37386	g_7262
Super-Scaffold_74	18841194	18849738	8544	g_7262	g_7263
Super-Scaffold_74	18849977	18872283	22306	g_7263	g_7264
Super-Scaffold_74	18872489	18928896	56407	g_7264	g_37388
Super-Scaffold_74	18929105	18959767	30662	g_37388	g_7265
Super-Scaffold_74	18961029	19023780	62751	g_7265	g_7267
Super-Scaffold_74	19024022	19068624	44602	g_7267	g_7268
Super-Scaffold_74	19068899	19099312	30413	g_7268	g_7270
Super-Scaffold_74	19099698	19100013	315	g_7270	g_7269
Super-Scaffold_74	19104852	19147872	43020	g_7269	g_7273
Super-Scaffold_74	19153777	19183008	29231	g_7273	g_7274
Super-Scaffold_74	19188676	19191946	3270	g_7274	g_7275
Super-Scaffold_74	19193476	19213862	20386	g_7275	g_7277
Super-Scaffold_74	19215051	19219420	4369	g_7277	g_7278
Super-Scaffold_74	19221003	19223358	2355	g_7278	g_7279
Super-Scaffold_74	19224714	19226470	1756	g_7279	g_7280
Super-Scaffold_74	19227567	19467389	239822	g_7280	g_7281
Super-Scaffold_74	19469531	19473863	4332	g_7281	g_7282
Super-Scaffold_74	19475036	19482529	7493	g_7282	g_43406
Super-Scaffold_74	19483768	19490041	6273	g_43406	g_43407
Super-Scaffold_74	19491921	19497319	5398	g_43407	g_7283
Super-Scaffold_74	19498446	19511831	13385	g_7283	g_7285
Super-Scaffold_74	19513768	19534943	21175	g_7285	g_7287
Super-Scaffold_74	19537006	19538737	1731	g_7287	g_7288
Super-Scaffold_74	19542064	19544347	2283	g_7288	g_7289
Super-Scaffold_74	19546412	19548179	1767	g_7289	g_7290
Super-Scaffold_74	19551171	19553451	2280	g_7290	g_7291
Super-Scaffold_74	19555520	19557288	1768	g_7291	g_7292
Super-Scaffold_74	19560462	19562794	2332	g_7292	g_7293
Super-Scaffold_74	19564635	19566386	1751	g_7293	g_7294
Super-Scaffold_74	19573037	19578276	5239	g_7294	g_7296
Super-Scaffold_74	19579859	19582795	2936	g_7296	g_7297
Super-Scaffold_74	19584864	19586616	1752	g_7297	g_7298
Super-Scaffold_74	19589662	19609583	19921	g_7298	g_7299
Super-Scaffold_74	19610723	19613949	3226	g_7299	g_7300
Super-Scaffold_74	19614536	19620544	6008	g_7300	g_7301
Super-Scaffold_74	19622232	19624652	2420	g_7301	g_7302
Super-Scaffold_74	19625383	19628861	3478	g_7302	g_7303
Super-Scaffold_74	19645016	19647235	2219	g_7303	g_7304
Super-Scaffold_74	19648933	19649517	584	g_7304	g_43408
Super-Scaffold_74	19652733	19654249	1516	g_43408	g_43409
Super-Scaffold_74	19720630	19723889	3259	g_43409	g_7305
Super-Scaffold_74	19730300	19732449	2149	g_7305	g_43410
Super-Scaffold_74	19743179	19760426	17247	g_43410	g_7307
Super-Scaffold_74	19780403	19782735	2332	g_7307	g_43411
Super-Scaffold_74	19789801	19790314	513	g_43411	g_43412
Super-Scaffold_74	19795093	19797217	2124	g_43412	g_7308
Super-Scaffold_74	19813131	19815905	2774	g_7308	g_7309
Super-Scaffold_74	19819310	19820597	1287	g_7309	g_7310
Super-Scaffold_74	19824108	19826799	2691	g_7310	g_7311
Super-Scaffold_74	19829511	19830265	754	g_7311	g_43413
Super-Scaffold_74	19832573	19835303	2730	g_43413	g_43414
Super-Scaffold_74	19842715	19854687	11972	g_43414	g_7312
Super-Scaffold_74	19875315	19953445	78130	g_7312	g_7315
Super-Scaffold_74	19953651	20271948	318297	g_7315	g_37394
Super-Scaffold_74	20272160	20330572	58412	g_37394	g_7323
Super-Scaffold_74	20335309	20351256	15947	g_7323	g_7324
Super-Scaffold_74	20358016	20453257	95241	g_7324	g_7327
Super-Scaffold_74	20453502	20524439	70937	g_7327	g_7331
Super-Scaffold_74	20524693	20528617	3924	g_7331	g_7332
Super-Scaffold_74	20528829	20597500	68671	g_7332	g_7334
Super-Scaffold_74	20613684	20661287	47603	g_7334	g_7336
Super-Scaffold_74	20680281	20707841	27560	g_7336	g_7337
Super-Scaffold_74	20711446	20712620	1174	g_7337	g_7338
Super-Scaffold_74	20713363	20714677	1314	g_7338	g_7339
Super-Scaffold_74	20724397	20741057	16660	g_7339	g_7340
Super-Scaffold_74	20747818	20752483	4665	g_7340	g_7341
Super-Scaffold_74	20765315	20806563	41248	g_7341	g_7342
Super-Scaffold_74	20813512	20861587	48075	g_7342	g_7343
Super-Scaffold_74	20862144	20865518	3374	g_7343	g_43415
Super-Scaffold_74	20866073	20867387	1314	g_43415	g_43416
Super-Scaffold_74	20867942	20878403	10461	g_43416	g_43417
Super-Scaffold_74	20885506	20887691	2185	g_43417	g_43418
Super-Scaffold_74	20893779	20905444	11665	g_43418	g_7344
Super-Scaffold_74	20908626	20911737	3111	g_7344	g_7345
Super-Scaffold_74	20912045	20921094	9049	g_7345	g_7346
Super-Scaffold_74	20923523	20924212	689	g_7346	g_43419
Super-Scaffold_74	20928469	20934281	5812	g_43419	g_7347
Super-Scaffold_74	20936002	20942470	6468	g_7347	g_7348
Super-Scaffold_74	20946732	20960797	14065	g_7348	g_7349
Super-Scaffold_74	20963416	20968662	5246	g_7349	g_43420
Super-Scaffold_74	20969606	20983532	13926	g_43420	g_7351
Super-Scaffold_74	20989855	20998150	8295	g_7351	g_7352
Super-Scaffold_74	21009245	21090357	81112	g_7352	g_7354
Super-Scaffold_74	21093815	21099449	5634	g_7354	g_7355
Super-Scaffold_74	21103556	21113450	9894	g_7355	g_7357
Super-Scaffold_74	21115576	21121397	5821	g_7357	g_7358
Super-Scaffold_74	21121934	21124886	2952	g_7358	g_7359
Super-Scaffold_74	21133527	21151854	18327	g_7359	g_7360
Super-Scaffold_74	21162530	21296189	133659	g_7360	g_7361
Super-Scaffold_74	21302061	21329668	27607	g_7361	g_7362
Super-Scaffold_74	21337790	21353489	15699	g_7362	g_7363
Super-Scaffold_74	21357758	21363695	5937	g_7363	g_7364
Super-Scaffold_74	21365140	21378976	13836	g_7364	g_7365
Super-Scaffold_74	21384467	21386739	2272	g_7365	g_7366
Super-Scaffold_74	21390550	21394067	3517	g_7366	g_7367
Super-Scaffold_74	21406870	21416120	9250	g_7367	g_7368
Super-Scaffold_74	21433162	21433363	201	g_7368	g_7369
Super-Scaffold_74	21435707	21437612	1905	g_7369	g_7370
Super-Scaffold_74	21450601	21453442	2841	g_7370	g_7371
Super-Scaffold_74	21463678	21471022	7344	g_7371	g_7372
Super-Scaffold_74	21488734	21496854	8120	g_7372	g_7373
Super-Scaffold_74	21514630	21553623	38993	g_7373	g_7374
Super-Scaffold_74	21556170	21570516	14346	g_7374	g_7375
Super-Scaffold_74	21571838	21579150	7312	g_7375	g_43421
Super-Scaffold_74	21580811	21594851	14040	g_43421	g_7376
Super-Scaffold_74	21621866	21635294	13428	g_7376	g_7377
Super-Scaffold_74	21647839	21658664	10825	g_7377	g_7378
Super-Scaffold_74	21676252	21683789	7537	g_7378	g_7379
Super-Scaffold_74	21688291	21720549	32258	g_7379	g_7381
Super-Scaffold_74	21721655	21785879	64224	g_7381	g_37408
Super-Scaffold_74	21786172	21855939	69767	g_37408	g_7382
Super-Scaffold_74	21858266	21918107	59841	g_7382	g_7383
Super-Scaffold_74	21920662	21974205	53543	g_7383	g_7385
Super-Scaffold_74	21974740	21995213	20473	g_7385	g_7386
Super-Scaffold_74	21996082	21998372	2290	g_7386	g_7388
Super-Scaffold_74	21999262	22088182	88920	g_7388	g_7390
Super-Scaffold_74	22096970	22121613	24643	g_7390	g_7392
Super-Scaffold_74	22126617	22143794	17177	g_7392	g_7393
Super-Scaffold_74	22147498	22160693	13195	g_7393	g_7394
Super-Scaffold_74	22163686	22170011	6325	g_7394	g_43422
Super-Scaffold_74	22197761	22240281	42520	g_43422	g_43423
Super-Scaffold_74	22240496	22265012	24516	g_43423	g_7395
Super-Scaffold_74	22268758	22270792	2034	g_7395	g_7396
Super-Scaffold_74	22277833	22323093	45260	g_7396	g_7399
Super-Scaffold_74	22353537	22386551	33014	g_7399	g_7400
Super-Scaffold_74	22394866	22399736	4870	g_7400	g_7401
Super-Scaffold_74	22408517	22411565	3048	g_7401	g_7402
Super-Scaffold_74	22418837	22427311	8474	g_7402	g_7403
Super-Scaffold_74	22450374	22462967	12593	g_7403	g_7404
Super-Scaffold_74	22474403	22524589	50186	g_7404	g_7406
Super-Scaffold_74	22526124	22563069	36945	g_7406	g_7409
Super-Scaffold_74	22564576	22568274	3698	g_7409	g_7410
Super-Scaffold_74	22570281	22572327	2046	g_7410	g_7411
Super-Scaffold_74	22583020	22585431	2411	g_7411	g_7412
Super-Scaffold_74	22601178	22604888	3710	g_7412	g_7413
Super-Scaffold_74	22611200	22615903	4703	g_7413	g_7414
Super-Scaffold_74	22618910	22619820	910	g_7414	g_7415
Super-Scaffold_74	22623247	22624983	1736	g_7415	g_7416
Super-Scaffold_74	22628810	22641815	13005	g_7416	g_7417
Super-Scaffold_74	22647534	22652044	4510	g_7417	g_7418
Super-Scaffold_74	22654734	22672797	18063	g_7418	g_7419
Super-Scaffold_74	22675863	22698440	22577	g_7419	g_7420
Super-Scaffold_74	22701431	22766814	65383	g_7420	g_7421
Super-Scaffold_74	22767530	22816193	48663	g_7421	g_37410
Super-Scaffold_74	22816423	22904856	88433	g_37410	g_37412
Super-Scaffold_74	22905488	22957068	51580	g_37412	g_7425
Super-Scaffold_74	22957433	22972005	14572	g_7425	g_7426
Super-Scaffold_74	22976143	22989924	13781	g_7426	g_43424
Super-Scaffold_74	23004289	23015212	10923	g_43424	g_7428
Super-Scaffold_74	23030939	23070506	39567	g_7428	g_7431
Super-Scaffold_74	23071848	23106995	35147	g_7431	g_7432
Super-Scaffold_74	23128535	23164963	36428	g_7432	g_7434
Super-Scaffold_74	23166819	23175172	8353	g_7434	g_7436
Super-Scaffold_74	23175594	23178612	3018	g_7436	g_7437
Super-Scaffold_74	23227247	23227634	387	g_7437	g_7438
Super-Scaffold_74	23236411	23252907	16496	g_7438	g_7439
Super-Scaffold_74	23257391	23264489	7098	g_7439	g_7440
Super-Scaffold_74	23271746	23273276	1530	g_7440	g_7441
Super-Scaffold_74	23288095	23293177	5082	g_7441	g_7442
Super-Scaffold_74	23308097	23357924	49827	g_7442	g_7444
Super-Scaffold_74	23365355	23371612	6257	g_7444	g_7445
Super-Scaffold_74	23377897	23384248	6351	g_7445	g_37414
Super-Scaffold_74	23384466	23399397	14931	g_37414	g_7446
Super-Scaffold_74	23434687	23437658	2971	g_7446	g_43425
Super-Scaffold_74	23446081	23449946	3865	g_43425	g_7447
Super-Scaffold_74	23451556	23469311	17755	g_7447	g_7448
Super-Scaffold_74	23470465	23481040	10575	g_7448	g_7449
Super-Scaffold_74	23496603	23511830	15227	g_7449	g_7450
Super-Scaffold_74	23514137	23579301	65164	g_7450	g_7452
Super-Scaffold_74	23579849	23621513	41664	g_7452	g_37418
Super-Scaffold_74	23621857	23654435	32578	g_37418	g_7455
Super-Scaffold_74	23654659	23666440	11781	g_7455	g_7456
Super-Scaffold_74	23668164	23678662	10498	g_7456	g_7458
Super-Scaffold_74	23679297	23702501	23204	g_7458	g_7459
Super-Scaffold_74	23725656	23727442	1786	g_7459	g_7460
Super-Scaffold_74	23728842	23729221	379	g_7460	g_7461
Super-Scaffold_74	23736360	23739224	2864	g_7461	g_7462
Super-Scaffold_74	23745309	23754647	9338	g_7462	g_7463
Super-Scaffold_74	23761888	23868359	106471	g_7463	g_7466
Super-Scaffold_74	23868718	23882129	13411	g_7466	g_7467
Super-Scaffold_74	23882389	23896535	14146	g_7467	g_7468
Super-Scaffold_74	23899773	23912720	12947	g_37419	g_7469
Super-Scaffold_74	23934702	23934953	251	g_7469	g_7470
Super-Scaffold_74	23935303	23989627	54324	g_7470	g_7471
Super-Scaffold_74	23990370	24017407	27037	g_7471	g_7472
Super-Scaffold_74	24019380	24063324	43944	g_7472	g_7476
Super-Scaffold_74	24067422	24175504	108082	g_7476	g_7479
Super-Scaffold_74	24180140	24180694	554	g_7479	g_7480
Super-Scaffold_74	24185834	24185885	51	g_7480	g_7481
Super-Scaffold_74	24193292	24246748	53456	g_7481	g_43426
Super-Scaffold_74	24246993	24269321	22328	g_43426	g_7485
Super-Scaffold_74	24300283	24368213	67930	g_7485	g_7486
Super-Scaffold_74	24383562	24415507	31945	g_7486	g_43427
Super-Scaffold_74	24443664	24459216	15552	g_43427	g_7487
Super-Scaffold_74	24459464	24483907	24443	g_7487	g_7488
Super-Scaffold_74	24490138	24490404	266	g_7488	g_7489
Super-Scaffold_74	24493251	24499449	6198	g_7489	g_7490
Super-Scaffold_74	24506605	24622105	115500	g_7490	g_7494
Super-Scaffold_79	81172	107834	26662	g_28877	g_28878
Super-Scaffold_79	120318	121908	1590	g_28878	g_28879
Super-Scaffold_79	128841	132748	3907	g_28879	g_28880
Super-Scaffold_79	133131	136190	3059	g_28880	g_28881
Super-Scaffold_79	144518	162698	18180	g_28881	g_28882
Super-Scaffold_79	170006	186289	16283	g_28882	g_28884
Super-Scaffold_79	203635	213770	10135	g_28884	g_28885
Super-Scaffold_79	226758	247865	21107	g_28885	g_28888
Super-Scaffold_79	253153	259390	6237	g_28888	g_45261
Super-Scaffold_80	22355	62751	40396	g_23786	g_23787
Super-Scaffold_80	63008	71071	8063	g_23787	g_23789
Super-Scaffold_80	81633	136675	55042	g_23789	g_23792
Super-Scaffold_80	136980	202446	65466	g_23792	g_23793
Super-Scaffold_80	203054	227340	24286	g_23793	g_23794
Super-Scaffold_80	233657	235442	1785	g_23794	g_23795
Super-Scaffold_80	240156	254991	14835	g_37707	g_23796
Super-Scaffold_80	265173	297979	32806	g_23796	g_23799
Super-Scaffold_80	304188	310037	5849	g_23799	g_23800
Super-Scaffold_80	310258	410303	100045	g_23800	g_37711
Super-Scaffold_80	410554	506745	96191	g_37711	g_23807
Super-Scaffold_80	507542	603953	96411	g_23807	g_23809
Super-Scaffold_80	604378	636605	32227	g_23809	g_23811
Super-Scaffold_80	660896	667300	6404	g_23811	g_44854
Super-Scaffold_80	667644	806125	138481	g_44854	g_23817
Super-Scaffold_80	806544	818804	12260	g_23817	g_23819
Super-Scaffold_80	830143	844870	14727	g_23819	g_37718
Super-Scaffold_80	845088	849245	4157	g_37718	g_23820
Super-Scaffold_80	849505	852440	2935	g_23820	g_23821
Super-Scaffold_80	853093	853447	354	g_23821	g_23822
Super-Scaffold_80	854202	876595	22393	g_23822	g_37719
Super-Scaffold_80	876939	889461	12522	g_37719	g_23824
Super-Scaffold_80	889703	896322	6619	g_23824	g_23825
Super-Scaffold_80	900518	911090	10572	g_23825	g_23826
Super-Scaffold_80	928191	991334	63143	g_23826	g_23828
Super-Scaffold_80	992692	1019092	26400	g_23828	g_23831
Super-Scaffold_80	1019331	1030795	11464	g_23831	g_23832
Super-Scaffold_80	1036980	1037680	700	g_23832	g_23833
Super-Scaffold_80	1039682	1046832	7150	g_23833	g_37721
Super-Scaffold_80	1047329	1056573	9244	g_37721	g_23835
Super-Scaffold_80	1057871	1073678	15807	g_23835	g_44855
Super-Scaffold_80	1095520	1102057	6537	g_44855	g_23836
Super-Scaffold_80	1109566	1118904	9338	g_23836	g_23837
Super-Scaffold_80	1119917	1129461	9544	g_23837	g_23838
Super-Scaffold_80	1133536	1134339	803	g_23838	g_23839
Super-Scaffold_80	1149936	1648859	498923	g_23839	g_23844
Super-Scaffold_80	1664217	1672258	8041	g_23844	g_23845
Super-Scaffold_80	1673760	1683781	10021	g_23845	g_23847
Super-Scaffold_80	1687492	1687944	452	g_23847	g_23848
Super-Scaffold_80	1688327	1700770	12443	g_23848	g_23849
Super-Scaffold_80	1701213	1706964	5751	g_23849	g_37723
Super-Scaffold_80	1707203	1707279	76	g_37723	g_23851
Super-Scaffold_80	1707500	1708200	700	g_23851	g_37724
Super-Scaffold_80	1710029	1782066	72037	g_37724	g_23855
Super-Scaffold_80	1805776	1807579	1803	g_23855	g_37727
Super-Scaffold_80	1809585	1821730	12145	g_37727	g_23857
Super-Scaffold_80	1855216	1869448	14232	g_23857	g_44856
Super-Scaffold_80	1883213	1892350	9137	g_44856	g_23859
Super-Scaffold_80	1895403	1899225	3822	g_23859	g_23860
Super-Scaffold_80	1900142	1907049	6907	g_23860	g_23861
Super-Scaffold_80	1907915	1924631	16716	g_23861	g_23863
Super-Scaffold_80	1936322	1941650	5328	g_23863	g_23864
Super-Scaffold_80	1957094	1959985	2891	g_23864	g_23865
Super-Scaffold_80	1960692	1967593	6901	g_23865	g_23866
Super-Scaffold_80	1968066	1968092	26	g_23866	g_23867
Super-Scaffold_80	2006039	2066377	60338	g_23867	g_37733
Super-Scaffold_80	2067282	2082163	14881	g_37733	g_23870
Super-Scaffold_80	2082780	2208107	125327	g_23870	g_37735
Super-Scaffold_80	2208307	2217160	8853	g_37735	g_23873
Super-Scaffold_80	2221011	2225828	4817	g_23873	g_23874
Super-Scaffold_80	2239344	2244183	4839	g_23874	g_44857
Super-Scaffold_80	2259742	2278714	18972	g_44857	g_23875
Super-Scaffold_80	2279238	2288126	8888	g_23875	g_37736
Super-Scaffold_80	2288854	2312316	23462	g_37736	g_23876
Super-Scaffold_80	2317729	2319442	1713	g_23876	g_23877
Super-Scaffold_80	2323279	2323454	175	g_23877	g_23878
Super-Scaffold_80	2334332	2344010	9678	g_23878	g_23879
Super-Scaffold_80	2360097	2366221	6124	g_23879	g_23880
Super-Scaffold_80	2379693	2381987	2294	g_23880	g_23881
Super-Scaffold_80	2404963	2432458	27495	g_37738	g_23882
Super-Scaffold_80	2444049	2462556	18507	g_37739	g_23884
Super-Scaffold_80	2475184	2480832	5648	g_23884	g_23885
Super-Scaffold_80	2493432	2504143	10711	g_23885	g_23889
Super-Scaffold_80	2515589	2558860	43271	g_37742	g_23891
Super-Scaffold_80	2559501	2569835	10334	g_23891	g_23892
Super-Scaffold_80	2580519	2589486	8967	g_23892	g_23894
Super-Scaffold_80	2592454	2900399	307945	g_23894	g_23899
Super-Scaffold_80	2922979	2928176	5197	g_23899	g_44858
Super-Scaffold_80	2929711	2968582	38871	g_44858	g_23902
Super-Scaffold_80	2968782	2969529	747	g_23902	g_44859
Super-Scaffold_80	2969832	2970175	343	g_44859	g_23903
Super-Scaffold_80	2970375	2971141	766	g_23903	g_44860
Super-Scaffold_80	2971444	2972312	868	g_44860	g_23904
Super-Scaffold_80	2974462	2977908	3446	g_23904	g_37744
Super-Scaffold_80	2978255	2995636	17381	g_37744	g_23908
Super-Scaffold_80	2996820	3045590	48770	g_23908	g_23910
Super-Scaffold_80	3045814	3051712	5898	g_23910	g_23911
Super-Scaffold_80	3053940	3054943	1003	g_23911	g_23912
Super-Scaffold_80	3055896	3059377	3481	g_23912	g_23913
Super-Scaffold_80	3059631	3062906	3275	g_23913	g_23914
Super-Scaffold_80	3063361	3077564	14203	g_23914	g_23915
Super-Scaffold_88	261008	261488	480	g_16595	g_16597
Super-Scaffold_88	263309	353741	90432	g_16597	g_16599
Super-Scaffold_88	354358	380286	25928	g_16599	g_16600
Super-Scaffold_88	380582	381659	1077	g_16600	g_44277
Super-Scaffold_88	382619	424573	41954	g_44277	g_16601
Super-Scaffold_88	424854	424889	35	g_16601	g_16602
Super-Scaffold_88	425624	485577	59953	g_16602	g_16604
Super-Scaffold_88	488829	495009	6180	g_16604	g_16605
Super-Scaffold_88	495263	503135	7872	g_16605	g_16606
Super-Scaffold_88	503738	503800	62	g_16606	g_16607
Super-Scaffold_88	508311	508905	594	g_16607	g_16608
Super-Scaffold_88	509810	510513	703	g_16608	g_16609
Super-Scaffold_88	511107	515062	3955	g_16609	g_38349
Super-Scaffold_88	516306	541873	25567	g_38349	g_16612
Super-Scaffold_88	542112	542159	47	g_16612	g_16613
Super-Scaffold_88	542404	547228	4824	g_16613	g_38350
Super-Scaffold_88	550170	566420	16250	g_16614	g_16615
Super-Scaffold_88	581917	611801	29884	g_16615	g_44278
Super-Scaffold_88	627515	723261	95746	g_44278	g_16616
Super-Scaffold_88	725371	736842	11471	g_16616	g_44279
Super-Scaffold_88	738296	738565	269	g_44279	g_44280
Super-Scaffold_88	739053	769320	30267	g_44280	g_16618
Super-Scaffold_88	769652	773423	3771	g_16618	g_16617
Super-Scaffold_88	779977	812327	32350	g_16617	g_44281
Super-Scaffold_88	812605	813225	620	g_44281	g_16619
Super-Scaffold_88	813428	855235	41807	g_16619	g_16620
Super-Scaffold_88	863486	914115	50629	g_16620	g_16621
Super-Scaffold_88	924497	945833	21336	g_16621	g_16622
Super-Scaffold_88	957219	969424	12205	g_16622	g_16623
Super-Scaffold_88	972633	978086	5453	g_16623	g_16624
Super-Scaffold_88	979027	979177	150	g_16624	g_16625
Super-Scaffold_88	979950	980524	574	g_16625	g_16626
Super-Scaffold_88	981048	989883	8835	g_16626	g_16628
Super-Scaffold_88	990590	991342	752	g_16628	g_16629
Super-Scaffold_88	991605	1030833	39228	g_16629	g_16631
Super-Scaffold_88	1033134	1039276	6142	g_16631	g_16632
Super-Scaffold_88	1050967	1073799	22832	g_16632	g_16633
Super-Scaffold_88	1081588	1119111	37523	g_16633	g_16634
Super-Scaffold_88	1120069	1136874	16805	g_16634	g_16635
Super-Scaffold_88	1146527	1161602	15075	g_16635	g_16636
Super-Scaffold_88	1161973	1223995	62022	g_16636	g_38353
Super-Scaffold_88	1224213	1249226	25013	g_38353	g_16639
Super-Scaffold_88	1249471	1308610	59139	g_16639	g_16641
Super-Scaffold_88	1320683	1327123	6440	g_16641	g_16642
Super-Scaffold_88	1341139	1352717	11578	g_16642	g_16643
Super-Scaffold_88	1375313	1387702	12389	g_16643	g_16644
Super-Scaffold_88	1389108	1396437	7329	g_16644	g_16645
Super-Scaffold_88	1401086	1410278	9192	g_16645	g_16646
Super-Scaffold_88	1423333	1456963	33630	g_38354	g_16647
Super-Scaffold_88	1457544	1459998	2454	g_16647	g_44282
Super-Scaffold_88	1474999	1480807	5808	g_44282	g_16649
Super-Scaffold_88	1492003	1495467	3464	g_16649	g_44283
Super-Scaffold_88	1514498	1515735	1237	g_44283	g_16650
Super-Scaffold_88	1519539	1522784	3245	g_16650	g_44284
Super-Scaffold_88	1524421	1554743	30322	g_44284	g_16652
Super-Scaffold_88	1555129	1581833	26704	g_16652	g_16655
Super-Scaffold_88	1597414	1610946	13532	g_16655	g_16657
Super-Scaffold_88	1611380	1632021	20641	g_16657	g_16658
Super-Scaffold_88	1638712	1651603	12891	g_16658	g_16660
Super-Scaffold_88	1652718	1667156	14438	g_16660	g_16661
Super-Scaffold_88	1685889	1699844	13955	g_16661	g_38356
Super-Scaffold_88	1700509	1715279	14770	g_38356	g_38357
Super-Scaffold_88	1715539	1735000	19461	g_38357	g_16662
Super-Scaffold_88	1739650	1741711	2061	g_16662	g_16663
Super-Scaffold_88	1762632	1765263	2631	g_16663	g_44285
Super-Scaffold_88	1775458	1780401	4943	g_44285	g_16664
Super-Scaffold_88	1783593	1787998	4405	g_16664	g_16665
Super-Scaffold_88	1805375	1815123	9748	g_16665	g_16666
Super-Scaffold_88	1817478	1818069	591	g_16666	g_16667
Super-Scaffold_88	1819585	1829855	10270	g_16667	g_16668
Super-Scaffold_88	1836884	1848279	11395	g_16668	g_16669
Super-Scaffold_88	1848554	1885635	37081	g_16669	g_16670
Super-Scaffold_88	1891419	1975119	83700	g_16670	g_16672
Super-Scaffold_88	1976601	2011415	34814	g_16672	g_16674
Super-Scaffold_88	2022521	2029825	7304	g_16674	g_16675
Super-Scaffold_88	2039259	2061099	21840	g_16675	g_16676
Super-Scaffold_88	2063231	2095934	32703	g_16676	g_16678
Super-Scaffold_88	2097331	2115852	18521	g_16678	g_16679
Super-Scaffold_88	2116691	2119641	2950	g_16679	g_16680
Super-Scaffold_88	2128571	2146222	17651	g_16680	g_16683
Super-Scaffold_88	2153087	2164921	11834	g_16683	g_44286
Super-Scaffold_88	2249804	2362502	112698	g_44286	g_16686
Super-Scaffold_88	2375611	2537970	162359	g_16686	g_16691
Super-Scaffold_88	2538233	2733644	195411	g_16691	g_16694
Super-Scaffold_88	2733937	2756325	22388	g_16694	g_16695
Super-Scaffold_88	2756528	3112524	355996	g_16695	g_16697
Super-Scaffold_88	3112799	3122084	9285	g_16697	g_16698
Super-Scaffold_88	3122323	3134338	12015	g_16698	g_16699
Super-Scaffold_88	3135465	3137600	2135	g_16699	g_16700
Super-Scaffold_88	3138244	3306790	168546	g_16700	g_16702
Super-Scaffold_88	3307011	3344240	37229	g_16702	g_16703
Super-Scaffold_88	3350801	3354456	3655	g_16703	g_44287
Super-Scaffold_88	3358659	3404089	45430	g_44287	g_16704
Super-Scaffold_88	3426589	3437545	10956	g_16704	g_16705
Super-Scaffold_88	3440324	3447973	7649	g_16705	g_16706
Super-Scaffold_88	3455072	3459324	4252	g_16706	g_16707
Super-Scaffold_88	3464525	3465618	1093	g_16707	g_16708
Super-Scaffold_88	3465827	3468228	2401	g_16708	g_16709
Super-Scaffold_88	3484947	3487786	2839	g_16709	g_16711
Super-Scaffold_88	3498522	3500182	1660	g_16711	g_44288
Super-Scaffold_88	3506555	3520645	14090	g_44288	g_38370
Super-Scaffold_88	3539551	3543028	3477	g_16712	g_16713
Super-Scaffold_88	3543255	3550244	6989	g_16713	g_16714
Super-Scaffold_88	3567125	3572710	5585	g_16714	g_16715
Super-Scaffold_88	3585448	3607631	22183	g_16715	g_16716
Super-Scaffold_88	3631574	3634952	3378	g_16716	g_44289
Super-Scaffold_88	3640138	3656106	15968	g_44289	g_16717
Super-Scaffold_88	3668594	3671250	2656	g_16717	g_16718
Super-Scaffold_88	3676752	3721561	44809	g_16718	g_16719
Super-Scaffold_88	3728291	3735481	7190	g_16719	g_38372
Super-Scaffold_88	3737612	3739696	2084	g_16720	g_16721
Super-Scaffold_88	3742631	3748066	5435	g_16721	g_16722
Super-Scaffold_88	3750724	3754695	3971	g_16722	g_16723
Super-Scaffold_88	3759279	3760157	878	g_16723	g_16724
Super-Scaffold_88	3761637	3764336	2699	g_16724	g_44290
Super-Scaffold_88	3770038	3792400	22362	g_44290	g_16726
Super-Scaffold_88	3795527	3798483	2956	g_16726	g_16727
Super-Scaffold_88	3798974	3811004	12030	g_16727	g_16728
Super-Scaffold_88	3814193	3824712	10519	g_16728	g_16729
Super-Scaffold_88	3826714	3830161	3447	g_16729	g_16730
Super-Scaffold_88	3841906	3851537	9631	g_16730	g_16732
Super-Scaffold_88	3862769	3923116	60347	g_16732	g_38374
Super-Scaffold_88	3923361	3925058	1697	g_38374	g_16734
Super-Scaffold_88	3932424	3983932	51508	g_16734	g_16736
Super-Scaffold_88	3993840	4142210	148370	g_16736	g_16740
Super-Scaffold_88	4142545	4150107	7562	g_16740	g_16741
Super-Scaffold_88	4211975	4231830	19855	g_16741	g_16743
Super-Scaffold_88	4233153	4262360	29207	g_16743	g_16744
Super-Scaffold_88	4266082	4275390	9308	g_16744	g_16745
Super-Scaffold_88	4309175	4312362	3187	g_16745	g_16746
Super-Scaffold_88	4312952	4319326	6374	g_16746	g_16748
Super-Scaffold_88	4328082	4331090	3008	g_16748	g_16749
Super-Scaffold_88	4333490	4336363	2873	g_16749	g_16750
Super-Scaffold_88	4346716	4353699	6983	g_16750	g_16751
Super-Scaffold_88	4367866	4377408	9542	g_16751	g_16752
Super-Scaffold_88	4377623	4379065	1442	g_16752	g_44291
Super-Scaffold_88	4389250	4438595	49345	g_44291	g_16754
Super-Scaffold_88	4451094	4456338	5244	g_16754	g_16755
Super-Scaffold_88	4472102	4474506	2404	g_16755	g_16756
Super-Scaffold_88	4479306	4491248	11942	g_16756	g_16757
Super-Scaffold_88	4495294	4499221	3927	g_16757	g_16758
Super-Scaffold_88	4500141	4517969	17828	g_16758	g_16760
Super-Scaffold_88	4529594	4539725	10131	g_16760	g_16761
Super-Scaffold_88	4543585	4545763	2178	g_16761	g_44292
Super-Scaffold_88	4552524	4558936	6412	g_44292	g_16762
Super-Scaffold_88	4562030	4567224	5194	g_16762	g_16763
Super-Scaffold_88	4573744	4577835	4091	g_16763	g_16764
Super-Scaffold_88	4594403	4595899	1496	g_16764	g_44293
Super-Scaffold_88	4599890	4606486	6596	g_44293	g_16765
Super-Scaffold_88	4625231	4628182	2951	g_16765	g_16766
Super-Scaffold_88	4637174	4645460	8286	g_16766	g_16767
Super-Scaffold_88	4648337	4650148	1811	g_16767	g_16768
Super-Scaffold_88	4664907	4696325	31418	g_16768	g_16770
Super-Scaffold_88	4713435	4718175	4740	g_16770	g_16771
Super-Scaffold_88	4738653	4798330	59677	g_16771	g_16773
Super-Scaffold_88	4798614	4872927	74313	g_16773	g_16774
Super-Scaffold_88	4877232	4897557	20325	g_16774	g_16776
Super-Scaffold_88	4897973	4958473	60500	g_16776	g_38381
Super-Scaffold_88	4958907	4975663	16756	g_38381	g_16779
Super-Scaffold_88	4988002	5035920	47918	g_16779	g_16781
Super-Scaffold_88	5068341	5078375	10034	g_16781	g_44294
Super-Scaffold_88	5106422	5110572	4150	g_44294	g_16782
Super-Scaffold_88	5110883	5116995	6112	g_16782	g_16783
Super-Scaffold_88	5123601	5138822	15221	g_16783	g_16784
Super-Scaffold_88	5139742	5150260	10518	g_16784	g_44295
Super-Scaffold_88	5173908	5197226	23318	g_44295	g_16785
Super-Scaffold_88	5208824	5211819	2995	g_16785	g_16786
Super-Scaffold_88	5213435	5272359	58924	g_16786	g_16787
Super-Scaffold_88	5284420	5288267	3847	g_16787	g_44296
Super-Scaffold_88	5290487	5293707	3220	g_44296	g_16788
Super-Scaffold_88	5307806	5314023	6217	g_16788	g_16789
Super-Scaffold_88	5320815	5326414	5599	g_16789	g_16790
Super-Scaffold_88	5335006	5340736	5730	g_16790	g_16791
Super-Scaffold_88	5345974	5350061	4087	g_16791	g_16792
Super-Scaffold_88	5358859	5363293	4434	g_16792	g_16793
Super-Scaffold_88	5368886	5371546	2660	g_16793	g_16794
Super-Scaffold_88	5373982	5381876	7894	g_16794	g_16795
Super-Scaffold_88	5387818	5393474	5656	g_16795	g_38383
Super-Scaffold_88	5393752	5398071	4319	g_38383	g_16797
Super-Scaffold_88	5398364	5420277	21913	g_16797	g_16798
Super-Scaffold_88	5420522	5450716	30194	g_16798	g_16799
Super-Scaffold_88	5451141	5457224	6083	g_16799	g_16800
Super-Scaffold_88	5475763	5487548	11785	g_16800	g_16801
Super-Scaffold_88	5505389	5508452	3063	g_16801	g_16802
Super-Scaffold_88	5530435	5555491	25056	g_16802	g_16803
Super-Scaffold_88	5556396	5571062	14666	g_16803	g_16804
Super-Scaffold_88	5572917	5643187	70270	g_38387	g_38390
Super-Scaffold_88	5643393	5657493	14100	g_38390	g_16806
Super-Scaffold_88	5671004	5804635	133631	g_16806	g_38393
Super-Scaffold_88	5804841	5900111	95270	g_38393	g_16811
Super-Scaffold_88	5902647	5948801	46154	g_16811	g_16812
Super-Scaffold_88	5977434	6004059	26625	g_16812	g_16813
Super-Scaffold_88	6024376	6054559	30183	g_16813	g_16815
Super-Scaffold_88	6054957	6085835	30878	g_16815	g_16817
Super-Scaffold_88	6089832	6136737	46905	g_16817	g_16818
Super-Scaffold_88	6148450	6185271	36821	g_16818	g_16820
Super-Scaffold_88	6191600	6204194	12594	g_16820	g_44297
Super-Scaffold_88	6224153	6275432	51279	g_44297	g_16822
Super-Scaffold_88	6292874	6333144	40270	g_16822	g_16825
Super-Scaffold_88	6340019	6343052	3033	g_16825	g_16826
Super-Scaffold_88	6343968	6385994	42026	g_16826	g_16827
Super-Scaffold_88	6389828	6420093	30265	g_16827	g_16828
Super-Scaffold_88	6427979	6460527	32548	g_16828	g_16830
Super-Scaffold_88	6462122	6597313	135191	g_16830	g_16832
Super-Scaffold_88	6597760	6661586	63826	g_16832	g_16833
Super-Scaffold_88	6663788	6790083	126295	g_16833	g_16834
Super-Scaffold_88	6791006	6864053	73047	g_16834	g_16837
Super-Scaffold_88	6864262	6940596	76334	g_16837	g_16838
Super-Scaffold_88	6941474	6953406	11932	g_16838	g_16839
Super-Scaffold_88	6953612	7124981	171369	g_16839	g_16842
Super-Scaffold_88	7137100	7140110	3010	g_16842	g_16843
Super-Scaffold_88	7141699	7141838	139	g_16843	g_16844
Super-Scaffold_88	7142542	7142586	44	g_16844	g_16845
Super-Scaffold_88	7144660	7363723	219063	g_16845	g_16847
Super-Scaffold_88	7365356	7405485	40129	g_16847	g_16848
Super-Scaffold_88	7468665	7609279	140614	g_16848	g_16849
Super-Scaffold_88	7609938	7834619	224681	g_16849	g_16850
Super-Scaffold_88	7835549	7843756	8207	g_16850	g_16851
Super-Scaffold_88	7844136	7859546	15410	g_16851	g_16852
Super-Scaffold_88	7863872	7875267	11395	g_16852	g_44298
Super-Scaffold_88	7875623	8017608	141985	g_44298	g_16853
Super-Scaffold_88	8025621	8036706	11085	g_16853	g_16854
Super-Scaffold_88	8037971	8039819	1848	g_16854	g_16855
Super-Scaffold_88	8057330	8065371	8041	g_16855	g_16856
Super-Scaffold_88	8068683	8097077	28394	g_16856	g_16857
Super-Scaffold_88	8103776	8106947	3171	g_16857	g_16858
Super-Scaffold_88	8131757	8238387	106630	g_16858	g_16860
Super-Scaffold_88	8238650	8386163	147513	g_16860	g_16866
Super-Scaffold_88	8407157	8418779	11622	g_16866	g_16867
Super-Scaffold_88	8423071	8426895	3824	g_16867	g_16868
Super-Scaffold_88	8434414	8458065	23651	g_16868	g_16870
Super-Scaffold_88	8469256	8473916	4660	g_16870	g_16871
Super-Scaffold_88	8478640	8490954	12314	g_16871	g_16872
Super-Scaffold_88	8493170	8495780	2610	g_16872	g_16873
Super-Scaffold_88	8500319	8503029	2710	g_16873	g_16874
Super-Scaffold_88	8506351	8508666	2315	g_16874	g_16875
Super-Scaffold_88	8518683	8522149	3466	g_16875	g_16876
Super-Scaffold_88	8544868	8569568	24700	g_16876	g_16877
Super-Scaffold_88	8581542	8600899	19357	g_16877	g_44299
Super-Scaffold_88	8608877	8609753	876	g_44299	g_16879
Super-Scaffold_88	8616167	8618872	2705	g_16879	g_16880
Super-Scaffold_88	8629970	8654554	24584	g_16880	g_16881
Super-Scaffold_88	8659442	8665219	5777	g_16881	g_16882
Super-Scaffold_88	8668132	8694345	26213	g_16882	g_16883
Super-Scaffold_88	8697045	8751994	54949	g_16883	g_16885
Super-Scaffold_88	8755057	8784076	29019	g_16885	g_16887
Super-Scaffold_88	8798271	8810690	12419	g_16887	g_16888
Super-Scaffold_88	8811833	8861273	49440	g_16888	g_16891
Super-Scaffold_88	8862670	8894801	32131	g_16891	g_16892
Super-Scaffold_88	8906477	8914152	7675	g_16892	g_16893
Super-Scaffold_88	8919339	8920169	830	g_16893	g_16894
Super-Scaffold_88	8925030	8927094	2064	g_16894	g_44300
Super-Scaffold_88	8931094	9003174	72080	g_44300	g_38406
Super-Scaffold_88	9003413	9098599	95186	g_38406	g_16898
Super-Scaffold_88	9100867	9101834	967	g_16898	g_16899
Super-Scaffold_88	9103150	9360272	257122	g_16899	g_16906
Super-Scaffold_88	9361520	9385317	23797	g_16906	g_16907
Super-Scaffold_88	9385649	9440998	55349	g_16907	g_16908
Super-Scaffold_88	9442566	9633286	190720	g_16908	g_16911
Super-Scaffold_88	9637524	9771232	133708	g_16911	g_16912
Super-Scaffold_88	9771687	9852446	80759	g_16912	g_16913
Super-Scaffold_88	9852877	9906789	53912	g_16913	g_16914
Super-Scaffold_88	9913779	10008806	95027	g_16914	g_38412
Super-Scaffold_88	10009123	10165325	156202	g_38412	g_38413
Super-Scaffold_88	10165609	10194942	29333	g_38413	g_38414
Super-Scaffold_88	10195310	10219585	24275	g_38414	g_16915
Super-Scaffold_88	10220043	10251364	31321	g_16915	g_38415
Super-Scaffold_88	10251726	10260732	9006	g_38415	g_16916
Super-Scaffold_88	10278232	10371531	93299	g_16916	g_16917
Super-Scaffold_88	10371752	10640242	268490	g_16917	g_38417
Super-Scaffold_88	10640460	10713075	72615	g_38417	g_16918
Super-Scaffold_88	10716969	10717957	988	g_16918	g_16919
Super-Scaffold_88	10739926	10740804	878	g_16919	g_44301
Super-Scaffold_88	10830752	10838432	7680	g_44301	g_16920
Super-Scaffold_88	10857796	10892263	34467	g_16920	g_38418
Super-Scaffold_88	10892466	10908660	16194	g_38418	g_16921
Super-Scaffold_88	10922969	10952270	29301	g_16921	g_16922
Super-Scaffold_88	10969383	11005884	36501	g_16922	g_16924
Super-Scaffold_88	11019963	11029305	9342	g_16924	g_16925
Super-Scaffold_88	11032115	11037838	5723	g_16925	g_16926
Super-Scaffold_88	11041900	11054829	12929	g_16926	g_16927
Super-Scaffold_88	11068489	11082615	14126	g_16927	g_16928
Super-Scaffold_88	11106723	11121155	14432	g_16928	g_16929
Super-Scaffold_88	11130146	11157049	26903	g_16929	g_16931
Super-Scaffold_88	11157306	11185397	28091	g_16931	g_16933
Super-Scaffold_88	11186333	11187862	1529	g_16933	g_16934
Super-Scaffold_88	11190017	11258787	68770	g_16934	g_16937
Super-Scaffold_88	11260136	11375039	114903	g_16937	g_38423
Super-Scaffold_88	11375275	11386187	10912	g_38423	g_16938
Super-Scaffold_88	11397985	11399603	1618	g_16938	g_16939
Super-Scaffold_88	11430517	11432355	1838	g_16939	g_16940
Super-Scaffold_88	11432780	11441163	8383	g_16940	g_16941
Super-Scaffold_88	11453086	11482815	29729	g_16941	g_16942
Super-Scaffold_88	11493731	11499891	6160	g_16942	g_16943
Super-Scaffold_88	11512054	11514999	2945	g_16943	g_16945
Super-Scaffold_88	11515386	11519813	4427	g_16945	g_16946
Super-Scaffold_88	11567236	11624643	57407	g_16946	g_16949
Super-Scaffold_88	11634524	11635352	828	g_16949	g_16950
Super-Scaffold_88	11636209	11642368	6159	g_16950	g_16951
Super-Scaffold_88	11642667	11644491	1824	g_16951	g_16952
Super-Scaffold_88	11649605	11652540	2935	g_16952	g_16953
Super-Scaffold_88	11661576	11663722	2146	g_16953	g_16954
Super-Scaffold_88	11664711	11693764	29053	g_16954	g_16957
Super-Scaffold_88	11694786	11696483	1697	g_16957	g_16958
Super-Scaffold_88	11700000	11709112	9112	g_16958	g_16959
Super-Scaffold_88	11716425	11759685	43260	g_16959	g_16960
Super-Scaffold_88	11762416	11773810	11394	g_16960	g_16961
Super-Scaffold_88	11786235	11789108	2873	g_16961	g_16962
Super-Scaffold_88	11791038	11795935	4897	g_16962	g_16963
Super-Scaffold_88	11797049	11798703	1654	g_16963	g_16964
Super-Scaffold_88	11799739	11800737	998	g_16964	g_16965
Super-Scaffold_88	11806676	11816189	9513	g_16965	g_16966
Super-Scaffold_88	11829552	11835367	5815	g_16966	g_44302
Super-Scaffold_88	11842859	11847035	4176	g_44302	g_16967
Super-Scaffold_88	11865810	11880747	14937	g_16967	g_16968
Super-Scaffold_88	11882618	11892541	9923	g_16968	g_16970
Super-Scaffold_88	11893794	11903040	9246	g_16970	g_16972
Super-Scaffold_88	11903552	11903786	234	g_16972	g_16973
Super-Scaffold_88	11904838	11909286	4448	g_16973	g_16974
Super-Scaffold_88	11912408	11919088	6680	g_16974	g_16975
Super-Scaffold_88	11921926	11923212	1286	g_16975	g_16976
Super-Scaffold_88	11940910	11941814	904	g_16976	g_16977
Super-Scaffold_88	11950662	11954485	3823	g_16977	g_16978
Super-Scaffold_88	11963136	11963728	592	g_16978	g_16979
Super-Scaffold_88	11966805	11970001	3196	g_16979	g_16980
Super-Scaffold_88	11972274	11976230	3956	g_16980	g_16981
Super-Scaffold_88	11987659	11990307	2648	g_16981	g_16982
Super-Scaffold_88	11990651	11991871	1220	g_16982	g_16983
Super-Scaffold_88	12005426	12007073	1647	g_16983	g_16984
Super-Scaffold_88	12013125	12014985	1860	g_16984	g_16985
Super-Scaffold_88	12018787	12023927	5140	g_16985	g_16986
Super-Scaffold_88	12048231	12058915	10684	g_16986	g_16987
Super-Scaffold_88	12060702	12062309	1607	g_16987	g_16988
Super-Scaffold_88	12086293	12105867	19574	g_16988	g_16989
Super-Scaffold_88	12108145	12121645	13500	g_16989	g_44303
Super-Scaffold_88	12127327	12130624	3297	g_44303	g_44304
Super-Scaffold_88	12133707	12217196	83489	g_44304	g_16990
Super-Scaffold_88	12235476	12259502	24026	g_16990	g_16991
Super-Scaffold_88	12260068	12299497	39429	g_16991	g_16993
Super-Scaffold_88	12299766	12323486	23720	g_16993	g_16996
Super-Scaffold_88	12324235	12424863	100628	g_16996	g_16999
Super-Scaffold_88	12425081	12442318	17237	g_16999	g_17000
Super-Scaffold_88	12469231	12475038	5807	g_17000	g_17001
Super-Scaffold_88	12482865	12497111	14246	g_17001	g_17002
Super-Scaffold_88	12497401	12516212	18811	g_17002	g_17005
Super-Scaffold_88	12518242	12518741	499	g_17005	g_17006
Super-Scaffold_88	12519763	12522098	2335	g_17006	g_17004
Super-Scaffold_88	12524367	12540480	16113	g_17004	g_17007
Super-Scaffold_88	12551822	12797943	246121	g_17007	g_17016
Super-Scaffold_88	12798341	12811295	12954	g_17016	g_17017
Super-Scaffold_88	12811525	12831438	19913	g_17017	g_17019
Super-Scaffold_88	12832594	12832814	220	g_17019	g_17020
Super-Scaffold_88	12844577	12850452	5875	g_17020	g_38436
Super-Scaffold_88	12850769	12856900	6131	g_38436	g_17021
Super-Scaffold_88	12869547	12873949	4402	g_17021	g_44305
Super-Scaffold_88	12898809	12900095	1286	g_44305	g_17022
Super-Scaffold_88	12903245	12904273	1028	g_17022	g_17023
Super-Scaffold_88	12906138	12908969	2831	g_17023	g_17024
Super-Scaffold_88	12912868	12913759	891	g_17024	g_17025
Super-Scaffold_88	12916158	12916311	153	g_17025	g_17026
Super-Scaffold_88	12918209	12920575	2366	g_17026	g_17027
Super-Scaffold_88	12923014	12929044	6030	g_17027	g_17028
Super-Scaffold_88	12935104	12936225	1121	g_17028	g_17029
Super-Scaffold_88	12954156	12957093	2937	g_17029	g_17030
Super-Scaffold_88	12964827	12994776	29949	g_17030	g_17031
Super-Scaffold_88	12996956	13014460	17504	g_17031	g_17032
Super-Scaffold_88	13035731	13083657	47926	g_17032	g_17033
Super-Scaffold_88	13086141	13087603	1462	g_17033	g_17034
Super-Scaffold_88	13099530	13103474	3944	g_17034	g_17035
Super-Scaffold_88	13118554	13118623	69	g_17035	g_38439
Super-Scaffold_88	13118982	13119965	983	g_17036	g_17037
Super-Scaffold_88	13126476	13127979	1503	g_17037	g_17038
Super-Scaffold_88	13129973	13132535	2562	g_17038	g_17039
Super-Scaffold_88	13135631	13161747	26116	g_17039	g_17041
Super-Scaffold_88	13176185	13225356	49171	g_17041	g_17042
Super-Scaffold_88	13226718	13233013	6295	g_17042	g_17043
Super-Scaffold_88	13240274	13241348	1074	g_17043	g_17044
Super-Scaffold_88	13249075	13259288	10213	g_17044	g_17045
Super-Scaffold_88	13262436	13274814	12378	g_17045	g_17046
Super-Scaffold_88	13278782	13305810	27028	g_17046	g_17047
Super-Scaffold_88	13307896	13315111	7215	g_17047	g_17048
Super-Scaffold_88	13323534	13331998	8464	g_17048	g_17049
Super-Scaffold_88	13332425	13334113	1688	g_17049	g_17050
Super-Scaffold_88	13348021	13389231	41210	g_17050	g_17053
Super-Scaffold_88	13397990	13400686	2696	g_17053	g_17054
Super-Scaffold_88	13410992	13432780	21788	g_17054	g_17055
Super-Scaffold_88	13449988	13460061	10073	g_17055	g_17056
Super-Scaffold_88	13474709	13493431	18722	g_17056	g_17057
Super-Scaffold_88	13502674	13505814	3140	g_17057	g_17058
Super-Scaffold_88	13513800	13514908	1108	g_17058	g_17059
Super-Scaffold_88	13522357	13525558	3201	g_17059	g_44306
Super-Scaffold_88	13532110	13537069	4959	g_44306	g_17060
Super-Scaffold_88	13542384	13546174	3790	g_17060	g_17061
Super-Scaffold_88	13553744	13555168	1424	g_17061	g_17062
Super-Scaffold_88	13560950	13561484	534	g_17062	g_44307
Super-Scaffold_88	13566010	13566550	540	g_44307	g_44308
Super-Scaffold_88	13575142	13582910	7768	g_44308	g_17063
Super-Scaffold_88	13594992	13596632	1640	g_17063	g_17064
Super-Scaffold_88	13605517	13614548	9031	g_17064	g_17065
Super-Scaffold_88	13638711	13642650	3939	g_17065	g_17066
Super-Scaffold_88	13645095	13648922	3827	g_17066	g_17067
Super-Scaffold_88	13650681	13657210	6529	g_17067	g_17068
Super-Scaffold_88	13662407	13680709	18302	g_17068	g_17071
Super-Scaffold_88	13681568	13688567	6999	g_17071	g_17072
Super-Scaffold_88	13698824	13701769	2945	g_17072	g_17073
Super-Scaffold_88	13704812	13707457	2645	g_17073	g_17074
Super-Scaffold_88	13717836	13719995	2159	g_17074	g_17075
Super-Scaffold_88	13720231	13727352	7121	g_17075	g_17076
Super-Scaffold_88	13743018	13744584	1566	g_17076	g_17077
Super-Scaffold_88	13745505	13746899	1394	g_17077	g_17078
Super-Scaffold_88	13753630	13755586	1956	g_17078	g_17079
Super-Scaffold_88	13763736	13770794	7058	g_17079	g_17080
Super-Scaffold_88	13774756	13776969	2213	g_17080	g_44309
Super-Scaffold_88	13777659	13783599	5940	g_44309	g_17081
Super-Scaffold_88	13787813	13794155	6342	g_17081	g_17082
Super-Scaffold_88	13794949	13795714	765	g_17082	g_17083
Super-Scaffold_88	13800755	13801656	901	g_17083	g_17084
Super-Scaffold_88	13817841	13821876	4035	g_17084	g_17085
Super-Scaffold_88	13822238	13822385	147	g_17085	g_17086
Super-Scaffold_88	13834421	13837997	3576	g_17086	g_17087
Super-Scaffold_88	13839367	13840805	1438	g_17087	g_17088
Super-Scaffold_88	13842541	13845366	2825	g_17088	g_17089
Super-Scaffold_88	13851191	13852986	1795	g_17089	g_17090
Super-Scaffold_88	13859321	13860516	1195	g_17090	g_44310
Super-Scaffold_88	13865934	13868537	2603	g_44310	g_17091
Super-Scaffold_88	13887611	13890059	2448	g_17091	g_17092
Super-Scaffold_88	13890608	13892495	1887	g_17092	g_44311
Super-Scaffold_88	13901191	13909776	8585	g_44311	g_17093
Super-Scaffold_88	13918626	13920374	1748	g_17093	g_44312
Super-Scaffold_88	13922919	13926359	3440	g_44312	g_17094
Super-Scaffold_88	13936235	13938452	2217	g_17094	g_44313
Super-Scaffold_88	13950525	13953111	2586	g_44313	g_17095
Super-Scaffold_88	14003449	14019171	15722	g_17095	g_17097
Super-Scaffold_88	14019449	14029084	9635	g_17097	g_17098
Super-Scaffold_88	14035499	14055030	19531	g_17098	g_17099
Super-Scaffold_88	14056404	14064229	7825	g_17099	g_44314
Super-Scaffold_88	14067882	14071988	4106	g_44314	g_44315
Super-Scaffold_88	14074802	14076087	1285	g_44315	g_17100
Super-Scaffold_88	14080183	14081276	1093	g_17100	g_17101
Super-Scaffold_88	14083890	14085517	1627	g_17101	g_17102
Super-Scaffold_88	14090824	14095051	4227	g_17102	g_38444
Super-Scaffold_88	14095400	14106849	11449	g_38444	g_17103
Super-Scaffold_88	14109910	14113869	3959	g_17103	g_44316
Super-Scaffold_88	14119848	14122948	3100	g_44316	g_44317
Super-Scaffold_88	14127166	14129551	2385	g_44317	g_17104
Super-Scaffold_88	14135234	14136668	1434	g_17104	g_17105
Super-Scaffold_88	14140944	14146159	5215	g_17105	g_17106
Super-Scaffold_88	14167794	14170664	2870	g_17106	g_44318
Super-Scaffold_88	14175236	14177900	2664	g_44318	g_17107
Super-Scaffold_88	14183345	14202757	19412	g_17107	g_17108
Super-Scaffold_88	14207151	14215327	8176	g_17108	g_44319
Super-Scaffold_88	14233133	14238658	5525	g_44319	g_17109
Super-Scaffold_88	14248355	14268317	19962	g_17109	g_17110
Super-Scaffold_88	14289507	14290830	1323	g_17110	g_17111
Super-Scaffold_88	14292442	14295056	2614	g_17111	g_17112
Super-Scaffold_88	14296657	14298264	1607	g_17112	g_44320
Super-Scaffold_88	14300776	14304177	3401	g_44320	g_17113
Super-Scaffold_88	14305769	14323311	17542	g_17113	g_17114
Super-Scaffold_88	14324244	14325871	1627	g_17114	g_44321
Super-Scaffold_88	14327099	14328948	1849	g_44321	g_17115
Super-Scaffold_88	14329616	14332690	3074	g_17115	g_17116
Super-Scaffold_88	14336175	14345088	8913	g_17116	g_17117
Super-Scaffold_88	14354256	14406421	52165	g_17117	g_17118
Super-Scaffold_88	14423276	14466540	43264	g_17118	g_17120
Super-Scaffold_88	14467677	14489246	21569	g_17120	g_17122
Super-Scaffold_88	14492000	14493441	1441	g_17122	g_17123
Super-Scaffold_88	14505184	14511218	6034	g_17123	g_17125
Super-Scaffold_88	14544446	14549756	5310	g_17125	g_17127
Super-Scaffold_88	14572347	14576090	3743	g_17127	g_44322
Super-Scaffold_88	14577398	14587976	10578	g_44322	g_17128
Super-Scaffold_88	14590642	14590833	191	g_17128	g_17129
Super-Scaffold_88	14591471	14598171	6700	g_17129	g_17132
Super-Scaffold_88	14598545	14599514	969	g_17132	g_17133
Super-Scaffold_88	14601145	14615469	14324	g_17133	g_17134
Super-Scaffold_88	14616128	14642637	26509	g_17134	g_17135
Super-Scaffold_88	14645792	14648725	2933	g_17135	g_38445
Super-Scaffold_88	14649099	14649237	138	g_38445	g_17136
Super-Scaffold_88	14661459	14665133	3674	g_17136	g_17137
Super-Scaffold_88	14671574	14672085	511	g_17137	g_17138
Super-Scaffold_88	14673242	14673323	81	g_17138	g_17139
Super-Scaffold_88	14673667	14683347	9680	g_17139	g_17141
Super-Scaffold_88	14691527	14695574	4047	g_17141	g_44323
Super-Scaffold_88	14698231	14699693	1462	g_44323	g_17142
Super-Scaffold_88	14709436	14716102	6666	g_17142	g_17143
Super-Scaffold_88	14720168	14722337	2169	g_17143	g_44324
Super-Scaffold_88	14727639	14734104	6465	g_44324	g_17144
Super-Scaffold_88	14736669	14740164	3495	g_17144	g_44325
Super-Scaffold_88	14742153	14744144	1991	g_44325	g_17145
Super-Scaffold_88	14762287	14765541	3254	g_17145	g_17146
Super-Scaffold_88	14769895	14775173	5278	g_17146	g_17147
Super-Scaffold_88	14777989	14781758	3769	g_17147	g_17148
Super-Scaffold_88	14782864	14789162	6298	g_17148	g_17149
Super-Scaffold_88	14789461	14801062	11601	g_17149	g_17151
Super-Scaffold_88	14808571	14817822	9251	g_17151	g_17152
Super-Scaffold_88	14836871	14848221	11350	g_17152	g_17153
Super-Scaffold_88	14849853	14852866	3013	g_17153	g_17154
Super-Scaffold_88	14853827	14858750	4923	g_17154	g_17155
Super-Scaffold_88	14889730	14901142	11412	g_17155	g_17157
Super-Scaffold_88	14905661	14906603	942	g_17157	g_17158
Super-Scaffold_88	14914077	14921404	7327	g_17158	g_17159
Super-Scaffold_88	14935766	14949410	13644	g_17159	g_17160
Super-Scaffold_88	14952329	14955450	3121	g_17160	g_44326
Super-Scaffold_88	14965934	14972631	6697	g_44326	g_17161
Super-Scaffold_88	14975210	14977724	2514	g_17161	g_17162
Super-Scaffold_88	14983135	14987009	3874	g_17162	g_17163
Super-Scaffold_88	15002659	15009874	7215	g_17163	g_17164
Super-Scaffold_88	15011793	15029425	17632	g_17164	g_17165
Super-Scaffold_88	15040028	15077469	37441	g_17165	g_17167
Super-Scaffold_88	15102957	15106221	3264	g_17167	g_17168
Super-Scaffold_88	15121264	15122039	775	g_17168	g_17169
Super-Scaffold_88	15126777	15127021	244	g_17169	g_17170
Super-Scaffold_88	15127236	15130170	2934	g_17170	g_17171
Super-Scaffold_88	15134253	15134994	741	g_17171	g_17172
Super-Scaffold_88	15136300	15137583	1283	g_17172	g_17173
Super-Scaffold_88	15142040	15172272	30232	g_17173	g_17175
Super-Scaffold_88	15181144	15229324	48180	g_17175	g_17176
Super-Scaffold_88	15229623	15229654	31	g_17176	g_17177
Super-Scaffold_88	15230211	15240486	10275	g_17177	g_17178
Super-Scaffold_88	15242520	15243943	1423	g_17178	g_17179
Super-Scaffold_88	15256105	15259553	3448	g_17179	g_44327
Super-Scaffold_88	15271444	15344974	73530	g_44327	g_17181
Super-Scaffold_88	15372067	15374238	2171	g_17181	g_44328
Super-Scaffold_88	15377250	15451035	73785	g_44328	g_17185
Super-Scaffold_88	15451457	15505931	54474	g_17185	g_17186
Super-Scaffold_88	15510495	15583147	72652	g_17186	g_17188
Super-Scaffold_88	15602036	15604112	2076	g_17188	g_17189
Super-Scaffold_88	15611684	15612835	1151	g_17189	g_17190
Super-Scaffold_88	15613645	15622492	8847	g_17190	g_17191
Super-Scaffold_88	15630082	15640449	10367	g_17191	g_17192
Super-Scaffold_88	15641708	15728760	87052	g_17192	g_17194
Super-Scaffold_88	15729840	15732200	2360	g_17194	g_44329
Super-Scaffold_88	15756933	15762408	5475	g_44329	g_17195
Super-Scaffold_88	15767435	15771189	3754	g_17195	g_44330
Super-Scaffold_88	15772583	15780093	7510	g_44330	g_17196
Super-Scaffold_88	15780386	15805510	25124	g_17196	g_17198
Super-Scaffold_88	15809098	15825177	16079	g_17198	g_17200
Super-Scaffold_88	15830203	15833663	3460	g_17200	g_17201
Super-Scaffold_88	15839202	15978921	139719	g_17201	g_17203
Super-Scaffold_88	15980938	16005902	24964	g_17203	g_17204
Super-Scaffold_88	16009181	16013791	4610	g_17204	g_17205
Super-Scaffold_88	16016177	16019457	3280	g_17205	g_17206
Super-Scaffold_88	16029887	16043108	13221	g_17206	g_17207
Super-Scaffold_88	16047615	16056395	8780	g_17207	g_17208
Super-Scaffold_88	16057154	16078199	21045	g_17208	g_17209
Super-Scaffold_88	16087337	16094682	7345	g_17209	g_17210
Super-Scaffold_88	16101168	16155363	54195	g_17210	g_17213
Super-Scaffold_88	16167065	16174078	7013	g_17213	g_17214
Super-Scaffold_88	16198419	16200412	1993	g_17214	g_44331
Super-Scaffold_88	16206876	16217501	10625	g_44331	g_44332
Super-Scaffold_88	16244228	16269391	25163	g_44332	g_17215
Super-Scaffold_88	16278746	16428908	150162	g_17215	g_17219
Super-Scaffold_88	16432127	16550478	118351	g_17219	g_17221
Super-Scaffold_88	16551203	16766527	215324	g_17221	g_17223
Super-Scaffold_88	16766742	16801436	34694	g_17223	g_17224
Super-Scaffold_88	16819732	16931231	111499	g_17224	g_17226
Super-Scaffold_88	16931476	16951247	19771	g_17226	g_17228
Super-Scaffold_88	16952846	16956025	3179	g_17228	g_17229
Super-Scaffold_88	16958815	16969108	10293	g_17229	g_17230
Super-Scaffold_88	16970014	16976872	6858	g_17230	g_17231
Super-Scaffold_88	16983787	17062693	78906	g_17231	g_17233
Super-Scaffold_88	17068285	17124681	56396	g_17233	g_17236
Super-Scaffold_88	17137758	17148662	10904	g_17236	g_17237
Super-Scaffold_88	17158043	17164034	5991	g_17237	g_17238
Super-Scaffold_88	17164384	17164409	25	g_17238	g_17239
Super-Scaffold_88	17164732	17175313	10581	g_17239	g_17240
Super-Scaffold_88	17181494	17197000	15506	g_17240	g_17241
Super-Scaffold_88	17215339	17217545	2206	g_17241	g_17242
Super-Scaffold_88	17217790	17225165	7375	g_17242	g_17243
Super-Scaffold_88	17229120	17328275	99155	g_17243	g_17245
Super-Scaffold_88	17328691	17343312	14621	g_17245	g_44333
Super-Scaffold_88	17350798	17352881	2083	g_44333	g_44334
Super-Scaffold_88	17366229	17370297	4068	g_44334	g_17246
Super-Scaffold_88	17375244	17377071	1827	g_17246	g_17247
Super-Scaffold_88	17381935	17384145	2210	g_17247	g_17248
Super-Scaffold_88	17386692	17390376	3684	g_17248	g_17249
Super-Scaffold_88	17394723	17395712	989	g_17249	g_17250
Super-Scaffold_88	17396359	17399978	3619	g_17250	g_17251
Super-Scaffold_88	17401790	17403988	2198	g_17251	g_44335
Super-Scaffold_88	17405969	17406447	478	g_44335	g_17252
Super-Scaffold_88	17409778	17427989	18211	g_17252	g_17253
Super-Scaffold_88	17428717	17475062	46345	g_17253	g_17263
Super-Scaffold_88	17477156	17478332	1176	g_17263	g_17264
Super-Scaffold_88	17479856	17481249	1393	g_17264	g_17265
Super-Scaffold_88	17482782	17501068	18286	g_17265	g_44336
Super-Scaffold_88	17503035	17505183	2148	g_44336	g_17266
Super-Scaffold_88	17508787	17590911	82124	g_17266	g_17269
Super-Scaffold_88	17592131	17624950	32819	g_17269	g_17270
Super-Scaffold_88	17625165	17644941	19776	g_17270	g_17271
Super-Scaffold_88	17650699	17652826	2127	g_17271	g_44337
Super-Scaffold_88	17662183	17664937	2754	g_44337	g_17272
Super-Scaffold_88	17665436	17669816	4380	g_38461	g_17273
Super-Scaffold_88	17691387	17919145	227758	g_17273	g_17276
Super-Scaffold_88	17920494	18137302	216808	g_17276	g_17277
Super-Scaffold_88	18137538	18277240	139702	g_17277	g_17280
Super-Scaffold_88	18278817	18318598	39781	g_17280	g_17281
Super-Scaffold_88	18318861	18364397	45536	g_17281	g_17284
Super-Scaffold_88	18365986	18403222	37236	g_17284	g_17285
Super-Scaffold_88	18411146	18580367	169221	g_17285	g_17287
Super-Scaffold_88	18587686	18704494	116808	g_17287	g_17291
Super-Scaffold_88	18714708	18716001	1293	g_17291	g_17292
Super-Scaffold_88	18723788	18732881	9093	g_17292	g_44338
Super-Scaffold_88	18742068	18749548	7480	g_44338	g_17293
Super-Scaffold_88	18762951	18789298	26347	g_17293	g_44339
Super-Scaffold_88	18790323	18871949	81626	g_44339	g_17295
Super-Scaffold_88	18885453	18904411	18958	g_17295	g_17296
Super-Scaffold_88	18917851	18925086	7235	g_17296	g_17297
Super-Scaffold_88	18934738	18985719	50981	g_17297	g_17299
Super-Scaffold_88	18985946	19000341	14395	g_17299	g_17300
Super-Scaffold_88	19019473	19036295	16822	g_17300	g_17301
Super-Scaffold_88	19048781	19050993	2212	g_17301	g_17302
Super-Scaffold_88	19068282	19084346	16064	g_17302	g_17303
Super-Scaffold_88	19091953	19096895	4942	g_17303	g_17304
Super-Scaffold_88	19111091	19114179	3088	g_17304	g_17305
Super-Scaffold_88	19118347	19120568	2221	g_17305	g_17306
Super-Scaffold_88	19122078	19124927	2849	g_17306	g_44340
Super-Scaffold_88	19127450	19129569	2119	g_44340	g_17307
Super-Scaffold_88	19132914	19196283	63369	g_17307	g_17308
Super-Scaffold_88	19203353	19217100	13747	g_17308	g_17309
Super-Scaffold_88	19226124	19247046	20922	g_17309	g_17310
Super-Scaffold_88	19265907	19277830	11923	g_17310	g_17311
Super-Scaffold_88	19280577	19287093	6516	g_17311	g_17312
Super-Scaffold_88	19287915	19289329	1414	g_17312	g_17313
Super-Scaffold_88	19294550	19300096	5546	g_17313	g_17314
Super-Scaffold_88	19305312	19334765	29453	g_17314	g_17315
Super-Scaffold_88	19349323	19352509	3186	g_17315	g_17316
Super-Scaffold_88	19377617	19400868	23251	g_17316	g_17318
Super-Scaffold_88	19411056	19413525	2469	g_17318	g_17319
Super-Scaffold_88	19436199	19439963	3764	g_17319	g_17320
Super-Scaffold_88	19449806	19461480	11674	g_17320	g_17322
Super-Scaffold_88	19467238	19533983	66745	g_17322	g_17323
Super-Scaffold_88	19537140	19538887	1747	g_17323	g_17324
Super-Scaffold_88	19539144	19615708	76564	g_17324	g_17326
Super-Scaffold_88	19616598	19616679	81	g_17326	g_17327
Super-Scaffold_88	19618218	19622105	3887	g_17327	g_44341
Super-Scaffold_88	19623743	19630343	6600	g_44341	g_17328
Super-Scaffold_88	19631713	19635625	3912	g_17328	g_17329
Super-Scaffold_88	19636104	19639482	3378	g_17329	g_17331
Super-Scaffold_88	19644622	19650848	6226	g_17331	g_17332
Super-Scaffold_88	19651435	19654903	3468	g_17332	g_17333
Super-Scaffold_88	19665618	19669921	4303	g_17333	g_17334
Super-Scaffold_88	19690424	19693578	3154	g_17334	g_17335
Super-Scaffold_88	19697086	19699333	2247	g_17335	g_17336
Super-Scaffold_88	19701806	19704740	2934	g_17336	g_17337
Super-Scaffold_88	19709607	19712799	3192	g_17337	g_44342
Super-Scaffold_88	19717415	19718778	1363	g_44342	g_17338
Super-Scaffold_88	19723918	19725050	1132	g_17338	g_17339
Super-Scaffold_88	19728781	19733236	4455	g_17339	g_44343
Super-Scaffold_88	19744546	19746123	1577	g_44343	g_17340
Super-Scaffold_88	19759994	19765598	5604	g_17340	g_17341
Super-Scaffold_88	19790001	19815408	25407	g_17341	g_17343
Super-Scaffold_88	19821955	19823570	1615	g_17343	g_17344
Super-Scaffold_88	19829808	19834858	5050	g_17344	g_44344
Super-Scaffold_88	19839864	19872922	33058	g_44344	g_17345
Super-Scaffold_88	19914785	19916753	1968	g_17345	g_17346
Super-Scaffold_88	19926167	19929000	2833	g_17346	g_17347
Super-Scaffold_88	19946557	20047388	100831	g_17347	g_17350
Super-Scaffold_88	20056271	20061806	5535	g_17350	g_17351
Super-Scaffold_88	20069121	20072877	3756	g_17351	g_17352
Super-Scaffold_88	20082626	20084896	2270	g_17352	g_17353
Super-Scaffold_88	20085189	20103817	18628	g_17353	g_17354
Super-Scaffold_88	20114644	20116460	1816	g_17354	g_17355
Super-Scaffold_88	20119148	20122409	3261	g_17355	g_17356
Super-Scaffold_88	20125452	20127237	1785	g_17356	g_17357
Super-Scaffold_88	20130057	20131132	1075	g_17357	g_17358
Super-Scaffold_88	20136134	20150862	14728	g_17358	g_17359
Super-Scaffold_88	20151566	20171368	19802	g_17359	g_17361
Super-Scaffold_88	20189577	20195782	6205	g_17361	g_17362
Super-Scaffold_88	20201968	20246503	44535	g_17362	g_17363
Super-Scaffold_88	20272349	20287071	14722	g_17363	g_17365
Super-Scaffold_88	20289050	20289502	452	g_17365	g_17366
Super-Scaffold_88	20290251	20291295	1044	g_17366	g_17368
Super-Scaffold_88	20294257	20296864	2607	g_17368	g_44345
Super-Scaffold_88	20308394	20310778	2384	g_44345	g_17370
Super-Scaffold_88	20315692	20319494	3802	g_17370	g_17371
Super-Scaffold_88	20327270	20331094	3824	g_17371	g_17372
Super-Scaffold_88	20340412	20385384	44972	g_17372	g_17374
Super-Scaffold_88	20395123	20416282	21159	g_17374	g_38472
Super-Scaffold_88	20416572	20479049	62477	g_38472	g_17375
Super-Scaffold_88	20479264	20526902	47638	g_17375	g_17376
Super-Scaffold_88	20528548	20532032	3484	g_17376	g_17377
Super-Scaffold_88	20539346	20543943	4597	g_17377	g_44346
Super-Scaffold_88	20545656	20576639	30983	g_44346	g_17378
Super-Scaffold_88	20587895	20591434	3539	g_17378	g_17379
Super-Scaffold_88	20596281	20598098	1817	g_17379	g_44347
Super-Scaffold_88	20605231	20605950	719	g_44347	g_17380
Super-Scaffold_88	20607968	20608966	998	g_17380	g_17381
Super-Scaffold_88	20613597	20615652	2055	g_17382	g_17383
Super-Scaffold_88	20615975	20754022	138047	g_17383	g_17385
Super-Scaffold_88	20761156	20793441	32285	g_17385	g_17387
Super-Scaffold_88	20807192	20809445	2253	g_17387	g_44348
Super-Scaffold_88	20827109	20831415	4306	g_44348	g_17388
Super-Scaffold_88	20836413	20838404	1991	g_17388	g_17389
Super-Scaffold_88	20844995	20858214	13219	g_17389	g_17390
Super-Scaffold_88	20859244	21040557	181313	g_17390	g_17395
Super-Scaffold_88	21063070	21069617	6547	g_17395	g_17396
Super-Scaffold_88	21089719	21092198	2479	g_17396	g_17397
Super-Scaffold_88	21101792	21103869	2077	g_17397	g_17398
Super-Scaffold_88	21105226	21113664	8438	g_17398	g_17399
Super-Scaffold_88	21126220	21131671	5451	g_17399	g_17400
Super-Scaffold_88	21145993	21152995	7002	g_17400	g_17401
Super-Scaffold_88	21160862	21160991	129	g_17401	g_38474
Super-Scaffold_88	21161203	21162976	1773	g_38474	g_17402
Super-Scaffold_88	21165477	21166517	1040	g_17402	g_44349
Super-Scaffold_88	21168571	21170260	1689	g_44349	g_44350
Super-Scaffold_88	21170709	21178333	7624	g_44350	g_44351
Super-Scaffold_88	21180390	21189078	8688	g_44351	g_17403
Super-Scaffold_88	21192375	21193792	1417	g_17403	g_17404
Super-Scaffold_88	21194787	21195965	1178	g_17404	g_17405
Super-Scaffold_88	21198313	21201145	2832	g_17405	g_17406
Super-Scaffold_88	21207585	21215371	7786	g_17406	g_17407
Super-Scaffold_88	21216584	21222734	6150	g_17407	g_17408
Super-Scaffold_88	21229268	21237807	8539	g_17408	g_17409
Super-Scaffold_88	21238152	21241035	2883	g_17409	g_17410
Super-Scaffold_88	21241380	21245164	3784	g_17410	g_17411
Super-Scaffold_88	21245734	21250060	4326	g_17411	g_17412
Super-Scaffold_88	21266337	21283724	17387	g_17412	g_17414
Super-Scaffold_88	21294670	21303631	8961	g_17414	g_17415
Super-Scaffold_88	21306811	21308405	1594	g_17415	g_17416
Super-Scaffold_88	21312302	21312909	607	g_17416	g_44352
Super-Scaffold_88	21315421	21319418	3997	g_44352	g_17417
Super-Scaffold_88	21321180	21464108	142928	g_17417	g_17421
Super-Scaffold_88	21472840	21504373	31533	g_17421	g_17422
Super-Scaffold_88	21505433	21506480	1047	g_17422	g_44353
Super-Scaffold_88	21507202	21514220	7018	g_44353	g_17423
Super-Scaffold_88	21521679	21524333	2654	g_17423	g_17424
Super-Scaffold_88	21527412	21528736	1324	g_17424	g_17426
Super-Scaffold_88	21528936	21530218	1282	g_17426	g_17427
Super-Scaffold_88	21535214	21535862	648	g_17427	g_44354
Super-Scaffold_88	21538741	21547137	8396	g_44354	g_17428
Super-Scaffold_88	21551888	21553141	1253	g_17428	g_17429
Super-Scaffold_88	21554257	21556804	2547	g_17429	g_17430
Super-Scaffold_88	21561809	21565512	3703	g_17430	g_17431
Super-Scaffold_88	21572468	21573989	1521	g_17431	g_17432
Super-Scaffold_88	21574973	21575632	659	g_17432	g_17433
Super-Scaffold_88	21587944	21599746	11802	g_17433	g_17434
Super-Scaffold_88	21601610	21617280	15670	g_17434	g_17437
Super-Scaffold_88	21619330	21622532	3202	g_17437	g_17438
Super-Scaffold_88	21624971	21626258	1287	g_17438	g_17439
Super-Scaffold_88	21626572	21709024	82452	g_17439	g_17442
Super-Scaffold_88	21713242	21715949	2707	g_17442	g_17443
Super-Scaffold_88	21733552	21739796	6244	g_17443	g_17444
Super-Scaffold_88	21750879	21757599	6720	g_17444	g_17445
Super-Scaffold_88	21762580	21763731	1151	g_17445	g_44355
Super-Scaffold_88	21765495	21773488	7993	g_44355	g_17446
Super-Scaffold_88	21777234	21781415	4181	g_17446	g_44356
Super-Scaffold_88	21787337	21797489	10152	g_44356	g_17447
Super-Scaffold_88	21798700	21804072	5372	g_17447	g_17448
Super-Scaffold_88	21804377	21828345	23968	g_17448	g_17449
Super-Scaffold_88	21830827	21833486	2659	g_17449	g_17450
Super-Scaffold_88	21836302	21838600	2298	g_17450	g_17451
Super-Scaffold_88	21839484	21844260	4776	g_17451	g_17452
Super-Scaffold_88	21845575	21870354	24779	g_17452	g_17453
Super-Scaffold_88	21873818	21878437	4619	g_17453	g_17454
Super-Scaffold_88	21883082	21885100	2018	g_17454	g_44357
Super-Scaffold_88	21887416	21890531	3115	g_44357	g_17455
Super-Scaffold_88	21892066	21893956	1890	g_17455	g_17456
Super-Scaffold_88	21897092	21907586	10494	g_17456	g_17457
Super-Scaffold_88	21909099	21929820	20721	g_38480	g_17458
Super-Scaffold_88	21930137	21932783	2646	g_17458	g_44358
Super-Scaffold_88	21932995	21940599	7604	g_44358	g_17459
Super-Scaffold_88	21940865	21965465	24600	g_17459	g_17460
Super-Scaffold_88	21965680	21971961	6281	g_17460	g_17461
Super-Scaffold_88	21972689	21983609	10920	g_17461	g_17463
Super-Scaffold_88	21983812	22033860	50048	g_17463	g_17467
Super-Scaffold_88	22035064	22041816	6752	g_17467	g_44359
Super-Scaffold_88	22050901	22058148	7247	g_44359	g_17468
Super-Scaffold_88	22063830	22067692	3862	g_17468	g_44360
Super-Scaffold_88	22070670	22079485	8815	g_44360	g_17469
Super-Scaffold_88	22079709	22087124	7415	g_17469	g_17470
Super-Scaffold_88	22090927	22159358	68431	g_17470	g_17471
Super-Scaffold_88	22171373	22174283	2910	g_17471	g_17472
Super-Scaffold_88	22174857	22177263	2406	g_17472	g_17473
Super-Scaffold_88	22177832	22181036	3204	g_17473	g_17474
Super-Scaffold_88	22181656	22185654	3998	g_17474	g_17475
Super-Scaffold_88	22191227	22195897	4670	g_17475	g_17476
Super-Scaffold_88	22201264	22204272	3008	g_17476	g_17477
Super-Scaffold_88	22208673	22239984	31311	g_17477	g_17479
Super-Scaffold_88	22253480	22259187	5707	g_17479	g_17480
Super-Scaffold_88	22260760	22269238	8478	g_17480	g_38485
Super-Scaffold_88	22269447	22291478	22031	g_38485	g_17481
Super-Scaffold_88	22291795	22310005	18210	g_17481	g_17482
Super-Scaffold_88	22310262	22311720	1458	g_17482	g_17483
Super-Scaffold_88	22319032	22320670	1638	g_17483	g_17484
Super-Scaffold_88	22330533	22333716	3183	g_17484	g_17485
Super-Scaffold_88	22341048	22341556	508	g_17485	g_17486
Super-Scaffold_88	22344220	22348760	4540	g_17486	g_17487
Super-Scaffold_88	22349695	22355215	5520	g_17487	g_17488
Super-Scaffold_88	22366770	22381594	14824	g_17488	g_17489
Super-Scaffold_88	22382043	22420568	38525	g_17489	g_17490
Super-Scaffold_88	22435630	22439507	3877	g_17490	g_17491
Super-Scaffold_88	22444777	22450337	5560	g_17491	g_17492
Super-Scaffold_88	22454970	22462855	7885	g_17492	g_17493
Super-Scaffold_88	22488231	22499685	11454	g_17493	g_17494
Super-Scaffold_88	22500035	22583667	83632	g_17494	g_17497
Super-Scaffold_88	22600317	22652353	52036	g_17497	g_17499
Super-Scaffold_88	22652655	22658025	5370	g_17499	g_44361
Super-Scaffold_88	22667751	22675110	7359	g_44361	g_17500
Super-Scaffold_88	22679302	22687559	8257	g_17500	g_17501
Super-Scaffold_88	22696126	22697603	1477	g_17501	g_44362
Super-Scaffold_88	22699773	22702117	2344	g_44362	g_17502
Super-Scaffold_88	22711976	22745295	33319	g_17502	g_17503
Super-Scaffold_88	22747126	22818797	71671	g_17503	g_17505
Super-Scaffold_88	22820710	22858185	37475	g_17505	g_17507
Super-Scaffold_88	22873448	22875550	2102	g_17507	g_44363
Super-Scaffold_88	22876890	22879804	2914	g_44363	g_44364
Super-Scaffold_88	22884039	22885545	1506	g_44364	g_17508
Super-Scaffold_88	22892687	22925891	33204	g_17508	g_17509
Super-Scaffold_88	22939527	22977106	37579	g_17509	g_17511
Super-Scaffold_88	22978197	22991491	13294	g_17511	g_17512
Super-Scaffold_88	23002779	23014238	11459	g_17512	g_17513
Super-Scaffold_88	23034886	23040112	5226	g_17513	g_44365
Super-Scaffold_88	23048713	23062359	13646	g_44365	g_17514
Super-Scaffold_88	23066050	23068441	2391	g_17514	g_17515
Super-Scaffold_88	23078466	23082247	3781	g_17515	g_17516
Super-Scaffold_88	23082873	23112918	30045	g_17516	g_17517
Super-Scaffold_88	23113202	23125866	12664	g_17517	g_17518
Super-Scaffold_88	23127800	23208573	80773	g_17518	g_17519
Super-Scaffold_88	23228818	23264726	35908	g_17519	g_17520
Super-Scaffold_88	23271202	23315934	44732	g_17520	g_17521
Super-Scaffold_88	23316798	23330640	13842	g_17521	g_17522
Super-Scaffold_88	23331143	23332605	1462	g_17522	g_17523
Super-Scaffold_88	23333336	23344829	11493	g_17523	g_17524
Super-Scaffold_88	23349403	23350821	1418	g_17524	g_17525
Super-Scaffold_88	23355949	23370355	14406	g_17525	g_17526
Super-Scaffold_88	23383984	23389820	5836	g_17526	g_17527
Super-Scaffold_88	23391409	23399319	7910	g_17527	g_17529
Super-Scaffold_88	23401565	23416559	14994	g_17529	g_17530
Super-Scaffold_88	23416894	23429426	12532	g_17530	g_17531
Super-Scaffold_88	23429761	23442298	12537	g_17531	g_17532
Super-Scaffold_88	23442633	23455088	12455	g_17532	g_17533
Super-Scaffold_88	23455423	23467878	12455	g_17533	g_17534
Super-Scaffold_88	23468213	23481277	13064	g_17534	g_17535
Super-Scaffold_88	23481612	23494676	13064	g_17535	g_17536
Super-Scaffold_88	23495011	23507546	12535	g_17536	g_17537
Super-Scaffold_88	23507881	23510804	2923	g_17537	g_17538
Super-Scaffold_88	23513562	23514330	768	g_17538	g_17539
Super-Scaffold_88	23516749	23525867	9118	g_38495	g_17540
Super-Scaffold_88	23535592	23554142	18550	g_17540	g_17541
Super-Scaffold_88	23568967	23572760	3793	g_17541	g_17542
Super-Scaffold_88	23578553	23610199	31646	g_17542	g_17544
Super-Scaffold_88	23626508	23629801	3293	g_17544	g_17545
Super-Scaffold_88	23641056	23655839	14783	g_17545	g_44366
Super-Scaffold_88	23675910	23680283	4373	g_44366	g_17546
Super-Scaffold_88	23683983	23686257	2274	g_17546	g_17547
Super-Scaffold_88	23686988	23694959	7971	g_17547	g_17548
Super-Scaffold_88	23707500	23709219	1719	g_17548	g_17549
Super-Scaffold_88	23726048	23793586	67538	g_17549	g_17551
Super-Scaffold_88	23812296	23859817	47521	g_17551	g_17554
Super-Scaffold_88	23877103	23883078	5975	g_17554	g_17555
Super-Scaffold_88	23897213	23913122	15909	g_17555	g_17558
Super-Scaffold_88	23915645	23918625	2980	g_17558	g_17559
Super-Scaffold_88	23933338	23951951	18613	g_17559	g_17560
Super-Scaffold_88	23966818	23967080	262	g_17560	g_17561
Super-Scaffold_88	23969889	23971346	1457	g_17561	g_17562
Super-Scaffold_88	23986252	23991659	5407	g_17562	g_17563
Super-Scaffold_88	24005664	24006737	1073	g_17563	g_17564
Super-Scaffold_88	24010242	24011955	1713	g_17564	g_44367
Super-Scaffold_88	24022927	24052598	29671	g_44367	g_17565
Super-Scaffold_88	24064163	24068810	4647	g_17565	g_17566
Super-Scaffold_88	24069827	24134876	65049	g_17566	g_17568
Super-Scaffold_88	24152827	24154783	1956	g_17568	g_17569
Super-Scaffold_88	24156589	24219347	62758	g_17569	g_17571
Super-Scaffold_88	24225384	24228345	2961	g_17571	g_17572
Super-Scaffold_88	24232601	24237785	5184	g_17572	g_17574
Super-Scaffold_88	24239876	24290123	50247	g_17574	g_17576
Super-Scaffold_88	24294528	24299270	4742	g_17576	g_17577
Super-Scaffold_88	24308766	24337632	28866	g_17577	g_17578
Super-Scaffold_88	24348790	24359764	10974	g_17578	g_17579
Super-Scaffold_88	24363936	24371509	7573	g_17579	g_17580
Super-Scaffold_88	24375837	24379052	3215	g_17580	g_17581
Super-Scaffold_88	24385650	24387317	1667	g_17581	g_17582
Super-Scaffold_88	24388438	24390363	1925	g_17582	g_17583
Super-Scaffold_88	24398057	24399021	964	g_17583	g_17584
Super-Scaffold_88	24402403	24402867	464	g_17584	g_44368
Super-Scaffold_88	24406291	24410393	4102	g_44368	g_17586
Super-Scaffold_88	24415048	24421952	6904	g_17586	g_17587
Super-Scaffold_88	24428840	24431932	3092	g_17587	g_17588
Super-Scaffold_88	24434837	24439909	5072	g_17588	g_17589
Super-Scaffold_88	24455105	24467233	12128	g_17589	g_17590
Super-Scaffold_88	24468829	24483970	15141	g_17590	g_17591
Super-Scaffold_88	24495439	24497687	2248	g_17591	g_44369
Super-Scaffold_88	24505320	24516864	11544	g_44369	g_17593
Super-Scaffold_88	24521005	24524195	3190	g_17593	g_17594
Super-Scaffold_88	24529831	24530863	1032	g_17594	g_17595
Super-Scaffold_88	24532640	24557203	24563	g_17595	g_17596
Super-Scaffold_88	24558908	24574700	15792	g_17596	g_17597
Super-Scaffold_88	24590533	24592101	1568	g_17597	g_17598
Super-Scaffold_88	24595745	24605184	9439	g_17598	g_17599
Super-Scaffold_88	24611235	24617943	6708	g_17599	g_17600
Super-Scaffold_88	24621208	24623065	1857	g_17600	g_17601
Super-Scaffold_88	24627459	24629357	1898	g_17601	g_17602
Super-Scaffold_88	24637191	24657005	19814	g_17602	g_17603
Super-Scaffold_88	24657424	24666069	8645	g_17603	g_17604
Super-Scaffold_88	24666416	24666803	387	g_17604	g_17605
Super-Scaffold_88	24670650	24676379	5729	g_17605	g_17606
Super-Scaffold_88	24682981	24686534	3553	g_17606	g_17607
Super-Scaffold_88	24689819	24698971	9152	g_17607	g_17608
Super-Scaffold_88	24709456	24743801	34345	g_17608	g_17609
Super-Scaffold_88	24751929	24764365	12436	g_17609	g_17610
Super-Scaffold_88	24784932	24799532	14600	g_17610	g_17611
Super-Scaffold_88	24800667	24830757	30090	g_17611	g_17612
Super-Scaffold_88	24832444	24832660	216	g_17612	g_38505
Super-Scaffold_88	24832908	24845421	12513	g_38505	g_17613
Super-Scaffold_88	24849989	24853995	4006	g_17613	g_17614
Super-Scaffold_88	24867494	24874309	6815	g_17614	g_17615
Super-Scaffold_88	24882418	24913319	30901	g_17615	g_17616
Super-Scaffold_88	24913591	24927140	13549	g_17616	g_17618
Super-Scaffold_88	24941568	24962730	21162	g_17618	g_17620
Super-Scaffold_88	24965037	24967690	2653	g_17620	g_44370
Super-Scaffold_88	24973859	24977580	3721	g_44370	g_17622
Super-Scaffold_88	24982788	24984750	1962	g_17622	g_44371
Super-Scaffold_88	24992772	24996130	3358	g_44371	g_17623
Super-Scaffold_88	25003090	25008525	5435	g_17623	g_17624
Super-Scaffold_88	25015661	25021876	6215	g_17624	g_17625
Super-Scaffold_88	25025304	25108171	82867	g_17625	g_17627
Super-Scaffold_88	25109337	25128471	19134	g_17627	g_17628
Super-Scaffold_88	25129833	25179052	49219	g_17628	g_17630
Super-Scaffold_88	25186355	25206991	20636	g_17630	g_17631
Super-Scaffold_88	25215684	25247929	32245	g_17631	g_17632
Super-Scaffold_88	25250449	25251922	1473	g_17632	g_17633
Super-Scaffold_88	25261035	25262305	1270	g_17633	g_17634
Super-Scaffold_88	25263396	25267832	4436	g_17634	g_17635
Super-Scaffold_88	25273026	25275629	2603	g_17635	g_17636
Super-Scaffold_88	25280023	25286985	6962	g_17636	g_44372
Super-Scaffold_88	25288846	25292604	3758	g_44372	g_17637
Super-Scaffold_88	25292864	25295897	3033	g_17637	g_17638
Super-Scaffold_88	25315543	25320068	4525	g_17638	g_17639
Super-Scaffold_88	25330988	25333317	2329	g_17639	g_17640
Super-Scaffold_88	25338747	25340589	1842	g_17640	g_17641
Super-Scaffold_88	25345370	25347528	2158	g_17641	g_38515
Super-Scaffold_88	25349932	25353540	3608	g_17642	g_44373
Super-Scaffold_88	25356746	25362393	5647	g_44373	g_17643
Super-Scaffold_88	25456977	25534050	77073	g_17643	g_17647
Super-Scaffold_88	25535846	25649966	114120	g_17647	g_17650
Super-Scaffold_88	25665396	25665430	34	g_17650	g_17651
Super-Scaffold_88	25665651	25677120	11469	g_17651	g_17652
Super-Scaffold_88	25689709	25691591	1882	g_17652	g_17653
Super-Scaffold_88	25697680	25704792	7112	g_17653	g_17655
Super-Scaffold_88	25710992	25711518	526	g_17655	g_17656
Super-Scaffold_88	25717310	25719009	1699	g_17656	g_17657
Super-Scaffold_88	25725535	25735552	10017	g_17657	g_17659
Super-Scaffold_88	25743855	25746619	2764	g_17659	g_17660
Super-Scaffold_88	25751004	25754134	3130	g_17660	g_17661
Super-Scaffold_88	25767678	25768109	431	g_17661	g_17662
Super-Scaffold_88	25768417	25776453	8036	g_17662	g_17664
Super-Scaffold_88	25793736	25810114	16378	g_17664	g_17665
Super-Scaffold_88	25812347	25824020	11673	g_17665	g_17666
Super-Scaffold_88	25846660	25853344	6684	g_17666	g_17667
Super-Scaffold_88	25857360	25861453	4093	g_17667	g_17668
Super-Scaffold_88	25873551	25892917	19366	g_17668	g_17669
Super-Scaffold_88	25937773	25941450	3677	g_17669	g_17670
Super-Scaffold_88	25946032	25947028	996	g_17670	g_17671
Super-Scaffold_88	25951738	25954889	3151	g_17671	g_17672
Super-Scaffold_88	25956262	25960480	4218	g_17672	g_17673
Super-Scaffold_88	25965680	25970999	5319	g_17673	g_17674
Super-Scaffold_88	25971892	25974347	2455	g_17674	g_38517
Super-Scaffold_88	25976737	25978242	1505	g_17675	g_17676
Super-Scaffold_88	26008390	26011110	2720	g_17676	g_17677
Super-Scaffold_88	26025036	26027038	2002	g_17677	g_17678
Super-Scaffold_88	26034261	26059850	25589	g_17678	g_17679
Super-Scaffold_88	26072096	26091911	19815	g_17679	g_17680
Super-Scaffold_88	26101282	26103133	1851	g_17680	g_17681
Super-Scaffold_88	26119066	26127077	8011	g_17681	g_17682
Super-Scaffold_88	26129811	26134703	4892	g_17682	g_17683
Super-Scaffold_88	26136081	26145758	9677	g_17683	g_17684
Super-Scaffold_88	26146072	26183113	37041	g_17684	g_17686
Super-Scaffold_88	26184785	26184936	151	g_17686	g_17687
Super-Scaffold_88	26190005	26193485	3480	g_17687	g_17688
Super-Scaffold_88	26197100	26201771	4671	g_17688	g_17689
Super-Scaffold_88	26202784	26204116	1332	g_17689	g_17690
Super-Scaffold_88	26205647	26215199	9552	g_17690	g_17691
Super-Scaffold_88	26216293	26227037	10744	g_17691	g_17692
Super-Scaffold_88	26246796	26251224	4428	g_17692	g_17693
Super-Scaffold_88	26253963	26254809	846	g_17693	g_17694
Super-Scaffold_88	26277944	26313523	35579	g_17694	g_17695
Super-Scaffold_88	26318554	26320893	2339	g_17695	g_44374
Super-Scaffold_88	26325401	26336038	10637	g_44374	g_17696
Super-Scaffold_88	26342150	26435408	93258	g_17696	g_17697
Super-Scaffold_88	26436421	26533962	97541	g_17697	g_17699
Super-Scaffold_88	26547769	26565683	17914	g_17699	g_38519
Super-Scaffold_88	26565886	26643370	77484	g_38519	g_17700
Super-Scaffold_88	26648051	26823146	175095	g_17700	g_17701
Super-Scaffold_88	26832314	26848370	16056	g_17701	g_44375
Super-Scaffold_88	26852637	26854251	1614	g_44375	g_17702
Super-Scaffold_88	26880026	26881979	1953	g_17702	g_17703
Super-Scaffold_88	26884300	26887062	2762	g_17703	g_17704
Super-Scaffold_88	26894304	26898586	4282	g_17704	g_17705
Super-Scaffold_88	26902958	26905696	2738	g_17705	g_17706
Super-Scaffold_88	26921000	26952255	31255	g_17706	g_17707
Super-Scaffold_88	26967986	26980436	12450	g_17707	g_17709
Super-Scaffold_88	26994379	26997594	3215	g_17709	g_17710
Super-Scaffold_88	27000426	27003821	3395	g_17710	g_17711
Super-Scaffold_88	27011601	27014197	2596	g_17711	g_17712
Super-Scaffold_88	27017760	27018517	757	g_17712	g_17713
Super-Scaffold_88	27023951	27025875	1924	g_17713	g_17714
Super-Scaffold_88	27027720	27032138	4418	g_17714	g_17715
Super-Scaffold_88	27042750	27046988	4238	g_17715	g_17716
Super-Scaffold_88	27047329	27062910	15581	g_17716	g_17717
Super-Scaffold_88	27069969	27079917	9948	g_17717	g_17718
Super-Scaffold_88	27080897	27086797	5900	g_17718	g_17719
Super-Scaffold_88	27087486	27094874	7388	g_17719	g_17720
Super-Scaffold_88	27102775	27121941	19166	g_17720	g_17722
Super-Scaffold_88	27126216	27128850	2634	g_17722	g_17723
Super-Scaffold_88	27154247	27157264	3017	g_17723	g_44376
Super-Scaffold_88	27165700	27168722	3022	g_44376	g_38520
Super-Scaffold_88	27169075	27184895	15820	g_38520	g_17725
Super-Scaffold_88	27197499	27198728	1229	g_17725	g_17726
Super-Scaffold_88	27201509	27204844	3335	g_17726	g_17727
Super-Scaffold_88	27211820	27261120	49300	g_17727	g_17728
Super-Scaffold_88	27262547	27302292	39745	g_17728	g_17731
Super-Scaffold_88	27302555	27315965	13410	g_17731	g_17733
Super-Scaffold_88	27340242	27403343	63101	g_17733	g_17738
Super-Scaffold_88	27404151	27454846	50695	g_17738	g_17741
Super-Scaffold_88	27455379	27455632	253	g_17741	g_17742
Super-Scaffold_88	27472589	27475766	3177	g_17742	g_17743
Super-Scaffold_88	27489190	27503290	14100	g_17743	g_17744
Super-Scaffold_88	27519147	27519912	765	g_17744	g_17745
Super-Scaffold_88	27523306	27583299	59993	g_17745	g_17747
Super-Scaffold_88	27593673	27637948	44275	g_17747	g_17750
Super-Scaffold_88	27639027	27639417	390	g_17750	g_17751
Super-Scaffold_88	27639626	27652780	13154	g_17751	g_44377
Super-Scaffold_88	27673731	27682652	8921	g_44377	g_17753
Super-Scaffold_88	27712522	27715812	3290	g_17753	g_17754
Super-Scaffold_88	27735635	27747036	11401	g_17754	g_44378
Super-Scaffold_88	27752937	27800759	47822	g_44378	g_17755
Super-Scaffold_88	27802570	27924559	121989	g_17755	g_17760
Super-Scaffold_88	27934137	27935549	1412	g_17760	g_17761
Super-Scaffold_88	27939314	27946345	7031	g_17761	g_17762
Super-Scaffold_88	27954120	27999342	45222	g_17762	g_17765
Super-Scaffold_88	27999629	28012665	13036	g_17765	g_17766
Super-Scaffold_88	28012964	28037919	24955	g_17766	g_17767
Super-Scaffold_88	28039359	28161467	122108	g_17767	g_17772
Super-Scaffold_88	28162946	28167873	4927	g_17772	g_38530
Super-Scaffold_88	28168352	28175434	7082	g_38530	g_17774
Super-Scaffold_88	28175670	28205364	29694	g_17774	g_17778
Super-Scaffold_88	28205588	28210184	4596	g_17778	g_17779
Super-Scaffold_88	28210489	28217811	7322	g_17779	g_17780
Super-Scaffold_88	28238354	28247890	9536	g_17780	g_17781
Super-Scaffold_88	28248246	28254162	5916	g_17781	g_17782
Super-Scaffold_88	28260992	28264572	3580	g_17782	g_17783
Super-Scaffold_88	28271231	28275460	4229	g_17783	g_17784
Super-Scaffold_88	28275660	28296944	21284	g_17784	g_17785
Super-Scaffold_88	28303339	28387720	84381	g_17785	g_17788
Super-Scaffold_88	28395678	28413267	17589	g_17788	g_17789
Super-Scaffold_88	28418843	28425746	6903	g_17789	g_44379
Super-Scaffold_88	28442850	28444220	1370	g_44379	g_17790
Super-Scaffold_88	28456199	28458506	2307	g_17790	g_17791
Super-Scaffold_88	28465386	28502008	36622	g_17791	g_17793
Super-Scaffold_88	28502364	28502436	72	g_17793	g_17794
Super-Scaffold_88	28522368	28564283	41915	g_17794	g_38539
Super-Scaffold_88	28564501	28711105	146604	g_38539	g_17797
Super-Scaffold_88	28777170	28805277	28107	g_17797	g_17798
Super-Scaffold_88	28810733	28812250	1517	g_17798	g_17799
Super-Scaffold_88	28825494	28878053	52559	g_17799	g_17803
Super-Scaffold_88	28882642	28883685	1043	g_17803	g_17804
Super-Scaffold_88	28887690	28893446	5756	g_17804	g_17805
Super-Scaffold_88	28895848	28909679	13831	g_17805	g_17806
Super-Scaffold_88	28934760	28936084	1324	g_17806	g_44380
Super-Scaffold_88	29002378	29007067	4689	g_44380	g_17807
Super-Scaffold_88	29026707	29030867	4160	g_17807	g_17808
Super-Scaffold_88	29037188	29043685	6497	g_17808	g_17809
Super-Scaffold_88	29057457	29059580	2123	g_17809	g_17810
Super-Scaffold_88	29070022	29074885	4863	g_17810	g_17811
Super-Scaffold_88	29081754	29088304	6550	g_17811	g_17813
Super-Scaffold_88	29109180	29135555	26375	g_17813	g_17814
Super-Scaffold_88	29148981	29154196	5215	g_17814	g_38543
Super-Scaffold_88	29154405	29154473	68	g_38543	g_17815
Super-Scaffold_88	29160095	29162511	2416	g_17815	g_17816
Super-Scaffold_88	29164273	29165760	1487	g_17816	g_44381
Super-Scaffold_88	29170197	29171516	1319	g_44381	g_44382
Super-Scaffold_88	29182235	29182980	745	g_44382	g_17818
Super-Scaffold_88	29183384	29183520	136	g_17818	g_17817
Super-Scaffold_88	29184569	29184956	387	g_17817	g_17819
Super-Scaffold_88	29186005	29188734	2729	g_17819	g_44383
Super-Scaffold_88	29191197	29193333	2136	g_44383	g_17821
Super-Scaffold_88	29194433	29231211	36778	g_17821	g_17822
Super-Scaffold_88	29238605	29281639	43034	g_17822	g_17824
Super-Scaffold_88	29362460	29383032	20572	g_17824	g_38550
Super-Scaffold_88	29383235	29391359	8124	g_38550	g_17825
Super-Scaffold_88	29391877	29399243	7366	g_17825	g_17826
Super-Scaffold_88	29399491	29399961	470	g_17826	g_17827
Super-Scaffold_88	29400224	29430316	30092	g_17827	g_17828
Super-Scaffold_88	29430567	29436095	5528	g_17828	g_17829
Super-Scaffold_88	29440815	29527778	86963	g_17829	g_17838
Super-Scaffold_88	29528125	29548242	20117	g_17838	g_17839
Super-Scaffold_88	29548589	29594141	45552	g_17839	g_17840
Super-Scaffold_88	29594356	29627025	32669	g_17840	g_17844
Super-Scaffold_88	29627309	29629994	2685	g_17844	g_17845
Super-Scaffold_88	29639581	29640818	1237	g_17845	g_17846
Super-Scaffold_88	29646486	29648242	1756	g_17846	g_17847
Super-Scaffold_88	29654093	29655977	1884	g_17847	g_17848
Super-Scaffold_88	29657095	29659064	1969	g_17848	g_17849
Super-Scaffold_88	29666764	29668409	1645	g_17849	g_17850
Super-Scaffold_88	29671261	29677213	5952	g_17850	g_17851
Super-Scaffold_88	29681178	29684037	2859	g_17851	g_17852
Super-Scaffold_88	29702895	29712199	9304	g_17852	g_17853
Super-Scaffold_88	29712597	29718324	5727	g_17853	g_38555
Super-Scaffold_88	29718749	29755346	36597	g_38555	g_17857
Super-Scaffold_88	29760417	29774153	13736	g_17857	g_17858
Super-Scaffold_88	29786579	29790392	3813	g_17858	g_17859
Super-Scaffold_88	29790697	29797925	7228	g_17859	g_44384
Super-Scaffold_88	29802292	29805248	2956	g_44384	g_17860
Super-Scaffold_88	29809669	29810824	1155	g_17860	g_44385
Super-Scaffold_88	29815395	29821361	5966	g_44385	g_17861
Super-Scaffold_88	29838687	29874367	35680	g_17861	g_17862
Super-Scaffold_88	29885531	29912577	27046	g_17862	g_17863
Super-Scaffold_88	29923359	29996053	72694	g_17863	g_17865
Super-Scaffold_88	29998250	30020412	22162	g_17865	g_44386
Super-Scaffold_88	30030867	30044536	13669	g_44386	g_17866
Super-Scaffold_88	30050884	30118696	67812	g_17866	g_17868
Super-Scaffold_88	30134838	30155484	20646	g_17868	g_17869
Super-Scaffold_88	30167131	30169554	2423	g_17869	g_17870
Super-Scaffold_88	30171891	30172679	788	g_17870	g_17871
Super-Scaffold_88	30186045	30191104	5059	g_17871	g_17872
Super-Scaffold_88	30196546	30199937	3391	g_17872	g_38558
Super-Scaffold_88	30206571	30222319	15748	g_17873	g_17874
Super-Scaffold_88	30222645	30257177	34532	g_17874	g_17876
Super-Scaffold_88	30258052	30270588	12536	g_17876	g_17877
Super-Scaffold_88	30271022	30347264	76242	g_17877	g_17881
Super-Scaffold_88	30347539	30377151	29612	g_17881	g_17882
Super-Scaffold_88	30379573	30381957	2384	g_17882	g_17883
Super-Scaffold_88	30394866	30396643	1777	g_17883	g_17884
Super-Scaffold_88	30398997	30400697	1700	g_17884	g_17885
Super-Scaffold_88	30401719	30402685	966	g_17885	g_17886
Super-Scaffold_88	30405225	30406835	1610	g_17886	g_17887
Super-Scaffold_88	30410917	30413506	2589	g_17887	g_44387
Super-Scaffold_88	30417025	30428622	11597	g_44387	g_17888
Super-Scaffold_88	30434692	30438687	3995	g_17888	g_44388
Super-Scaffold_88	30445686	30463854	18168	g_38563	g_17889
Super-Scaffold_88	30479248	30482337	3089	g_17889	g_17890
Super-Scaffold_88	30501431	30509435	8004	g_17890	g_44389
Super-Scaffold_88	30512547	30515866	3319	g_44389	g_17891
Super-Scaffold_88	30516108	30571726	55618	g_17891	g_17893
Super-Scaffold_88	30596900	30626062	29162	g_17893	g_17895
Super-Scaffold_88	30632296	30634060	1764	g_17895	g_44390
Super-Scaffold_88	30644339	30650355	6016	g_44390	g_17896
Super-Scaffold_88	30656128	30688817	32689	g_17896	g_17897
Super-Scaffold_88	30694558	30715210	20652	g_17897	g_17898
Super-Scaffold_88	30729528	30734171	4643	g_17898	g_44391
Super-Scaffold_88	30761077	30767155	6078	g_44391	g_17899
Super-Scaffold_88	30777632	30779527	1895	g_17900	g_17902
Super-Scaffold_88	30781116	30828720	47604	g_17902	g_17903
Super-Scaffold_88	30830024	30836966	6942	g_17903	g_17905
Super-Scaffold_88	30840548	30986346	145798	g_17905	g_17907
Super-Scaffold_88	30993243	30994087	844	g_17907	g_17908
Super-Scaffold_88	30994503	31167775	173272	g_17908	g_17910
Super-Scaffold_88	31180353	31189622	9269	g_17910	g_17911
Super-Scaffold_88	31200047	31201633	1586	g_17911	g_17912
Super-Scaffold_88	31207063	31210413	3350	g_17912	g_17913
Super-Scaffold_88	31215098	31236955	21857	g_17913	g_17915
Super-Scaffold_88	31253979	31280768	26789	g_17915	g_17916
Super-Scaffold_88	31300628	31303931	3303	g_17916	g_17917
Super-Scaffold_88	31308608	31322680	14072	g_17917	g_44392
Super-Scaffold_88	31329287	31332464	3177	g_44392	g_44393
Super-Scaffold_88	31341452	31345091	3639	g_44393	g_38566
Super-Scaffold_88	31345399	31347065	1666	g_38566	g_17919
Super-Scaffold_88	31356421	31366425	10004	g_38567	g_17921
Super-Scaffold_88	31377838	31378940	1102	g_17921	g_44394
Super-Scaffold_88	31389201	31403364	14163	g_44394	g_17922
Super-Scaffold_88	31439325	31440122	797	g_17922	g_17923
Super-Scaffold_88	31442352	31447178	4826	g_17923	g_17924
Super-Scaffold_88	31457444	31465281	7837	g_17924	g_17925
Super-Scaffold_88	31472149	31473096	947	g_17925	g_17926
Super-Scaffold_88	31483256	31488097	4841	g_17926	g_17927
Super-Scaffold_88	31498661	31501386	2725	g_17927	g_17928
Super-Scaffold_88	31516356	31524145	7789	g_17928	g_44395
Super-Scaffold_88	31529907	31647169	117262	g_38568	g_17929
Super-Scaffold_88	31653893	31670999	17106	g_17929	g_17930
Super-Scaffold_88	31672998	31686241	13243	g_17931	g_17933
Super-Scaffold_88	31693124	31701243	8119	g_17933	g_17935
Super-Scaffold_88	31701896	31713022	11126	g_17935	g_17936
Super-Scaffold_88	31713701	31729342	15641	g_17936	g_17937
Super-Scaffold_88	31730044	31736897	6853	g_17937	g_17938
Super-Scaffold_88	31737590	31744963	7373	g_17938	g_17939
Super-Scaffold_88	31745662	31753075	7413	g_17939	g_17940
Super-Scaffold_88	31753774	31760106	6332	g_17940	g_17941
Super-Scaffold_88	31766664	31771829	5165	g_17941	g_17942
Super-Scaffold_88	31784693	31801084	16391	g_17942	g_17943
Super-Scaffold_88	31806211	31816178	9967	g_17944	g_17946
Super-Scaffold_88	31817368	31854377	37009	g_17946	g_17948
Super-Scaffold_88	31854763	31860028	5265	g_17948	g_17949
Super-Scaffold_88	31860387	31862101	1714	g_17949	g_17950
Super-Scaffold_88	31869642	31870743	1101	g_17950	g_17951
Super-Scaffold_88	31871087	31874342	3255	g_17951	g_17952
Super-Scaffold_88	31889332	31901854	12522	g_17952	g_17954
Super-Scaffold_88	31909243	31924134	14891	g_17954	g_17955
Super-Scaffold_88	31935649	31943644	7995	g_17955	g_17956
Super-Scaffold_88	31957702	32027991	70289	g_17956	g_17960
Super-Scaffold_88	32036003	32039088	3085	g_17960	g_17961
Super-Scaffold_88	32047133	32055755	8622	g_17961	g_17962
Super-Scaffold_88	32067923	32071415	3492	g_17962	g_17963
Super-Scaffold_88	32080884	32085337	4453	g_17963	g_17964
Super-Scaffold_88	32092996	32119592	26596	g_17964	g_17966
Super-Scaffold_88	32148700	32158414	9714	g_17966	g_17967
Super-Scaffold_88	32177012	32180159	3147	g_17967	g_44396
Super-Scaffold_88	32195082	32195337	255	g_44396	g_17968
Super-Scaffold_88	32195660	32203105	7445	g_17968	g_17969
Super-Scaffold_88	32203323	32220344	17021	g_17969	g_17971
Super-Scaffold_88	32220923	32230911	9988	g_17971	g_17972
Super-Scaffold_88	32233248	32254769	21521	g_17972	g_17973
Super-Scaffold_88	32288204	32325726	37522	g_17973	g_17975
Super-Scaffold_88	32330220	32348198	17978	g_17975	g_17976
Super-Scaffold_88	32367317	32373897	6580	g_17976	g_17977
Super-Scaffold_88	32389022	32403498	14476	g_17977	g_17978
Super-Scaffold_88	32408116	32490126	82010	g_17978	g_17979
Super-Scaffold_88	32511856	32519252	7396	g_17979	g_17980
Super-Scaffold_88	32528333	32534126	5793	g_17980	g_17981
Super-Scaffold_88	32534365	32547921	13556	g_17981	g_17982
Super-Scaffold_88	32556282	32582731	26449	g_17982	g_17983
Super-Scaffold_88	32595209	32595998	789	g_17983	g_17984
Super-Scaffold_88	32602076	32686001	83925	g_17984	g_17986
Super-Scaffold_88	32688703	32695958	7255	g_17986	g_17987
Super-Scaffold_88	32699204	32706464	7260	g_17987	g_17988
Super-Scaffold_88	32720984	32746562	25578	g_17988	g_17991
Super-Scaffold_88	32747191	32799402	52211	g_17991	g_17993
Super-Scaffold_88	32799689	32804793	5104	g_17993	g_17994
Super-Scaffold_88	32807385	32841807	34422	g_17994	g_17996
Super-Scaffold_88	32842145	32873486	31341	g_17996	g_17998
Super-Scaffold_88	32877855	32904916	27061	g_17998	g_18000
Super-Scaffold_88	32928857	32934883	6026	g_18000	g_44397
Super-Scaffold_88	32937838	32942506	4668	g_44397	g_18001
Super-Scaffold_88	32947829	32949115	1286	g_18001	g_18002
Super-Scaffold_88	32950597	32956431	5834	g_18002	g_18003
Super-Scaffold_88	32957663	32958874	1211	g_18003	g_18004
Super-Scaffold_88	32965109	32967457	2348	g_18004	g_18005
Super-Scaffold_88	32977181	32979391	2210	g_18005	g_18006
Super-Scaffold_88	32980785	32984188	3403	g_18006	g_18007
Super-Scaffold_88	32996712	33003657	6945	g_18008	g_18009
Super-Scaffold_88	33030747	33033428	2681	g_18009	g_18010
Super-Scaffold_88	33041958	33048053	6095	g_18010	g_18011
Super-Scaffold_88	33052455	33074979	22524	g_18011	g_18013
Super-Scaffold_88	33075446	33076001	555	g_18013	g_18014
Super-Scaffold_88	33076460	33076764	304	g_18014	g_18015
Super-Scaffold_88	33077114	33077142	28	g_18015	g_18016
Super-Scaffold_88	33077540	33079304	1764	g_18016	g_18017
Super-Scaffold_88	33079990	33089683	9693	g_18017	g_18018
Super-Scaffold_88	33090916	33092713	1797	g_18018	g_18019
Super-Scaffold_88	33095541	33122692	27151	g_18019	g_18020
Super-Scaffold_88	33127000	33283769	156769	g_18020	g_18021
Super-Scaffold_88	33290863	33368076	77213	g_18021	g_18024
Super-Scaffold_88	33368300	33388116	19816	g_18024	g_18025
Super-Scaffold_88	33400557	33412303	11746	g_18025	g_18026
Super-Scaffold_88	33419757	33429878	10121	g_18026	g_18027
Super-Scaffold_88	33435247	33448393	13146	g_18027	g_18028
Super-Scaffold_88	33448662	33456749	8087	g_18028	g_18029
Super-Scaffold_88	33457795	33462739	4944	g_18029	g_18030
Super-Scaffold_88	33462942	33464891	1949	g_18030	g_18031
Super-Scaffold_88	33480273	33485249	4976	g_18031	g_18032
Super-Scaffold_88	33490405	33494946	4541	g_18032	g_44398
Super-Scaffold_88	33508112	33528697	20585	g_44398	g_18033
Super-Scaffold_88	33536625	33542742	6117	g_18033	g_18034
Super-Scaffold_88	33562331	33568880	6549	g_18034	g_18035
Super-Scaffold_88	33582750	33587004	4254	g_18035	g_18036
Super-Scaffold_88	33603953	33625012	21059	g_18036	g_38586
Super-Scaffold_88	33625308	33639893	14585	g_38586	g_18038
Super-Scaffold_88	33640570	33666808	26238	g_18038	g_18041
Super-Scaffold_88	33667071	33694951	27880	g_18041	g_18043
Super-Scaffold_88	33695157	33719971	24814	g_18043	g_18045
Super-Scaffold_88	33729129	33732785	3656	g_18045	g_18046
Super-Scaffold_88	33733981	33741208	7227	g_18046	g_18047
Super-Scaffold_88	33752246	33756747	4501	g_18047	g_38589
Super-Scaffold_88	33758662	33830677	72015	g_18048	g_18050
Super-Scaffold_88	33832638	33860365	27727	g_18050	g_18051
Super-Scaffold_88	33889531	33891405	1874	g_18051	g_18052
Super-Scaffold_88	33896601	33903676	7075	g_18052	g_18054
Super-Scaffold_88	33972086	33983474	11388	g_18054	g_18055
Super-Scaffold_88	34007699	34013926	6227	g_18055	g_18056
Super-Scaffold_88	34024628	34025584	956	g_18056	g_18057
Super-Scaffold_88	34038377	34040480	2103	g_18057	g_18058
Super-Scaffold_88	34052726	34058770	6044	g_18058	g_18059
Super-Scaffold_88	34083023	34097049	14026	g_18059	g_18060
Super-Scaffold_88	34100004	34105324	5320	g_18060	g_44399
Super-Scaffold_88	34113181	34119483	6302	g_44399	g_18061
Super-Scaffold_88	34120641	34123141	2500	g_18061	g_44400
Super-Scaffold_88	34131603	34135427	3824	g_44400	g_18062
Super-Scaffold_88	34150566	34181507	30941	g_18062	g_18063
Super-Scaffold_88	34189985	34193842	3857	g_18063	g_18064
Super-Scaffold_88	34209272	34216274	7002	g_18064	g_18065
Super-Scaffold_88	34260837	34266647	5810	g_18065	g_18066
Super-Scaffold_88	34270807	34273162	2355	g_18066	g_18067
Super-Scaffold_88	34301472	34308019	6547	g_18067	g_44401
Super-Scaffold_88	34313448	34319786	6338	g_44401	g_44402
Super-Scaffold_88	34325332	34340298	14966	g_44402	g_18068
Super-Scaffold_88	34352405	34356514	4109	g_18068	g_44403
Super-Scaffold_88	34358822	34370834	12012	g_44403	g_18069
Super-Scaffold_88	34374039	34379123	5084	g_18069	g_18070
Super-Scaffold_88	34381106	34387890	6784	g_18070	g_18071
Super-Scaffold_88	34392723	34395805	3082	g_18071	g_44404
Super-Scaffold_88	34398094	34410371	12277	g_44404	g_18072
Super-Scaffold_88	34411565	34411987	422	g_18072	g_18073
Super-Scaffold_88	34413480	34414802	1322	g_18073	g_18075
Super-Scaffold_88	34415113	34429995	14882	g_18075	g_18076
Super-Scaffold_88	34450575	34467131	16556	g_18076	g_18077
Super-Scaffold_88	34467607	34469288	1681	g_18077	g_18078
Super-Scaffold_88	34469551	34473717	4166	g_18078	g_18079
Super-Scaffold_88	34475122	34477470	2348	g_18079	g_18080
Super-Scaffold_88	34478054	34484777	6723	g_18080	g_18081
Super-Scaffold_88	34487012	34488505	1493	g_18081	g_18082
Super-Scaffold_88	34496477	34505844	9367	g_18082	g_18083
Super-Scaffold_88	34537498	34538640	1142	g_18083	g_18084
Super-Scaffold_88	34548589	34572589	24000	g_18084	g_18085
Super-Scaffold_88	34575172	34576109	937	g_18085	g_18086
Super-Scaffold_88	34576600	34583874	7274	g_18086	g_18087
Super-Scaffold_88	34595001	34622394	27393	g_18088	g_18089
Super-Scaffold_88	34631019	34638796	7777	g_18089	g_18090
Super-Scaffold_88	34676575	34686474	9899	g_18090	g_44405
Super-Scaffold_88	34695554	34715685	20131	g_44405	g_18092
Super-Scaffold_88	34716389	34718528	2139	g_18092	g_44406
Super-Scaffold_88	34722487	34730648	8161	g_44406	g_18093
Super-Scaffold_88	34735524	34743597	8073	g_18093	g_44407
Super-Scaffold_88	34748465	34778165	29700	g_44407	g_18094
Super-Scaffold_88	34785617	34785849	232	g_18094	g_18095
Super-Scaffold_88	34791490	34792088	598	g_18095	g_44408
Super-Scaffold_88	34794255	34819623	25368	g_44408	g_18096
Super-Scaffold_88	34824740	34829304	4564	g_18096	g_18097
Super-Scaffold_88	34833312	34837899	4587	g_18097	g_44409
Super-Scaffold_88	34841907	34847413	5506	g_44409	g_18098
Super-Scaffold_88	34856509	34856649	140	g_18098	g_18099
Super-Scaffold_88	34857110	34863086	5976	g_18099	g_18100
Super-Scaffold_88	34867554	34870078	2524	g_18100	g_18101
Super-Scaffold_88	34880435	34885646	5211	g_18101	g_18102
Super-Scaffold_88	34933541	34999617	66076	g_18102	g_18104
Super-Scaffold_88	35012995	35026559	13564	g_18104	g_18105
Super-Scaffold_88	35034179	35046939	12760	g_18105	g_18107
Super-Scaffold_88	35047262	35053989	6727	g_18107	g_18106
Super-Scaffold_88	35056670	35067133	10463	g_18106	g_18108
Super-Scaffold_88	35072321	35078340	6019	g_18108	g_44410
Super-Scaffold_88	35084352	35088640	4288	g_44410	g_44411
Super-Scaffold_88	35091038	35102944	11906	g_44411	g_44412
Super-Scaffold_88	35117563	35120361	2798	g_44412	g_44413
Super-Scaffold_88	35134046	35141366	7320	g_44413	g_44414
Super-Scaffold_88	35150574	35165043	14469	g_44414	g_18109
Super-Scaffold_88	35172048	35173774	1726	g_18109	g_18110
Super-Scaffold_88	35183716	35190183	6467	g_38593	g_38594
Super-Scaffold_88	35190383	35191243	860	g_38594	g_18111
Super-Scaffold_88	35209389	35232098	22709	g_18111	g_18112
Super-Scaffold_88	35232547	35233346	799	g_18112	g_18114
Super-Scaffold_88	35233582	35234600	1018	g_18114	g_18116
Super-Scaffold_88	35272027	35280297	8270	g_18116	g_18117
Super-Scaffold_88	35280518	35400995	120477	g_18117	g_18119
Super-Scaffold_88	35418234	35447324	29090	g_18119	g_18120
Super-Scaffold_88	35467397	35472547	5150	g_18120	g_18121
Super-Scaffold_88	35494502	35504033	9531	g_18121	g_18122
Super-Scaffold_88	35513732	35546993	33261	g_18122	g_18124
Super-Scaffold_88	35549823	35566925	17102	g_18124	g_18125
Super-Scaffold_88	35578244	35578344	100	g_18125	g_18126
Super-Scaffold_88	35618594	35680702	62108	g_18126	g_18128
Super-Scaffold_88	35681217	35694135	12918	g_18128	g_18129
Super-Scaffold_88	35698590	35718548	19958	g_18129	g_18130
Super-Scaffold_88	35721079	35724816	3737	g_18130	g_18131
Super-Scaffold_88	35738907	35744801	5894	g_18131	g_44415
Super-Scaffold_88	35749780	35762414	12634	g_44415	g_44416
Super-Scaffold_88	35766830	35769164	2334	g_44416	g_44417
Super-Scaffold_88	35773804	35782275	8471	g_44417	g_18132
Super-Scaffold_88	35785147	35788627	3480	g_18132	g_18133
Super-Scaffold_88	35795465	35802459	6994	g_18133	g_18134
Super-Scaffold_88	35820935	35821730	795	g_18134	g_44418
Super-Scaffold_88	35838137	35841214	3077	g_44418	g_44419
Super-Scaffold_88	35850630	35865654	15024	g_44419	g_18135
Super-Scaffold_88	35890983	35893434	2451	g_18135	g_44420
Super-Scaffold_88	35898608	35901735	3127	g_44420	g_44421
Super-Scaffold_88	35906907	35910341	3434	g_44421	g_18136
Super-Scaffold_88	35913992	35916500	2508	g_18136	g_44422
Super-Scaffold_88	35933859	35939179	5320	g_44422	g_44423
Super-Scaffold_88	35942612	35998638	56026	g_44423	g_18137
Super-Scaffold_88	36006355	36022391	16036	g_18137	g_18138
Super-Scaffold_88	36027532	36037737	10205	g_18138	g_44424
Super-Scaffold_88	36042564	36051543	8979	g_44424	g_18139
Super-Scaffold_88	36059969	36061938	1969	g_18139	g_18140
Super-Scaffold_88	36064114	36071712	7598	g_18140	g_18141
Super-Scaffold_88	36071951	36082227	10276	g_18141	g_18142
Super-Scaffold_88	36083612	36084936	1324	g_18142	g_18143
Super-Scaffold_88	36092544	36129091	36547	g_18143	g_18144
Super-Scaffold_88	36165015	36166471	1456	g_18144	g_18145
Super-Scaffold_88	36166764	36170470	3706	g_18145	g_18146
Super-Scaffold_88	36178632	36182191	3559	g_18146	g_18147
Super-Scaffold_88	36185642	36187644	2002	g_18147	g_18148
Super-Scaffold_88	36193092	36201286	8194	g_18148	g_44425
Super-Scaffold_88	36213287	36217796	4509	g_44425	g_18149
Super-Scaffold_88	36221464	36234990	13526	g_18149	g_18150
Super-Scaffold_88	36241937	36252702	10765	g_18150	g_18151
Super-Scaffold_88	36258526	36262177	3651	g_18151	g_18152
Super-Scaffold_88	36265626	36267629	2003	g_18152	g_44426
Super-Scaffold_88	36277629	36284402	6773	g_44426	g_44427
Super-Scaffold_88	36288503	36291878	3375	g_44427	g_18153
Super-Scaffold_88	36298232	36306305	8073	g_18153	g_18154
Super-Scaffold_88	36315058	36316869	1811	g_18154	g_44428
Super-Scaffold_88	36326851	36337836	10985	g_44428	g_18156
Super-Scaffold_88	36338036	36361976	23940	g_18156	g_18157
Super-Scaffold_88	36362353	36386674	24321	g_18157	g_18158
Super-Scaffold_88	36386904	36393210	6306	g_18158	g_18160
Super-Scaffold_88	36393518	36456311	62793	g_18160	g_18165
Super-Scaffold_88	36497423	36503021	5598	g_18165	g_44429
Super-Scaffold_88	36526892	36530833	3941	g_38603	g_18166
Super-Scaffold_88	36550484	36580551	30067	g_18166	g_18168
Super-Scaffold_88	36581081	36594047	12966	g_18168	g_18169
Super-Scaffold_88	36605980	36622044	16064	g_18169	g_18170
Super-Scaffold_88	36634698	36635041	343	g_18170	g_18171
Super-Scaffold_88	36635529	36658817	23288	g_18171	g_18173
Super-Scaffold_88	36673490	36675286	1796	g_18173	g_18174
Super-Scaffold_88	36696321	36702435	6114	g_18174	g_18175
Super-Scaffold_88	36714784	36722083	7299	g_18175	g_18176
Super-Scaffold_88	36755248	36791550	36302	g_18176	g_18178
Super-Scaffold_88	36795911	36842425	46514	g_18178	g_18179
Super-Scaffold_88	36842760	37112915	270155	g_18179	g_18182
Super-Scaffold_88	37117910	39512701	2394791	g_18182	g_18185
Super-Scaffold_88	39513684	39516510	2826	g_18185	g_18186
Super-Scaffold_88	39516722	39537261	20539	g_18186	g_18187
Super-Scaffold_88	39540109	39552693	12584	g_18187	g_18189
Super-Scaffold_88	39562228	39594474	32246	g_18189	g_38608
Super-Scaffold_88	39594923	39595344	421	g_38608	g_38609
Super-Scaffold_88	39595916	39601962	6046	g_38609	g_18192
Super-Scaffold_88	39602258	39602834	576	g_18192	g_18193
Super-Scaffold_88	39604372	39615603	11231	g_18193	g_18194
Super-Scaffold_88	39635779	39664525	28746	g_18194	g_18195
Super-Scaffold_88	39692032	39736260	44228	g_18195	g_18196
Super-Scaffold_88	39742948	39760732	17784	g_18196	g_18199
Super-Scaffold_88	39761268	39806502	45234	g_18199	g_18200
Super-Scaffold_88	39807746	39813199	5453	g_18200	g_18201
Super-Scaffold_88	39818141	39820935	2794	g_18201	g_44430
Super-Scaffold_88	39827063	39829704	2641	g_44430	g_18204
Super-Scaffold_88	39830794	39870545	39751	g_18204	g_18206
Super-Scaffold_88	39891376	39897616	6240	g_18206	g_18207
Super-Scaffold_88	39921055	39931941	10886	g_18207	g_18208
Super-Scaffold_88	39948533	39951326	2793	g_18208	g_18209
Super-Scaffold_88	39952515	39978405	25890	g_38615	g_18211
Super-Scaffold_88	39995597	40006776	11179	g_18211	g_44431
Super-Scaffold_88	40008611	40009612	1001	g_44431	g_18212
Super-Scaffold_88	40010559	40028320	17761	g_18212	g_18213
Super-Scaffold_88	40035522	40062712	27190	g_38617	g_18214
Super-Scaffold_88	40066144	40070085	3941	g_18214	g_18215
Super-Scaffold_88	40070799	40071203	404	g_38620	g_38621
Super-Scaffold_88	40071766	40073188	1422	g_38621	g_38622
Super-Scaffold_88	40074474	40102110	27636	g_38622	g_18216
Super-Scaffold_88	40109327	40110893	1566	g_18216	g_44432
Super-Scaffold_88	40118746	40121906	3160	g_44432	g_18217
Super-Scaffold_88	40153721	40155056	1335	g_18217	g_18218
Super-Scaffold_88	40175185	40182219	7034	g_18218	g_18219
Super-Scaffold_88	40182824	40183460	636	g_18219	g_18220
Super-Scaffold_88	40183888	40197702	13814	g_18220	g_18222
Super-Scaffold_88	40198655	40200137	1482	g_18222	g_18223
Super-Scaffold_88	40235695	40236075	380	g_18223	g_18224
Super-Scaffold_88	40236827	40237161	334	g_18224	g_18225
Super-Scaffold_88	40237445	40244505	7060	g_18225	g_18226
Super-Scaffold_88	40253076	40319508	66432	g_18226	g_18231
Super-Scaffold_88	40320631	40320937	306	g_18231	g_18232
Super-Scaffold_88	40332611	40356104	23493	g_18232	g_38625
Super-Scaffold_88	40357615	40380194	22579	g_38625	g_18233
Super-Scaffold_88	40380751	40381154	403	g_18233	g_38626
Super-Scaffold_88	40385572	40433681	48109	g_38626	g_18235
Super-Scaffold_88	40453994	40467197	13203	g_18235	g_18236
Super-Scaffold_88	40477990	40478074	84	g_18236	g_18237
Super-Scaffold_88	40478484	40478517	33	g_18237	g_18238
Super-Scaffold_88	40478825	40478833	8	g_18238	g_18239
Super-Scaffold_88	40479133	40481008	1875	g_18239	g_18240
Super-Scaffold_88	40482765	40486251	3486	g_18240	g_18241
Super-Scaffold_88	40486607	40490616	4009	g_18241	g_18243
Super-Scaffold_88	40491008	40498407	7399	g_18243	g_44433
Super-Scaffold_88	40498613	40499824	1211	g_44433	g_18244
Super-Scaffold_88	40502362	40871803	369441	g_18244	g_18246
Super-Scaffold_88	40886149	40887040	891	g_18246	g_18247
Super-Scaffold_88	40887273	40887368	95	g_18247	g_18248
Super-Scaffold_88	40887601	40887935	334	g_18248	g_18249
Super-Scaffold_88	40888537	40888591	54	g_18249	g_18250
Super-Scaffold_88	40889121	40909376	20255	g_18250	g_18252
Super-Scaffold_88	40918697	40944173	25476	g_18252	g_18253
Super-Scaffold_88	40945258	40947992	2734	g_18253	g_18254
Super-Scaffold_88	40948198	40996995	48797	g_18254	g_18257
Super-Scaffold_88	41000348	41044998	44650	g_18257	g_18259
Super-Scaffold_88	41057417	41063364	5947	g_18259	g_18260
Super-Scaffold_88	41063816	41074160	10344	g_18260	g_18261
Super-Scaffold_88	41096625	41100518	3893	g_18261	g_18262
Super-Scaffold_88	41101362	41101561	199	g_18262	g_18263
Super-Scaffold_88	41101806	41102041	235	g_18263	g_18264
Super-Scaffold_88	41102373	41133518	31145	g_18264	g_18266
Super-Scaffold_88	41138241	41142510	4269	g_18266	g_18267
Super-Scaffold_88	41143823	41146030	2207	g_18267	g_18268
Super-Scaffold_88	41167523	41169738	2215	g_18268	g_18269
Super-Scaffold_88	41171056	41297125	126069	g_18269	g_18271
Super-Scaffold_88	41298969	41299382	413	g_18271	g_18272
Super-Scaffold_88	41299612	41303272	3660	g_18272	g_18274
Super-Scaffold_88	41305116	41305529	413	g_18274	g_18275
Super-Scaffold_88	41305759	41309419	3660	g_18275	g_18277
Super-Scaffold_88	41311263	41311676	413	g_18277	g_18278
