Scaffold	start_pos	end_pos	intergenic_length	upstream_gene	downstream_gene
ptg000001l	0	1	1	none	g_24051
ptg000001l	27728	87491	59763	g_24051	g_30642
ptg000001l	88654	127323	38669	g_30642	g_24704
ptg000001l	127526	133417	5891	g_24704	g_28652
ptg000001l	143456	152848	9392	g_28652	g_30436
ptg000001l	174023	213415	39392	g_30436	g_11309
ptg000001l	213858	214767	909	g_11309	g_5605
ptg000001l	215918	375217	159299	g_5605	g_29883
ptg000001l	393571	404141	10570	g_29883	g_29356
ptg000001l	404932	427579	22647	g_29356	g_15569
ptg000001l	429668	450860	21192	g_15569	g_16932
ptg000001l	451610	476687	25077	g_16932	g_28477
ptg000001l	477475	477710	235	g_28477	g_28423
ptg000001l	478948	501840	22892	g_28423	g_2268
ptg000001l	510952	805020	294068	g_2268	g_4324
ptg000001l	892241	928464	36223	g_4324	g_19841
ptg000001l	935539	949444	13905	g_19841	g_36338
ptg000001l	958019	976224	18205	g_36338	g_38127
ptg000001l	986347	1043552	57205	g_38127	g_11674
ptg000001l	1043779	1129295	85516	g_11674	g_936
ptg000001l	1163148	1168605	5457	g_936	g_27565
ptg000001l	1194146	1229824	35678	g_27565	g_6833
ptg000001l	1235447	1247501	12054	g_6833	g_36798
ptg000001l	1258201	1263433	5232	g_36798	g_11861
ptg000001l	1275308	1300896	25588	g_11861	g_4091
ptg000001l	1306010	1308797	2787	g_4091	g_19240
ptg000001l	1315224	1358318	43094	g_19240	g_17001
ptg000001l	1362872	1365212	2340	g_17001	g_19561
ptg000001l	1368856	1369448	592	g_19561	g_18160
ptg000001l	1372064	1372538	474	g_18160	g_40183
ptg000001l	1373990	1379099	5109	g_40183	g_19186
ptg000001l	1379314	1395789	16475	g_19186	g_25925
ptg000001l	1399821	1404407	4586	g_25925	g_35594
ptg000001l	1418165	1420362	2197	g_35594	g_15914
ptg000001l	1427089	1460037	32948	g_15914	g_2585
ptg000001l	1479122	1507710	28588	g_2585	g_39985
ptg000001l	1513609	1516580	2971	g_39985	g_4891
ptg000001l	1518707	1524771	6064	g_4891	g_7105
ptg000001l	1533931	1536568	2637	g_7105	g_5269
ptg000001l	1541139	1550553	9414	g_5269	g_21254
ptg000001l	1555612	1586849	31237	g_21254	g_36951
ptg000001l	1587103	1720579	133476	g_36951	g_14228
ptg000001l	1749956	1775695	25739	g_14228	g_14088
ptg000001l	1776195	1780564	4369	g_14088	g_35167
ptg000001l	1791195	1834065	42870	g_35167	g_34534
ptg000001l	1835949	1838353	2404	g_34534	g_30761
ptg000001l	1840241	1844272	4031	g_30761	g_2742
ptg000001l	1845432	1854676	9244	g_2742	g_3855
ptg000001l	1855932	1890817	34885	g_3855	g_34994
ptg000001l	1895749	1897695	1946	g_34994	g_31448
ptg000001l	1904733	1906949	2216	g_31448	g_21104
ptg000001l	1918258	1927533	9275	g_21104	g_6278
ptg000001l	1941535	1946189	4654	g_6278	g_25020
ptg000001l	1952847	1954104	1257	g_25020	g_38228
ptg000001l	1955211	1958140	2929	g_38228	g_32125
ptg000001l	1973792	1996558	22766	g_32125	g_30250
ptg000001l	2000591	2013252	12661	g_30250	g_792
ptg000001l	2016148	2017127	979	g_792	g_33818
ptg000001l	2019362	2020706	1344	g_33818	g_8549
ptg000001l	2022494	2026430	3936	g_8549	g_6242
ptg000001l	2038896	2067117	28221	g_6242	g_19304
ptg000001l	2088841	2092926	4085	g_19304	g_40197
ptg000001l	2093990	2159989	65999	g_40197	g_17979
ptg000001l	2161014	2206627	45613	g_17979	g_15289
ptg000001l	2229233	2236876	7643	g_15289	g_10463
ptg000001l	2237292	2245944	8652	g_10463	g_12264
ptg000001l	2257871	2265236	7365	g_12264	g_40109
ptg000001l	2282268	2323884	41616	g_40109	g_32848
ptg000001l	2329690	2341640	11950	g_32848	g_23219
ptg000001l	2358921	2361560	2639	g_23219	g_33842
ptg000001l	2365674	2367267	1593	g_33842	g_28171
ptg000001l	2368463	2413653	45190	g_28171	g_5256
ptg000001l	2417275	2424309	7034	g_5256	g_5640
ptg000001l	2425238	2446292	21054	g_5640	g_31728
ptg000001l	2447499	2454856	7357	g_31728	g_5111
ptg000001l	2469881	2745114	275233	g_5111	g_7659
ptg000001l	2757428	2774197	16769	g_7659	g_29409
ptg000001l	2776583	2779281	2698	g_29409	g_6546
ptg000001l	2793675	2824606	30931	g_6546	g_4617
ptg000001l	2825097	2828416	3319	g_4617	g_29861
ptg000001l	2829053	2833165	4112	g_38936	g_28843
ptg000001l	2845070	2847610	2540	g_28843	g_33805
ptg000001l	2866244	2951676	85432	g_33805	g_23060
ptg000001l	2957386	2961972	4586	g_23060	g_8012
ptg000001l	2982693	3037923	55230	g_8012	g_16766
ptg000001l	3046746	3054796	8050	g_16766	g_6567
ptg000001l	3055290	3066494	11204	g_6567	g_40257
ptg000001l	3074839	3078664	3825	g_40257	g_25704
ptg000001l	3084070	3086708	2638	g_25704	g_31551
ptg000001l	3088280	3091510	3230	g_31551	g_7726
ptg000001l	3093375	3109734	16359	g_7726	g_34776
ptg000001l	3119012	3190816	71804	g_34776	g_16923
ptg000001l	3193718	3198102	4384	g_16923	g_21762
ptg000001l	3201019	3201801	782	g_21762	g_4653
ptg000001l	3204053	3209329	5276	g_4653	g_3845
ptg000001l	3210198	3236758	26560	g_3845	g_1954
ptg000001l	3244512	3284340	39828	g_1954	g_18734
ptg000001l	3286676	3290877	4201	g_18734	g_23932
ptg000001l	3293700	3370180	76480	g_23932	g_28225
ptg000001l	3386965	3393705	6740	g_28225	g_31679
ptg000001l	3395339	3430443	35104	g_31679	g_5443
ptg000001l	3431060	3441723	10663	g_5443	g_31164
ptg000001l	3442022	3535502	93480	g_31164	g_20454
ptg000001l	3536515	3542569	6054	g_20454	g_22523
ptg000001l	3543705	3551732	8027	g_22523	g_16323
ptg000001l	3553377	3570682	17305	g_16323	g_1300
ptg000001l	3570891	3615787	44896	g_1300	g_5685
ptg000001l	3632009	3647361	15352	g_5685	g_19588
ptg000001l	3650168	3655412	5244	g_19588	g_7821
ptg000001l	3658060	3770723	112663	g_7821	g_23218
ptg000001l	3779920	3856558	76638	g_23218	g_20295
ptg000001l	3868412	4018327	149915	g_20295	g_34926
ptg000001l	4027030	4029506	2476	g_34926	g_18721
ptg000001l	4034802	4038605	3803	g_18721	g_20075
ptg000001l	4042459	4044139	1680	g_20075	g_35405
ptg000001l	4049601	4149060	99459	g_35405	g_26859
ptg000001l	4149272	4149572	300	g_26859	g_28580
ptg000001l	4157351	4171970	14619	g_28580	g_17835
ptg000001l	4172464	4231667	59203	g_17835	g_12908
ptg000001l	4232059	4238824	6765	g_12908	g_28260
ptg000001l	4252004	4254099	2095	g_28260	g_18563
ptg000001l	4263619	4271560	7941	g_18563	g_39922
ptg000001l	4274353	4276781	2428	g_39922	g_1281
ptg000001l	4288278	4295364	7086	g_1281	g_31699
ptg000001l	4325196	4332077	6881	g_31699	g_528
ptg000001l	4334343	4368076	33733	g_528	g_3966
ptg000001l	4383831	4407161	23330	g_3966	g_33307
ptg000001l	4408994	4451383	42389	g_33307	g_23462
ptg000001l	4462737	4529461	66724	g_23462	g_12081
ptg000001l	4535779	4536536	757	g_12081	g_38643
ptg000001l	4536784	4547204	10420	g_38643	g_13083
ptg000001l	4549297	4596084	46787	g_13083	g_28408
ptg000001l	4597814	4609332	11518	g_28408	g_2000
ptg000001l	4613699	4621367	7668	g_2000	g_27239
ptg000001l	4624567	4660336	35769	g_27239	g_20794
ptg000001l	4675432	4798301	122869	g_20794	g_4543
ptg000001l	4800128	4819724	19596	g_4543	g_30851
ptg000001l	4833676	4844783	11107	g_30851	g_26378
ptg000001l	4858393	4877497	19104	g_26378	g_38470
ptg000001l	4888230	4927451	39221	g_9377	g_624
ptg000001l	4928215	4942544	14329	g_624	g_25471
ptg000001l	4943341	4943867	526	g_25471	g_9255
ptg000001l	4944115	4971837	27722	g_9255	g_5205
ptg000001l	4975185	4976395	1210	g_5205	g_4590
ptg000001l	4979104	4979801	697	g_4590	g_3660
ptg000001l	4984228	4986857	2629	g_3660	g_9596
ptg000001l	4991466	4994648	3182	g_9596	g_14614
ptg000001l	4996986	4999654	2668	g_14614	g_12964
ptg000001l	5005568	5007167	1599	g_12964	g_17313
ptg000001l	5009909	5014993	5084	g_17313	g_33698
ptg000001l	5018203	5018298	95	g_33698	g_9143
ptg000001l	5020689	5022003	1314	g_9143	g_16151
ptg000001l	5058100	5066370	8270	g_16151	g_39943
ptg000001l	5088196	5093837	5641	g_39943	g_2446
ptg000001l	5101376	5105521	4145	g_2446	g_1051
ptg000001l	5105754	5112118	6364	g_1051	g_37979
ptg000001l	5113113	5123000	9887	g_37979	g_13179
ptg000001l	5124497	5135593	11096	g_13179	g_10591
ptg000001l	5146086	5153720	7634	g_10591	g_10552
ptg000001l	5158319	5160549	2230	g_10552	g_18583
ptg000001l	5167944	5172649	4705	g_18583	g_34481
ptg000001l	5175473	5176599	1126	g_34481	g_2488
ptg000001l	5184429	5185545	1116	g_2488	g_39945
ptg000001l	5187722	5198743	11021	g_39945	g_39946
ptg000001l	5208017	5209139	1122	g_39946	g_35595
ptg000001l	5229418	5233126	3708	g_35595	g_6320
ptg000001l	5243408	5247884	4476	g_6320	g_3871
ptg000001l	5248138	5268460	20322	g_3871	g_30972
ptg000001l	5269912	5276096	6184	g_30972	g_9215
ptg000001l	5277463	5285626	8163	g_9215	g_20387
ptg000001l	5307125	5308492	1367	g_20387	g_19865
ptg000001l	5310524	5311924	1400	g_19865	g_9885
ptg000001l	5315534	5317927	2393	g_9885	g_9571
ptg000001l	5340912	5368781	27869	g_9571	g_21557
ptg000001l	5381489	5385493	4004	g_21557	g_14990
ptg000001l	5398359	5398838	479	g_14990	g_19154
ptg000001l	5404783	5406279	1496	g_19154	g_6275
ptg000001l	5409158	5496620	87462	g_6275	g_26037
ptg000001l	5498477	5506833	8356	g_26037	g_14798
ptg000001l	5509390	5513089	3699	g_14798	g_3262
ptg000001l	5520256	5522011	1755	g_3262	g_309
ptg000001l	5529667	5534113	4446	g_309	g_14969
ptg000001l	5543009	5566265	23256	g_14969	g_19332
ptg000001l	5574002	5583494	9492	g_39612	g_24082
ptg000001l	5585206	5586800	1594	g_24082	g_20606
ptg000001l	5587051	5627309	40258	g_20606	g_28822
ptg000001l	5627512	5672275	44763	g_28822	g_12671
ptg000001l	5679894	5696975	17081	g_12671	g_29590
ptg000001l	5699118	5709652	10534	g_29590	g_4839
ptg000001l	5710918	5716506	5588	g_4839	g_25976
ptg000001l	5717901	5721899	3998	g_25976	g_8205
ptg000001l	5723638	5725822	2184	g_8205	g_10455
ptg000001l	5727129	5739785	12656	g_10455	g_4176
ptg000001l	5741113	5750055	8942	g_4176	g_7727
ptg000001l	5751674	5795399	43725	g_7727	g_24477
ptg000001l	5795881	5847258	51377	g_24477	g_17080
ptg000001l	5850457	5854433	3976	g_17080	g_24972
ptg000001l	5860704	5932643	71939	g_24972	g_19040
ptg000001l	5933049	5943371	10322	g_19040	g_6577
ptg000001l	5969046	5992609	23563	g_6577	g_1015
ptg000001l	5992995	5997785	4790	g_1015	g_1887
ptg000001l	6020402	6021650	1248	g_1887	g_37103
ptg000001l	6022729	6026109	3380	g_37103	g_15967
ptg000001l	6032849	6035630	2781	g_15967	g_31412
ptg000001l	6036797	6046268	9471	g_38523	g_9925
ptg000001l	6055636	6057960	2324	g_9925	g_18007
ptg000001l	6110100	6141168	31068	g_18007	g_40140
ptg000001l	6152871	6154262	1391	g_40140	g_15142
ptg000001l	6160984	6171211	10227	g_15142	g_31889
ptg000001l	6171471	6199583	28112	g_31889	g_8603
ptg000001l	6207418	6207565	147	g_8603	g_28411
ptg000001l	6207792	6212641	4849	g_28411	g_3343
ptg000001l	6220512	6231448	10936	g_3343	g_38451
ptg000001l	6232197	6287277	55080	g_38451	g_26604
ptg000001l	6287828	6318688	30860	g_26604	g_7947
ptg000001l	6324869	6327175	2306	g_7947	g_39953
ptg000001l	6338249	6341022	2773	g_39953	g_2875
ptg000001l	6341896	6347251	5355	g_2875	g_40162
ptg000001l	6348799	6351193	2394	g_40162	g_16733
ptg000001l	6351489	6415085	63596	g_16733	g_11616
ptg000001l	6415810	6433786	17976	g_11616	g_28928
ptg000001l	6437418	6440060	2642	g_28928	g_19966
ptg000001l	6443735	6464284	20549	g_19966	g_37057
ptg000001l	6484647	6551057	66410	g_37057	g_24870
ptg000001l	6553492	6595332	41840	g_24870	g_38774
ptg000001l	6607258	6663288	56030	g_12323	g_17437
ptg000001l	6666190	6680445	14255	g_17437	g_2447
ptg000001l	6692453	6695484	3031	g_2447	g_24809
ptg000001l	6705451	6792176	86725	g_24809	g_13732
ptg000001l	6792715	6816549	23834	g_13732	g_35536
ptg000001l	6823554	6826084	2530	g_35536	g_21758
ptg000001l	6826692	6840688	13996	g_21758	g_7422
ptg000001l	6851511	6886411	34900	g_7422	g_20978
ptg000001l	6891299	6905429	14130	g_20978	g_2506
ptg000001l	6921048	6931704	10656	g_2506	g_29748
ptg000001l	6938752	6941334	2582	g_29748	g_34571
ptg000001l	6947211	7059381	112170	g_34571	g_28729
ptg000001l	7064328	7127124	62796	g_28729	g_19684
ptg000001l	7141932	7168628	26696	g_19684	g_19985
ptg000001l	7170882	7195056	24174	g_19985	g_24471
ptg000001l	7196192	7210014	13822	g_24471	g_29851
ptg000001l	7211284	7212361	1077	g_29851	g_26824
ptg000001l	7213635	7214699	1064	g_26824	g_11356
ptg000001l	7215867	7217060	1193	g_11356	g_31132
ptg000001l	7218333	7219412	1079	g_31132	g_8921
ptg000001l	7220700	7221781	1081	g_8921	g_21306
ptg000001l	7223054	7224157	1103	g_21306	g_29678
ptg000001l	7225958	7227027	1069	g_29678	g_19584
ptg000001l	7228291	7235549	7258	g_19584	g_8183
ptg000001l	7236813	7250196	13383	g_8183	g_30056
ptg000001l	7250570	7258487	7917	g_30056	g_36624
ptg000001l	7271586	7273793	2207	g_36624	g_6501
ptg000001l	7278583	7280495	1912	g_6501	g_31150
ptg000001l	7280827	7299929	19102	g_31150	g_14158
ptg000001l	7302055	7315893	13838	g_14158	g_25243
ptg000001l	7340418	7349147	8729	g_25243	g_40191
ptg000001l	7350580	7377229	26649	g_40191	g_18731
ptg000001l	7383257	7385257	2000	g_18731	g_270
ptg000001l	7391863	7393729	1866	g_270	g_16694
ptg000001l	7394004	7442616	48612	g_16694	g_22350
ptg000001l	7446373	7450553	4180	g_22350	g_33435
ptg000001l	7451686	7476017	24331	g_33435	g_22231
ptg000001l	7477264	7535259	57995	g_22231	g_5096
ptg000001l	7553727	7556337	2610	g_5096	g_690
ptg000001l	7560808	7569794	8986	g_690	g_8174
ptg000001l	7577580	7608024	30444	g_8174	g_29624
ptg000001l	7615979	7628994	13015	g_29624	g_21823
ptg000001l	7634841	7659418	24577	g_21823	g_25912
ptg000001l	7665637	7667681	2044	g_25912	g_331
ptg000001l	7672733	7673633	900	g_331	g_12387
ptg000001l	7678547	7758353	79806	g_12387	g_17365
ptg000001l	7758658	7888021	129363	g_17365	g_16113
ptg000001l	7889076	7892332	3256	g_16113	g_27453
ptg000001l	7894551	7923526	28975	g_27453	g_34919
ptg000001l	8006879	8077379	70500	g_34919	g_2512
ptg000001l	8112722	8147716	34994	g_2512	g_4746
ptg000001l	8164435	8166245	1810	g_4746	g_2280
ptg000001l	8169616	8174106	4490	g_2280	g_25186
ptg000001l	8179879	8182117	2238	g_25186	g_23722
ptg000001l	8184302	8186319	2017	g_23722	g_22305
ptg000001l	8189829	8193205	3376	g_22305	g_3448
ptg000001l	8194556	8203389	8833	g_3448	g_5964
ptg000001l	8205651	8236620	30969	g_5964	g_21132
ptg000001l	8242987	8295262	52275	g_21132	g_26226
ptg000001l	8299324	8320062	20738	g_26226	g_9536
ptg000001l	8327475	8329911	2436	g_9536	g_24994
ptg000001l	8333637	8338915	5278	g_24994	g_29027
ptg000001l	8342084	8344608	2524	g_29027	g_3541
ptg000001l	8355021	8388131	33110	g_3541	g_23994
ptg000001l	8394260	8395619	1359	g_23994	g_29886
ptg000001l	8398454	8402656	4202	g_29886	g_36574
ptg000001l	8405451	8409383	3932	g_36574	g_39018
ptg000001l	8409826	8416402	6576	g_39018	g_5587
ptg000001l	8417613	8417702	89	g_5587	g_4631
ptg000001l	8418328	8424863	6535	g_4631	g_31707
ptg000001l	8433446	8455076	21630	g_31707	g_20048
ptg000001l	8468472	8471620	3148	g_20048	g_34587
ptg000001l	8483480	8488017	4537	g_34587	g_22379
ptg000001l	8491487	8494818	3331	g_22379	g_18146
ptg000001l	8499444	8500626	1182	g_18146	g_1767
ptg000001l	8509871	8520546	10675	g_1767	g_34416
ptg000001l	8526425	8527357	932	g_34416	g_12108
ptg000001l	8533541	8533918	377	g_12108	g_8990
ptg000001l	8535719	8545118	9399	g_39079	g_27599
ptg000001l	8554316	8566571	12255	g_27599	g_9801
ptg000001l	8566997	8567535	538	g_9801	g_31392
ptg000001l	8576024	8616196	40172	g_31392	g_18797
ptg000001l	8625914	8627490	1576	g_18797	g_36037
ptg000001l	8635547	8636247	700	g_36037	g_35389
ptg000001l	8639431	8645079	5648	g_35389	g_4467
ptg000001l	8658561	8686067	27506	g_4467	g_34981
ptg000001l	8687440	8693311	5871	g_34981	g_28128
ptg000001l	8696299	8697291	992	g_28128	g_22348
ptg000001l	8698320	8706387	8067	g_22348	g_14544
ptg000001l	8711673	8712359	686	g_14544	g_26676
ptg000001l	8717200	8749774	32574	g_26676	g_19123
ptg000001l	8778380	8780968	2588	g_19123	g_8428
ptg000001l	8783860	8785114	1254	g_8428	g_40044
ptg000001l	8787408	8806301	18893	g_40044	g_40137
ptg000001l	8810483	8812470	1987	g_40137	g_14812
ptg000001l	8833729	8839411	5682	g_14812	g_2769
ptg000001l	8853827	8888714	34887	g_2769	g_35823
ptg000001l	8889022	8897567	8545	g_35823	g_18149
ptg000001l	8918070	8939299	21229	g_18149	g_12189
ptg000001l	8941232	8956938	15706	g_12189	g_30758
ptg000001l	8957528	8982927	25399	g_30758	g_33533
ptg000001l	8983634	9050229	66595	g_33533	g_18737
ptg000001l	9050522	9067156	16634	g_18737	g_30656
ptg000001l	9070277	9088736	18459	g_30656	g_22040
ptg000001l	9089074	9122066	32992	g_22040	g_35959
ptg000001l	9122404	9147677	25273	g_35959	g_1667
ptg000001l	9153567	9157897	4330	g_1667	g_1517
ptg000001l	9160242	9165779	5537	g_1517	g_23620
ptg000001l	9181444	9200220	18776	g_23620	g_26652
ptg000001l	9200498	9216167	15669	g_26652	g_12244
ptg000001l	9217781	9321386	103605	g_12244	g_21316
ptg000001l	9323082	9364049	40967	g_21316	g_12821
ptg000001l	9364267	9389498	25231	g_12821	g_3072
ptg000001l	9432423	9448391	15968	g_3072	g_17056
ptg000001l	9465503	9498380	32877	g_17056	g_14026
ptg000001l	9515113	9532941	17828	g_14026	g_2039
ptg000001l	9534133	9548554	14421	g_2039	g_36368
ptg000001l	9552182	9555273	3091	g_36368	g_19138
ptg000001l	9576059	9579666	3607	g_19138	g_13606
ptg000001l	9581113	9582429	1316	g_13606	g_25169
ptg000001l	9602433	9645891	43458	g_25169	g_31368
ptg000001l	9646598	9660134	13536	g_31368	g_24675
ptg000001l	9660352	9673068	12716	g_24675	g_6078
ptg000001l	9673289	9686138	12849	g_6078	g_210
ptg000001l	9688348	9760796	72448	g_210	g_31409
ptg000001l	9769706	9790973	21267	g_31409	g_25646
ptg000001l	9791185	9803887	12702	g_25646	g_32656
ptg000001l	9808677	9821839	13162	g_32656	g_22891
ptg000001l	9825427	9846933	21506	g_22891	g_5450
ptg000001l	9848312	9854204	5892	g_5450	g_9880
ptg000001l	9867466	9870018	2552	g_9880	g_25617
ptg000001l	9875514	9878947	3433	g_25617	g_24523
ptg000001l	9885814	9931101	45287	g_24523	g_31931
ptg000001l	9933128	9991825	58697	g_31931	g_23832
ptg000001l	9992811	9995754	2943	g_23832	g_32477
ptg000001l	10015260	10017205	1945	g_32477	g_1020
ptg000001l	10032062	10033854	1792	g_1020	g_21656
ptg000001l	10044707	10045452	745	g_21656	g_16689
ptg000001l	10047581	10050688	3107	g_16689	g_28232
ptg000001l	10059202	10071742	12540	g_28232	g_21319
ptg000001l	10074254	10124273	50019	g_21319	g_36750
ptg000001l	10125688	10130100	4412	g_36750	g_35739
ptg000001l	10130390	10141329	10939	g_35739	g_19636
ptg000001l	10157791	10162704	4913	g_19636	g_7766
ptg000001l	10172881	10192715	19834	g_7766	g_6142
ptg000001l	10209185	10263458	54273	g_6142	g_10439
ptg000001l	10267148	10355901	88753	g_10439	g_9219
ptg000001l	10356653	10377238	20585	g_9219	g_9807
ptg000001l	10378224	10384748	6524	g_9807	g_22283
ptg000001l	10388125	10422677	34552	g_22283	g_4293
ptg000001l	10435633	10542951	107318	g_4293	g_21029
ptg000001l	10553505	10582814	29309	g_21029	g_17802
ptg000001l	10587581	10592332	4751	g_17802	g_4876
ptg000001l	10605003	10631955	26952	g_4876	g_13221
ptg000001l	10643296	10648165	4869	g_13221	g_4107
ptg000001l	10655247	10663483	8236	g_4107	g_12867
ptg000001l	10682713	10687266	4553	g_12867	g_25245
ptg000001l	10693332	10697066	3734	g_25245	g_18014
ptg000001l	10698638	10711386	12748	g_18014	g_12446
ptg000001l	10717493	10719046	1553	g_12446	g_40113
ptg000001l	10722481	10723001	520	g_40113	g_23157
ptg000001l	10730853	10836984	106131	g_23157	g_8002
ptg000001l	10855869	10899536	43667	g_8002	g_7994
ptg000001l	10899982	11033649	133667	g_7994	g_6118
ptg000001l	11034074	11106135	72061	g_6118	g_25922
ptg000001l	11120442	11369318	248876	g_25922	g_38138
ptg000001l	11393978	11411253	17275	g_38138	g_35641
ptg000001l	11411510	11469212	57702	g_35641	g_1372
ptg000001l	11473544	11623725	150181	g_1372	g_20242
ptg000001l	11629000	11732445	103445	g_20242	g_17972
ptg000001l	11732663	11736212	3549	g_17972	g_23911
ptg000001l	11737129	11739579	2450	g_23911	g_21697
ptg000001l	11739959	11746891	6932	g_21697	g_34569
ptg000001l	11756468	11793554	37086	g_34569	g_8028
ptg000001l	11797712	11893461	95749	g_8028	g_31231
ptg000001l	11906166	11908120	1954	g_31231	g_8441
ptg000001l	11918665	11923437	4772	g_8441	g_694
ptg000001l	11927587	11928811	1224	g_694	g_18750
ptg000001l	11940350	12020318	79968	g_18750	g_154
ptg000001l	12020755	12135869	115114	g_154	g_34484
ptg000001l	12137897	12158134	20237	g_34484	g_3289
ptg000001l	12168236	12172587	4351	g_3289	g_27501
ptg000001l	12182024	12205902	23878	g_27501	g_5481
ptg000001l	12207677	12262292	54615	g_5481	g_18874
ptg000001l	12263500	12266434	2934	g_18874	g_30275
ptg000001l	12274823	12279938	5115	g_30275	g_6690
ptg000001l	12286060	12295758	9698	g_6690	g_16614
ptg000001l	12296000	12571574	275574	g_16614	g_8657
ptg000001l	12574832	12809531	234699	g_8657	g_21659
ptg000001l	12810199	12937409	127210	g_21659	g_37170
ptg000001l	12939326	12951375	12049	g_37170	g_15773
ptg000001l	12953029	12957871	4842	g_15773	g_14003
ptg000001l	12965469	13017146	51677	g_14003	g_2035
ptg000001l	13017934	13037608	19674	g_2035	g_39997
ptg000001l	13037817	13042954	5137	g_39997	g_5321
ptg000001l	13050219	13086365	36146	g_5321	g_10916
ptg000001l	13088915	13090572	1657	g_10916	g_6674
ptg000001l	13095165	13112588	17423	g_6674	g_15021
ptg000001l	13113364	13146450	33086	g_15021	g_14033
ptg000001l	13149056	13165938	16882	g_14033	g_37634
ptg000001l	13166174	13173479	7305	g_37634	g_12579
ptg000001l	13175444	13220420	44976	g_12579	g_3644
ptg000001l	13242376	13258631	16255	g_3644	g_9633
ptg000001l	13260331	13294349	34018	g_9633	g_6614
ptg000001l	13294939	13295084	145	g_6614	g_28217
ptg000001l	13295809	13343268	47459	g_28217	g_12094
ptg000001l	13350873	13365411	14538	g_12094	g_16573
ptg000001l	13370782	13373886	3104	g_16573	g_11212
ptg000001l	13380962	13389066	8104	g_11212	g_9727
ptg000001l	13400192	13450097	49905	g_9727	g_33418
ptg000001l	13450792	13475789	24997	g_33418	g_13096
ptg000001l	13476391	13583933	107542	g_13096	g_1563
ptg000001l	13592283	13596516	4233	g_1563	g_38045
ptg000001l	13605837	13607705	1868	g_38045	g_15663
ptg000001l	13610814	13611614	800	g_15663	g_23702
ptg000001l	13645691	13650086	4395	g_23702	g_37478
ptg000001l	13651779	13728565	76786	g_37478	g_17499
ptg000001l	13729353	13859675	130322	g_17499	g_30651
ptg000001l	13907885	13928119	20234	g_30651	g_6461
ptg000001l	13933247	13977659	44412	g_6461	g_27386
ptg000001l	13977913	14009312	31399	g_27386	g_319
ptg000001l	14016135	14046863	30728	g_319	g_1476
ptg000001l	14050754	14053584	2830	g_1476	g_26245
ptg000001l	14054246	14054989	743	g_26245	g_1858
ptg000001l	14055669	14069129	13460	g_1858	g_2906
ptg000001l	14069638	14070771	1133	g_2906	g_21518
ptg000001l	14073107	14074078	971	g_21518	g_11984
ptg000001l	14075091	14086042	10951	g_11984	g_19086
ptg000001l	14088897	14089989	1092	g_19086	g_21608
ptg000001l	14101676	14277604	175928	g_21608	g_23856
ptg000001l	14287202	14291355	4153	g_23856	g_20094
ptg000001l	14300677	14301668	991	g_20094	g_24939
ptg000001l	14305287	14319271	13984	g_24939	g_22371
ptg000001l	14324188	14338815	14627	g_22371	g_25070
ptg000001l	14339615	14454178	114563	g_25070	g_7151
ptg000001l	14454768	14620882	166114	g_7151	g_34441
ptg000001l	14736197	14746355	10158	g_34441	g_26529
ptg000001l	14751816	15089330	337514	g_26529	g_28277
ptg000001l	15089764	15104523	14759	g_28277	g_8506
ptg000001l	15111955	15124556	12601	g_8506	g_37632
ptg000001l	15127495	15205521	78026	g_37632	g_34144
ptg000001l	15208158	15312149	103991	g_34144	g_37663
ptg000001l	15312676	15362057	49381	g_37663	g_19564
ptg000001l	15385701	15424235	38534	g_19564	g_22673
ptg000001l	15425113	15439745	14632	g_22673	g_30238
ptg000001l	15442291	15453435	11144	g_30238	g_6199
ptg000001l	15455286	15467603	12317	g_6199	g_1839
ptg000001l	15474841	15562172	87331	g_1839	g_710
ptg000001l	15568600	16174240	605640	g_710	g_23139
ptg000001l	16218362	16264309	45947	g_23139	g_22823
ptg000001l	16266114	16293703	27589	g_22823	g_13237
ptg000001l	16301025	16386856	85831	g_13237	g_22094
ptg000001l	16393545	16408247	14702	g_22094	g_31563
ptg000001l	16416374	16520351	103977	g_31563	g_13985
ptg000001l	16548742	16609744	61002	g_13985	g_10157
ptg000001l	16631346	16725561	94215	g_10157	g_18435
ptg000001l	16730854	16733400	2546	g_18435	g_40187
ptg000001l	16741119	16865315	124196	g_40187	g_37141
ptg000001l	16866214	16899166	32952	g_37141	g_38399
ptg000001l	16899375	16925301	25926	g_38399	g_14506
ptg000001l	16966169	16978152	11983	g_14506	g_33509
ptg000001l	16986277	16988124	1847	g_33509	g_2869
ptg000001l	16990849	17288268	297419	g_2869	g_1068
ptg000001l	17293074	17308071	14997	g_1068	g_25990
ptg000001l	17312540	17333361	20821	g_25990	g_2185
ptg000001l	17339578	17381057	41479	g_2185	g_14890
ptg000001l	17382608	17400243	17635	g_14890	g_35642
ptg000001l	17400737	17597893	197156	g_35642	g_5104
ptg000001l	17598336	17622628	24292	g_5104	g_33458
ptg000001l	17623906	17664700	40794	g_33458	g_31054
ptg000001l	17665641	17669030	3389	g_31054	g_17998
ptg000001l	17670926	17674086	3160	g_17998	g_3135
ptg000001l	17676331	17681578	5247	g_3135	g_17701
ptg000001l	17695035	17697439	2404	g_17701	g_18551
ptg000001l	17711469	17930290	218821	g_18551	g_28426
ptg000001l	17930688	17981531	50843	g_28426	g_27955
ptg000001l	17982283	18068827	86544	g_27955	g_1843
ptg000001l	18069561	18634585	565024	g_1843	g_1545
ptg000001l	18635136	18877876	242740	g_1545	g_33977
ptg000001l	18878268	19019108	140840	g_33977	g_927
ptg000001l	19035831	19042140	6309	g_927	g_9210
ptg000001l	19045478	19084942	39464	g_9210	g_553
ptg000001l	19097157	19114597	17440	g_553	g_19599
ptg000001l	19130953	19145787	14834	g_19599	g_5507
ptg000001l	19160928	19163236	2308	g_5507	g_15307
ptg000001l	19177939	19233867	55928	g_15307	g_18769
ptg000001l	19234517	19244727	10210	g_18769	g_40193
ptg000001l	19278936	19374110	95174	g_40193	g_1566
ptg000001l	19375513	19378226	2713	g_1566	g_9187
ptg000001l	19396652	19420078	23426	g_9187	g_10942
ptg000001l	19420878	19487005	66127	g_10942	g_30664
ptg000001l	19500193	19591590	91397	g_30664	g_31658
ptg000001l	19613750	19647308	33558	g_31658	g_24473
ptg000001l	19674399	19781483	107084	g_24473	g_28259
ptg000001l	19781776	19970163	188387	g_28259	g_35853
ptg000001l	19992498	19999825	7327	g_35853	g_22120
ptg000001l	20025105	20314582	289477	g_22120	g_20795
ptg000001l	20317348	20365708	48360	g_20795	g_14064
ptg000001l	20366226	20462421	96195	g_14064	g_14077
ptg000001l	20463305	20658645	195340	g_14077	g_1789
ptg000001l	20658911	20903781	244870	g_1789	g_14447
ptg000001l	20905187	20971631	66444	g_14447	g_16326
ptg000001l	20979152	20980795	1643	g_16326	g_5086
ptg000001l	20986028	20988427	2399	g_5086	g_3853
ptg000001l	20995658	20997208	1550	g_3853	g_6526
ptg000001l	21008977	21015470	6493	g_6526	g_6344
ptg000001l	21025767	21027293	1526	g_6344	g_38132
ptg000001l	21037695	21039312	1617	g_38132	g_2218
ptg000001l	21042085	21042893	808	g_2218	g_6846
ptg000001l	21065375	21066059	684	g_6846	g_32226
ptg000001l	21074266	21076164	1898	g_32226	g_16890
ptg000001l	21077570	21079589	2019	g_16890	g_7509
ptg000001l	21092335	21170716	78381	g_7509	g_18265
ptg000001l	21170976	21185526	14550	g_18265	g_28199
ptg000001l	21187855	21207501	19646	g_28199	g_982
ptg000001l	21220604	21223516	2912	g_982	g_22390
ptg000001l	21227299	21228884	1585	g_22390	g_24483
ptg000001l	21229906	21231353	1447	g_24483	g_23867
ptg000001l	21232057	21233857	1800	g_23867	g_35858
ptg000001l	21238607	21313179	74572	g_35858	g_21505
ptg000001l	21316014	21376828	60814	g_21505	g_17820
ptg000001l	21377124	21389590	12466	g_17820	g_40177
ptg000001l	21409859	21419360	9501	g_40177	g_33065
ptg000001l	21420013	21543615	123602	g_33065	g_8858
ptg000001l	21545855	21568413	22558	g_8858	g_24903
ptg000001l	21569162	21592067	22905	g_24903	g_22637
ptg000001l	21595393	21606315	10922	g_22637	g_11811
ptg000001l	21607112	21608646	1534	g_11811	g_40099
ptg000001l	21609173	21617494	8321	g_40099	g_25809
ptg000001l	21618087	21632034	13947	g_25809	g_13711
ptg000001l	21632348	21779649	147301	g_13711	g_5794
ptg000001l	21786081	21791368	5287	g_5794	g_20091
ptg000001l	21801427	22272087	470660	g_20091	g_20381
ptg000001l	22272536	22513787	241251	g_20381	g_17933
ptg000001l	22514314	22521301	6987	g_17933	g_30065
ptg000001l	22521570	22641192	119622	g_30065	g_19840
ptg000001l	22641605	22863094	221489	g_19840	g_19155
ptg000001l	22863693	22935604	71911	g_19155	g_12040
ptg000001l	22935855	22957727	21872	g_12040	g_25644
ptg000001l	22958029	22958113	84	g_25644	g_14743
ptg000001l	22958511	22958540	29	g_14743	g_9179
ptg000001l	22958902	23019516	60614	g_9179	g_30084
ptg000001l	23020316	23171665	151349	g_30084	g_5238
ptg000001l	23171880	23184758	12878	g_5238	g_19519
ptg000001l	23185177	23186014	837	g_19519	g_34727
ptg000001l	23186250	23227913	41663	g_34727	g_36627
ptg000001l	23242895	23249946	7051	g_36627	g_34299
ptg000001l	23253462	23280655	27193	g_34299	g_37591
ptg000001l	23288059	23404472	116413	g_37591	g_19914
ptg000001l	23404732	23569988	165256	g_19914	g_18845
ptg000001l	23574088	23584000	9912	g_18845	g_17814
ptg000001l	23600569	23661499	60930	g_17814	g_27520
ptg000001l	23667861	23696466	28605	g_27520	g_7798
ptg000001l	23701489	23702501	1012	g_7798	g_33015
ptg000001l	23712990	23723209	10219	g_33015	g_1416
ptg000001l	23748960	23750906	1946	g_1416	g_31937
ptg000001l	23763394	23769257	5863	g_31937	g_1660
ptg000001l	23793648	23823109	29461	g_1660	g_32440
ptg000001l	23824413	23925779	101366	g_32440	g_21545
ptg000001l	23927590	23979192	51602	g_21545	g_37753
ptg000001l	23983915	23995936	12021	g_37753	g_35839
ptg000001l	23996184	24037413	41229	g_35839	g_3851
ptg000001l	24037727	24356027	318300	g_3851	g_6896
ptg000001l	24356932	24387983	31051	g_6896	g_2578
ptg000001l	24388216	24406100	17884	g_2578	g_14375
ptg000001l	24406873	24511604	104731	g_14375	g_25567
ptg000001l	24512092	24579211	67119	g_25567	g_13406
ptg000001l	24579621	24629714	50093	g_13406	g_24235
ptg000001l	24630151	24677422	47271	g_24235	g_21609
ptg000001l	24687331	24811976	124645	g_21609	g_22211
ptg000001l	24812515	24913274	100759	g_22211	g_29232
ptg000001l	24913843	24914417	574	g_29232	g_18439
ptg000001l	24914692	24999730	85038	g_18439	g_35456
ptg000001l	25000737	25015903	15166	g_35456	g_2374
ptg000001l	25016406	25031474	15068	g_2374	g_1129
ptg000001l	25033294	25143811	110517	g_1129	g_17493
ptg000001l	25147558	25147872	314	g_17493	g_12285
ptg000001l	25148936	25151999	3063	g_12285	g_37947
ptg000001l	25153458	25308081	154623	g_37947	g_21503
ptg000001l	25308833	25322348	13515	g_21503	g_8771
ptg000001l	25322578	25342656	20078	g_8771	g_29682
ptg000001l	25342868	25359592	16724	g_29682	g_30790
ptg000001l	25359873	25360602	729	g_30790	g_22376
ptg000001l	25362158	25362199	41	g_22376	g_364
ptg000001l	25362483	25414729	52246	g_364	g_17650
ptg000001l	25421271	25462218	40947	g_17650	g_38448
ptg000001l	25463231	25463306	75	g_38448	g_7488
ptg000001l	25471332	25472201	869	g_7488	g_25007
ptg000001l	25475054	25515489	40435	g_25007	g_16940
ptg000001l	25523321	25524671	1350	g_16940	g_3619
ptg000001l	25542155	25573563	31408	g_3619	g_17247
ptg000001l	25573964	25617717	43753	g_17247	g_25666
ptg000001l	25628001	25631669	3668	g_25666	g_30928
ptg000001l	25635499	25774809	139310	g_30928	g_28626
ptg000001l	25775192	25778775	3583	g_28626	g_34502
ptg000001l	25779098	25912061	132963	g_34502	g_9821
ptg000001l	25925632	25941043	15411	g_9821	g_17219
ptg000001l	25944468	25944679	211	g_17219	g_40181
ptg000001l	25948732	25948887	155	g_40181	g_18112
ptg000001l	25949436	25954100	4664	g_18112	g_31686
ptg000001l	25954486	25968814	14328	g_31686	g_6509
ptg000001l	25970905	25985243	14338	g_6509	g_60
ptg000001l	25991613	25997463	5850	g_60	g_9355
ptg000001l	26008281	26008689	408	g_9355	g_8177
ptg000001l	26009441	26015828	6387	g_8177	g_4349
ptg000001l	26023050	26036086	13036	g_4349	g_25403
ptg000001l	26057619	26082244	24625	g_25403	g_8839
ptg000001l	26097536	26134113	36577	g_8839	g_9783
ptg000001l	26134772	26151773	17001	g_9783	g_33405
ptg000001l	26188171	26191376	3205	g_33405	g_22222
ptg000001l	26191648	26217360	25712	g_22222	g_14211
ptg000001l	26247007	26344318	97311	g_14211	g_440
ptg000001l	26355194	26388005	32811	g_440	g_20077
ptg000001l	26389171	26398225	9054	g_20077	g_6660
ptg000001l	26404994	26439122	34128	g_6660	g_3374
ptg000001l	26460394	26461780	1386	g_3374	g_25521
ptg000001l	26464365	26473258	8893	g_25521	g_9403
ptg000001l	26477366	26547676	70310	g_9403	g_24399
ptg000001l	26548074	26559213	11139	g_24399	g_3531
ptg000001l	26559929	26571648	11719	g_3531	g_20425
ptg000001l	26572109	26603775	31666	g_20425	g_23460
ptg000001l	26604368	26688643	84275	g_23460	g_23691
ptg000001l	26691720	26724774	33054	g_23691	g_5906
ptg000001l	26743145	26756701	13556	g_5906	g_31178
ptg000001l	26757698	26790026	32328	g_31178	g_7292
ptg000001l	26797230	26802466	5236	g_7292	g_37174
ptg000001l	26802909	26820381	17472	g_37174	g_2473
ptg000001l	26828196	26836282	8086	g_2473	g_11781
ptg000001l	26837256	26878665	41409	g_11781	g_6659
ptg000001l	26879108	26881269	2161	g_6659	g_16501
ptg000001l	26882402	26898867	16465	g_16501	g_36795
ptg000001l	26904550	26924675	20125	g_36795	g_38248
ptg000001l	26925451	26929071	3620	g_38248	g_32184
ptg000001l	26931473	26960207	28734	g_32184	g_32522
ptg000002l	33794	98595	64801	g_39742	g_17509
ptg000002l	107022	110184	3162	g_17509	g_3630
ptg000002l	118434	126134	7700	g_3630	g_3197
ptg000002l	126442	137030	10588	g_3197	g_25172
ptg000002l	137737	196185	58448	g_25172	g_27373
ptg000002l	197210	197603	393	g_27373	g_35374
ptg000002l	198331	198755	424	g_35374	g_32139
ptg000002l	199285	200035	750	g_32139	g_30072
ptg000002l	200490	221726	21236	g_30072	g_29197
ptg000002l	222340	290412	68072	g_29197	g_12591
ptg000002l	300617	316289	15672	g_12591	g_34757
ptg000002l	337351	343377	6026	g_34757	g_13069
ptg000002l	354431	415185	60754	g_13069	g_3180
ptg000002l	415961	445791	29830	g_3180	g_7614
ptg000002l	446874	449615	2741	g_7614	g_6469
ptg000002l	450686	469270	18584	g_3270	g_2094
ptg000002l	469935	489734	19799	g_2094	g_37660
ptg000002l	490519	508625	18106	g_37660	g_29771
ptg000002l	509221	617576	108355	g_29771	g_23545
ptg000002l	618640	618722	82	g_23545	g_9410
ptg000002l	619546	671129	51583	g_9410	g_6918
ptg000002l	672697	711314	38617	g_6918	g_27215
ptg000002l	711922	832058	120136	g_27215	g_26067
ptg000002l	833179	834210	1031	g_26067	g_30795
ptg000002l	834464	888488	54024	g_30795	g_14237
ptg000002l	889717	903018	13301	g_14237	g_18125
ptg000002l	904895	935514	30619	g_18125	g_14388
ptg000002l	935720	963829	28109	g_14388	g_2944
ptg000002l	964692	1200268	235576	g_2944	g_27759
ptg000002l	1200945	1252592	51647	g_27759	g_26983
ptg000002l	1253179	1265266	12087	g_26983	g_19903
ptg000002l	1275944	1289914	13970	g_19903	g_22657
ptg000002l	1290138	1383686	93548	g_22657	g_18943
ptg000002l	1390944	1391084	140	g_18943	g_2106
ptg000002l	1394625	1397675	3050	g_2106	g_8271
ptg000002l	1402848	1418843	15995	g_39880	g_6138
ptg000002l	1419310	1442770	23460	g_6138	g_3982
ptg000002l	1443051	1446247	3196	g_3982	g_15105
ptg000002l	1453907	1463999	10092	g_15105	g_33816
ptg000002l	1469861	1472198	2337	g_33816	g_35238
ptg000002l	1482134	1582924	100790	g_35238	g_29626
ptg000002l	1583496	1748521	165025	g_29626	g_9494
ptg000002l	1749684	1754932	5248	g_9494	g_25016
ptg000002l	1769162	1792366	23204	g_25016	g_37959
ptg000002l	1793454	1794135	681	g_37959	g_34515
ptg000002l	1795124	1795393	269	g_34515	g_24031
ptg000002l	1796739	1798153	1414	g_24031	g_10572
ptg000002l	1800169	1876283	76114	g_10572	g_4204
ptg000002l	1877041	1891851	14810	g_4204	g_7693
ptg000002l	1892195	1923847	31652	g_7693	g_25942
ptg000002l	1924532	1929038	4506	g_25942	g_23487
ptg000002l	1937050	1951107	14057	g_23487	g_12304
ptg000002l	1955231	1998899	43668	g_12304	g_2167
ptg000002l	2008812	2027892	19080	g_2167	g_2098
ptg000002l	2028302	2046059	17757	g_2098	g_33689
ptg000003l	411722	516242	104520	g_12463	g_1468
ptg000003l	516586	693156	176570	g_1468	g_35356
ptg000003l	693737	975376	281639	g_35356	g_22336
ptg000003l	975603	1026029	50426	g_22336	g_39474
ptg000003l	1026343	1151514	125171	g_39474	g_15224
ptg000003l	1151789	1333422	181633	g_15224	g_9456
ptg000003l	1338774	1355314	16540	g_9456	g_27939
ptg000003l	1363976	1369538	5562	g_27939	g_18499
ptg000003l	1376610	1400839	24229	g_18499	g_11121
ptg000003l	1415013	1707524	292511	g_11121	g_11675
ptg000003l	1714860	1802026	87166	g_11675	g_37452
ptg000003l	1818022	2084627	266605	g_37452	g_9166
ptg000003l	2085019	2168131	83112	g_9166	g_10643
ptg000003l	2169534	2272801	103267	g_10643	g_14219
ptg000003l	2273100	2277690	4590	g_14219	g_6343
ptg000003l	2287536	2311471	23935	g_6343	g_13488
ptg000003l	2312892	2323937	11045	g_13488	g_33392
ptg000003l	2325136	2355625	30489	g_33392	g_2250
ptg000003l	2368805	2524119	155314	g_2250	g_29370
ptg000003l	2524526	2565887	41361	g_29370	g_10836
ptg000003l	2575339	2590521	15182	g_10836	g_34622
ptg000003l	2591498	2670506	79008	g_34622	g_32475
ptg000003l	2676172	2750397	74225	g_32475	g_14793
ptg000003l	2750839	2750891	52	g_14793	g_12951
ptg000003l	2751775	2768619	16844	g_12951	g_3903
ptg000003l	2770871	3133267	362396	g_3903	g_31528
ptg000003l	3147499	3281063	133564	g_31528	g_15488
ptg000003l	3281518	3327599	46081	g_15488	g_12432
ptg000003l	3327811	3524968	197157	g_12432	g_12700
ptg000003l	3538661	3566238	27577	g_12700	g_10427
ptg000003l	3579003	3647504	68501	g_10427	g_31958
ptg000003l	3648732	3686279	37547	g_31958	g_32861
ptg000003l	3686662	3723212	36550	g_32861	g_19020
ptg000003l	3724757	3862945	138188	g_19020	g_38014
ptg000003l	3863412	3870938	7526	g_38014	g_33793
ptg000003l	3871342	3871383	41	g_33793	g_4807
ptg000003l	3871814	3883999	12185	g_4807	g_10979
ptg000003l	3884397	3901211	16814	g_10979	g_33133
ptg000003l	3902756	4086434	183678	g_33133	g_39607
ptg000003l	4087315	4105630	18315	g_39607	g_4374
ptg000003l	4106028	4113620	7592	g_4374	g_1509
ptg000003l	4114060	4121805	7745	g_1509	g_21170
ptg000003l	4138449	4150187	11738	g_21170	g_35473
ptg000003l	4150714	4213799	63085	g_35473	g_5919
ptg000003l	4215136	4338028	122892	g_5919	g_21442
ptg000003l	4338762	4372365	33603	g_21442	g_18015
ptg000003l	4380541	4408021	27480	g_18015	g_9542
ptg000003l	4408890	4411790	2900	g_9542	g_39569
ptg000003l	4412092	4419212	7120	g_39569	g_11996
ptg000003l	4442940	4636102	193162	g_11996	g_27972
ptg000003l	4636374	4693796	57422	g_27972	g_16058
ptg000003l	4695517	4784654	89137	g_16058	g_27841
ptg000003l	4786459	4786520	61	g_27841	g_21696
ptg000003l	4786888	4787301	413	g_21696	g_520
ptg000003l	4787579	4787622	43	g_520	g_5538
ptg000003l	4787879	4787897	18	g_5538	g_19514
ptg000003l	4790191	4876314	86123	g_19514	g_5055
ptg000003l	4876661	4892191	15530	g_5055	g_1909
ptg000003l	4892937	4917070	24133	g_1909	g_15729
ptg000003l	4917327	4942594	25267	g_15729	g_26446
ptg000003l	4945938	5016886	70948	g_26446	g_33434
ptg000003l	5021298	5021383	85	g_33434	g_15159
ptg000003l	5023806	5023858	52	g_15159	g_31416
ptg000003l	5025446	5047704	22258	g_31416	g_18344
ptg000003l	5048270	5128448	80178	g_18344	g_21488
ptg000003l	5129752	5158686	28934	g_21488	g_25423
ptg000003l	5159540	5159587	47	g_25423	g_16725
ptg000003l	5160306	5160580	274	g_16725	g_36577
ptg000003l	5161029	5161076	47	g_36577	g_26500
ptg000003l	5161660	5249202	87542	g_26500	g_6508
ptg000003l	5260279	5260554	275	g_6508	g_38948
ptg000003l	5261003	5279831	18828	g_38948	g_40016
ptg000003l	5286803	5288295	1492	g_40016	g_21603
ptg000003l	5288498	5321433	32935	g_21603	g_17317
ptg000003l	5323955	5329218	5263	g_17317	g_31001
ptg000003l	5352151	5352475	324	g_31001	g_8381
ptg000003l	5352933	5353825	892	g_8381	g_8677
ptg000003l	5354193	5374088	19895	g_8677	g_31467
ptg000003l	5375179	5389190	14011	g_31467	g_30479
ptg000003l	5389861	5400815	10954	g_30479	g_34266
ptg000003l	5404139	5411347	7208	g_34266	g_23591
ptg000003l	5452171	5524500	72329	g_39003	g_30647
ptg000003l	5525189	5526045	856	g_30647	g_11989
ptg000003l	5546236	5658746	112510	g_11989	g_33335
ptg000003l	5660777	5744718	83941	g_33335	g_33059
ptg000003l	5745449	5745558	109	g_33059	g_14336
ptg000003l	5746127	5746445	318	g_14336	g_31492
ptg000003l	5748109	5774367	26258	g_31492	g_33003
ptg000003l	5774573	5778743	4170	g_33003	g_25199
ptg000003l	5796600	5811586	14986	g_25199	g_29351
ptg000003l	5812056	5814533	2477	g_29351	g_31027
ptg000003l	5814859	5824934	10075	g_31027	g_4516
ptg000003l	5825224	5832607	7383	g_4516	g_32673
ptg000003l	5840927	5846073	5146	g_32673	g_15708
ptg000003l	5846600	5846748	148	g_15708	g_20714
ptg000003l	5848043	5856418	8375	g_20714	g_40282
ptg000003l	5864531	5920386	55855	g_40282	g_36682
ptg000003l	5942101	5946480	4379	g_36682	g_25076
ptg000003l	5946743	5959872	13129	g_25076	g_35884
ptg000003l	5962067	5980172	18105	g_35884	g_22226
ptg000003l	5981080	6077742	96662	g_22226	g_21905
ptg000004l	95292	97644	2352	g_30588	g_12311
ptg000004l	108486	116071	7585	g_12311	g_21668
ptg000004l	121668	165373	43705	g_21668	g_6403
ptg000004l	174034	225439	51405	g_6403	g_6798
ptg000004l	225738	300188	74450	g_6798	g_36713
ptg000004l	309425	318040	8615	g_36713	g_34730
ptg000004l	327324	394982	67658	g_34730	g_36966
ptg000004l	395284	411950	16666	g_36966	g_9107
ptg000004l	422425	471935	49510	g_9107	g_35682
ptg000004l	488441	512105	23664	g_35682	g_32032
ptg000004l	579222	668996	89774	g_32032	g_12956
ptg000004l	676389	679504	3115	g_12956	g_15731
ptg000004l	701396	775842	74446	g_15731	g_5241
ptg000004l	781216	798563	17347	g_5241	g_33541
ptg000004l	798763	844421	45658	g_33541	g_20065
ptg000004l	844798	873267	28469	g_20065	g_9134
ptg000004l	979404	1042088	62684	g_9134	g_18575
ptg000004l	1042681	1077830	35149	g_18575	g_20194
ptg000004l	1093988	1170794	76806	g_20194	g_29346
ptg000004l	1187713	1367123	179410	g_29346	g_21343
ptg000004l	1388153	1414239	26086	g_21343	g_29096
ptg000004l	1415241	1448573	33332	g_29096	g_30682
ptg000004l	1449004	1635632	186628	g_30682	g_26766
ptg000004l	1636018	1869314	233296	g_26766	g_12828
ptg000004l	1869553	1882965	13412	g_12828	g_23670
ptg000004l	1886747	1907893	21146	g_23670	g_25334
ptg000004l	1917607	1921252	3645	g_25334	g_21204
ptg000004l	1922388	1932220	9832	g_21204	g_7976
ptg000004l	1933959	1990854	56895	g_7976	g_32837
ptg000004l	1991111	2169116	178005	g_32837	g_6665
ptg000004l	2170336	2175855	5519	g_6665	g_7676
ptg000004l	2177075	2275472	98397	g_7676	g_2359
ptg000004l	2280987	2400632	119645	g_2359	g_16298
ptg000004l	2409981	2413455	3474	g_16298	g_2874
ptg000004l	2426439	2594621	168182	g_2874	g_1306
ptg000004l	2646631	2843216	196585	g_1306	g_34882
ptg000004l	2850694	2869709	19015	g_34882	g_13405
ptg000004l	2877402	2964913	87511	g_13405	g_20634
ptg000004l	2972441	3058742	86301	g_20634	g_32544
ptg000004l	3092898	3224638	131740	g_32544	g_19137
ptg000004l	3239546	3250061	10515	g_19137	g_11802
ptg000004l	3268795	3287684	18889	g_11802	g_13772
ptg000004l	3288736	3295964	7228	g_13772	g_24640
ptg000004l	3297073	3306589	9516	g_24640	g_20866
ptg000004l	3307344	3315970	8626	g_20866	g_10229
ptg000004l	3316419	3358750	42331	g_10229	g_16871
ptg000004l	3360585	3391497	30912	g_16871	g_28193
ptg000004l	3392642	3392691	49	g_28193	g_25025
ptg000004l	3393647	3541928	148281	g_25025	g_12955
ptg000004l	3564822	3569976	5154	g_12955	g_23493
ptg000004l	3583411	3758693	175282	g_23493	g_2389
ptg000004l	3838775	3903899	65124	g_2389	g_2353
ptg000004l	3904279	3907344	3065	g_2353	g_16352
ptg000004l	3907724	3908836	1112	g_16352	g_32370
ptg000004l	3909246	3912364	3118	g_32370	g_16203
ptg000004l	3912747	3929743	16996	g_16203	g_6165
ptg000004l	3930363	3931333	970	g_6165	g_21782
ptg000004l	3931743	3933371	1628	g_21782	g_2234
ptg000004l	3933751	3942478	8727	g_2234	g_8036
ptg000004l	3943101	3947218	4117	g_8036	g_12501
ptg000004l	3947601	3949465	1864	g_12501	g_11255
ptg000004l	3949845	3957620	7775	g_11255	g_28505
ptg000004l	3958000	3961674	3674	g_28505	g_30434
ptg000004l	3962057	3968584	6527	g_30434	g_34985
ptg000004l	3968838	3973032	4194	g_34985	g_20929
ptg000004l	3973760	3979730	5970	g_20929	g_21434
ptg000004l	3980140	3981564	1424	g_21434	g_35072
ptg000004l	3981947	3983014	1067	g_35072	g_6877
ptg000004l	3983394	3985331	1937	g_6877	g_13520
ptg000004l	3985711	3989086	3375	g_13520	g_14641
ptg000004l	3989469	3994781	5312	g_14641	g_33696
ptg000004l	3995161	3996553	1392	g_33696	g_7326
ptg000004l	3996936	4001182	4246	g_7326	g_37303
ptg000004l	4001592	4011495	9903	g_37303	g_15500
ptg000004l	4012106	4019022	6916	g_15500	g_24160
ptg000004l	4019789	4020899	1110	g_24160	g_36745
ptg000004l	4021309	4023760	2451	g_36745	g_26594
ptg000004l	4024140	4026349	2209	g_26594	g_2073
ptg000004l	4026660	4036181	9521	g_2073	g_38222
ptg000004l	4039644	4067605	27961	g_38222	g_37562
ptg000004l	4076805	4084909	8104	g_37562	g_19638
ptg000004l	4096725	4106171	9446	g_19638	g_6269
ptg000004l	4107043	4109897	2854	g_6269	g_3717
ptg000004l	4134317	4209118	74801	g_3717	g_24459
ptg000004l	4209441	4251060	41619	g_24459	g_22344
ptg000004l	4259637	4319503	59866	g_22344	g_36509
ptg000004l	4329210	4537574	208364	g_36509	g_17403
ptg000004l	4538212	4868414	330202	g_17403	g_5596
ptg000004l	4907608	4966873	59265	g_5596	g_15635
ptg000004l	4967409	4977677	10268	g_15635	g_23998
ptg000004l	4983545	5083869	100324	g_23998	g_4281
ptg000004l	5084162	5207528	123366	g_4281	g_39533
ptg000004l	5207737	5238345	30608	g_39533	g_24481
ptg000004l	5246706	5285291	38585	g_24481	g_35634
ptg000004l	5286901	5287327	426	g_35634	g_39628
ptg000004l	5291008	5300476	9468	g_2609	g_3093
ptg000004l	5300955	5314536	13581	g_3093	g_944
ptg000004l	5323105	5331484	8379	g_944	g_17245
ptg000004l	5353349	5360535	7186	g_17245	g_36075
ptg000004l	5361257	5422328	61071	g_36075	g_39144
ptg000004l	5422741	5465552	42811	g_39144	g_7085
ptg000004l	5471578	5485652	14074	g_7085	g_18158
ptg000004l	5487295	5523376	36081	g_18158	g_7100
ptg000004l	5527014	5540228	13214	g_7100	g_26554
ptg000004l	5541871	5576909	35038	g_26554	g_8318
ptg000004l	5578552	5606841	28289	g_8318	g_32793
ptg000004l	5608484	5618037	9553	g_32793	g_2110
ptg000004l	5621669	5630295	8626	g_2110	g_22182
ptg000004l	5651605	5655617	4012	g_22182	g_13491
ptg000004l	5660505	5671236	10731	g_13491	g_40019
ptg000004l	5681407	5683656	2249	g_40019	g_6552
ptg000004l	5684841	5697465	12624	g_6552	g_30380
ptg000004l	5698539	5703050	4511	g_30380	g_6024
ptg000005l	607	863	256	g_20073	g_30676
ptg000005l	3691	15121	11430	g_30676	g_35754
ptg000005l	17887	20875	2988	g_35754	g_28899
ptg000005l	29260	33300	4040	g_28899	g_11250
ptg000005l	51689	59372	7683	g_11250	g_30632
ptg000005l	62944	65306	2362	g_30632	g_28410
ptg000005l	70200	98347	28147	g_28410	g_23403
ptg000005l	127645	146206	18561	g_23403	g_19782
ptg000005l	148125	154676	6551	g_19782	g_11504
ptg000005l	178411	189521	11110	g_11504	g_23595
ptg000005l	193429	225306	31877	g_23595	g_38153
ptg000005l	227103	232943	5840	g_38153	g_18350
ptg000005l	241535	243713	2178	g_18350	g_16548
ptg000005l	244921	248703	3782	g_16548	g_38899
ptg000005l	250140	251562	1422	g_38899	g_31510
ptg000005l	258834	263315	4481	g_31510	g_26578
ptg000005l	273917	280581	6664	g_26578	g_18708
ptg000005l	293058	295987	2929	g_18708	g_10428
ptg000005l	298287	316693	18406	g_10428	g_35621
ptg000005l	318200	323495	5295	g_35621	g_29562
ptg000005l	324106	364588	40482	g_29562	g_2775
ptg000005l	390672	446585	55913	g_2775	g_18961
ptg000005l	447544	452576	5032	g_18961	g_19241
ptg000005l	453838	458571	4733	g_19241	g_2686
ptg000005l	459008	461233	2225	g_2686	g_4346
ptg000005l	469888	480689	10801	g_4346	g_81
ptg000005l	491641	494248	2607	g_81	g_20018
ptg000005l	494706	495788	1082	g_20018	g_15851
ptg000005l	500048	501705	1657	g_15851	g_5368
ptg000005l	505027	509246	4219	g_5368	g_14437
ptg000005l	516242	520485	4243	g_14437	g_1822
ptg000005l	527674	980972	453298	g_1822	g_29330
ptg000005l	981277	988057	6780	g_29330	g_10322
ptg000005l	989013	989916	903	g_10322	g_11148
ptg000005l	990560	991160	600	g_11148	g_20912
ptg000005l	991654	1100595	108941	g_20912	g_11221
ptg000005l	1186570	1215215	28645	g_11221	g_9797
ptg000005l	1220033	1223781	3748	g_9797	g_32009
ptg000005l	1232742	1254855	22113	g_32009	g_12352
ptg000005l	1256290	1273545	17255	g_12352	g_39951
ptg000005l	1281391	1281459	68	g_39951	g_2743
ptg000005l	1295583	1314785	19202	g_2743	g_15693
ptg000005l	1320533	1475773	155240	g_15693	g_32550
ptg000005l	1490646	1619429	128783	g_32550	g_28935
ptg000005l	1619635	1648431	28796	g_28935	g_33245
ptg000005l	1660688	1660750	62	g_33245	g_9961
ptg000005l	1661073	1663150	2077	g_9961	g_8986
ptg000005l	1673770	1785209	111439	g_8986	g_11702
ptg000005l	1786575	1806698	20123	g_11702	g_5938
ptg000005l	1814275	1820537	6262	g_5938	g_29551
ptg000005l	1821790	1858336	36546	g_29551	g_24792
ptg000005l	1860266	1863723	3457	g_24792	g_16618
ptg000005l	1873336	1876213	2877	g_16618	g_19050
ptg000005l	1876434	2127810	251376	g_19050	g_28587
ptg000005l	2149693	2238795	89102	g_28587	g_1115
ptg000005l	2239679	2369250	129571	g_1115	g_2020
ptg000005l	2369624	2407087	37463	g_2020	g_25215
ptg000005l	2407305	2427445	20140	g_25215	g_35988
ptg000005l	2432757	2459627	26870	g_35988	g_5402
ptg000005l	2461395	2482591	21196	g_5402	g_24957
ptg000005l	2485265	2492206	6941	g_24957	g_27358
ptg000005l	2496698	2502142	5444	g_27358	g_37305
ptg000005l	2506702	2511155	4453	g_37305	g_23492
ptg000005l	2529623	2540033	10410	g_23492	g_37406
ptg000005l	2540401	2572860	32459	g_37406	g_26889
ptg000005l	2574404	2596790	22386	g_26889	g_35584
ptg000005l	2603052	2607123	4071	g_35584	g_16393
ptg000005l	2615134	2698989	83855	g_16393	g_16710
ptg000005l	2730442	2745770	15328	g_16710	g_32594
ptg000005l	2762142	2763103	961	g_32594	g_616
ptg000005l	2768089	2770325	2236	g_616	g_33508
ptg000005l	2781625	2829975	48350	g_33508	g_37711
ptg000005l	2830331	2832929	2598	g_37711	g_23680
ptg000005l	2834186	2860854	26668	g_23680	g_36315
ptg000005l	2861207	2937843	76636	g_36315	g_11619
ptg000005l	2954752	2962935	8183	g_11619	g_2987
ptg000005l	2977659	3058054	80395	g_2987	g_509
ptg000005l	3062680	3064034	1354	g_509	g_31628
ptg000005l	3065074	3189841	124767	g_31628	g_20434
ptg000005l	3196819	3199969	3150	g_20434	g_26677
ptg000005l	3223083	3228028	4945	g_26677	g_34913
ptg000005l	3238316	3293121	54805	g_34913	g_35769
ptg000005l	3295069	3297139	2070	g_35769	g_20382
ptg000005l	3300548	3421224	120676	g_20382	g_18079
ptg000005l	3423960	3567781	143821	g_18079	g_25854
ptg000005l	3585416	3588288	2872	g_25854	g_36909
ptg000005l	3604202	3741761	137559	g_36909	g_26852
ptg000005l	3742120	3996525	254405	g_26852	g_29212
ptg000005l	4037051	4048137	11086	g_29212	g_8387
ptg000005l	4056135	4061794	5659	g_8387	g_40042
ptg000005l	4062289	4064612	2323	g_40042	g_5792
ptg000005l	4067797	4071309	3512	g_5792	g_1484
ptg000005l	4076107	4082494	6387	g_1484	g_310
ptg000005l	4088469	4090236	1767	g_310	g_26183
ptg000005l	4090576	4095844	5268	g_26183	g_19288
ptg000005l	4097555	4098479	924	g_19288	g_28498
ptg000005l	4104241	4106613	2372	g_28498	g_19111
ptg000005l	4115530	4134725	19195	g_19111	g_32540
ptg000005l	4143634	4147378	3744	g_32540	g_40003
ptg000005l	4150879	4154156	3277	g_40003	g_40004
ptg000005l	4158919	4159244	325	g_40004	g_5893
ptg000005l	4159694	4175882	16188	g_5893	g_32361
ptg000005l	4198815	4200733	1918	g_32361	g_10414
ptg000005l	4206101	4207921	1820	g_10414	g_2887
ptg000005l	4214751	4215714	963	g_2887	g_24847
ptg000005l	4217409	4221312	3903	g_24847	g_3083
ptg000005l	4236456	4242867	6411	g_3083	g_29161
ptg000005l	4249393	4262224	12831	g_29161	g_251
ptg000005l	4263852	4265575	1723	g_251	g_12606
ptg000005l	4275883	4277236	1353	g_12606	g_30341
ptg000005l	4280403	4280645	242	g_30341	g_8417
ptg000005l	4283903	4286426	2523	g_8417	g_12970
ptg000005l	4315296	4424962	109666	g_12970	g_25604
ptg000005l	4425174	4432866	7692	g_25604	g_39813
ptg000005l	4435008	4444564	9556	g_27060	g_10477
ptg000005l	4446408	4458907	12499	g_10477	g_10516
ptg000005l	4460622	4467259	6637	g_10516	g_3889
ptg000005l	4467585	4471586	4001	g_3889	g_5441
ptg000005l	4472653	4493291	20638	g_5441	g_36771
ptg000005l	4497328	4514183	16855	g_36771	g_28829
ptg000005l	4514617	4549814	35197	g_28829	g_5262
ptg000005l	4569686	4571416	1730	g_5262	g_10859
ptg000005l	4576241	4577574	1333	g_10859	g_4952
ptg000005l	4581979	4593298	11319	g_4952	g_22974
ptg000005l	4598407	4600615	2208	g_22974	g_21622
ptg000005l	4605784	4613917	8133	g_21622	g_15948
ptg000005l	4621981	4624170	2189	g_15948	g_2975
ptg000005l	4625537	4628863	3326	g_2975	g_2711
ptg000005l	4633406	4646273	12867	g_2711	g_10923
ptg000005l	4653455	4663126	9671	g_10923	g_18868
ptg000005l	4667154	4682713	15559	g_18868	g_26292
ptg000005l	4684144	4686648	2504	g_26292	g_5145
ptg000005l	4691303	4703739	12436	g_5145	g_30892
ptg000005l	4711506	4725249	13743	g_30892	g_9365
ptg000005l	4726782	4729307	2525	g_9365	g_36409
ptg000005l	4741825	4810595	68770	g_36409	g_996
ptg000005l	4812125	4835465	23340	g_996	g_23654
ptg000005l	4857322	4864501	7179	g_23654	g_12128
ptg000005l	4864959	4888320	23361	g_12128	g_15401
ptg000005l	4888538	4935526	46988	g_15401	g_24246
ptg000005l	4936455	4944397	7942	g_24246	g_28135
ptg000005l	4958352	4973188	14836	g_28135	g_19503
ptg000005l	4975925	5009407	33482	g_19503	g_7854
ptg000005l	5025864	5033617	7753	g_7854	g_2708
ptg000005l	5038211	5044202	5991	g_2708	g_7020
ptg000005l	5052200	5086790	34590	g_7020	g_7460
ptg000005l	5096430	5098177	1747	g_7460	g_7170
ptg000005l	5107358	5108573	1215	g_7170	g_36190
ptg000005l	5110894	5123382	12488	g_36190	g_13946
ptg000005l	5132695	5134188	1493	g_13946	g_21138
ptg000005l	5143359	5153532	10173	g_21138	g_35712
ptg000005l	5156927	5165612	8685	g_35712	g_13030
ptg000005l	5168374	5175762	7388	g_13030	g_1315
ptg000005l	5181796	5184584	2788	g_1315	g_29191
ptg000005l	5187396	5249769	62373	g_29191	g_31546
ptg000005l	5256997	5263909	6912	g_31546	g_25548
ptg000005l	5276464	5300173	23709	g_25548	g_8086
ptg000005l	5303667	5306273	2606	g_8086	g_10846
ptg000005l	5322635	5325290	2655	g_10846	g_5608
ptg000005l	5344738	5359274	14536	g_5608	g_14889
ptg000005l	5364444	5378563	14119	g_14889	g_32447
ptg000005l	5380947	5382632	1685	g_32447	g_8542
ptg000005l	5384905	5387098	2193	g_8542	g_38923
ptg000005l	5388238	5394101	5863	g_31751	g_24610
ptg000005l	5398707	5401892	3185	g_24610	g_20084
ptg000005l	5403433	5407120	3687	g_20084	g_17438
ptg000005l	5407383	5407657	274	g_17438	g_1232
ptg000005l	5408910	5409090	180	g_1232	g_24083
ptg000005l	5409443	5415838	6395	g_24083	g_32690
ptg000005l	5421367	5425239	3872	g_32690	g_34594
ptg000005l	5426335	5429758	3423	g_34594	g_28116
ptg000005l	5436640	5442903	6263	g_28116	g_2241
ptg000005l	5444553	5448639	4086	g_2241	g_668
ptg000005l	5450904	5455287	4383	g_668	g_9164
ptg000005l	5463804	5500914	37110	g_9164	g_37129
ptg000005l	5502615	5554822	52207	g_37129	g_1588
ptg000005l	5555166	5580452	25286	g_1588	g_18193
ptg000005l	5608367	5613419	5052	g_18193	g_37592
ptg000005l	5623298	5846314	223016	g_37592	g_19608
ptg000005l	5863589	5867371	3782	g_19608	g_4153
ptg000005l	5888913	5906207	17294	g_4153	g_1750
ptg000005l	5908775	5913119	4344	g_1750	g_4446
ptg000005l	5916124	5919347	3223	g_4446	g_10546
ptg000005l	5938241	5939119	878	g_10546	g_13351
ptg000005l	5942717	5942976	259	g_13351	g_21122
ptg000005l	5944680	5948086	3406	g_21122	g_16407
ptg000005l	5948658	5952231	3573	g_16407	g_13447
ptg000005l	5957540	5961934	4394	g_13447	g_33992
ptg000005l	5969332	5972264	2932	g_33992	g_23070
ptg000005l	5988045	5995012	6967	g_23070	g_15048
ptg000005l	5999379	6002284	2905	g_15048	g_17946
ptg000005l	6005658	6008210	2552	g_17946	g_37474
ptg000005l	6014267	6016393	2126	g_37474	g_27916
ptg000005l	6021463	6023823	2360	g_27916	g_25783
ptg000005l	6026601	6028435	1834	g_25783	g_13263
ptg000005l	6032029	6034694	2665	g_13263	g_18376
ptg000005l	6037755	6039769	2014	g_18376	g_880
ptg000005l	6046526	6050585	4059	g_880	g_33788
ptg000005l	6056348	6060592	4244	g_33788	g_35735
ptg000005l	6066760	6136689	69929	g_35735	g_8460
ptg000005l	6137636	6143496	5860	g_8460	g_5030
ptg000005l	6145513	6192228	46715	g_5030	g_38
ptg000005l	6201650	6208482	6832	g_38	g_17597
ptg000005l	6214536	6225712	11176	g_17597	g_7806
ptg000005l	6230483	6278845	48362	g_7806	g_37242
ptg000005l	6280167	6281328	1161	g_37242	g_3720
ptg000005l	6286939	6291546	4607	g_3720	g_14289
ptg000005l	6292181	6294915	2734	g_14289	g_16116
ptg000005l	6300028	6344275	44247	g_16116	g_22071
ptg000005l	6346135	6347560	1425	g_22071	g_11154
ptg000005l	6354861	6359317	4456	g_11154	g_34629
ptg000005l	6365864	6368247	2383	g_34629	g_4123
ptg000005l	6393288	6400004	6716	g_4123	g_6768
ptg000005l	6416611	6423783	7172	g_6768	g_12022
ptg000005l	6435257	6437350	2093	g_12022	g_12378
ptg000005l	6441402	6442282	880	g_12378	g_8815
ptg000005l	6444882	6447787	2905	g_8815	g_23310
ptg000005l	6453444	6455176	1732	g_23310	g_6932
ptg000005l	6459079	6460811	1732	g_6932	g_20111
ptg000005l	6463684	6506318	42634	g_20111	g_18661
ptg000005l	6510978	6514010	3032	g_18661	g_25326
ptg000005l	6514420	6514789	369	g_25326	g_5848
ptg000005l	6518521	6520713	2192	g_5848	g_35776
ptg000005l	6538015	6557732	19717	g_35776	g_13098
ptg000005l	6569821	6575190	5369	g_13098	g_14721
ptg000005l	6580984	6603796	22812	g_14721	g_20734
ptg000005l	6607588	6612519	4931	g_20734	g_5951
ptg000005l	6621087	6644574	23487	g_5951	g_9131
ptg000005l	6654722	6681196	26474	g_9131	g_33081
ptg000005l	6682262	6687513	5251	g_33081	g_9002
ptg000005l	6691107	6696236	5129	g_9002	g_38155
ptg000005l	6697971	6704348	6377	g_38155	g_34457
ptg000005l	6706677	6766648	59971	g_34457	g_33027
ptg000005l	6768098	6768135	37	g_33027	g_22189
ptg000005l	6768757	6771023	2266	g_22189	g_36374
ptg000005l	6773600	6774919	1319	g_36374	g_36203
ptg000005l	6789364	6792470	3106	g_36203	g_7001
ptg000005l	6797666	6797893	227	g_7001	g_2451
ptg000005l	6805988	6819563	13575	g_2451	g_8343
ptg000005l	6843127	6887154	44027	g_8343	g_25915
ptg000005l	6898612	7101212	202600	g_25915	g_28640
ptg000005l	7102459	7103187	728	g_28640	g_34759
ptg000005l	7105091	7105742	651	g_34759	g_40151
ptg000005l	7109008	7112545	3537	g_40151	g_15692
ptg000005l	7112778	7116795	4017	g_15692	g_9040
ptg000005l	7122211	7130600	8389	g_9040	g_17555
ptg000005l	7134957	7150414	15457	g_17555	g_10536
ptg000005l	7150629	7188925	38296	g_10536	g_16474
ptg000005l	7189437	7192068	2631	g_16474	g_6245
ptg000005l	7196840	7198440	1600	g_6245	g_1966
ptg000005l	7204527	7224102	19575	g_1966	g_12283
ptg000005l	7230739	7263537	32798	g_12283	g_8525
ptg000005l	7280566	7298654	18088	g_8525	g_17816
ptg000005l	7306622	7312073	5451	g_17816	g_36767
ptg000005l	7313509	7332734	19225	g_36767	g_10233
ptg000005l	7334104	7394714	60610	g_10233	g_2193
ptg000005l	7394980	7412630	17650	g_2193	g_18787
ptg000005l	7412875	7428579	15704	g_18787	g_20122
ptg000005l	7450155	7474084	23929	g_20122	g_2211
ptg000005l	7478947	7522123	43176	g_2211	g_17314
ptg000005l	7524731	7534995	10264	g_17314	g_13902
ptg000005l	7537780	7547909	10129	g_38878	g_10216
ptg000005l	7553616	7556147	2531	g_10216	g_12391
ptg000005l	7578384	7581454	3070	g_12391	g_34140
ptg000005l	7596068	7655299	59231	g_34140	g_29477
ptg000005l	7655523	7682719	27196	g_29477	g_13340
ptg000005l	7684498	7689782	5284	g_13340	g_39950
ptg000005l	7690099	7698024	7925	g_39950	g_2701
ptg000005l	7699277	7705515	6238	g_2701	g_39948
ptg000005l	7706591	7709166	2575	g_39948	g_39949
ptg000005l	7710242	7717785	7543	g_39949	g_37720
ptg000005l	7723796	7726358	2562	g_37720	g_698
ptg000005l	7728935	7746445	17510	g_698	g_17160
ptg000005l	7747539	7755465	7926	g_17160	g_12658
ptg000005l	7755815	7827281	71466	g_12658	g_31023
ptg000005l	7827675	7837775	10100	g_31023	g_12825
ptg000005l	7839684	7843535	3851	g_12825	g_26100
ptg000005l	7845567	7846609	1042	g_26100	g_8785
ptg000005l	7851155	7887435	36280	g_8785	g_24853
ptg000005l	7893108	8099096	205988	g_24853	g_28716
ptg000005l	8105895	8115271	9376	g_28716	g_8493
ptg000005l	8116473	8147833	31360	g_8493	g_17408
ptg000005l	8154563	8158843	4280	g_17408	g_25727
ptg000005l	8161576	8167238	5662	g_25727	g_20232
ptg000005l	8207427	8210996	3569	g_20232	g_1192
ptg000005l	8229137	8231586	2449	g_1192	g_30515
ptg000005l	8236358	8246830	10472	g_30515	g_31796
ptg000005l	8270834	8308796	37962	g_31796	g_11225
ptg000005l	8315988	8321337	5349	g_11225	g_26571
ptg000005l	8333698	8367225	33527	g_26571	g_5079
ptg000005l	8368259	8379236	10977	g_5079	g_30024
ptg000005l	8379484	8391041	11557	g_30024	g_32003
ptg000005l	8407517	8417003	9486	g_32003	g_38121
ptg000005l	8417974	8424739	6765	g_38121	g_24066
ptg000005l	8425446	8438132	12686	g_24066	g_28602
ptg000005l	8439964	8500475	60511	g_28602	g_3760
ptg000005l	8501419	8509381	7962	g_3760	g_23105
ptg000005l	8512467	8530735	18268	g_23105	g_16839
ptg000005l	8550819	8597557	46738	g_16839	g_27478
ptg000005l	8602990	8608135	5145	g_27478	g_30354
ptg000005l	8627984	8740660	112676	g_30354	g_32050
ptg000005l	8753225	8766569	13344	g_32050	g_21520
ptg000005l	8771835	8772908	1073	g_21520	g_12847
ptg000005l	8775668	8781632	5964	g_12847	g_16827
ptg000005l	8787778	8799654	11876	g_16827	g_15620
ptg000005l	8834365	8870858	36493	g_15620	g_6008
ptg000005l	8875443	8887072	11629	g_6008	g_8433
ptg000005l	8902665	8919724	17059	g_8433	g_32523
ptg000005l	8934837	8935154	317	g_32523	g_8544
ptg000005l	8935456	8962878	27422	g_8544	g_10712
ptg000005l	8972973	8997865	24892	g_10712	g_37451
ptg000005l	9011509	9020074	8565	g_37451	g_5442
ptg000005l	9028233	9041126	12893	g_5442	g_28339
ptg000005l	9045149	9047763	2614	g_28339	g_17461
ptg000005l	9054675	9200243	145568	g_17461	g_15716
ptg000005l	9201160	9229838	28678	g_15716	g_16087
ptg000005l	9241026	9245205	4179	g_16087	g_11851
ptg000005l	9257105	9269621	12516	g_11851	g_29123
ptg000005l	9275474	9286338	10864	g_29123	g_39991
ptg000005l	9300087	9301632	1545	g_39991	g_5082
ptg000005l	9305036	9308239	3203	g_5082	g_28566
ptg000005l	9315325	9387902	72577	g_28566	g_28075
ptg000005l	9388210	9392529	4319	g_28075	g_40100
ptg000005l	9392876	9392996	120	g_40100	g_11855
ptg000005l	9395831	9401114	5283	g_11855	g_12728
ptg000005l	9414547	9417536	2989	g_12728	g_8547
ptg000005l	9426110	9429817	3707	g_8547	g_13507
ptg000005l	9432594	9433273	679	g_13507	g_25991
ptg000005l	9450727	9474899	24172	g_25991	g_12079
ptg000005l	9480997	9485347	4350	g_12079	g_26564
ptg000005l	9504629	9536104	31475	g_26564	g_3748
ptg000005l	9539744	9554195	14451	g_3748	g_37111
ptg000005l	9557792	9559961	2169	g_37111	g_18461
ptg000005l	9569047	9571424	2377	g_18461	g_26408
ptg000005l	9574600	9593194	18594	g_26408	g_29911
ptg000005l	9593520	9595626	2106	g_29911	g_4666
ptg000005l	9598388	9614665	16277	g_4666	g_14029
ptg000005l	9621807	9636308	14501	g_14029	g_10458
ptg000005l	9636988	9637285	297	g_10458	g_29967
ptg000005l	9637836	9640632	2796	g_29967	g_12027
ptg000005l	9641219	9682338	41119	g_12027	g_22547
ptg000005l	9685493	9693715	8222	g_22547	g_26631
ptg000005l	9704704	9715268	10564	g_26631	g_32309
ptg000005l	9719486	9720484	998	g_32309	g_40142
ptg000005l	9726269	9727182	913	g_40142	g_15306
ptg000005l	9730941	9731885	944	g_15306	g_6752
ptg000005l	9737812	9789205	51393	g_6752	g_11063
ptg000005l	9805504	9809040	3536	g_11063	g_34164
ptg000005l	9810050	9814822	4772	g_34164	g_39107
ptg000005l	9816223	9819596	3373	g_39107	g_10396
ptg000005l	9822784	9826166	3382	g_10396	g_12419
ptg000005l	9828796	9834109	5313	g_12419	g_3506
ptg000005l	9836484	9908641	72157	g_3506	g_13122
ptg000005l	9919648	9925366	5718	g_13122	g_35047
ptg000005l	9936984	9957956	20972	g_35047	g_33701
ptg000005l	9960835	9964319	3484	g_33701	g_14601
ptg000005l	9965117	9971720	6603	g_14601	g_31298
ptg000005l	9984895	9988426	3531	g_31298	g_36270
ptg000005l	9997151	9999809	2658	g_36270	g_10845
ptg000005l	10008066	10200256	192190	g_10845	g_22357
ptg000005l	10201350	10207839	6489	g_22357	g_4353
ptg000005l	10209086	10219996	10910	g_4353	g_16804
ptg000005l	10221652	10293986	72334	g_16804	g_30708
ptg000005l	10296419	10296970	551	g_30708	g_3584
ptg000005l	10298935	10311245	12310	g_3584	g_8212
ptg000005l	10326210	10329253	3043	g_8212	g_30944
ptg000005l	10347266	10381975	34709	g_30944	g_17233
ptg000005l	10383162	10414152	30990	g_17233	g_9550
ptg000005l	10425755	10461149	35394	g_9550	g_20365
ptg000005l	10461379	10654914	193535	g_20365	g_35915
ptg000005l	10676594	10701569	24975	g_35915	g_6083
ptg000005l	10713545	10749473	35928	g_6083	g_33497
ptg000005l	10761005	10841603	80598	g_33497	g_26925
ptg000005l	10842844	10856351	13507	g_26925	g_22770
ptg000005l	10874080	10902787	28707	g_22770	g_17101
ptg000005l	10903764	10921908	18144	g_17101	g_22128
ptg000005l	10930902	10932198	1296	g_22128	g_34500
ptg000005l	10933697	10934514	817	g_34500	g_29627
ptg000005l	10937425	10941372	3947	g_29627	g_30830
ptg000005l	10946846	10979751	32905	g_30830	g_37893
ptg000005l	10980641	11002893	22252	g_37893	g_18173
ptg000005l	11005037	11028082	23045	g_18173	g_27066
ptg000005l	11028387	11028694	307	g_27066	g_22378
ptg000005l	11029047	11029182	135	g_22378	g_10490
ptg000005l	11030315	11053193	22878	g_10490	g_22065
ptg000005l	11055337	11079960	24623	g_22065	g_13681
ptg000005l	11082077	11104847	22770	g_13681	g_28665
ptg000005l	11106961	11130339	23378	g_28665	g_27
ptg000005l	11132423	11151559	19136	g_27	g_13130
ptg000005l	11153703	11176600	22897	g_13130	g_20565
ptg000005l	11177304	11177611	307	g_20565	g_22859
ptg000005l	11178744	11203753	25009	g_22859	g_36845
ptg000005l	11204970	11204996	26	g_36845	g_12414
ptg000005l	11205838	11224666	18828	g_12414	g_16969
ptg000005l	11226840	11341866	115026	g_16969	g_15484
ptg000005l	11342862	11355357	12495	g_15484	g_34120
ptg000005l	11355881	11427097	71216	g_34120	g_1654
ptg000005l	11437440	11623599	186159	g_1654	g_8081
ptg000005l	11656928	11706971	50043	g_8081	g_26977
ptg000005l	11709560	11712542	2982	g_26977	g_5786
ptg000005l	11718721	11719521	800	g_5786	g_37820
ptg000005l	11729827	11729873	46	g_37820	g_31237
ptg000005l	11730517	11733772	3255	g_31237	g_6717
ptg000005l	11757484	11768727	11243	g_6717	g_16199
ptg000005l	11787909	11789092	1183	g_16199	g_10819
ptg000005l	11792454	11841020	48566	g_10819	g_872
ptg000005l	11848916	11858169	9253	g_872	g_34383
ptg000005l	11866808	11874386	7578	g_34383	g_11835
ptg000005l	11879353	11881043	1690	g_11835	g_10070
ptg000005l	11885773	11886965	1192	g_10070	g_16988
ptg000005l	11893632	11902408	8776	g_16988	g_1918
ptg000005l	11906945	11909241	2296	g_1918	g_39937
ptg000005l	11917054	11927787	10733	g_39937	g_3963
ptg000005l	11936260	11945619	9359	g_3963	g_25893
ptg000005l	11959267	11966884	7617	g_25893	g_30930
ptg000005l	11971614	11979960	8346	g_30930	g_23961
ptg000005l	11988070	11989226	1156	g_23961	g_38170
ptg000005l	11990912	11993789	2877	g_38170	g_14049
ptg000005l	11998946	12094285	95339	g_14049	g_11942
ptg000005l	12102206	12111178	8972	g_11942	g_26670
ptg000005l	12128152	12136341	8189	g_26670	g_35598
ptg000005l	12149325	12151370	2045	g_35598	g_18984
ptg000005l	12163181	12165117	1936	g_18984	g_36735
ptg000005l	12168006	12171001	2995	g_36735	g_4699
ptg000005l	12178747	12179533	786	g_4699	g_39980
ptg000005l	12189174	12205794	16620	g_39980	g_13888
ptg000005l	12206801	12257021	50220	g_13888	g_2646
ptg000005l	12257401	12402844	145443	g_2646	g_28754
ptg000005l	12416305	12461684	45379	g_28754	g_14724
ptg000005l	12462523	12466996	4473	g_14724	g_24442
ptg000005l	12470403	12476057	5654	g_24442	g_29198
ptg000005l	12479232	12487014	7782	g_29198	g_8418
ptg000005l	12501937	12504016	2079	g_8418	g_17479
ptg000005l	12506192	12514412	8220	g_17479	g_14058
ptg000005l	12516551	12628475	111924	g_14058	g_18319
ptg000005l	12629493	12657145	27652	g_18319	g_31367
ptg000005l	12657363	12829513	172150	g_31367	g_18838
ptg000005l	12833030	12882485	49455	g_18838	g_26156
ptg000005l	12883714	12939215	55501	g_26156	g_4822
ptg000005l	12961012	12966978	5966	g_4822	g_15842
ptg000005l	12973243	13018828	45585	g_15842	g_3000
ptg000005l	13033739	13061400	27661	g_3000	g_33732
ptg000005l	13063693	13099311	35618	g_33732	g_31651
ptg000005l	13114655	13122344	7689	g_31651	g_34214
ptg000005l	13127913	13132957	5044	g_34214	g_5973
ptg000005l	13155094	13158933	3839	g_5973	g_1765
ptg000005l	13168574	13209485	40911	g_1765	g_29725
ptg000005l	13210093	13256136	46043	g_29725	g_14005
ptg000005l	13265506	13362153	96647	g_14005	g_35268
ptg000005l	13363403	13365016	1613	g_35268	g_19895
ptg000005l	13370955	13507813	136858	g_19895	g_7110
ptg000005l	13508115	13511485	3370	g_7110	g_6645
ptg000005l	13522364	13541281	18917	g_6645	g_6421
ptg000005l	13549590	13555633	6043	g_6421	g_7370
ptg000005l	13563500	13567540	4040	g_7370	g_30694
ptg000005l	13570098	13615825	45727	g_30694	g_17800
ptg000005l	13621297	13625218	3921	g_17800	g_23919
ptg000005l	13630558	13726861	96303	g_23919	g_11505
ptg000005l	13733683	13735932	2249	g_11505	g_12575
ptg000005l	13746344	13753623	7279	g_12575	g_21855
ptg000005l	13762252	13763373	1121	g_21855	g_26514
ptg000005l	13765580	13807248	41668	g_26514	g_12803
ptg000005l	13820536	13847902	27366	g_12803	g_24178
ptg000005l	13854709	13881467	26758	g_24178	g_30638
ptg000005l	13883614	13885511	1897	g_30638	g_17997
ptg000005l	13904008	13909025	5017	g_17997	g_30644
ptg000005l	13941793	14052590	110797	g_30644	g_8712
ptg000005l	14070771	14132713	61942	g_8712	g_7703
ptg000005l	14155419	14285181	129762	g_7703	g_1856
ptg000005l	14287022	14435463	148441	g_1856	g_13397
ptg000005l	14435762	14814046	378284	g_13397	g_26621
ptg000005l	14831248	14970614	139366	g_26621	g_11016
ptg000005l	14971927	14975293	3366	g_11016	g_3068
ptg000005l	14991481	14993911	2430	g_3068	g_26358
ptg000005l	15005121	15008655	3534	g_26358	g_36964
ptg000005l	15013435	15026772	13337	g_36964	g_9872
ptg000005l	15033660	15064031	30371	g_9872	g_37443
ptg000005l	15073051	15091100	18049	g_37443	g_33198
ptg000005l	15096352	15140915	44563	g_33198	g_21827
ptg000005l	15157578	15187548	29970	g_21827	g_22275
ptg000005l	15188144	15190375	2231	g_22275	g_37338
ptg000005l	15206021	15213140	7119	g_37338	g_20389
ptg000005l	15219620	15220545	925	g_20389	g_29722
ptg000005l	15220895	15401568	180673	g_29722	g_15867
ptg000005l	15415586	15474611	59025	g_15867	g_9635
ptg000005l	15486999	15586699	99700	g_9635	g_1158
ptg000005l	15587739	15619928	32189	g_1158	g_19049
ptg000005l	15620416	15661227	40811	g_19049	g_22106
ptg000005l	15661517	15668529	7012	g_22106	g_25779
ptg000005l	15669516	15687630	18114	g_25779	g_10682
ptg000005l	15759145	15899934	140789	g_10682	g_9683
ptg000005l	15910975	15946468	35493	g_9683	g_35587
ptg000005l	15975023	15999613	24590	g_35587	g_14112
ptg000005l	15999987	16000069	82	g_14112	g_26637
ptg000005l	16000455	16010820	10365	g_26637	g_11819
ptg000005l	16032395	16059854	27459	g_11819	g_2469
ptg000005l	16060204	16064878	4674	g_2469	g_31989
ptg000005l	16083998	16117637	33639	g_31989	g_32293
ptg000005l	16138319	16169823	31504	g_32293	g_8402
ptg000005l	16181922	16191668	9746	g_8402	g_7942
ptg000005l	16198975	16203950	4975	g_7942	g_10003
ptg000005l	16222500	16267336	44836	g_10003	g_15935
ptg000005l	16269754	16272497	2743	g_15935	g_16667
ptg000005l	16294703	16294916	213	g_16667	g_21995
ptg000005l	16295623	16319888	24265	g_21995	g_3738
ptg000005l	16345914	16361387	15473	g_3738	g_14687
ptg000005l	16365064	16365489	425	g_14687	g_39020
ptg000005l	16366502	16370175	3673	g_39020	g_1405
ptg000005l	16380118	16386109	5991	g_1405	g_11704
ptg000005l	16386507	16427413	40906	g_11704	g_16254
ptg000005l	16441348	16518595	77247	g_16254	g_22565
ptg000005l	16523254	16524676	1422	g_22565	g_9943
ptg000005l	16528244	16587503	59259	g_9943	g_40164
ptg000005l	16591864	16593437	1573	g_40164	g_16745
ptg000005l	16596240	16610505	14265	g_16745	g_11411
ptg000005l	16625712	16627188	1476	g_11411	g_34468
ptg000005l	16638230	16684470	46240	g_34468	g_26999
ptg000005l	16693550	16693610	60	g_26999	g_24445
ptg000005l	16693813	16717737	23924	g_24445	g_31692
ptg000005l	16729968	16731277	1309	g_31692	g_31893
ptg000005l	16740248	16764405	24157	g_31893	g_33828
ptg000005l	16765520	16772554	7034	g_33828	g_34822
ptg000005l	16775145	16775735	590	g_34822	g_31610
ptg000005l	16776097	16778847	2750	g_31610	g_631
ptg000005l	16784826	16792480	7654	g_631	g_26515
ptg000005l	16792998	16797195	4197	g_26515	g_37724
ptg000005l	16805512	16855333	49821	g_37724	g_2076
ptg000005l	16855563	16872181	16618	g_2076	g_4768
ptg000005l	16946886	16956747	9861	g_7868	g_23520
ptg000005l	16967931	16971477	3546	g_23520	g_28871
ptg000005l	16975589	16978328	2739	g_28871	g_15957
ptg000005l	16982489	16993031	10542	g_15957	g_4395
ptg000005l	17018056	17024044	5988	g_4395	g_9650
ptg000005l	17035469	17059867	24398	g_9650	g_7503
ptg000005l	17061717	17106164	44447	g_7503	g_23889
ptg000006l	116214	534108	417894	g_28032	g_768
ptg000006l	539092	541219	2127	g_768	g_35547
ptg000006l	553631	555437	1806	g_35547	g_15139
ptg000006l	568686	592263	23577	g_15139	g_21181
ptg000006l	600818	601198	380	g_21181	g_25764
ptg000006l	603268	604534	1266	g_25764	g_7569
ptg000006l	605260	610575	5315	g_7569	g_26129
ptg000006l	623205	676267	53062	g_26129	g_30121
ptg000006l	721852	806496	84644	g_30121	g_14178
ptg000006l	832889	834314	1425	g_14178	g_34688
ptg000006l	841879	905107	63228	g_34688	g_24119
ptg000006l	911135	919924	8789	g_24119	g_27281
ptg000006l	928636	946564	17928	g_27281	g_38147
ptg000006l	955103	958539	3436	g_38147	g_28198
ptg000006l	968681	973972	5291	g_28198	g_20059
ptg000006l	975767	978146	2379	g_20059	g_17486
ptg000006l	1007936	1042978	35042	g_17486	g_17513
ptg000006l	1055190	1059251	4061	g_17513	g_30750
ptg000006l	1078365	1117183	38818	g_30750	g_36074
ptg000006l	1126209	1143867	17658	g_36074	g_28813
ptg000006l	1144379	1170638	26259	g_28813	g_25988
ptg000006l	1171150	1197703	26553	g_25988	g_20906
ptg000006l	1201626	1204147	2521	g_20906	g_17731
ptg000006l	1204542	1229045	24503	g_17731	g_7745
ptg000006l	1229557	1240012	10455	g_7745	g_25770
ptg000006l	1243987	1301652	57665	g_25770	g_32160
ptg000006l	1302164	1359731	57567	g_32160	g_17720
ptg000006l	1360237	1438267	78030	g_17720	g_14114
ptg000006l	1449418	1500261	50843	g_14114	g_24153
ptg000006l	1500752	1638750	137998	g_24153	g_30496
ptg000006l	1657339	1832264	174925	g_30496	g_7673
ptg000006l	1834069	1840936	6867	g_7673	g_34418
ptg000006l	1841154	1878136	36982	g_34418	g_20902
ptg000006l	1878393	1914751	36358	g_20902	g_12310
ptg000006l	1915602	1956839	41237	g_12310	g_8868
ptg000006l	1957129	2165720	208591	g_8868	g_35661
ptg000006l	2166679	2209429	42750	g_35661	g_26730
ptg000006l	2209713	2219835	10122	g_26730	g_35033
ptg000006l	2220107	2365062	144955	g_35033	g_14582
ptg000006l	2384554	2392259	7705	g_14582	g_1074
ptg000006l	2392627	2399112	6485	g_1074	g_6959
ptg000006l	2414529	2457063	42534	g_6959	g_22242
ptg000006l	2468904	2470849	1945	g_22242	g_470
ptg000006l	2478483	2480463	1980	g_470	g_16324
ptg000006l	2486102	2495001	8899	g_16324	g_28488
ptg000006l	2512596	2512673	77	g_28488	g_129
ptg000006l	2512942	2513013	71	g_129	g_34029
ptg000006l	2513384	2576837	63453	g_34029	g_27723
ptg000006l	2582254	2584632	2378	g_27723	g_17902
ptg000006l	2588461	2590257	1796	g_17902	g_2131
ptg000006l	2600143	2618852	18709	g_2131	g_28053
ptg000006l	2619070	2620653	1583	g_28053	g_20063
ptg000006l	2621840	2640797	18957	g_20063	g_12268
ptg000006l	2641459	2652746	11287	g_12268	g_33109
ptg000006l	2653408	2662620	9212	g_33109	g_3003
ptg000006l	2663282	2832407	169125	g_3003	g_20035
ptg000006l	2832673	2890336	57663	g_20035	g_19188
ptg000006l	2912978	2960709	47731	g_19188	g_16211
ptg000006l	2972753	2979705	6952	g_16211	g_40155
ptg000006l	2999291	3000397	1106	g_40155	g_37958
ptg000006l	3010925	3022740	11815	g_37958	g_37539
ptg000006l	3023054	3069571	46517	g_37539	g_33737
ptg000006l	3078616	3142643	64027	g_33737	g_33134
ptg000006l	3142879	3147139	4260	g_33134	g_34592
ptg000006l	3147561	3163729	16168	g_34592	g_27647
ptg000006l	3163932	3367101	203169	g_27647	g_22263
ptg000006l	3367310	3598711	231401	g_22263	g_34267
ptg000006l	3605006	3644045	39039	g_34267	g_32988
ptg000006l	3666566	3716483	49917	g_32988	g_6043
ptg000006l	3721639	3816234	94595	g_6043	g_13446
ptg000006l	3838313	3841477	3164	g_13446	g_33016
ptg000006l	3845885	3847775	1890	g_33016	g_37897
ptg000006l	3865163	3878830	13667	g_37897	g_13853
ptg000006l	3884752	3896390	11638	g_13853	g_13084
ptg000006l	3915409	3935889	20480	g_13084	g_4513
ptg000006l	3936660	3955652	18992	g_4513	g_10533
ptg000006l	3956526	3956621	95	g_10533	g_20021
ptg000006l	3957505	3979349	21844	g_20021	g_33684
ptg000006l	3980232	4089612	109380	g_33684	g_20368
ptg000006l	4089893	4177879	87986	g_20368	g_1423
ptg000006l	4180801	4196698	15897	g_1423	g_5468
ptg000006l	4196898	4213186	16288	g_5468	g_7782
ptg000006l	4228863	4232288	3425	g_7782	g_8017
ptg000006l	4234239	4257098	22859	g_8017	g_15188
ptg000006l	4257355	4263404	6049	g_15188	g_1585
ptg000006l	4281627	4305037	23410	g_1585	g_17272
ptg000006l	4307386	4368886	61500	g_17272	g_10958
ptg000006l	4369152	4443275	74123	g_10958	g_11098
ptg000006l	4451907	4462572	10665	g_11098	g_33736
ptg000006l	4463231	4469113	5882	g_33736	g_20549
ptg000006l	4469778	4470465	687	g_20549	g_32714
ptg000006l	4484967	4485925	958	g_32714	g_16568
ptg000006l	4489166	4490842	1676	g_16568	g_8537
ptg000006l	4496188	4669818	173630	g_8537	g_29962
ptg000006l	4670964	4672126	1162	g_29962	g_34791
ptg000006l	4676013	4676761	748	g_34791	g_3965
ptg000006l	4679501	4682411	2910	g_3965	g_39518
ptg000006l	4694010	4730021	36011	g_37325	g_12811
ptg000006l	4730272	4756762	26490	g_12811	g_32623
ptg000006l	4762318	4768603	6285	g_32623	g_9908
ptg000006l	4774621	4830906	56285	g_9908	g_27568
ptg000006l	4831286	4866852	35566	g_27568	g_16267
ptg000006l	4878008	4882757	4749	g_16267	g_28643
ptg000006l	4887096	4894634	7538	g_28643	g_32294
ptg000006l	4894843	4903251	8408	g_32294	g_36810
ptg000006l	4910493	4914516	4023	g_36810	g_36205
ptg000006l	4916774	4996231	79457	g_36205	g_26511
ptg000006l	5007085	5133994	126909	g_26511	g_15481
ptg000006l	5134695	5161011	26316	g_15481	g_155
ptg000006l	5161481	5168638	7157	g_155	g_11620
ptg000006l	5168936	5224165	55229	g_11620	g_5857
ptg000006l	5232116	5261256	29140	g_5857	g_29926
ptg000006l	5264490	5302781	38291	g_29926	g_6536
ptg000006l	5302993	5309602	6609	g_6536	g_30142
ptg000006l	5312330	5319016	6686	g_30142	g_3912
ptg000006l	5325153	5393754	68601	g_3912	g_17879
ptg000006l	5397570	5417320	19750	g_17879	g_6380
ptg000006l	5430271	5432372	2101	g_6380	g_1931
ptg000006l	5442388	5460992	18604	g_1931	g_28547
ptg000006l	5465519	5467586	2067	g_28547	g_4236
ptg000006l	5473216	5479863	6647	g_4236	g_18699
ptg000006l	5493194	5497487	4293	g_18699	g_17688
ptg000006l	5524205	5533966	9761	g_17688	g_3356
ptg000006l	5549808	5573879	24071	g_3356	g_19951
ptg000006l	5601065	5607685	6620	g_19951	g_22383
ptg000006l	5626520	5627330	810	g_22383	g_21077
ptg000006l	5629172	5630175	1003	g_21077	g_12667
ptg000006l	5633765	5634547	782	g_12667	g_19549
ptg000006l	5637427	5645578	8151	g_19549	g_29664
ptg000006l	5665725	5705963	40238	g_29664	g_32261
ptg000006l	5707264	5724999	17735	g_32261	g_20364
ptg000006l	5732853	5744907	12054	g_20364	g_29089
ptg000006l	5747100	5749573	2473	g_29089	g_1534
ptg000006l	5762767	5765711	2944	g_1534	g_20151
ptg000006l	5778683	5781772	3089	g_20151	g_12584
ptg000006l	5781981	5800114	18133	g_12584	g_27755
ptg000006l	5800434	5801964	1530	g_27755	g_9990
ptg000006l	5802221	5810312	8091	g_9990	g_26585
ptg000006l	5812343	5896766	84423	g_26585	g_12858
ptg000006l	5900121	5905771	5650	g_12858	g_2003
ptg000006l	5921681	5925728	4047	g_2003	g_36540
ptg000006l	5938788	5941547	2759	g_36540	g_23671
ptg000006l	5944376	5951886	7510	g_23671	g_13334
ptg000006l	5955654	5956912	1258	g_13334	g_39768
ptg000006l	5957277	5959512	2235	g_39768	g_39288
ptg000006l	5960354	5964793	4439	g_39288	g_32176
ptg000006l	5969741	5991445	21704	g_32176	g_27085
ptg000006l	5999570	6003486	3916	g_27085	g_48
ptg000006l	6007714	6041197	33483	g_48	g_17580
ptg000006l	6041454	6043952	2498	g_17580	g_27411
ptg000006l	6054640	6060318	5678	g_27411	g_17621
ptg000006l	6063294	6065747	2453	g_17621	g_36487
ptg000006l	6066295	6067928	1633	g_36487	g_35432
ptg000006l	6093929	6101120	7191	g_35432	g_17614
ptg000006l	6104779	6106926	2147	g_17614	g_40173
ptg000006l	6107165	6107681	516	g_40173	g_33281
ptg000006l	6109685	6110688	1003	g_33281	g_13037
ptg000006l	6115533	6144673	29140	g_13037	g_2173
ptg000006l	6162189	6165607	3418	g_2173	g_37006
ptg000006l	6166581	6177783	11202	g_37006	g_21718
ptg000006l	6178757	6183827	5070	g_21718	g_13008
ptg000006l	6208066	6220994	12928	g_13008	g_11612
ptg000006l	6224884	6232203	7319	g_11612	g_38128
ptg000006l	6233396	6278177	44781	g_38128	g_19418
ptg000006l	6284883	6288267	3384	g_19418	g_8340
ptg000006l	6291699	6294731	3032	g_8340	g_22639
ptg000006l	6299876	6304371	4495	g_22639	g_36413
ptg000006l	6311688	6315464	3776	g_36413	g_22161
ptg000006l	6325346	6367377	42031	g_22161	g_3497
ptg000006l	6377021	6379088	2067	g_3497	g_24437
ptg000006l	6381117	6394485	13368	g_24437	g_17578
ptg000006l	6406892	6412784	5892	g_17578	g_32686
ptg000006l	6416062	6429430	13368	g_32686	g_20544
ptg000006l	6430718	6431733	1015	g_20544	g_3680
ptg000006l	6437047	6437743	696	g_3680	g_27845
ptg000006l	6441161	6462707	21546	g_27845	g_37842
ptg000006l	6467952	6473086	5134	g_37842	g_16756
ptg000006l	6480020	6496022	16002	g_16756	g_33443
ptg000006l	6496799	6565713	68914	g_39296	g_1791
ptg000006l	6600892	6601814	922	g_1791	g_18008
ptg000006l	6604693	6610555	5862	g_18008	g_15163
ptg000006l	6614415	6617661	3246	g_15163	g_38136
ptg000006l	6619322	6620363	1041	g_38136	g_40296
ptg000006l	6623350	6624805	1455	g_40296	g_22374
ptg000006l	6628281	6629836	1555	g_22374	g_36856
ptg000006l	6632088	6645675	13587	g_36856	g_34117
ptg000006l	6648319	6657276	8957	g_34117	g_1160
ptg000006l	6682467	6704125	21658	g_1160	g_31242
ptg000006l	6715224	6752347	37123	g_31242	g_7193
ptg000006l	6774518	6778837	4319	g_7193	g_24755
ptg000006l	6787558	6789527	1969	g_24755	g_36379
ptg000006l	6792112	6793499	1387	g_36379	g_36287
ptg000006l	6807881	6828708	20827	g_36287	g_35679
ptg000006l	6828986	6848549	19563	g_35679	g_17880
ptg000006l	6882928	6884522	1594	g_17880	g_22270
ptg000006l	6893825	6895159	1334	g_22270	g_9794
ptg000006l	6899979	6918506	18527	g_9794	g_21263
ptg000006l	6924270	6927515	3245	g_21263	g_2968
ptg000006l	6946507	6948056	1549	g_2968	g_32928
ptg000006l	6962138	6998804	36666	g_32928	g_2554
ptg000006l	7014845	7018712	3867	g_2554	g_18536
ptg000006l	7019752	7033970	14218	g_18536	g_6443
ptg000006l	7035956	7038259	2303	g_6443	g_25328
ptg000006l	7053014	7055820	2806	g_25328	g_3430
ptg000006l	7057921	7058437	516	g_3430	g_10558
ptg000006l	7059942	7064074	4132	g_10558	g_86
ptg000006l	7064814	7072035	7221	g_86	g_15937
ptg000006l	7089212	7113074	23862	g_15937	g_5273
ptg000006l	7126188	7134163	7975	g_5273	g_10520
ptg000006l	7134384	7136315	1931	g_10520	g_30960
ptg000006l	7139500	7141343	1843	g_30960	g_33100
ptg000006l	7148098	7149371	1273	g_33100	g_37432
ptg000006l	7152502	7157982	5480	g_37432	g_33269
ptg000006l	7159077	7160773	1696	g_33269	g_35184
ptg000006l	7163231	7165840	2609	g_35184	g_115
ptg000006l	7168638	7169311	673	g_115	g_13500
ptg000006l	7169778	7172900	3122	g_13500	g_16728
ptg000006l	7175361	7179204	3843	g_16728	g_20346
ptg000006l	7180031	7185613	5582	g_20346	g_28589
ptg000006l	7186080	7194031	7951	g_28589	g_29773
ptg000006l	7194549	7198232	3683	g_29773	g_8046
ptg000006l	7198750	7238645	39895	g_8046	g_4058
ptg000006l	7246708	7254585	7877	g_4058	g_16363
ptg000006l	7260367	7262075	1708	g_16363	g_11401
ptg000006l	7275463	7277328	1865	g_11401	g_18711
ptg000006l	7282824	7284115	1291	g_18711	g_40025
ptg000006l	7288608	7291480	2872	g_40025	g_6954
ptg000006l	7301516	7388251	86735	g_6954	g_35140
ptg000006l	7388544	7394332	5788	g_35140	g_3675
ptg000006l	7400287	7400573	286	g_3675	g_21824
ptg000006l	7402438	7402893	455	g_21824	g_22445
ptg000006l	7406577	7408875	2298	g_22445	g_37775
ptg000006l	7415548	7418162	2614	g_37775	g_35097
ptg000006l	7419891	7421554	1663	g_35097	g_12344
ptg000006l	7430063	7442262	12199	g_12344	g_19744
ptg000006l	7448446	7462456	14010	g_19744	g_7682
ptg000006l	7468571	7472129	3558	g_7682	g_37362
ptg000006l	7472617	7475831	3214	g_37362	g_38171
ptg000006l	7489994	7497190	7196	g_38171	g_13814
ptg000006l	7500438	7501367	929	g_13814	g_28310
ptg000006l	7508039	7513031	4992	g_28310	g_32090
ptg000006l	7514772	7518153	3381	g_32090	g_23704
ptg000006l	7525633	7531595	5962	g_23704	g_11758
ptg000006l	7532251	7539453	7202	g_11758	g_19152
ptg000006l	7548128	7550517	2389	g_19152	g_31363
ptg000006l	7560731	7564253	3522	g_31363	g_40167
ptg000006l	7570837	7573000	2163	g_40167	g_17041
ptg000006l	7580918	7582178	1260	g_17041	g_3609
ptg000006l	7586247	7593162	6915	g_3609	g_6125
ptg000006l	7607034	7625700	18666	g_6125	g_26078
ptg000006l	7639063	7669833	30770	g_26078	g_23110
ptg000006l	7670120	7678902	8782	g_23110	g_4597
ptg000006l	7684814	7690365	5551	g_4597	g_27652
ptg000006l	7692299	7694628	2329	g_27652	g_9486
ptg000006l	7706369	7718531	12162	g_9486	g_21621
ptg000006l	7732837	7735437	2600	g_21621	g_33997
ptg000006l	7747714	7751270	3556	g_33997	g_6042
ptg000006l	7755691	7756667	976	g_6042	g_628
ptg000006l	7765163	7767547	2384	g_628	g_19256
ptg000006l	7771302	7785151	13849	g_19256	g_2130
ptg000006l	7793487	7795352	1865	g_2130	g_15332
ptg000006l	7799066	7803188	4122	g_15332	g_19092
ptg000006l	7809320	7815296	5976	g_19092	g_29154
ptg000006l	7836678	7847222	10544	g_29154	g_7054
ptg000006l	7851811	7901130	49319	g_7054	g_32415
ptg000006l	7908965	7914227	5262	g_32415	g_5797
ptg000006l	7920190	7923906	3716	g_5797	g_27517
ptg000006l	7935204	7969288	34084	g_27517	g_2105
ptg000006l	7973931	8040574	66643	g_2105	g_28294
ptg000006l	8045929	8066507	20578	g_28294	g_18625
ptg000006l	8081539	8083582	2043	g_18625	g_24588
ptg000006l	8094241	8096588	2347	g_24588	g_30874
ptg000006l	8102964	8106977	4013	g_30874	g_15793
ptg000006l	8121300	8123915	2615	g_15793	g_1007
ptg000006l	8128801	8152044	23243	g_1007	g_28331
ptg000006l	8153467	8183422	29955	g_28331	g_14639
ptg000006l	8186230	8187020	790	g_14639	g_40136
ptg000006l	8188909	8193961	5052	g_40136	g_33664
ptg000006l	8197666	8197962	296	g_33664	g_24091
ptg000006l	8203965	8205506	1541	g_24091	g_34215
ptg000006l	8220007	8222131	2124	g_34215	g_15640
ptg000006l	8229852	8265433	35581	g_15640	g_16221
ptg000006l	8290366	8294215	3849	g_16221	g_4450
ptg000006l	8315740	8318469	2729	g_4450	g_14968
ptg000006l	8320737	8320911	174	g_14968	g_30411
ptg000006l	8325434	8326646	1212	g_30411	g_2312
ptg000006l	8332037	8332582	545	g_2312	g_37056
ptg000006l	8341929	8355333	13404	g_37056	g_17858
ptg000006l	8376948	8385364	8416	g_17858	g_1924
ptg000006l	8401501	8405315	3814	g_1924	g_36508
ptg000006l	8417070	8425435	8365	g_36508	g_39914
ptg000006l	8427997	8434638	6641	g_39914	g_819
ptg000006l	8445202	8513123	67921	g_819	g_1161
ptg000006l	8516461	8518629	2168	g_1161	g_37228
ptg000006l	8523705	8525845	2140	g_37228	g_21194
ptg000006l	8531335	8536675	5340	g_21194	g_1227
ptg000006l	8542955	8544742	1787	g_1227	g_22768
ptg000006l	8546500	8550471	3971	g_22768	g_15637
ptg000006l	8552495	8579978	27483	g_15637	g_21536
ptg000006l	8595118	8649583	54465	g_21536	g_21203
ptg000006l	8654775	8874184	219409	g_21203	g_13466
ptg000006l	8874438	9009698	135260	g_13466	g_23995
ptg000006l	9039979	9041718	1739	g_23995	g_16447
ptg000006l	9043812	9082745	38933	g_16447	g_2969
ptg000006l	9094429	9161214	66785	g_2969	g_12055
ptg000006l	9174444	9196092	21648	g_12055	g_24026
ptg000006l	9196451	9361620	165169	g_24026	g_4777
ptg000006l	9374931	9404133	29202	g_4777	g_32285
ptg000006l	9416334	9439413	23079	g_32285	g_20352
ptg000006l	9439634	9450686	11052	g_20352	g_11421
ptg000006l	9454131	9468091	13960	g_11421	g_32488
ptg000006l	9477180	9481623	4443	g_32488	g_30425
ptg000006l	9486723	9829637	342914	g_30425	g_17651
ptg000006l	9830026	9854970	24944	g_17651	g_13818
ptg000006l	9861503	9945558	84055	g_13818	g_19018
ptg000006l	9969787	9973845	4058	g_19018	g_21712
ptg000006l	9974117	10006396	32279	g_21712	g_34948
ptg000006l	10024614	10124977	100363	g_34948	g_19969
ptg000006l	10135745	10206768	71023	g_19969	g_2152
ptg000006l	10238040	10239457	1417	g_2152	g_37904
ptg000006l	10239894	10322436	82542	g_37904	g_15365
ptg000006l	10329822	10330995	1173	g_15365	g_20377
ptg000006l	10332539	10335631	3092	g_20377	g_18027
ptg000006l	10342121	10357153	15032	g_18027	g_1784
ptg000006l	10362477	10366478	4001	g_1784	g_2206
ptg000006l	10368743	10372268	3525	g_2206	g_25435
ptg000006l	10375983	10395630	19647	g_25435	g_22351
ptg000006l	10397017	10399738	2721	g_22351	g_22430
ptg000006l	10401592	10405552	3960	g_22430	g_29943
ptg000006l	10408390	10411624	3234	g_29943	g_29293
ptg000006l	10423071	10452142	29071	g_29293	g_6765
ptg000006l	10454039	10457321	3282	g_6765	g_30328
ptg000006l	10460661	10466868	6207	g_30328	g_28406
ptg000006l	10472783	10478790	6007	g_28406	g_11137
ptg000006l	10498040	10503495	5455	g_11137	g_33265
ptg000006l	10508986	10530850	21864	g_33265	g_5222
ptg000006l	10533098	10555556	22458	g_5222	g_2146
ptg000006l	10560942	10564859	3917	g_2146	g_7572
ptg000006l	10572166	10577415	5249	g_7572	g_2685
ptg000006l	10579498	10586019	6521	g_2685	g_21671
ptg000006l	10594482	10598715	4233	g_21671	g_30269
ptg000006l	10608997	10616260	7263	g_30269	g_27522
ptg000006l	10621919	10626019	4100	g_27522	g_18220
ptg000006l	10633469	10729455	95986	g_18220	g_35925
ptg000006l	10731065	10754177	23112	g_35925	g_13155
ptg000006l	10756780	10762316	5536	g_13155	g_11089
ptg000006l	10763260	10816628	53368	g_11089	g_3467
ptg000006l	10818786	10881643	62857	g_3467	g_8285
ptg000006l	10888919	10903078	14159	g_8285	g_29142
ptg000006l	10904181	10916400	12219	g_29142	g_31147
ptg000006l	10920898	10922066	1168	g_31147	g_7856
ptg000006l	10923528	10958533	35005	g_7856	g_33914
ptg000006l	10966021	10983017	16996	g_33914	g_16773
ptg000006l	11005773	11015877	10104	g_16773	g_12568
ptg000006l	11021500	11024798	3298	g_12568	g_28002
ptg000006l	11029059	11033392	4333	g_28002	g_7167
ptg000006l	11036418	11068186	31768	g_7167	g_9307
ptg000006l	11068410	11096933	28523	g_9307	g_5365
ptg000006l	11103279	11204928	101649	g_5365	g_12662
ptg000006l	11205146	11260923	55777	g_12662	g_39935
ptg000006l	11265656	11267708	2052	g_39935	g_1827
ptg000006l	11273093	11277085	3992	g_1827	g_18138
ptg000006l	11281153	11306870	25717	g_18138	g_11224
ptg000006l	11312211	11374784	62573	g_11224	g_5422
ptg000006l	11400586	11404362	3776	g_5422	g_26633
ptg000006l	11416379	11422034	5655	g_26633	g_5105
ptg000006l	11422255	11437415	15160	g_5105	g_7017
ptg000006l	11439166	11507906	68740	g_7017	g_3898
ptg000006l	11515953	11523198	7245	g_3898	g_7893
ptg000006l	11545894	11683103	137209	g_7893	g_33899
ptg000006l	11689036	11703331	14295	g_33899	g_34706
ptg000006l	11712023	11712465	442	g_34706	g_12987
ptg000006l	11714188	11731609	17421	g_12987	g_30312
ptg000006l	11743510	11753380	9870	g_30312	g_17735
ptg000006l	11754371	11799388	45017	g_17735	g_8049
ptg000006l	11803088	11834902	31814	g_8049	g_9433
ptg000006l	11839587	11853143	13556	g_9433	g_31775
ptg000006l	11854669	11875375	20706	g_31775	g_27094
ptg000006l	11875587	11882624	7037	g_27094	g_18942
ptg000006l	11883037	11911004	27967	g_18942	g_17316
ptg000006l	11911234	11918099	6865	g_17316	g_30283
ptg000006l	11918497	11932763	14266	g_30283	g_1303
ptg000006l	11933080	11933638	558	g_1303	g_37203
ptg000006l	11933898	11942021	8123	g_37203	g_3921
ptg000006l	11942718	12089391	146673	g_3921	g_11200
ptg000006l	12102582	12230392	127810	g_11200	g_14234
ptg000006l	12251056	12260055	8999	g_14234	g_34623
ptg000006l	12263252	12276350	13098	g_34623	g_1541
ptg000006l	12282394	12287549	5155	g_1541	g_36388
ptg000006l	12290875	12296834	5959	g_36388	g_31579
ptg000006l	12302016	12341331	39315	g_31579	g_15889
ptg000006l	12342077	12348520	6443	g_15889	g_34012
ptg000006l	12355279	12381410	26131	g_34012	g_13333
ptg000006l	12383124	12385828	2704	g_13333	g_2731
ptg000006l	12390066	12397781	7715	g_2731	g_37247
ptg000006l	12402662	12405218	2556	g_37247	g_24426
ptg000006l	12415001	12455936	40935	g_24426	g_15817
ptg000006l	12457021	12468422	11401	g_15817	g_35631
ptg000006l	12469294	12472266	2972	g_35631	g_33460
ptg000006l	12477558	12492197	14639	g_33460	g_38288
ptg000006l	12494492	12497938	3446	g_38288	g_31407
ptg000006l	12515764	12520144	4380	g_31407	g_36510
ptg000006l	12527439	12529898	2459	g_36510	g_24594
ptg000006l	12531319	12544446	13127	g_24594	g_20665
ptg000006l	12570013	12574084	4071	g_20665	g_28802
ptg000006l	12589992	12594638	4646	g_28802	g_35532
ptg000006l	12595924	12596659	735	g_35532	g_25165
ptg000006l	12599658	12600551	893	g_25165	g_37314
ptg000006l	12615297	12624143	8846	g_37314	g_13222
ptg000006l	12630413	12641678	11265	g_13222	g_10151
ptg000006l	12643645	12649368	5723	g_10151	g_10928
ptg000006l	12674829	12677822	2993	g_10928	g_23404
ptg000006l	12681046	12689127	8081	g_23404	g_32792
ptg000006l	12690871	12699755	8884	g_32792	g_8449
ptg000006l	12701979	12710723	8744	g_8449	g_36226
ptg000006l	12712465	12714406	1941	g_36226	g_14182
ptg000006l	12716640	12739981	23341	g_14182	g_6129
ptg000006l	12742215	12743895	1680	g_6129	g_11635
ptg000006l	12746797	12776921	30124	g_11635	g_6070
ptg000006l	12781167	12795036	13869	g_6070	g_26143
ptg000006l	12795305	12865961	70656	g_26143	g_29219
ptg000006l	12886836	12893681	6845	g_29219	g_39927
ptg000006l	12897454	12900779	3325	g_39927	g_1455
ptg000006l	12902512	12919555	17043	g_1455	g_29076
ptg000006l	12921105	12924863	3758	g_29076	g_9180
ptg000006l	12929172	12933661	4489	g_9180	g_12367
ptg000006l	12938070	12938901	831	g_12367	g_34704
ptg000006l	12942823	12954946	12123	g_34704	g_13797
ptg000006l	12964059	12975624	11565	g_13797	g_3359
ptg000006l	12981342	12987820	6478	g_3359	g_18343
ptg000006l	13002501	13003293	792	g_18343	g_13103
ptg000006l	13006760	13008712	1952	g_13103	g_8680
ptg000006l	13009624	13011498	1874	g_8680	g_4117
ptg000006l	13014743	13017810	3067	g_4117	g_18928
ptg000006l	13040839	13052847	12008	g_18928	g_14791
ptg000006l	13053927	13065395	11468	g_14791	g_11722
ptg000006l	13070926	13076073	5147	g_23191	g_8610
ptg000006l	13084619	13087355	2736	g_8610	g_20508
ptg000006l	13090066	13106337	16271	g_20508	g_20118
ptg000006l	13113112	13124478	11366	g_20118	g_38219
ptg000006l	13132183	13135706	3523	g_38219	g_34106
ptg000006l	13136720	13142584	5864	g_34106	g_7
ptg000006l	13181010	13386153	205143	g_7	g_13432
ptg000006l	13389725	13661747	272022	g_13432	g_29812
ptg000006l	13662049	13668461	6412	g_29812	g_19179
ptg000006l	13675600	13687771	12171	g_39537	g_34004
ptg000006l	13694618	13702069	7451	g_34004	g_3951
ptg000006l	13707278	13708269	991	g_3951	g_15329
ptg000006l	13711560	13712591	1031	g_15329	g_40143
ptg000006l	13713495	13725342	11847	g_40143	g_25647
ptg000006l	13741210	13820667	79457	g_25647	g_35557
ptg000006l	13823511	13861221	37710	g_35557	g_14389
ptg000006l	13861442	13868228	6786	g_14389	g_18276
ptg000006l	13869187	13879364	10177	g_18276	g_24290
ptg000006l	13880539	13920023	39484	g_24290	g_23214
ptg000006l	13936050	13956533	20483	g_23214	g_7037
ptg000006l	13973692	13978227	4535	g_7037	g_32759
ptg000006l	13982113	13986947	4834	g_32759	g_8618
ptg000006l	13988920	14402234	413314	g_8618	g_35342
ptg000006l	14407184	14429860	22676	g_35342	g_35812
ptg000006l	14430897	14514142	83245	g_35812	g_38644
ptg000006l	14533312	14545094	11782	g_38644	g_30508
ptg000006l	14552735	14558583	5848	g_30508	g_8923
ptg000006l	14560289	14565708	5419	g_8923	g_5171
ptg000006l	14584959	14595338	10379	g_5171	g_17626
ptg000006l	14596845	14614525	17680	g_17626	g_29848
ptg000006l	14623681	14631103	7422	g_29848	g_30374
ptg000006l	14648428	14655546	7118	g_30374	g_38327
ptg000006l	14666120	14676703	10583	g_38327	g_2877
ptg000006l	14685789	14688534	2745	g_2877	g_36094
ptg000006l	14692083	14699131	7048	g_36094	g_32612
ptg000006l	14707190	14709962	2772	g_32612	g_31618
ptg000006l	14735534	14759719	24185	g_31618	g_28218
ptg000006l	14793494	14873771	80277	g_28218	g_12864
ptg000006l	14884909	14887024	2115	g_12864	g_11691
ptg000006l	14897848	14902885	5037	g_11691	g_36025
ptg000006l	14907346	14920050	12704	g_36025	g_22313
ptg000006l	14925775	14940594	14819	g_22313	g_6863
ptg000006l	14972291	15041686	69395	g_6863	g_30300
ptg000006l	15063165	15090027	26862	g_30300	g_17506
ptg000006l	15095074	15103239	8165	g_17506	g_23593
ptg000006l	15108767	15110648	1881	g_23593	g_14842
ptg000006l	15112378	15115453	3075	g_14842	g_12538
ptg000006l	15121649	15193091	71442	g_12538	g_9557
ptg000006l	15195352	15200248	4896	g_9557	g_37425
ptg000006l	15200751	15210657	9906	g_37425	g_22514
ptg000006l	15225723	15322892	97169	g_22514	g_16061
ptg000006l	15323734	15823282	499548	g_16061	g_29001
ptg000006l	15824328	15834916	10588	g_29001	g_4390
ptg000006l	15848142	15849803	1661	g_4390	g_13210
ptg000006l	15851957	15854747	2790	g_13210	g_30574
ptg000006l	15857062	15859066	2004	g_30574	g_15240
ptg000006l	15861459	15863896	2437	g_15240	g_14419
ptg000006l	15864369	15864924	555	g_14419	g_28653
ptg000006l	15865793	15866044	251	g_28653	g_16063
ptg000006l	15866433	15869325	2892	g_16063	g_37619
ptg000006l	15873658	15899392	25734	g_37619	g_9361
ptg000006l	15907664	15912500	4836	g_9361	g_20846
ptg000006l	15918495	15921303	2808	g_20846	g_27741
ptg000006l	15927824	15976629	48805	g_27741	g_20522
ptg000006l	15981268	15982554	1286	g_20522	g_20033
ptg000006l	15983999	15987391	3392	g_20033	g_27298
ptg000006l	15996725	16004084	7359	g_27298	g_13686
ptg000006l	16025423	16142786	117363	g_13686	g_13858
ptg000006l	16143088	16193531	50443	g_13858	g_5098
ptg000006l	16195737	16200675	4938	g_5098	g_1512
ptg000006l	16211614	16226919	15305	g_1512	g_31632
ptg000006l	16227143	16230635	3492	g_31632	g_20810
ptg000006l	16230856	16230955	99	g_20810	g_27875
ptg000006l	16231449	16254869	23420	g_27875	g_24328
ptg000006l	16272887	16294240	21353	g_24328	g_12666
ptg000006l	16315625	16317366	1741	g_12666	g_16175
ptg000006l	16318412	16320687	2275	g_16175	g_18643
ptg000006l	16335851	16591536	255685	g_18643	g_27831
ptg000006l	16608995	16628889	19894	g_27831	g_34412
ptg000006l	16631565	16837801	206236	g_34412	g_17565
ptg000006l	16838274	16842027	3753	g_17565	g_16509
ptg000006l	16844119	16846518	2399	g_16509	g_12830
ptg000006l	16852393	16854904	2511	g_12830	g_19056
ptg000006l	16858088	16858921	833	g_19056	g_37383
ptg000006l	16865410	16886870	21460	g_37383	g_22273
ptg000006l	16908849	16919451	10602	g_22273	g_3283
ptg000006l	16957265	16957720	455	g_3283	g_6811
ptg000006l	16960926	16999275	38349	g_6811	g_34226
ptg000006l	17008545	17016434	7889	g_34226	g_22050
ptg000006l	17017857	17023998	6141	g_22050	g_34954
ptg000006l	17027687	17038916	11229	g_34954	g_1206
ptg000006l	17044647	17047784	3137	g_1206	g_39920
ptg000006l	17052059	17055843	3784	g_39920	g_31565
ptg000006l	17056693	17577334	520641	g_31565	g_19511
ptg000006l	17582630	17585037	2407	g_19511	g_3444
ptg000006l	17586427	17587676	1249	g_3444	g_108
ptg000006l	17598967	17605800	6833	g_108	g_25909
ptg000006l	17608368	17610433	2065	g_25909	g_6661
ptg000006l	17615150	17619223	4073	g_6661	g_13242
ptg000006l	17620333	17622923	2590	g_13242	g_3058
ptg000006l	17624173	17635422	11249	g_3058	g_23910
ptg000006l	17642427	17647578	5151	g_23910	g_19827
ptg000006l	17649800	17651098	1298	g_19827	g_12820
ptg000006l	17657683	17659589	1906	g_12820	g_602
ptg000006l	17660327	17667734	7407	g_602	g_5144
ptg000006l	17684367	17696920	12553	g_5144	g_8758
ptg000006l	17698625	17719447	20822	g_8758	g_14891
ptg000006l	17739675	17743950	4275	g_14891	g_20332
ptg000006l	17753524	17755084	1560	g_20332	g_5461
ptg000006l	17759035	17762720	3685	g_5461	g_15622
ptg000006l	17766292	17770119	3827	g_15622	g_19377
ptg000006l	17776002	17781342	5340	g_19377	g_34428
ptg000006l	17790650	17797003	6353	g_34428	g_29215
ptg000006l	17805108	17809717	4609	g_29215	g_6710
ptg000006l	17818287	17823140	4853	g_6710	g_15653
ptg000006l	17833888	17836928	3040	g_15653	g_4544
ptg000006l	17896933	17915860	18927	g_33786	g_19853
ptg000006l	17916753	17934618	17865	g_19853	g_26361
ptg000006l	17960619	17964662	4043	g_26361	g_4811
ptg000006l	17989508	18242975	253467	g_4811	g_15750
ptg000006l	18251652	18256986	5334	g_15750	g_26931
ptg000006l	18261637	18277857	16220	g_26931	g_9485
ptg000006l	18278480	18281993	3513	g_9485	g_4850
ptg000006l	18290519	18317667	27148	g_4850	g_5162
ptg000006l	18320279	18327091	6812	g_5162	g_26200
ptg000006l	18327306	18328592	1286	g_26200	g_2758
ptg000006l	18329245	18342111	12866	g_2758	g_21331
ptg000006l	18347995	18353245	5250	g_21331	g_5632
ptg000006l	18357024	18363490	6466	g_5632	g_10039
ptg000006l	18371727	18390904	19177	g_10039	g_36910
ptg000006l	18397710	18402188	4478	g_36910	g_3461
ptg000006l	18403786	18407018	3232	g_3461	g_30993
ptg000006l	18408103	18418676	10573	g_30993	g_34319
ptg000006l	18423867	18434433	10566	g_34319	g_5724
ptg000006l	18452572	18460850	8278	g_5724	g_16283
ptg000006l	18461743	18487406	25663	g_16283	g_30978
ptg000006l	18490537	18531963	41426	g_30978	g_21460
ptg000006l	18532289	18552289	20000	g_21460	g_23106
ptg000006l	18555015	18556334	1319	g_23106	g_37181
ptg000006l	18562720	18564583	1863	g_37181	g_366
ptg000006l	18569562	18621956	52394	g_366	g_2811
ptg000006l	18622783	18715635	92852	g_2811	g_9948
ptg000006l	18717212	18725035	7823	g_9948	g_22938
ptg000006l	18726999	18730762	3763	g_22938	g_20568
ptg000006l	18733863	18738797	4934	g_20568	g_10738
ptg000006l	18743829	18784857	41028	g_10738	g_15869
ptg000006l	18786677	18792107	5430	g_15869	g_38750
ptg000006l	18792840	18896964	104124	g_38750	g_11367
ptg000006l	18900939	18932657	31718	g_11367	g_2338
ptg000006l	18937065	18987643	50578	g_2338	g_28404
ptg000006l	18998402	19004312	5910	g_28404	g_2465
ptg000006l	19006116	19023070	16954	g_2465	g_23078
ptg000006l	19025576	19027199	1623	g_23078	g_16511
ptg000006l	19030939	19033192	2253	g_16511	g_20879
ptg000006l	19038016	19039476	1460	g_20879	g_7556
ptg000006l	19041995	19088698	46703	g_7556	g_40087
ptg000006l	19097190	19097916	726	g_40087	g_10606
ptg000006l	19100575	19103766	3191	g_10606	g_27033
ptg000006l	19104541	19106253	1712	g_27033	g_40184
ptg000006l	19111002	19113863	2861	g_40184	g_18188
ptg000006l	19116376	19117851	1475	g_18188	g_25413
ptg000006l	19119064	19122158	3094	g_25413	g_38307
ptg000006l	19126304	19127125	821	g_38307	g_17069
ptg000006l	19129242	19136109	6867	g_17069	g_14902
ptg000006l	19139245	19141522	2277	g_14902	g_20833
ptg000006l	19160172	19165064	4892	g_20833	g_3017
ptg000006l	19175672	19188312	12640	g_3017	g_34068
ptg000006l	19189295	19191618	2323	g_34068	g_39655
ptg000006l	19192541	19194739	2198	g_39655	g_3636
ptg000006l	19219447	19221793	2346	g_3636	g_3219
ptg000006l	19237990	19250052	12062	g_3219	g_8152
ptg000006l	19256469	19262024	5555	g_39473	g_34858
ptg000006l	19264507	19266070	1563	g_34858	g_33507
ptg000006l	19274061	19274824	763	g_33507	g_18623
ptg000006l	19277144	19277780	636	g_18623	g_37572
ptg000006l	19291552	19322390	30838	g_37572	g_1695
ptg000006l	19322650	19332004	9354	g_1695	g_21959
ptg000006l	19333722	19347043	13321	g_21959	g_3410
ptg000006l	19347927	19353348	5421	g_3410	g_32664
ptg000006l	19354265	19361000	6735	g_32664	g_19313
ptg000006l	19361866	19367949	6083	g_19313	g_399
ptg000006l	19368836	19382987	14151	g_399	g_29261
ptg000006l	19384617	19386870	2253	g_29261	g_32671
ptg000006l	19392904	19449879	56975	g_32671	g_22484
ptg000006l	19451995	19456210	4215	g_22484	g_9543
ptg000006l	19459932	19460991	1059	g_9543	g_35862
ptg000006l	19462747	19466094	3347	g_35862	g_21128
ptg000006l	19471246	19474843	3597	g_21128	g_20555
ptg000006l	19493742	19502001	8259	g_20555	g_4528
ptg000006l	19507934	19513592	5658	g_4528	g_26027
ptg000006l	19521059	19528853	7794	g_26027	g_35285
ptg000006l	19543214	19547885	4671	g_35285	g_23947
ptg000006l	19552792	19567703	14911	g_23947	g_40247
ptg000006l	19569149	19596170	27021	g_40247	g_34102
ptg000006l	19596385	19691413	95028	g_34102	g_33146
ptg000006l	19701427	19715698	14271	g_33146	g_37236
ptg000006l	19739319	19742507	3188	g_37236	g_9658
ptg000006l	19744999	19778704	33705	g_9658	g_4256
ptg000006l	19784154	19787414	3260	g_4256	g_13700
ptg000006l	19800204	19807614	7410	g_13700	g_22989
ptg000006l	19824692	19863134	38442	g_22989	g_29176
ptg000006l	19880979	19882555	1576	g_29176	g_7426
ptg000006l	19884662	19924462	39800	g_7426	g_1106
ptg000006l	19926149	19935889	9740	g_1106	g_6366
ptg000006l	19937684	19939782	2098	g_6366	g_19889
ptg000006l	19951412	19953569	2157	g_19889	g_29993
ptg000006l	19959013	19963897	4884	g_29993	g_31248
ptg000006l	19967273	19970930	3657	g_31248	g_36797
ptg000006l	19975628	20022739	47111	g_36797	g_22554
ptg000006l	20049474	20058896	9422	g_22554	g_10257
ptg000006l	20073953	20077254	3301	g_10257	g_29606
ptg000006l	20113849	20155290	41441	g_29606	g_29518
ptg000006l	20178760	20238197	59437	g_29518	g_661
ptg000006l	20238982	20365902	126920	g_661	g_31705
ptg000006l	20366327	20423057	56730	g_31705	g_28078
ptg000006l	20425806	20456567	30761	g_28078	g_15400
ptg000006l	20462389	20482252	19863	g_15400	g_33566
ptg000006l	20487844	20491949	4105	g_33566	g_19159
ptg000006l	20499725	20504756	5031	g_19159	g_15823
ptg000006l	20512797	20543319	30522	g_15823	g_27670
ptg000006l	20557523	20559092	1569	g_27670	g_2950
ptg000006l	20570327	20642412	72085	g_2950	g_4735
ptg000006l	20642816	20851118	208302	g_4735	g_38875
ptg000006l	20851330	20919037	67707	g_38875	g_10140
ptg000006l	20931179	21069664	138485	g_10140	g_27301
ptg000006l	21070116	21086015	15899	g_27301	g_24623
ptg000006l	21086281	21212808	126527	g_24623	g_28490
ptg000006l	21213128	21245319	32191	g_28490	g_34007
ptg000006l	21271653	21275217	3564	g_34007	g_4941
ptg000006l	21277729	21296612	18883	g_4941	g_10006
ptg000006l	21314543	21341195	26652	g_10006	g_2081
ptg000006l	21344737	21361354	16617	g_2081	g_22024
ptg000006l	21366142	21378843	12701	g_22024	g_23816
ptg000006l	21384697	21387537	2840	g_23816	g_34946
ptg000006l	21399928	21407869	7941	g_34946	g_27600
ptg000006l	21411236	21412221	985	g_27600	g_21497
ptg000006l	21413601	21417572	3971	g_21497	g_40214
ptg000006l	21426844	21435571	8727	g_40214	g_18398
ptg000006l	21437502	21446574	9072	g_18398	g_12937
ptg000006l	21452731	21484971	32240	g_12937	g_14916
ptg000006l	21501457	21512138	10681	g_14916	g_27509
ptg000006l	21523585	21554463	30878	g_27509	g_13450
ptg000006l	21557457	21559328	1871	g_13450	g_24783
ptg000006l	21562151	21566251	4100	g_24783	g_3336
ptg000006l	21569126	21576252	7126	g_3336	g_20819
ptg000006l	21583905	21584616	711	g_20819	g_3752
ptg000006l	21588174	21592481	4307	g_3752	g_216
ptg000006l	21592945	21594826	1881	g_216	g_30455
ptg000006l	21601795	21616416	14621	g_30455	g_36718
ptg000006l	21624135	21624603	468	g_36718	g_40292
ptg000006l	21625163	21627795	2632	g_40292	g_30245
ptg000006l	21640944	21646598	5654	g_30245	g_34493
ptg000006l	21646936	21680982	34046	g_34493	g_20976
ptg000006l	21687073	21696114	9041	g_20976	g_33051
ptg000006l	21702238	21727617	25379	g_33051	g_19229
ptg000006l	21731721	21772594	40873	g_19229	g_34880
ptg000006l	21777916	21779976	2060	g_34880	g_13035
ptg000006l	21785579	21839914	54335	g_13035	g_686
ptg000006l	21875344	21879581	4237	g_686	g_21768
ptg000006l	21886327	21896279	9952	g_21768	g_28741
ptg000006l	21918732	21931417	12685	g_28741	g_15609
ptg000006l	21969487	22005967	36480	g_15609	g_26709
ptg000006l	22017103	22128967	111864	g_26709	g_13959
ptg000006l	22132227	22133691	1464	g_13959	g_7585
ptg000006l	22134460	22139590	5130	g_7585	g_25551
ptg000006l	22142142	22377648	235506	g_25551	g_9068
ptg000006l	22378712	22406849	28137	g_9068	g_17033
ptg000006l	22407361	22494008	86647	g_17033	g_38746
ptg000006l	22495366	22747460	252094	g_38746	g_17262
ptg000006l	22763963	22820964	57001	g_17262	g_37005
ptg000006l	22841961	22887750	45789	g_37005	g_29
ptg000006l	22909482	22916028	6546	g_29	g_14880
ptg000006l	22924636	22926189	1553	g_14880	g_13475
ptg000006l	22933687	22935544	1857	g_13475	g_18187
ptg000006l	22944222	22945237	1015	g_18187	g_20991
ptg000006l	22970466	22971090	624	g_20991	g_28151
ptg000006l	22971371	22974248	2877	g_28151	g_14414
ptg000006l	22991295	22992161	866	g_14414	g_19720
ptg000006l	22994585	22996211	1626	g_19720	g_21602
ptg000006l	22999797	23027618	27821	g_21602	g_25185
ptg000006l	23032964	23088717	55753	g_25185	g_8128
ptg000006l	23089397	23245090	155693	g_8128	g_9728
ptg000006l	23249197	23276134	26937	g_9728	g_37512
ptg000006l	23278093	23280409	2316	g_37512	g_10093
ptg000006l	23288860	23361494	72634	g_10093	g_35371
ptg000006l	23370151	23494394	124243	g_35371	g_20956
ptg000006l	23494804	23557841	63037	g_20956	g_29138
ptg000006l	23571673	23631195	59522	g_29138	g_16321
ptg000006l	23631758	23631909	151	g_16321	g_40156
ptg000006l	23633465	23671677	38212	g_40156	g_4412
ptg000006l	23672096	23704155	32059	g_4412	g_7311
ptg000006l	23713771	23716958	3187	g_7311	g_30216
ptg000006l	23722254	23737095	14841	g_30216	g_18144
ptg000006l	23744177	23784343	40166	g_18144	g_27609
ptg000006l	23784561	23855196	70635	g_27609	g_32345
ptg000006l	23857252	23879459	22207	g_32345	g_39123
ptg000006l	23879788	23883212	3424	g_39123	g_21367
ptg000006l	23883424	23905327	21903	g_21367	g_30620
ptg000006l	23908127	23932102	23975	g_30620	g_4475
ptg000006l	23932362	23935282	2920	g_4475	g_17229
ptg000006l	23935836	23936446	610	g_17229	g_39242
ptg000006l	23936775	23940932	4157	g_39242	g_6618
ptg000006l	23941177	23944096	2919	g_6618	g_39957
ptg000006l	23944650	23949027	4377	g_39957	g_2978
ptg000006l	23949239	23970519	21280	g_2978	g_32313
ptg000006l	23973342	23990009	16667	g_32313	g_2871
ptg000006l	23990239	23993159	2920	g_2871	g_33055
ptg000006l	23993713	23994322	609	g_33055	g_39577
ptg000006l	23994651	23998811	4160	g_39577	g_639
ptg000006l	23999059	24001979	2920	g_639	g_12810
ptg000006l	24002533	24003142	609	g_12810	g_40115
ptg000006l	24003465	24007774	4309	g_40115	g_20079
ptg000006l	24008010	24010929	2919	g_20079	g_4929
ptg000006l	24011483	24015720	4237	g_4929	g_6001
ptg000006l	24015932	24039024	23092	g_6001	g_30906
ptg000006l	24048026	24060347	12321	g_30906	g_9064
ptg000006l	24069699	24145640	75941	g_9064	g_39015
ptg000006l	24147925	24181855	33930	g_39015	g_3960
ptg000006l	24183870	24192715	8845	g_3960	g_7964
ptg000006l	24194491	24195232	741	g_7964	g_38010
ptg000006l	24196197	24342358	146161	g_38010	g_17752
ptg000006l	24342594	24369229	26635	g_17752	g_19856
ptg000006l	24400728	24510512	109784	g_19856	g_11420
ptg000006l	24514735	24516689	1954	g_11420	g_13713
ptg000006l	24529689	24531997	2308	g_13713	g_17315
ptg000006l	24537244	24570844	33600	g_17315	g_31088
ptg000006l	24585499	24621466	35967	g_31088	g_17310
ptg000006l	24624464	24637025	12561	g_17310	g_29183
ptg000006l	24640501	24656479	15978	g_29183	g_3732
ptg000006l	24657174	24731872	74698	g_3732	g_31746
ptg000006l	24797806	25018627	220821	g_31746	g_14755
ptg000006l	25051663	25093421	41758	g_14755	g_37351
ptg000006l	25107834	25139330	31496	g_37351	g_27613
ptg000006l	25141186	25217341	76155	g_27613	g_29018
ptg000006l	25238617	25249103	10486	g_29018	g_10598
ptg000006l	25259852	25273133	13281	g_10598	g_14733
ptg000006l	25279750	25317673	37923	g_14733	g_20490
ptg000006l	25332245	25360607	28362	g_20490	g_26053
ptg000006l	25379169	25427769	48600	g_26053	g_28165
ptg000006l	25428002	25444367	16365	g_28165	g_15649
ptg000006l	25492432	25515901	23469	g_15649	g_15056
ptg000006l	25517213	25518152	939	g_15056	g_26552
ptg000006l	25520867	25546491	25624	g_26552	g_7375
ptg000006l	25550104	25551926	1822	g_7375	g_21857
ptg000006l	25557755	25561899	4144	g_21857	g_25892
ptg000006l	25562462	25562626	164	g_25892	g_21465
ptg000006l	25563039	25586627	23588	g_21465	g_3282
ptg000006l	25598483	25643224	44741	g_3282	g_33521
ptg000006l	25658535	25662028	3493	g_33521	g_17754
ptg000006l	25673611	25886542	212931	g_17754	g_32016
ptg000006l	25950450	25953272	2822	g_32016	g_32835
ptg000006l	25962306	26034052	71746	g_32835	g_17887
ptg000006l	26042387	26104172	61785	g_17887	g_19479
ptg000006l	26104513	26115849	11336	g_19479	g_32614
ptg000006l	26116475	26154373	37898	g_32614	g_34330
ptg000006l	26154651	26159919	5268	g_34330	g_19400
ptg000006l	26160368	26280994	120626	g_19400	g_1677
ptg000006l	26294782	26299086	4304	g_1677	g_26355
ptg000006l	26299448	26301901	2453	g_26355	g_17548
ptg000006l	26316636	26373392	56756	g_17548	g_11496
ptg000006l	26375858	26407451	31593	g_11496	g_36048
ptg000006l	26407687	26407797	110	g_36048	g_14297
ptg000006l	26429348	26447722	18374	g_14297	g_6051
ptg000006l	26452407	26459485	7078	g_6051	g_35215
ptg000006l	26459688	26537114	77426	g_35215	g_34411
ptg000006l	26537638	26551442	13804	g_34411	g_1052
ptg000006l	26556185	26608388	52203	g_1052	g_24825
ptg000006l	26630867	26686693	55826	g_24825	g_13068
ptg000006l	26687256	26799149	111893	g_13068	g_36198
ptg000006l	26809875	26815418	5543	g_36198	g_12947
ptg000006l	26830880	27055465	224585	g_12947	g_15302
ptg000006l	27057704	27321856	264152	g_15302	g_28557
ptg000006l	27343116	27345333	2217	g_28557	g_36814
ptg000006l	27349438	27354730	5292	g_36814	g_20601
ptg000006l	27367005	27372713	5708	g_20601	g_2363
ptg000006l	27390669	27405789	15120	g_2363	g_16432
ptg000006l	27407019	27408046	1027	g_16432	g_40157
ptg000006l	27420400	27429264	8864	g_40157	g_19200
ptg000006l	27435196	27467601	32405	g_19200	g_12423
ptg000006l	27467840	27486550	18710	g_12423	g_12949
ptg000006l	27507307	27517710	10403	g_12949	g_5837
ptg000006l	27528995	27532198	3203	g_5837	g_36838
ptg000006l	27542002	27547115	5113	g_36838	g_12767
ptg000006l	27559385	27611741	52356	g_12767	g_6677
ptg000006l	27616028	27696698	80670	g_6677	g_33179
ptg000006l	27710467	27720898	10431	g_33179	g_17815
ptg000006l	27723300	27776176	52876	g_17815	g_8595
ptg000006l	27777246	27959163	181917	g_8595	g_24692
ptg000006l	27962127	27964518	2391	g_24692	g_12945
ptg000006l	27966098	27976031	9933	g_12945	g_37805
ptg000006l	27977611	27985516	7905	g_37805	g_7423
ptg000006l	27993572	28020324	26752	g_7423	g_15278
ptg000006l	28020536	28029830	9294	g_15278	g_12110
ptg000006l	28034053	28036486	2433	g_12110	g_24986
ptg000006l	28038362	28146774	108412	g_24986	g_10318
ptg000006l	28148533	28155518	6985	g_10318	g_15131
ptg000006l	28174203	28184405	10202	g_15131	g_12616
ptg000006l	28184803	28186470	1667	g_12616	g_19285
ptg000006l	28187141	28188552	1411	g_19285	g_16664
ptg000006l	28200386	28226441	26055	g_16664	g_8076
ptg000006l	28230936	28264136	33200	g_8076	g_7794
ptg000006l	28277302	28280945	3643	g_7794	g_32822
ptg000006l	28281661	28300420	18759	g_32822	g_16419
ptg000006l	28310208	28312494	2286	g_16419	g_32466
ptg000006l	28313495	28315327	1832	g_32466	g_1546
ptg000006l	28328463	28367370	38907	g_1546	g_34290
ptg000006l	28373685	28387611	13926	g_34290	g_12883
ptg000006l	28412345	28493608	81263	g_12883	g_25781
ptg000006l	28493991	28614116	120125	g_25781	g_11653
ptg000006l	28614472	28656818	42346	g_11653	g_30923
ptg000006l	28658554	28669823	11269	g_30923	g_20255
ptg000006l	28672072	28718542	46470	g_20255	g_33268
ptg000006l	28718892	28732810	13918	g_33268	g_18726
ptg000006l	28740115	28826470	86355	g_18726	g_35298
ptg000006l	28862190	28863540	1350	g_35298	g_26165
ptg000006l	28868214	28884747	16533	g_26165	g_22302
ptg000006l	28899597	28931297	31700	g_22302	g_8483
ptg000006l	28936715	28961352	24637	g_8483	g_8628
ptg000006l	28961570	28987894	26324	g_8628	g_30570
ptg000006l	28988691	29087602	98911	g_30570	g_11714
ptg000006l	29088183	29203635	115452	g_11714	g_29700
ptg000006l	29208015	29231594	23579	g_29700	g_10406
ptg000006l	29234184	29345996	111812	g_10406	g_343
ptg000006l	29359317	29362425	3108	g_343	g_37526
ptg000006l	29365950	29517389	151439	g_37526	g_23716
ptg000006l	29524906	29531422	6516	g_23716	g_7570
ptg000006l	29536952	29549804	12852	g_7570	g_5398
ptg000006l	29556031	29574798	18767	g_5398	g_10386
ptg000006l	29591023	29631850	40827	g_10386	g_5436
ptg000006l	29646789	29677922	31133	g_5436	g_15167
ptg000006l	29684349	29700287	15938	g_15167	g_11500
ptg000006l	29700535	29702401	1866	g_11500	g_25677
ptg000006l	29707049	29718243	11194	g_25677	g_39211
ptg000006l	29721896	29785558	63662	g_39211	g_21906
ptg000006l	29798873	29808261	9388	g_21906	g_7736
ptg000006l	29834900	29893636	58736	g_7736	g_3740
ptg000006l	29899628	29914724	15096	g_3740	g_39256
ptg000006l	29915026	29940001	24975	g_39256	g_3593
ptg000006l	29947475	29958299	10824	g_3593	g_14429
ptg000006l	29965916	29975444	9528	g_14429	g_12019
ptg000006l	29978652	30005297	26645	g_12019	g_28573
ptg000006l	30015260	30072778	57518	g_28573	g_24919
ptg000006l	30073110	30101812	28702	g_24919	g_249
ptg000006l	30102084	30102111	27	g_249	g_15728
ptg000006l	30102389	30102980	591	g_15728	g_11160
ptg000006l	30109546	30136827	27281	g_11160	g_18634
ptg000006l	30160565	30175480	14915	g_18634	g_32920
ptg000006l	30175686	30251908	76222	g_32920	g_36726
ptg000006l	30252870	30296908	44038	g_36726	g_7385
ptg000006l	30297453	30332465	35012	g_7385	g_34396
ptg000006l	30332770	30366018	33248	g_34396	g_16744
ptg000006l	30366473	30488158	121685	g_16744	g_23228
ptg000006l	30500548	30514141	13593	g_23228	g_36940
ptg000006l	30529070	30534262	5192	g_36940	g_25977
ptg000006l	30561589	30601822	40233	g_25977	g_28509
ptg000006l	30602229	30632261	30032	g_28509	g_32794
ptg000006l	30633538	30635364	1826	g_32794	g_29379
ptg000006l	30635645	30662247	26602	g_29379	g_16922
ptg000006l	30675459	30902895	227436	g_16922	g_28162
ptg000006l	30916604	30920315	3711	g_28162	g_37091
ptg000006l	30923167	30930812	7645	g_37091	g_878
ptg000006l	30945544	30950327	4783	g_878	g_19958
ptg000006l	30950797	30956699	5902	g_19958	g_30087
ptg000006l	30956920	30959315	2395	g_30087	g_20649
ptg000006l	30960910	31002333	41423	g_20649	g_9632
ptg000006l	31002581	31008554	5973	g_9632	g_10368
ptg000006l	31010403	31015616	5213	g_10368	g_31768
ptg000006l	31016194	31021396	5202	g_31768	g_9617
ptg000006l	31027812	31040496	12684	g_9617	g_30696
ptg000006l	31065050	31089699	24649	g_30696	g_28255
ptg000006l	31090791	31149940	59149	g_28255	g_12408
ptg000006l	31159728	31188910	29182	g_12408	g_37084
ptg000006l	31196054	31200890	4836	g_37084	g_1172
ptg000006l	31205221	31212987	7766	g_1172	g_14605
ptg000006l	31221544	31228070	6526	g_14605	g_17977
ptg000006l	31232336	31250454	18118	g_17977	g_31196
ptg000006l	31263578	31302866	39288	g_31196	g_27633
ptg000006l	31303084	31315645	12561	g_27633	g_34251
ptg000006l	31315845	31330608	14763	g_34251	g_13377
ptg000006l	31330961	31384530	53569	g_13377	g_103
ptg000006l	31384874	31384939	65	g_103	g_17491
ptg000006l	31385343	31420531	35188	g_17491	g_29695
ptg000006l	31420752	31521503	100751	g_29695	g_20855
ptg000006l	31526874	31575773	48899	g_20855	g_801
ptg000006l	31576168	31608188	32020	g_801	g_29666
ptg000006l	31608418	31653123	44705	g_29666	g_31757
ptg000006l	31661082	31717333	56251	g_31757	g_33715
ptg000006l	31718247	31774203	55956	g_33715	g_8787
ptg000006l	31774886	31789957	15071	g_8787	g_26721
ptg000006l	31795511	31817493	21982	g_26721	g_2108
ptg000006l	31821200	31833112	11912	g_2108	g_22794
ptg000006l	31841421	31872529	31108	g_22794	g_675
ptg000006l	31873872	31888222	14350	g_675	g_36246
ptg000006l	31898679	31909882	11203	g_36246	g_28465
ptg000006l	31924953	31925732	779	g_28465	g_4147
ptg000006l	31935779	31966440	30661	g_4147	g_15475
ptg000006l	31970498	31971243	745	g_15475	g_5910
ptg000006l	31972499	31981784	9285	g_5910	g_31968
ptg000006l	31985914	32028061	42147	g_31968	g_6595
ptg000006l	32028312	32044627	16315	g_6595	g_18094
ptg000006l	32061881	32067729	5848	g_18094	g_36516
ptg000006l	32073222	32087531	14309	g_36516	g_19803
ptg000006l	32091085	32119145	28060	g_19803	g_5465
ptg000006l	32125749	32161156	35407	g_5465	g_29348
ptg000006l	32162877	32200060	37183	g_29348	g_18718
ptg000006l	32200779	32282490	81711	g_18718	g_293
ptg000006l	32283518	32295110	11592	g_293	g_37756
ptg000006l	32300247	32329507	29260	g_37756	g_12155
ptg000006l	32331728	32343481	11753	g_12155	g_12751
ptg000006l	32359423	32362970	3547	g_12751	g_23826
ptg000006l	32363575	32401802	38227	g_23826	g_29388
ptg000006l	32402089	32417988	15899	g_29388	g_3911
ptg000006l	32431231	32587516	156285	g_3911	g_39826
ptg000006l	32588148	32601497	13349	g_39826	g_27832
ptg000006l	32601697	32631816	30119	g_27832	g_23875
ptg000006l	32632583	32699210	66627	g_23875	g_36432
ptg000006l	32719697	32722785	3088	g_36432	g_2356
ptg000006l	32731852	32734518	2666	g_2356	g_8022
ptg000006l	32738442	32740126	1684	g_8022	g_27903
ptg000006l	32740476	32742691	2215	g_27903	g_30348
ptg000006l	32748393	32801672	53279	g_30348	g_618
ptg000006l	32802376	32816899	14523	g_618	g_7547
ptg000006l	32840333	32845123	4790	g_7547	g_14958
ptg000006l	32845530	32849468	3938	g_14958	g_17477
ptg000006l	32864572	32866018	1446	g_17477	g_2870
ptg000006l	32884897	32889030	4133	g_2870	g_31148
ptg000006l	32889239	32945344	56105	g_31148	g_12
ptg000006l	32974482	32997079	22597	g_12	g_16287
ptg000006l	33004634	33050479	45845	g_16287	g_3132
ptg000006l	33052866	33078179	25313	g_3132	g_19149
ptg000006l	33078511	33111212	32701	g_19149	g_20948
ptg000006l	33111730	33112671	941	g_20948	g_30282
ptg000006l	33113342	33114068	726	g_30282	g_20850
ptg000006l	33114373	33114407	34	g_20850	g_891
ptg000006l	33115351	33145155	29804	g_891	g_229
ptg000006l	33145454	33193947	48493	g_229	g_20286
ptg000006l	33206463	33241779	35316	g_20286	g_34681
ptg000006l	33242063	33267491	25428	g_34681	g_26265
ptg000006l	33267883	33290673	22790	g_26265	g_15985
ptg000006l	33291029	33294470	3441	g_15985	g_19829
ptg000006l	33294685	33307313	12628	g_19829	g_28059
ptg000006l	33315925	33336539	20614	g_28059	g_32761
ptg000006l	33337546	33345952	8406	g_32761	g_14645
ptg000006l	33362795	33371022	8227	g_14645	g_6317
ptg000006l	33396004	33439458	43454	g_6317	g_25566
ptg000006l	33439661	33444051	4390	g_25566	g_2325
ptg000006l	33444278	33484831	40553	g_2325	g_344
ptg000006l	33485823	33526393	40570	g_344	g_5810
ptg000006l	33526950	33567338	40388	g_5810	g_32371
ptg000006l	33567796	33572947	5151	g_32371	g_18055
ptg000006l	33573417	33636343	62926	g_18055	g_37312
ptg000006l	33645712	33712695	66983	g_37312	g_12447
ptg000006l	33712916	33761514	48598	g_12447	g_26942
ptg000006l	33761816	33762999	1183	g_26942	g_18170
ptg000006l	33763247	33825581	62334	g_18170	g_4503
ptg000006l	33838407	33934357	95950	g_4503	g_4422
ptg000006l	33935091	33951693	16602	g_4422	g_9262
ptg000006l	33951902	33964163	12261	g_9262	g_9311
ptg000006l	33968814	33970499	1685	g_9311	g_1883
ptg000006l	33972369	34044764	72395	g_1883	g_25408
ptg000006l	34046284	34111041	64757	g_25408	g_14368
ptg000006l	34111487	34141478	29991	g_14368	g_29539
ptg000006l	34167192	34169838	2646	g_29539	g_19535
ptg000006l	34173692	34199137	25445	g_19535	g_27036
ptg000006l	34202700	34226793	24093	g_27036	g_16253
ptg000006l	34233999	34240453	6454	g_16253	g_11139
ptg000006l	34251254	34300581	49327	g_11139	g_12445
ptg000006l	34302542	34365315	62773	g_12445	g_7602
ptg000006l	34365524	34369554	4030	g_7602	g_15166
ptg000006l	34397091	34494466	97375	g_15166	g_4757
ptg000006l	34511568	34520309	8741	g_4757	g_4832
ptg000006l	34521082	34609847	88765	g_4832	g_22686
ptg000007l	56822	62174	5352	g_11469	g_8897
ptg000007l	63007	101554	38547	g_8897	g_32351
ptg000007l	105335	105934	599	g_32351	g_35592
ptg000007l	109428	115760	6332	g_35592	g_14293
ptg000007l	117209	169515	52306	g_4717	g_13047
ptg000007l	170429	171188	759	g_13047	g_32897
ptg000007l	172042	182932	10890	g_32897	g_28825
ptg000007l	183444	237690	54246	g_28825	g_7222
ptg000007l	238802	238812	10	g_7222	g_9882
ptg000007l	249136	249983	847	g_9882	g_4691
ptg000007l	250321	259847	9526	g_4691	g_8253
ptg000007l	272447	278095	5648	g_8253	g_24355
ptg000007l	288233	371264	83031	g_24355	g_39679
ptg000007l	371698	373560	1862	g_39679	g_22355
ptg000007l	387058	393182	6124	g_22355	g_30297
ptg000007l	409269	418947	9678	g_30297	g_26563
ptg000007l	430645	436399	5754	g_26563	g_12746
ptg000007l	440963	493537	52574	g_12746	g_23251
ptg000007l	508054	513935	5881	g_23251	g_22614
ptg000007l	527451	532268	4817	g_22614	g_10002
ptg000007l	536119	551807	15688	g_10002	g_31191
ptg000008l	88633	93233	4600	g_3309	g_7006
ptg000008l	93604	112279	18675	g_7006	g_19711
ptg000008l	118862	132841	13979	g_19711	g_39671
ptg000008l	135858	141157	5299	g_3463	g_32593
ptg000008l	141378	177104	35726	g_32593	g_25944
ptg000008l	191477	256065	64588	g_25944	g_852
ptg000008l	257348	363595	106247	g_852	g_1515
ptg000008l	365435	374121	8686	g_1515	g_13688
ptg000008l	395797	397550	1753	g_13688	g_33713
ptg000008l	401068	402235	1167	g_33713	g_3705
ptg000008l	410016	413370	3354	g_3705	g_11146
ptg000008l	414435	418914	4479	g_11146	g_10262
ptg000008l	431979	444071	12092	g_10262	g_13282
ptg000008l	458313	459923	1610	g_13282	g_37593
ptg000008l	464852	466383	1531	g_37593	g_5417
ptg000008l	486063	490856	4793	g_5417	g_4031
ptg000008l	495715	512191	16476	g_4031	g_39820
ptg000008l	512718	522012	9294	g_39820	g_28713
ptg000008l	523487	525076	1589	g_28713	g_37664
ptg000008l	525794	527058	1264	g_37664	g_17441
ptg000008l	529050	531442	2392	g_17441	g_10513
ptg000008l	533046	570873	37827	g_10513	g_22306
ptg000008l	572024	584842	12818	g_22306	g_35083
ptg000008l	585069	819857	234788	g_35083	g_25459
ptg000008l	822863	849659	26796	g_25459	g_26309
ptg000008l	864564	871053	6489	g_26309	g_33151
ptg000008l	881260	1046808	165548	g_33151	g_28416
ptg000008l	1048214	1111717	63503	g_28416	g_18882
ptg000008l	1112022	1130107	18085	g_18882	g_9449
ptg000008l	1138072	1141902	3830	g_9449	g_20675
ptg000008l	1165039	1175429	10390	g_20675	g_2112
ptg000008l	1187640	1222929	35289	g_2112	g_17793
ptg000008l	1223588	1242165	18577	g_17793	g_17761
ptg000008l	1242632	1285941	43309	g_17761	g_4676
ptg000008l	1311778	1319625	7847	g_4676	g_3595
ptg000008l	1334596	1342794	8198	g_3595	g_34432
ptg000008l	1355448	1357485	2037	g_34432	g_32448
ptg000008l	1368657	1369723	1066	g_32448	g_3980
ptg000008l	1372921	1380832	7911	g_3980	g_32772
ptg000008l	1381032	1384899	3867	g_32772	g_34800
ptg000008l	1399976	1405967	5991	g_34800	g_22920
ptg000008l	1415709	1421731	6022	g_22920	g_3529
ptg000008l	1438479	1439546	1067	g_3529	g_32592
ptg000008l	1443565	1445034	1469	g_32592	g_4847
ptg000008l	1451787	1458591	6804	g_4847	g_44
ptg000008l	1460467	1572026	111559	g_44	g_27573
ptg000008l	1576933	1579713	2780	g_27573	g_15348
ptg000008l	1581485	1582402	917	g_15348	g_27626
ptg000008l	1595919	1617867	21948	g_27626	g_35052
ptg000008l	1633742	1636666	2924	g_35052	g_12853
ptg000008l	1637784	1640660	2876	g_12853	g_19078
ptg000008l	1642578	1645469	2891	g_19078	g_9702
ptg000008l	1650865	1655921	5056	g_9702	g_17736
ptg000008l	1660105	1661288	1183	g_17736	g_14032
ptg000008l	1668502	1689955	21453	g_14032	g_33575
ptg000008l	1691773	1692960	1187	g_33575	g_29898
ptg000008l	1694153	1707857	13704	g_29898	g_16115
ptg000008l	1708980	1730418	21438	g_16115	g_19337
ptg000008l	1751119	1765970	14851	g_19337	g_30766
ptg000008l	1770704	1773374	2670	g_30766	g_10874
ptg000008l	1778520	1780906	2386	g_10874	g_34588
ptg000008l	1787324	1796398	9074	g_34588	g_11747
ptg000008l	1796844	1798627	1783	g_11747	g_21916
ptg000008l	1801386	1802009	623	g_21916	g_31795
ptg000008l	1807571	1812067	4496	g_31795	g_29465
ptg000008l	1823567	1829607	6040	g_29465	g_711
ptg000008l	1833948	1845593	11645	g_711	g_25834
ptg000008l	1846144	1988636	142492	g_25834	g_9075
ptg000008l	1994852	2122460	127608	g_9075	g_31806
ptg000008l	2123368	2124920	1552	g_31806	g_2148
ptg000008l	2125138	2126346	1208	g_2148	g_8633
ptg000008l	2134894	2142301	7407	g_8633	g_26071
ptg000008l	2163110	2169569	6459	g_26071	g_15323
ptg000008l	2170033	2181214	11181	g_15323	g_23902
ptg000008l	2181450	2206829	25379	g_23902	g_7507
ptg000008l	2209548	2312323	102775	g_7507	g_22763
ptg000008l	2313501	2352480	38979	g_22763	g_25498
ptg000008l	2352779	2424609	71830	g_25498	g_32604
ptg000008l	2445968	2448514	2546	g_32604	g_10877
ptg000008l	2448747	2449264	517	g_10877	g_1491
ptg000008l	2449497	2495001	45504	g_1491	g_34810
ptg000008l	2504248	2506585	2337	g_34810	g_2357
ptg000008l	2516687	2518724	2037	g_2357	g_1872
ptg000008l	2548843	2601378	52535	g_1872	g_36300
ptg000008l	2610626	2678495	67869	g_36300	g_22919
ptg000008l	2678869	2706012	27143	g_22919	g_19779
ptg000008l	2709482	2715003	5521	g_19779	g_7853
ptg000008l	2715755	2738091	22336	g_7853	g_7148
ptg000008l	2749391	2784495	35104	g_7148	g_7145
ptg000008l	2785100	2812799	27699	g_7145	g_24617
ptg000008l	2827057	2827355	298	g_24617	g_6348
ptg000008l	2830906	2833533	2627	g_6348	g_15474
ptg000008l	2838131	2839229	1098	g_15474	g_25660
ptg000008l	2842026	2865597	23571	g_25660	g_8877
ptg000008l	2875431	2958457	83026	g_8877	g_23450
ptg000008l	2958660	3023190	64530	g_23450	g_19394
ptg000008l	3037571	3041806	4235	g_19394	g_38030
ptg000008l	3051563	3053808	2245	g_38030	g_211
ptg000008l	3057146	3092851	35705	g_211	g_28717
ptg000008l	3095881	3099799	3918	g_28717	g_22850
ptg000008l	3108205	3186239	78034	g_22850	g_4630
ptg000008l	3186929	3200349	13420	g_4630	g_15666
ptg000008l	3202049	3203944	1895	g_15666	g_19167
ptg000008l	3211325	3214022	2697	g_19167	g_20456
ptg000008l	3217607	3258859	41252	g_20456	g_35579
ptg000008l	3263424	3264103	679	g_35579	g_37477
ptg000008l	3265395	3271837	6442	g_37477	g_8715
ptg000008l	3297742	3309178	11436	g_8715	g_779
ptg000008l	3314973	3338620	23647	g_779	g_37639
ptg000008l	3351449	3353103	1654	g_37639	g_8774
ptg000008l	3357919	3373770	15851	g_8774	g_5440
ptg000008l	3402978	3494224	91246	g_5440	g_10967
ptg000008l	3498703	3572732	74029	g_10967	g_25066
ptg000008l	3575308	3581730	6422	g_25066	g_7164
ptg000008l	3587547	3594601	7054	g_7164	g_11155
ptg000008l	3597854	3604719	6865	g_11155	g_25814
ptg000008l	3611264	3658588	47324	g_25814	g_26990
ptg000008l	3663925	3668553	4628	g_26990	g_8857
ptg000008l	3673964	3677532	3568	g_8857	g_14282
ptg000008l	3699796	3793261	93465	g_14282	g_26614
ptg000008l	3793875	3821943	28068	g_26614	g_32795
ptg000008l	3822509	3896266	73757	g_32795	g_21212
ptg000008l	3903523	3908014	4491	g_21212	g_21979
ptg000008l	3908598	3914003	5405	g_21979	g_16080
ptg000008l	3914338	3937099	22761	g_16080	g_20378
ptg000008l	3937383	3953512	16129	g_20378	g_34115
ptg000008l	3953889	3964722	10833	g_34115	g_29092
ptg000008l	3964949	4056716	91767	g_29092	g_11249
ptg000008l	4061507	4069889	8382	g_11249	g_36022
ptg000008l	4076776	4114969	38193	g_36022	g_14244
ptg000008l	4115955	4202895	86940	g_14244	g_11886
ptg000008l	4206134	4451213	245079	g_11886	g_37823
ptg000008l	4451857	4576073	124216	g_37823	g_32648
ptg000008l	4576336	4592139	15803	g_32648	g_5824
ptg000008l	4592414	4669832	77418	g_5824	g_23334
ptg000008l	4672455	4755327	82872	g_23334	g_15647
ptg000008l	4756743	4772297	15554	g_15647	g_34942
ptg000008l	4773808	4776014	2206	g_34942	g_15046
ptg000008l	4779559	4845931	66372	g_15046	g_27762
ptg000008l	4854886	4857032	2146	g_27762	g_35680
ptg000008l	4857523	4857903	380	g_35680	g_5986
ptg000008l	4858460	4928129	69669	g_5986	g_27627
ptg000008l	4946592	4947491	899	g_27627	g_15873
ptg000008l	4954855	4959135	4280	g_15873	g_16029
ptg000008l	4961825	4965653	3828	g_16029	g_24247
ptg000008l	4971440	4974867	3427	g_24247	g_12396
ptg000008l	4975886	4978933	3047	g_12396	g_36110
ptg000008l	4984130	4991534	7404	g_36110	g_18090
ptg000008l	5003308	5023252	19944	g_18090	g_36092
ptg000008l	5029404	5030375	971	g_36092	g_32474
ptg000008l	5034402	5047376	12974	g_32474	g_13635
ptg000008l	5049646	5054071	4425	g_13635	g_35695
ptg000008l	5060496	5118307	57811	g_35695	g_6605
ptg000008l	5141078	5142247	1169	g_6605	g_30762
ptg000008l	5143408	5145907	2499	g_30762	g_20863
ptg000008l	5146200	5146364	164	g_20863	g_11930
ptg000008l	5150963	5153249	2286	g_11930	g_14106
ptg000008l	5162495	5172723	10228	g_14106	g_14122
ptg000008l	5174177	5213185	39008	g_14122	g_29753
ptg000008l	5222015	5228589	6574	g_29753	g_25296
ptg000008l	5230949	5233285	2336	g_25296	g_33627
ptg000008l	5239693	5241539	1846	g_33627	g_7903
ptg000008l	5250090	5261070	10980	g_7903	g_8189
ptg000008l	5272252	5277032	4780	g_8189	g_24321
ptg000008l	5294523	5314151	19628	g_24321	g_2696
ptg000008l	5316642	5320921	4279	g_2696	g_7749
ptg000008l	5337862	5342358	4496	g_7749	g_4966
ptg000008l	5355016	5360269	5253	g_4966	g_19298
ptg000008l	5368022	5412378	44356	g_19298	g_33442
ptg000008l	5450306	5473177	22871	g_33442	g_3622
ptg000008l	5492060	5497738	5678	g_3622	g_15863
ptg000008l	5509382	5516608	7226	g_15863	g_17792
ptg000008l	5521652	5631288	109636	g_17792	g_21924
ptg000008l	5643166	5645603	2437	g_21924	g_13673
ptg000008l	5652788	5668479	15691	g_13673	g_10924
ptg000008l	5683063	5704358	21295	g_10924	g_34348
ptg000008l	5719558	5749391	29833	g_34348	g_10419
ptg000008l	5750760	5763075	12315	g_10419	g_2333
ptg000008l	5769193	5787804	18611	g_2333	g_5868
ptg000008l	5812726	5813951	1225	g_5868	g_2429
ptg000008l	5817349	5822713	5364	g_2429	g_36925
ptg000008l	5829566	5835568	6002	g_36925	g_8495
ptg000008l	5839106	5840210	1104	g_8495	g_8695
ptg000008l	5842878	5846163	3285	g_8695	g_9873
ptg000008l	5848629	5852426	3797	g_9873	g_1907
ptg000008l	5864403	5865879	1476	g_1907	g_25759
ptg000008l	5878087	5882954	4867	g_25759	g_14584
ptg000008l	5883385	5948032	64647	g_14584	g_13999
ptg000008l	5954930	5980973	26043	g_13999	g_35756
ptg000008l	5983615	5985609	1994	g_35756	g_16297
ptg000008l	6022666	6025031	2365	g_16297	g_18618
ptg000008l	6040126	6041617	1491	g_18618	g_27868
ptg000008l	6044619	6046226	1607	g_27868	g_29910
ptg000008l	6052183	6081628	29445	g_29910	g_6032
ptg000008l	6092745	6160387	67642	g_6032	g_25078
ptg000008l	6161771	6179324	17553	g_25078	g_3248
ptg000008l	6214608	6254957	40349	g_3248	g_1935
ptg000008l	6256186	6438072	181886	g_1935	g_31321
ptg000008l	6445174	6446161	987	g_31321	g_37130
ptg000008l	6448393	6449271	878	g_37130	g_21551
ptg000008l	6455664	6554958	99294	g_21551	g_21198
ptg000008l	6573900	6576748	2848	g_21198	g_18900
ptg000008l	6593060	6594806	1746	g_18900	g_28412
ptg000008l	6597498	6608069	10571	g_28412	g_1214
ptg000008l	6613857	6637331	23474	g_1214	g_4442
ptg000008l	6641086	6642919	1833	g_4442	g_16044
ptg000008l	6647556	6684039	36483	g_16044	g_2891
ptg000008l	6684380	6712735	28355	g_2891	g_7991
ptg000008l	6726538	6764419	37881	g_7991	g_36416
ptg000008l	6767439	6775527	8088	g_36416	g_21350
ptg000008l	6779718	6793474	13756	g_21350	g_16646
ptg000008l	6796754	6799852	3098	g_16646	g_7182
ptg000008l	6800184	6820087	19903	g_7182	g_21202
ptg000008l	6821863	6824864	3001	g_21202	g_15390
ptg000008l	6826053	6829692	3639	g_15390	g_13724
ptg000008l	6833744	6834529	785	g_13724	g_25122
ptg000008l	6835927	6837396	1469	g_25122	g_33607
ptg000008l	6840026	6840586	560	g_33607	g_28007
ptg000008l	6848968	6850570	1602	g_28007	g_32850
ptg000008l	6870685	6878380	7695	g_32850	g_3152
ptg000008l	6878598	6885658	7060	g_3152	g_6124
ptg000008l	6895055	6896396	1341	g_6124	g_8545
ptg000008l	6897964	6903946	5982	g_8545	g_19047
ptg000008l	6907112	6912441	5329	g_19047	g_26763
ptg000008l	6915197	6922026	6829	g_26763	g_7827
ptg000008l	6922418	6936038	13620	g_7827	g_13457
ptg000008l	6939174	6944067	4893	g_13457	g_8415
ptg000008l	6945691	6975020	29329	g_8415	g_12165
ptg000008l	6975238	7109334	134096	g_12165	g_34408
ptg000008l	7109972	7110190	218	g_34408	g_16069
ptg000008l	7111248	7113042	1794	g_16069	g_4169
ptg000008l	7114573	7116036	1463	g_4169	g_25571
ptg000008l	7117223	7117675	452	g_25571	g_39909
ptg000008l	7120493	7121691	1198	g_39909	g_527
ptg000008l	7132031	7138313	6282	g_527	g_21628
ptg000008l	7141420	7147310	5890	g_21628	g_32570
ptg000008l	7152380	7155249	2869	g_32570	g_35852
ptg000008l	7156034	7158386	2352	g_35852	g_18016
ptg000008l	7159900	7161128	1228	g_18016	g_5039
ptg000008l	7167123	7193160	26037	g_5039	g_2471
ptg000008l	7193363	7194763	1400	g_2471	g_39944
ptg000008l	7213734	7219066	5332	g_39944	g_40021
ptg000008l	7221014	7223562	2548	g_40021	g_6603
ptg000008l	7226371	7228797	2426	g_6603	g_21173
ptg000008l	7230138	7247404	17266	g_21173	g_11036
ptg000008l	7261280	7279527	18247	g_11036	g_11730
ptg000008l	7288181	7339935	51754	g_11730	g_25450
ptg000008l	7346915	7369238	22323	g_25450	g_5423
ptg000008l	7377848	7380238	2390	g_5423	g_6866
ptg000008l	7404174	7420729	16555	g_6866	g_3962
ptg000008l	7421121	7462961	41840	g_3962	g_32427
ptg000009l	10850	15195	4345	g_30091	g_34589
ptg000009l	20709	21739	1030	g_34589	g_27420
ptg000009l	24397	27542	3145	g_27420	g_18497
ptg000009l	34407	35816	1409	g_18497	g_35561
ptg000009l	40506	53688	13182	g_35561	g_8137
ptg000009l	61131	64946	3815	g_8137	g_17741
ptg000009l	78410	88650	10240	g_17741	g_30918
ptg000009l	97241	98538	1297	g_30918	g_22927
ptg000009l	111068	121582	10514	g_22927	g_1178
ptg000009l	130347	163115	32768	g_1178	g_351
ptg000009l	165659	170227	4568	g_351	g_25126
ptg000009l	177395	182299	4904	g_25126	g_19108
ptg000009l	197252	204431	7179	g_19108	g_33466
ptg000009l	220490	226223	5733	g_33466	g_23348
ptg000009l	231225	237458	6233	g_23348	g_250
ptg000009l	245276	248707	3431	g_250	g_5149
ptg000009l	253560	293622	40062	g_5149	g_16361
ptg000009l	299787	304769	4982	g_16361	g_37456
ptg000009l	310327	315343	5016	g_37456	g_22100
ptg000009l	327219	333235	6016	g_22100	g_23281
ptg000009l	352771	360017	7246	g_23281	g_11546
ptg000009l	364865	401332	36467	g_11546	g_10082
ptg000009l	408893	493346	84453	g_10082	g_31063
ptg000009l	508047	621640	113593	g_31063	g_14072
ptg000009l	631413	634816	3403	g_14072	g_4052
ptg000009l	639182	642468	3286	g_4052	g_346
ptg000009l	644182	645360	1178	g_346	g_22879
ptg000009l	660239	674166	13927	g_22879	g_4851
ptg000009l	685498	694141	8643	g_4851	g_34257
ptg000009l	696837	702176	5339	g_34257	g_37522
ptg000009l	712077	782078	70001	g_37522	g_22008
ptg000009l	782707	783848	1141	g_22008	g_35133
ptg000009l	784258	784967	709	g_35133	g_608
ptg000009l	785350	795375	10025	g_608	g_18202
ptg000009l	795758	797934	2176	g_18202	g_8335
ptg000009l	798344	801146	2802	g_8335	g_37293
ptg000009l	801775	806668	4893	g_37293	g_15197
ptg000009l	816676	820069	3393	g_15197	g_25971
ptg000009l	821091	826337	5246	g_25971	g_20685
ptg000009l	831492	880194	48702	g_20685	g_224
ptg000009l	904963	908615	3652	g_224	g_19570
ptg000009l	923663	925955	2292	g_19570	g_20533
ptg000009l	939409	951690	12281	g_20533	g_38203
ptg000009l	953196	978880	25684	g_38203	g_16537
ptg000009l	980289	986818	6529	g_16537	g_15634
ptg000009l	988230	992165	3935	g_15634	g_25154
ptg000009l	1003233	1017477	14244	g_25154	g_33661
ptg000009l	1017896	1027591	9695	g_33661	g_19907
ptg000009l	1048782	1049832	1050	g_19907	g_11286
ptg000009l	1055356	1075418	20062	g_11286	g_30166
ptg000009l	1076809	1085021	8212	g_30166	g_8997
ptg000009l	1098662	1102323	3661	g_8997	g_15041
ptg000009l	1124506	1128095	3589	g_15041	g_31949
ptg000009l	1134376	1145468	11092	g_31949	g_27859
ptg000009l	1146364	1147170	806	g_27859	g_36256
ptg000009l	1147547	1158935	11388	g_36256	g_4010
ptg000009l	1164663	1170678	6015	g_4010	g_21705
ptg000009l	1177210	1186975	9765	g_21705	g_32015
ptg000009l	1195006	1195102	96	g_32015	g_26401
ptg000009l	1196517	1196575	58	g_26401	g_16753
ptg000009l	1196892	1197400	508	g_16753	g_31204
ptg000009l	1197717	1198001	284	g_31204	g_14568
ptg000011l	1964	41255	39291	g_18839	g_13306
ptg000011l	43870	48692	4822	g_13306	g_18511
ptg000011l	50617	56835	6218	g_18511	g_5028
ptg000011l	59082	66777	7695	g_5028	g_9364
ptg000011l	73616	81064	7448	g_9364	g_25753
ptg000011l	86210	90506	4296	g_25753	g_11368
ptg000011l	108170	137595	29425	g_11368	g_16867
ptg000011l	137834	166999	29165	g_16867	g_4818
ptg000011l	167205	195271	28066	g_4818	g_33439
ptg000011l	198207	211074	12867	g_33439	g_9249
ptg000011l	215421	220746	5325	g_9249	g_18948
ptg000011l	221555	285775	64220	g_18948	g_6851
ptg000011l	291770	295001	3231	g_6851	g_34256
ptg000011l	307412	310461	3049	g_34256	g_19563
ptg000011l	316994	368589	51595	g_19563	g_34000
ptg000011l	369903	378272	8369	g_34000	g_36332
ptg000011l	378535	383992	5457	g_36332	g_23034
ptg000011l	387875	446019	58144	g_23034	g_1403
ptg000011l	453061	461246	8185	g_1403	g_39300
ptg000011l	462091	472228	10137	g_39300	g_25686
ptg000011l	475146	483228	8082	g_25686	g_29829
ptg000011l	486328	488406	2078	g_29829	g_19719
ptg000011l	491769	496341	4572	g_19719	g_9296
ptg000011l	508649	553533	44884	g_9296	g_36485
ptg000011l	554651	566966	12315	g_36485	g_25523
ptg000011l	591470	599969	8499	g_25523	g_6624
ptg000011l	601048	657723	56675	g_6624	g_7721
ptg000011l	661068	673332	12264	g_7721	g_26544
ptg000011l	691149	761483	70334	g_26544	g_19266
ptg000011l	761734	805487	43753	g_19266	g_28251
ptg000011l	809202	818572	9370	g_28251	g_33274
ptg000011l	825546	934454	108908	g_33274	g_15095
ptg000011l	950109	952839	2730	g_15095	g_18098
ptg000011l	955230	965262	10032	g_18098	g_20001
ptg000011l	966734	971641	4907	g_20001	g_22793
ptg000011l	1001798	1005533	3735	g_22793	g_16787
ptg000011l	1017900	1021970	4070	g_16787	g_38253
ptg000011l	1026854	1029689	2835	g_38253	g_12295
ptg000011l	1032510	1053309	20799	g_12295	g_23621
ptg000011l	1058914	1063530	4616	g_23621	g_19420
ptg000011l	1074882	1082436	7554	g_19420	g_11669
ptg000011l	1088747	1091815	3068	g_11669	g_18925
ptg000011l	1111963	1127662	15699	g_18925	g_26010
ptg000011l	1130110	1138777	8667	g_26010	g_4160
ptg000011l	1149131	1159805	10674	g_4160	g_27536
ptg000011l	1168595	1175417	6822	g_27536	g_34381
ptg000011l	1179458	1182785	3327	g_34381	g_31310
ptg000011l	1189425	1247501	58076	g_31310	g_34318
ptg000011l	1266800	1279135	12335	g_34318	g_12475
ptg000011l	1282349	1285959	3610	g_12475	g_13869
ptg000011l	1286420	1289633	3213	g_13869	g_35793
ptg000011l	1298967	1306747	7780	g_35793	g_10030
ptg000011l	1318354	1343206	24852	g_10030	g_6196
ptg000011l	1355797	1358208	2411	g_6196	g_19425
ptg000011l	1384870	1395475	10605	g_19425	g_39485
ptg000011l	1406060	1413422	7362	g_39485	g_22323
ptg000011l	1420298	1441284	20986	g_22323	g_37147
ptg000011l	1441716	1449255	7539	g_37147	g_6095
ptg000011l	1450999	1472352	21353	g_6095	g_24803
ptg000011l	1476500	1481060	4560	g_24803	g_13276
ptg000011l	1496802	1507434	10632	g_13276	g_23362
ptg000011l	1509836	1621343	111507	g_23362	g_5409
ptg000011l	1627772	1660743	32971	g_5409	g_37483
ptg000011l	1661348	1718487	57139	g_37483	g_9423
ptg000011l	1723199	1786120	62921	g_9423	g_8961
ptg000011l	1786347	1840281	53934	g_8961	g_35504
ptg000011l	1844083	1872746	28663	g_35504	g_26744
ptg000011l	1888042	1967163	79121	g_26744	g_2970
ptg000011l	1971248	1976004	4756	g_2970	g_20823
ptg000011l	1977399	1981756	4357	g_20823	g_36887
ptg000011l	1982142	1988428	6286	g_36887	g_4749
ptg000011l	1990534	1991336	802	g_4749	g_22363
ptg000011l	2000545	2063880	63335	g_22363	g_10158
ptg000011l	2064930	2068478	3548	g_10158	g_9389
ptg000011l	2080591	2081055	464	g_9389	g_32936
ptg000011l	2090737	2169788	79051	g_32936	g_30610
ptg000011l	2193804	2200041	6237	g_30610	g_1687
ptg000011l	2205824	2218281	12457	g_1687	g_33062
ptg000011l	2245454	2266825	21371	g_33062	g_39877
ptg000011l	2267277	2344358	77081	g_39877	g_10452
ptg000011l	2344699	2350651	5952	g_10452	g_29683
ptg000011l	2350890	2411799	60909	g_29683	g_6606
ptg000011l	2412029	2419504	7475	g_6606	g_27519
ptg000011l	2419719	2456469	36750	g_27519	g_33360
ptg000011l	2466363	2585786	119423	g_33360	g_13875
ptg000011l	2594200	2597293	3093	g_13875	g_6347
ptg000011l	2607148	2621335	14187	g_6347	g_23871
ptg000011l	2638930	2644825	5895	g_23871	g_24286
ptg000011l	2645991	2675665	29674	g_24286	g_17776
ptg000011l	2675976	2770330	94354	g_17776	g_10669
ptg000011l	2778696	2780949	2253	g_10669	g_3666
ptg000011l	2791587	2791916	329	g_3666	g_21116
ptg000011l	2795218	2797405	2187	g_21116	g_18457
ptg000011l	2818466	2820844	2378	g_18457	g_40188
ptg000011l	2823606	2825942	2336	g_40188	g_38133
ptg000011l	2832600	3162610	330010	g_38133	g_20199
ptg000011l	3166123	3209468	43345	g_20199	g_1911
ptg000011l	3212254	3248488	36234	g_1911	g_34111
ptg000011l	3249186	3289754	40568	g_34111	g_12777
ptg000011l	3291000	3314253	23253	g_12777	g_14689
ptg000011l	3329414	3332943	3529	g_14689	g_3094
ptg000011l	3334691	3347823	13132	g_3094	g_34703
ptg000011l	3363146	3416142	52996	g_34703	g_25641
ptg000011l	3416459	3423309	6850	g_25641	g_15354
ptg000011l	3425181	3470374	45193	g_15354	g_9672
ptg000011l	3472006	3567673	95667	g_9672	g_13557
ptg000011l	3570755	3579240	8485	g_13557	g_14751
ptg000011l	3581339	3598315	16976	g_14751	g_17698
ptg000011l	3619149	3652267	33118	g_17698	g_26712
ptg000011l	3657526	3658764	1238	g_26712	g_21380
ptg000011l	3667331	3676054	8723	g_21380	g_11688
ptg000011l	3681543	3746251	64708	g_11688	g_20877
ptg000011l	3769483	3835975	66492	g_20877	g_23538
ptg000011l	3846823	3945338	98515	g_23538	g_10483
ptg000011l	3951326	3956092	4766	g_10483	g_31444
ptg000011l	3956301	4180846	224545	g_31444	g_3663
ptg000011l	4188643	4191892	3249	g_3663	g_18375
ptg000011l	4192197	4192768	571	g_18375	g_28859
ptg000011l	4193184	4195308	2124	g_28859	g_16911
ptg000011l	4197531	4254692	57161	g_16911	g_1977
ptg000011l	4256167	4381838	125671	g_1977	g_37564
ptg000011l	4392894	4395547	2653	g_37564	g_2301
ptg000011l	4400972	4417274	16302	g_2301	g_32780
ptg000011l	4417552	4418214	662	g_32780	g_33728
ptg000011l	4418921	4420959	2038	g_33728	g_17627
ptg000011l	4421990	4422082	92	g_17627	g_39961
ptg000011l	4422384	4424860	2476	g_39961	g_3241
ptg000011l	4431771	4433355	1584	g_3241	g_1249
ptg000011l	4443604	4447117	3513	g_1249	g_3394
ptg000011l	4454584	4539837	85253	g_3394	g_34200
ptg000011l	4540721	4546439	5718	g_34200	g_20358
ptg000011l	4555126	4570983	15857	g_20358	g_35019
ptg000011l	4571525	4573802	2277	g_35019	g_8509
ptg000011l	4575002	4575421	419	g_8509	g_40049
ptg000011l	4581383	4599426	18043	g_40049	g_15260
ptg000011l	4605128	4617795	12667	g_15260	g_2543
ptg000011l	4626482	4656105	29623	g_2543	g_6373
ptg000011l	4671326	4676455	5129	g_6373	g_9292
ptg000011l	4680997	4689513	8516	g_9292	g_30094
ptg000011l	4699532	4723515	23983	g_30094	g_33182
ptg000011l	4748662	4973845	225183	g_33182	g_8372
ptg000011l	4974804	5007625	32821	g_8372	g_4661
ptg000011l	5007987	5086262	78275	g_4661	g_28869
ptg000011l	5093232	5095399	2167	g_28869	g_5127
ptg000011l	5106446	5126873	20427	g_5127	g_18974
ptg000011l	5138082	5279777	141695	g_18974	g_3860
ptg000011l	5288239	5295803	7564	g_3860	g_22787
ptg000011l	5316372	5340972	24600	g_22787	g_28832
ptg000011l	5349504	5362491	12987	g_28832	g_34826
ptg000011l	5372056	5404244	32188	g_34826	g_39289
ptg000011l	5406929	5444619	37690	g_39289	g_39392
ptg000011l	5447581	5624054	176473	g_39392	g_17709
ptg000011l	5624272	5799524	175252	g_17709	g_2943
ptg000011l	5800846	5852625	51779	g_2943	g_32561
ptg000011l	5853524	5874736	21212	g_32561	g_16869
ptg000011l	5876537	5877651	1114	g_16869	g_21752
ptg000011l	5883675	5901004	17329	g_21752	g_12943
ptg000011l	5902415	6059721	157306	g_12943	g_12348
ptg000011l	6059945	6134821	74876	g_12348	g_6412
ptg000011l	6135267	6185333	50066	g_6412	g_15515
ptg000011l	6185557	6201918	16361	g_15515	g_14592
ptg000011l	6226542	6256299	29757	g_14592	g_7014
ptg000011l	6256855	6362530	105675	g_7014	g_596
ptg000011l	6363054	6601917	238863	g_596	g_37296
ptg000011l	6602174	6645809	43635	g_37296	g_35231
ptg000011l	6658442	6811107	152665	g_35231	g_7579
ptg000011l	6811367	6829548	18181	g_7579	g_6819
ptg000011l	6837214	6910167	72953	g_6819	g_35274
ptg000011l	6910623	6945512	34889	g_35274	g_28086
ptg000011l	6946666	6964596	17930	g_28086	g_7143
ptg000011l	6972441	6986583	14142	g_7143	g_12320
ptg000011l	6991282	7030536	39254	g_12320	g_35610
ptg000011l	7035674	7202701	167027	g_35610	g_26407
ptg000011l	7221693	7268389	46696	g_26407	g_18312
ptg000011l	7279810	7280282	472	g_18312	g_20288
ptg000011l	7281184	7288262	7078	g_20288	g_2959
ptg000011l	7293976	7297258	3282	g_2959	g_36429
ptg000011l	7301238	7481142	179904	g_36429	g_8765
ptg000011l	7482068	7561166	79098	g_8765	g_33278
ptg000011l	7572884	7623600	50716	g_33278	g_4351
ptg000011l	7636456	7642772	6316	g_4351	g_18328
ptg000011l	7655460	7724372	68912	g_18328	g_5250
ptg000011l	7724794	7725138	344	g_5250	g_39996
ptg000011l	7727826	7729523	1697	g_39996	g_39931
ptg000011l	7732957	7733434	477	g_39931	g_1602
ptg000011l	7740203	7786203	46000	g_1602	g_16513
ptg000011l	7786409	7798289	11880	g_16513	g_17683
ptg000011l	7800986	7802268	1282	g_17683	g_26383
ptg000011l	7821620	7826312	4692	g_26383	g_32005
ptg000011l	7828097	7836074	7977	g_32005	g_19041
ptg000011l	7854827	7936533	81706	g_19041	g_20227
ptg000011l	7954001	7958339	4338	g_20227	g_34729
ptg000011l	7959769	8058929	99160	g_34729	g_358
ptg000011l	8060824	8063241	2417	g_358	g_13578
ptg000011l	8064514	8098519	34005	g_13578	g_6564
ptg000011l	8104068	8109572	5504	g_6564	g_38441
ptg000011l	8110144	8110434	290	g_38441	g_15626
ptg000011l	8133917	8142479	8562	g_15626	g_5518
ptg000011l	8142865	8143337	472	g_5518	g_8854
ptg000011l	8163050	8164733	1683	g_8854	g_5803
ptg000011l	8166867	8167930	1063	g_5803	g_5224
ptg000011l	8169863	8171724	1861	g_5224	g_8194
ptg000011l	8172389	8177300	4911	g_8194	g_29707
ptg000011l	8185419	8188455	3036	g_29707	g_30955
ptg000011l	8193859	8328584	134725	g_30955	g_32632
ptg000011l	8329459	8334726	5267	g_32632	g_537
ptg000011l	8337693	8347703	10010	g_537	g_9923
ptg000011l	8348227	8352487	4260	g_9923	g_16636
ptg000011l	8352884	8362566	9682	g_16636	g_29945
ptg000011l	8363969	8428328	64359	g_29945	g_32483
ptg000011l	8428852	8429349	497	g_32483	g_35258
ptg000011l	8430686	8527769	97083	g_35258	g_12532
ptg000011l	8541618	8601491	59873	g_12532	g_33063
ptg000011l	8606175	8607933	1758	g_33063	g_20721
ptg000011l	8610316	8610999	683	g_20721	g_31052
ptg000011l	8615868	8618452	2584	g_31052	g_32500
ptg000011l	8626758	8631997	5239	g_32500	g_10803
ptg000011l	8640644	8733934	93290	g_10803	g_22027
ptg000011l	8741186	8751305	10119	g_22027	g_27570
ptg000011l	8770335	8993815	223480	g_27570	g_16793
ptg000011l	8994024	9110261	116237	g_16793	g_8382
ptg000011l	9110524	9154659	44135	g_8382	g_6702
ptg000011l	9170213	9178175	7962	g_6702	g_15087
ptg000011l	9178492	9246307	67815	g_15087	g_35304
ptg000011l	9250175	9286233	36058	g_35304	g_2668
ptg000011l	9286448	9325996	39548	g_2668	g_11014
ptg000011l	9329822	9580451	250629	g_11014	g_16045
ptg000011l	9591616	9645931	54315	g_16045	g_2873
ptg000011l	9646194	9658857	12663	g_2873	g_20529
ptg000011l	9672999	9685691	12692	g_20529	g_17801
ptg000011l	9697008	9741327	44319	g_17801	g_13704
ptg000011l	9748068	9750021	1953	g_13704	g_35239
ptg000011l	9752309	9789099	36790	g_35239	g_900
ptg000011l	9795476	9806787	11311	g_900	g_19447
ptg000011l	9821245	9922988	101743	g_19447	g_26516
ptg000011l	9923704	10116834	193130	g_26516	g_32219
ptg000011l	10117280	10170136	52856	g_32219	g_4864
ptg000011l	10171527	10175523	3996	g_4864	g_6221
ptg000011l	10176857	10186618	9761	g_6221	g_32028
ptg000011l	10187952	10191944	3992	g_32028	g_24385
ptg000011l	10193281	10197275	3994	g_24385	g_15398
ptg000011l	10198612	10208502	9890	g_15398	g_13877
ptg000011l	10209836	10235118	25282	g_13877	g_33799
ptg000011l	10235657	10238327	2670	g_33799	g_37178
ptg000011l	10239079	10245765	6686	g_37178	g_29128
ptg000011l	10270834	10322451	51617	g_29128	g_29405
ptg000011l	10323732	10349151	25419	g_29405	g_12593
ptg000011l	10350749	10405777	55028	g_12593	g_22101
ptg000011l	10415433	10417541	2108	g_22101	g_22266
ptg000011l	10423350	10490647	67297	g_22266	g_22771
ptg000011l	10515912	10529522	13610	g_22771	g_13533
ptg000011l	10535682	10553574	17892	g_13533	g_36661
ptg000011l	10553969	10583524	29555	g_36661	g_5312
ptg000011l	10608946	10612790	3844	g_5312	g_27638
ptg000011l	10613125	10631182	18057	g_27638	g_18873
ptg000011l	10647061	10686211	39150	g_18873	g_22784
ptg000011l	10705477	10730757	25280	g_22784	g_183
ptg000011l	10731773	10740009	8236	g_183	g_27422
ptg000011l	10755572	10992712	237140	g_27422	g_32400
ptg000011l	10996612	11093404	96792	g_32400	g_36077
ptg000011l	11096688	11120212	23524	g_36077	g_3052
ptg000011l	11136743	11153422	16679	g_3052	g_5136
ptg000011l	11157067	11195904	38837	g_5136	g_12739
ptg000011l	11196158	11259267	63109	g_12739	g_20019
ptg000011l	11264074	11379199	115125	g_20019	g_16291
ptg000011l	11380002	11527389	147387	g_16291	g_20532
ptg000011l	11527829	11555187	27358	g_20532	g_34147
ptg000011l	11555414	11674787	119373	g_34147	g_34207
ptg000011l	11675455	11690188	14733	g_34207	g_11961
ptg000011l	11690775	11749298	58523	g_11961	g_11857
ptg000011l	11749855	11781009	31154	g_11857	g_1390
ptg000011l	11790351	11864439	74088	g_1390	g_10763
ptg000011l	11876166	11896581	20415	g_10763	g_26727
ptg000011l	11897027	11934380	37353	g_26727	g_10418
ptg000011l	11936044	11986768	50724	g_10418	g_22800
ptg000011l	11987331	11990023	2692	g_22800	g_16562
ptg000011l	11997418	12024465	27047	g_16562	g_37804
ptg000011l	12024665	12028395	3730	g_37804	g_7793
ptg000011l	12031077	12038483	7406	g_7793	g_267
ptg000011l	12043334	12044109	775	g_267	g_4945
ptg000011l	12053644	12058872	5228	g_4945	g_6839
ptg000011l	12083992	12085217	1225	g_6839	g_15908
ptg000011l	12091277	12094495	3218	g_15908	g_22732
ptg000011l	12105249	12109855	4606	g_22732	g_24333
ptg000011l	12112153	12133226	21073	g_24333	g_36971
ptg000011l	12141558	12147208	5650	g_36971	g_24105
ptg000011l	12158701	12193506	34805	g_24105	g_26787
ptg000011l	12211615	12284486	72871	g_26787	g_6585
ptg000011l	12289943	12294547	4604	g_6585	g_26215
ptg000011l	12297842	12300280	2438	g_26215	g_22503
ptg000011l	12305912	12313721	7809	g_22503	g_25015
ptg000011l	12328882	12344004	15122	g_25015	g_704
ptg000011l	12344618	12353920	9302	g_704	g_23854
ptg000011l	12363585	12380263	16678	g_23854	g_632
ptg000011l	12380874	12391842	10968	g_632	g_24282
ptg000011l	12392411	12409092	16681	g_24282	g_25774
ptg000011l	12420362	12425642	5280	g_25774	g_6887
ptg000011l	12426894	12448468	21574	g_6887	g_17531
ptg000011l	12449190	12461239	12049	g_17531	g_38973
ptg000011l	12461454	12462202	748	g_38973	g_39480
ptg000011l	12462537	12522340	59803	g_39480	g_36112
ptg000011l	12533346	12564548	31202	g_36112	g_30418
ptg000011l	12569644	12588780	19136	g_30418	g_14785
ptg000011l	12589604	12613142	23538	g_14785	g_26507
ptg000011l	12620451	12658358	37907	g_26507	g_733
ptg000011l	12665359	12815137	149778	g_733	g_37077
ptg000011l	12826484	12943787	117303	g_37077	g_23082
ptg000011l	12943999	13032903	88904	g_23082	g_12418
ptg000011l	13033838	13284573	250735	g_12418	g_25341
ptg000011l	13284836	13370729	85893	g_25341	g_14804
ptg000011l	13371322	13378713	7391	g_14804	g_13617
ptg000011l	13378940	13423808	44868	g_13617	g_23131
ptg000011l	13424521	13424930	409	g_23131	g_17911
ptg000011l	13425340	13615867	190527	g_17911	g_16206
ptg000011l	13616124	13815506	199382	g_16206	g_4981
ptg000011l	13830025	13931922	101897	g_4981	g_29923
ptg000011l	13932326	14135848	203522	g_29923	g_31522
ptg000011l	14137298	14292911	155613	g_31522	g_22074
ptg000011l	14293525	14407699	114174	g_22074	g_5737
ptg000011l	14409264	14452210	42946	g_5737	g_9283
ptg000011l	14453529	14628376	174847	g_9283	g_28123
ptg000011l	14628816	14737701	108885	g_28123	g_19806
ptg000011l	14738876	14747069	8193	g_19806	g_3645
ptg000011l	14766318	14827810	61492	g_3645	g_25212
ptg000011l	14836242	14846634	10392	g_25212	g_3750
ptg000011l	14846861	14894251	47390	g_3750	g_2844
ptg000011l	14906176	14950487	44311	g_2844	g_6002
ptg000011l	14958248	15036963	78715	g_6002	g_19419
ptg000011l	15041037	15042102	1065	g_19419	g_31193
ptg000011l	15044216	15045122	906	g_31193	g_11834
ptg000011l	15046702	15049438	2736	g_11834	g_16615
ptg000011l	15054953	15056047	1094	g_16615	g_32747
ptg000011l	15060776	15069625	8849	g_32747	g_34646
ptg000011l	15078451	15080545	2094	g_34646	g_36918
ptg000011l	15087756	15102154	14398	g_36918	g_6156
ptg000011l	15114027	15212712	98685	g_6156	g_3167
ptg000011l	15212957	15252862	39905	g_3167	g_3681
ptg000011l	15254436	15270665	16229	g_3681	g_18573
ptg000011l	15271549	15300004	28455	g_18573	g_18702
ptg000011l	15301539	15309243	7704	g_18702	g_2084
ptg000011l	15310082	15352533	42451	g_2084	g_16768
ptg000011l	15358425	15359671	1246	g_16768	g_17261
ptg000011l	15361371	15363557	2186	g_17261	g_20300
ptg000011l	15363974	15368044	4070	g_20300	g_24302
ptg000011l	15371159	15371962	803	g_24302	g_3460
ptg000011l	15379328	15392854	13526	g_3460	g_37353
ptg000011l	15393970	15417025	23055	g_37353	g_202
ptg000011l	15427696	15431955	4259	g_202	g_33033
ptg000011l	15436296	15448571	12275	g_33033	g_12181
ptg000011l	15477115	15481787	4672	g_12181	g_1741
ptg000011l	15484318	15503822	19504	g_1741	g_20169
ptg000011l	15510440	15513828	3388	g_20169	g_29399
ptg000011l	15518238	15562347	44109	g_29399	g_9239
ptg000011l	15562550	15566890	4340	g_9239	g_37317
ptg000011l	15579728	15800600	220872	g_37317	g_16778
ptg000011l	15800800	15811522	10722	g_16778	g_27277
ptg000011l	15811827	15829097	17270	g_27277	g_12047
ptg000011l	15829303	15842300	12997	g_12047	g_33917
ptg000011l	15842530	15859446	16916	g_33917	g_22949
ptg000011l	15859781	15869206	9425	g_22949	g_9804
ptg000011l	15872168	15943170	71002	g_9804	g_19471
ptg000011l	15943937	15944695	758	g_19471	g_9581
ptg000011l	15945084	16127066	181982	g_9581	g_238
ptg000011l	16129621	16137395	7774	g_238	g_15040
ptg000011l	16141363	16171052	29689	g_15040	g_35323
ptg000011l	16175802	16229279	53477	g_35323	g_9477
ptg000011l	16229689	16347207	117518	g_9477	g_24593
ptg000011l	16350926	16497905	146979	g_24593	g_5281
ptg000011l	16523874	16530636	6762	g_5281	g_25258
ptg000011l	16530908	16530953	45	g_25258	g_33557
ptg000011l	16532485	16597594	65109	g_33557	g_8247
ptg000011l	16598304	16615425	17121	g_8247	g_14784
ptg000011l	16616000	16616033	33	g_14784	g_3656
ptg000011l	16616500	16624627	8127	g_3656	g_7192
ptg000011l	16625415	16625539	124	g_7192	g_7712
ptg000011l	16626555	16627331	776	g_7712	g_29536
ptg000011l	16628269	16692416	64147	g_29536	g_248
ptg000011l	16692805	16838271	145466	g_248	g_29972
ptg000011l	16838702	16838936	234	g_29972	g_16863
ptg000011l	16839205	16858755	19550	g_16863	g_24680
ptg000011l	16859321	16896663	37342	g_24680	g_13045
ptg000011l	16896932	16904410	7478	g_13045	g_8707
ptg000011l	16904739	16910213	5474	g_8707	g_5599
ptg000011l	16911154	16922795	11641	g_5599	g_15109
ptg000011l	16950252	16962436	12184	g_15109	g_9358
ptg000011l	16978738	16982851	4113	g_9358	g_14682
ptg000011l	17000081	17002494	2413	g_14682	g_19902
ptg000011l	17012394	17013948	1554	g_19902	g_25978
ptg000011l	17021022	17021694	672	g_25978	g_22560
ptg000011l	17023999	17036703	12704	g_22560	g_612
ptg000011l	17039914	17040949	1035	g_612	g_32195
ptg000011l	17046073	17055855	9782	g_32195	g_21411
ptg000011l	17067991	17140992	73001	g_21411	g_17888
ptg000011l	17144878	17145601	723	g_17888	g_15670
ptg000011l	17164250	17167246	2996	g_15670	g_18380
ptg000011l	17170504	17183556	13052	g_18380	g_26040
ptg000011l	17200660	17254236	53576	g_26040	g_10072
ptg000011l	17254466	17323875	69409	g_10072	g_33529
ptg000011l	17340980	17428242	87262	g_33529	g_9721
ptg000011l	17429078	17452604	23526	g_9721	g_27803
ptg000011l	17453695	17493642	39947	g_27803	g_30765
ptg000011l	17501535	17516597	15062	g_30765	g_35755
ptg000011l	17531460	17535085	3625	g_35755	g_27456
ptg000011l	17558490	17570567	12077	g_27456	g_7833
ptg000011l	17571586	17600382	28796	g_7833	g_32619
ptg000011l	17606259	17617640	11381	g_32619	g_16700
ptg000011l	17617849	17621264	3415	g_16700	g_17501
ptg000011l	17621542	17683333	61791	g_17501	g_16645
ptg000011l	17683563	17696556	12993	g_16645	g_22369
ptg000011l	17696783	17894359	197576	g_22369	g_9333
ptg000011l	17895123	17912698	17575	g_9333	g_4694
ptg000011l	17912916	17950161	37245	g_4694	g_7872
ptg000011l	17950382	17950615	233	g_7872	g_16103
ptg000011l	17951235	17962478	11243	g_16103	g_8238
ptg000011l	17963475	18016390	52915	g_8238	g_965
ptg000011l	18025303	18032252	6949	g_965	g_33838
ptg000011l	18035196	18092920	57724	g_33838	g_22860
ptg000011l	18097812	18105964	8152	g_22860	g_15553
ptg000011l	18129962	18190675	60713	g_15553	g_1504
ptg000011l	18197548	18218822	21274	g_1504	g_29760
ptg000011l	18243603	18253082	9479	g_29760	g_20982
ptg000011l	18259092	18273446	14354	g_20982	g_8487
ptg000011l	18275671	18280560	4889	g_8487	g_17116
ptg000011l	18285924	18288757	2833	g_17116	g_29445
ptg000011l	18289506	18334702	45196	g_29445	g_9063
ptg000011l	18336004	18409362	73358	g_9063	g_35704
ptg000011l	18409802	18456992	47190	g_35704	g_26690
ptg000011l	18457273	18467745	10472	g_26690	g_12876
ptg000011l	18474050	18510955	36905	g_12876	g_14840
ptg000011l	18511350	18603139	91789	g_14840	g_35608
ptg000011l	18603471	18641411	37940	g_35608	g_3119
ptg000011l	18641872	18646569	4697	g_3119	g_33436
ptg000011l	18646958	18662097	15139	g_33436	g_15904
ptg000011l	18662381	19026816	364435	g_15904	g_7995
ptg000011l	19027238	19063679	36441	g_7995	g_33180
ptg000011l	19069352	19080456	11104	g_33180	g_9745
ptg000011l	19082128	19354093	271965	g_9745	g_39
ptg000011l	19354542	19354597	55	g_39	g_13779
ptg000011l	19354896	19355016	120	g_13779	g_11354
ptg000012l	128151	143550	15399	g_9201	g_457
ptg000012l	189998	224199	34201	g_457	g_10021
ptg000012l	227045	254266	27221	g_10021	g_7394
ptg000012l	317532	381052	63520	g_7394	g_6303
ptg000012l	381309	440284	58975	g_6303	g_11582
ptg000012l	440544	558846	118302	g_11582	g_12206
ptg000012l	562016	592231	30215	g_12206	g_28100
ptg000012l	594249	597091	2842	g_28100	g_11672
ptg000012l	606298	635806	29508	g_11672	g_1671
ptg000012l	640330	692546	52216	g_1671	g_16640
ptg000012l	696339	773367	77028	g_16640	g_1038
ptg000012l	774992	807854	32862	g_1038	g_16007
ptg000012l	819279	831232	11953	g_16007	g_13094
ptg000012l	832613	840894	8281	g_13094	g_38034
ptg000012l	842088	865733	23645	g_38034	g_20375
ptg000012l	870175	873104	2929	g_20375	g_24646
ptg000012l	880358	883912	3554	g_24646	g_12353
ptg000012l	888096	894669	6573	g_12353	g_577
ptg000012l	900472	903100	2628	g_577	g_24379
ptg000012l	947443	970808	23365	g_24379	g_9659
ptg000012l	977409	1019903	42494	g_9659	g_16107
ptg000012l	1021601	1185579	163978	g_16107	g_5738
ptg000012l	1206879	1207882	1003	g_5738	g_29991
ptg000012l	1208418	1210452	2034	g_29991	g_40002
ptg000012l	1218959	1235133	16174	g_40002	g_21740
ptg000012l	1240022	1242396	2374	g_21740	g_18637
ptg000012l	1251668	1326993	75325	g_18637	g_16633
ptg000012l	1333961	1340062	6101	g_16633	g_22883
ptg000012l	1342760	1343656	896	g_22883	g_18717
ptg000012l	1356564	1360643	4079	g_18717	g_36118
ptg000012l	1361731	1370480	8749	g_36118	g_28697
ptg000012l	1372932	1374995	2063	g_28697	g_7843
ptg000012l	1377139	1382181	5042	g_7843	g_7533
ptg000012l	1400566	1403928	3362	g_7533	g_18096
ptg000012l	1409727	1411598	1871	g_18096	g_38159
ptg000012l	1435479	1443400	7921	g_38159	g_31542
ptg000012l	1443702	1446200	2498	g_31542	g_10073
ptg000012l	1447562	1456755	9193	g_10073	g_10317
ptg000012l	1463259	1464343	1084	g_10317	g_28963
ptg000012l	1470680	1471199	519	g_28963	g_11865
ptg000012l	1478746	1482243	3497	g_11865	g_2557
ptg000012l	1485292	1498336	13044	g_2557	g_729
ptg000012l	1501312	1505673	4361	g_729	g_9263
ptg000012l	1507277	1510063	2786	g_9263	g_15940
ptg000012l	1514620	1517943	3323	g_15940	g_13979
ptg000012l	1527599	1554958	27359	g_13979	g_27622
ptg000012l	1556942	1558193	1251	g_27622	g_1848
ptg000012l	1558674	1559634	960	g_1848	g_22884
ptg000012l	1565313	1568784	3471	g_22884	g_35898
ptg000012l	1582880	1583931	1051	g_35898	g_14401
ptg000012l	1584218	1586254	2036	g_14401	g_33586
ptg000012l	1588677	1589852	1175	g_33586	g_32601
ptg000012l	1596421	1631619	35198	g_32601	g_3231
ptg000012l	1650229	1663854	13625	g_3231	g_13396
ptg000012l	1664669	1667801	3132	g_13396	g_5313
ptg000012l	1692988	1696144	3156	g_5313	g_7250
ptg000012l	1699814	1749001	49187	g_7250	g_2855
ptg000012l	1749540	1749564	24	g_2855	g_12336
ptg000012l	1767709	1984709	217000	g_12336	g_20391
ptg000012l	1999617	2005946	6329	g_20391	g_16038
ptg000012l	2013158	2113926	100768	g_16038	g_26253
ptg000012l	2123506	2177992	54486	g_26253	g_30645
ptg000012l	2178768	2297939	119171	g_30645	g_22285
ptg000012l	2299441	2306886	7445	g_22285	g_24849
ptg000012l	2317301	2356534	39233	g_24849	g_26789
ptg000012l	2356788	2394154	37366	g_26789	g_16891
ptg000012l	2395242	2405000	9758	g_16891	g_21415
ptg000012l	2419911	2432520	12609	g_21415	g_5116
ptg000012l	2436439	2437774	1335	g_5116	g_19497
ptg000012l	2441647	2532417	90770	g_19497	g_1396
ptg000012l	2532854	2578759	45905	g_1396	g_20692
ptg000012l	2579028	2684262	105234	g_20692	g_7508
ptg000012l	2690880	2710338	19458	g_7508	g_30743
ptg000012l	2723052	2769796	46744	g_30743	g_3521
ptg000012l	2772040	2776681	4641	g_3521	g_13095
ptg000012l	2778017	2788670	10653	g_13095	g_6492
ptg000012l	2788912	2807813	18901	g_6492	g_28101
ptg000012l	2810094	2834592	24498	g_28101	g_15671
ptg000012l	2866527	2892551	26024	g_15671	g_9282
ptg000012l	2893192	2925326	32134	g_9282	g_30857
ptg000012l	2943858	3128781	184923	g_30857	g_8207
ptg000012l	3132966	3224508	91542	g_8207	g_35177
ptg000012l	3233972	3246390	12418	g_35177	g_36280
ptg000012l	3247229	3257082	9853	g_36280	g_31118
ptg000012l	3258221	3260921	2700	g_31118	g_23123
ptg000012l	3272135	3276741	4606	g_23123	g_37614
ptg000012l	3277640	3420930	143290	g_37614	g_22081
ptg000012l	3421208	3421311	103	g_22081	g_18983
ptg000012l	3422474	3452389	29915	g_18983	g_17257
ptg000012l	3456278	3467376	11098	g_17257	g_14286
ptg000012l	3480387	3482452	2065	g_14286	g_18712
ptg000012l	3492562	3497907	5345	g_18712	g_19725
ptg000012l	3502042	3503308	1266	g_19725	g_16915
ptg000012l	3515555	3531675	16120	g_16915	g_34070
ptg000012l	3532145	3582000	49855	g_34070	g_19274
ptg000012l	3582596	3586330	3734	g_19274	g_8672
ptg000012l	3595400	3636200	40800	g_8672	g_28219
ptg000012l	3639752	3641931	2179	g_28219	g_26119
ptg000012l	3655309	3658163	2854	g_26119	g_6763
ptg000012l	3660459	3662233	1774	g_6763	g_1291
ptg000012l	3667822	3675542	7720	g_1291	g_11440
ptg000012l	3698285	3708896	10611	g_11440	g_23370
ptg000012l	3713851	3717454	3603	g_23370	g_20927
ptg000012l	3719431	3721187	1756	g_20927	g_4947
ptg000012l	3730937	3733613	2676	g_4947	g_40118
ptg000012l	3737460	3737495	35	g_40118	g_12922
ptg000012l	3744065	3744781	716	g_12922	g_35873
ptg000012l	3762362	3765216	2854	g_35873	g_33516
ptg000012l	3767312	3783480	16168	g_33516	g_38339
ptg000012l	3806398	3810396	3998	g_38339	g_14579
ptg000012l	3814013	3818415	4402	g_14579	g_32319
ptg000012l	3850881	3853600	2719	g_32319	g_21115
ptg000012l	3858734	3860294	1560	g_21115	g_15156
ptg000012l	3861107	3865706	4599	g_15156	g_25210
ptg000012l	3867927	3871749	3822	g_25210	g_3708
ptg000012l	3879193	3898271	19078	g_3708	g_14382
ptg000012l	3902867	3905863	2996	g_14382	g_25927
ptg000012l	3914922	3917145	2223	g_25927	g_19211
ptg000012l	3941486	4008446	66960	g_19211	g_29254
ptg000012l	4012068	4063730	51662	g_29254	g_37607
ptg000012l	4069705	4075941	6236	g_37607	g_15352
ptg000012l	4082964	4086102	3138	g_15352	g_30126
ptg000012l	4093841	4101562	7721	g_30126	g_30904
ptg000012l	4113914	4187021	73107	g_30904	g_20700
ptg000012l	4199249	4223183	23934	g_20700	g_17123
ptg000012l	4254108	4264965	10857	g_17123	g_37232
ptg000012l	4273014	4290822	17808	g_37232	g_34685
ptg000012l	4303726	4304887	1161	g_34685	g_34580
ptg000012l	4308901	4309684	783	g_34580	g_32022
ptg000012l	4314406	4378121	63715	g_32022	g_1963
ptg000012l	4386546	4396292	9746	g_1963	g_32116
ptg000012l	4396540	4481647	85107	g_32116	g_9905
ptg000012l	4481889	4496404	14515	g_9905	g_1452
ptg000012l	4496658	4548827	52169	g_1452	g_25558
ptg000012l	4549255	4630571	81316	g_25558	g_37789
ptg000012l	4630957	4658389	27432	g_37789	g_17038
ptg000013l	28564	47753	19189	g_30577	g_17959
ptg000013l	48877	60727	11850	g_17959	g_39226
ptg000013l	61890	99945	38055	g_39226	g_29189
ptg000013l	100289	109707	9418	g_29189	g_33860
ptg000013l	113799	114432	633	g_33860	g_37016
ptg000013l	117017	117957	940	g_37016	g_34740
ptg000013l	121774	126453	4679	g_34740	g_33371
ptg000013l	152404	166771	14367	g_33371	g_9679
ptg000013l	171800	174559	2759	g_9679	g_8094
ptg000013l	184526	188350	3824	g_8094	g_32859
ptg000013l	190393	191674	1281	g_32859	g_8808
ptg000013l	206785	208171	1386	g_8808	g_35778
ptg000013l	217358	250054	32696	g_35778	g_16971
ptg000013l	250683	271886	21203	g_16971	g_16131
ptg000013l	283404	286520	3116	g_16131	g_19197
ptg000013l	290461	291542	1081	g_19197	g_17921
ptg000013l	294188	299954	5766	g_17921	g_849
ptg000013l	300397	303201	2804	g_849	g_2142
ptg000013l	307792	314284	6492	g_2142	g_7811
ptg000013l	315282	356654	41372	g_7811	g_20441
ptg000013l	357898	368831	10933	g_20441	g_9286
ptg000013l	377593	382530	4937	g_9286	g_36760
ptg000013l	383828	393890	10062	g_36760	g_13345
ptg000013l	394099	402444	8345	g_13345	g_15555
ptg000013l	404693	437388	32695	g_15555	g_281
ptg000013l	445572	455227	9655	g_281	g_36818
ptg000013l	474590	480241	5651	g_36818	g_15961
ptg000013l	483764	485668	1904	g_15961	g_25993
ptg000013l	494088	499543	5455	g_25993	g_23761
ptg000013l	503987	507847	3860	g_23761	g_19646
ptg000013l	510769	513824	3055	g_19646	g_14575
ptg000013l	517471	521753	4282	g_14575	g_15591
ptg000013l	523515	524587	1072	g_15591	g_12157
ptg000013l	526551	532126	5575	g_12157	g_18154
ptg000013l	533397	539940	6543	g_18154	g_10824
ptg000013l	560498	561906	1408	g_10824	g_31858
ptg000013l	567613	585071	17458	g_31858	g_20786
ptg000013l	593735	605894	12159	g_20786	g_12335
ptg000013l	607167	631068	23901	g_12335	g_21421
ptg000013l	635293	690311	55018	g_21421	g_21266
ptg000013l	702766	704455	1689	g_21266	g_1893
ptg000013l	707982	711153	3171	g_1893	g_6850
ptg000013l	716446	717218	772	g_6850	g_3196
ptg000013l	727778	776817	49039	g_3196	g_844
ptg000013l	783857	813073	29216	g_844	g_26280
ptg000013l	815735	818793	3058	g_26280	g_23766
ptg000013l	821448	822957	1509	g_23766	g_20478
ptg000013l	830504	842644	12140	g_20478	g_24252
ptg000013l	848028	849523	1495	g_24252	g_3674
ptg000013l	856743	862194	5451	g_3674	g_16702
ptg000013l	867478	878570	11092	g_16702	g_479
ptg000013l	882787	919606	36819	g_479	g_16446
ptg000013l	921324	1097454	176130	g_16446	g_6681
ptg000013l	1098885	1152787	53902	g_6681	g_30402
ptg000013l	1169095	1190231	21136	g_30402	g_33777
ptg000013l	1198298	1209133	10835	g_33777	g_8566
ptg000013l	1210353	1212847	2494	g_8566	g_7051
ptg000013l	1215105	1216190	1085	g_7051	g_7910
ptg000013l	1226301	1229087	2786	g_7910	g_7998
ptg000013l	1230673	1235835	5162	g_7998	g_2854
ptg000013l	1250301	1252354	2053	g_2854	g_1761
ptg000013l	1252632	1333790	81158	g_1761	g_7882
ptg000013l	1351420	1356368	4948	g_7882	g_8978
ptg000013l	1359466	1362739	3273	g_8978	g_11219
ptg000013l	1364034	1372775	8741	g_11219	g_5449
ptg000013l	1373071	1381373	8302	g_5449	g_33633
ptg000013l	1383327	1385863	2536	g_33633	g_10450
ptg000013l	1387568	1390654	3086	g_10450	g_36085
ptg000013l	1396949	1445928	48979	g_36085	g_24886
ptg000013l	1446581	1543099	96518	g_24886	g_39809
ptg000013l	1543299	1560471	17172	g_39809	g_10982
ptg000013l	1567952	1569426	1474	g_10982	g_27786
ptg000013l	1577548	1580286	2738	g_27786	g_11118
ptg000013l	1580879	1621793	40914	g_11118	g_567
ptg000013l	1624260	1625177	917	g_567	g_36453
ptg000013l	1634065	1635811	1746	g_36453	g_9564
ptg000013l	1648086	1652293	4207	g_9564	g_33492
ptg000013l	1656158	1672624	16466	g_33492	g_4923
ptg000013l	1674570	1677374	2804	g_4923	g_23073
ptg000013l	1681981	1691921	9940	g_23073	g_16181
ptg000013l	1694280	1706670	12390	g_16181	g_28961
ptg000013l	1717004	1730184	13180	g_28961	g_11698
ptg000013l	1730468	1737553	7085	g_11698	g_31772
ptg000013l	1738956	1751154	12198	g_31772	g_27149
ptg000013l	1752674	1769155	16481	g_27149	g_2485
ptg000013l	1771644	1788395	16751	g_2485	g_18062
ptg000013l	1796752	1809468	12716	g_18062	g_4627
ptg000013l	1817911	1821599	3688	g_4627	g_30317
ptg000013l	1831559	1834813	3254	g_30317	g_8314
ptg000013l	1837713	1842206	4493	g_8314	g_3843
ptg000013l	1842436	1843964	1528	g_3843	g_1903
ptg000013l	1844565	1849399	4834	g_1903	g_15694
ptg000013l	1851705	1856807	5102	g_15694	g_12376
ptg000013l	1859861	1862346	2485	g_12376	g_4366
ptg000013l	1862582	1865759	3177	g_4366	g_35054
ptg000013l	1875395	1876885	1490	g_35054	g_18270
ptg000013l	1879699	1882017	2318	g_18270	g_25477
ptg000013l	1890407	1894966	4559	g_25477	g_6163
ptg000013l	1914019	1918982	4963	g_6163	g_1130
ptg000013l	1955066	1974363	19297	g_1130	g_19338
ptg000013l	1977953	1987181	9228	g_19338	g_3456
ptg000013l	1996103	2006301	10198	g_3456	g_715
ptg000013l	2009406	2013965	4559	g_715	g_39912
ptg000013l	2016684	2022795	6111	g_39912	g_18053
ptg000013l	2023226	2036146	12920	g_18053	g_14022
ptg000013l	2036427	2062595	26168	g_14022	g_11245
ptg000013l	2063999	2073393	9394	g_11245	g_13933
ptg000013l	2075657	2078710	3053	g_13933	g_24078
ptg000013l	2081066	2081586	520	g_24078	g_37118
ptg000013l	2082776	2085183	2407	g_37118	g_18203
ptg000013l	2086196	2088586	2390	g_18203	g_1045
ptg000013l	2092827	2100669	7842	g_1045	g_26630
ptg000013l	2102262	2104906	2644	g_26630	g_26809
ptg000013l	2106133	2106744	611	g_26809	g_31232
ptg000013l	2110247	2113637	3390	g_31232	g_35335
ptg000013l	2120140	2146086	25946	g_35335	g_11378
ptg000013l	2150076	2153672	3596	g_11378	g_5202
ptg000013l	2155492	2167219	11727	g_5202	g_33068
ptg000013l	2171877	2178207	6330	g_33068	g_21267
ptg000013l	2181222	2183234	2012	g_21267	g_14197
ptg000013l	2184812	2198104	13292	g_39243	g_22267
ptg000013l	2200326	2201725	1399	g_22267	g_5267
ptg000013l	2206151	2207345	1194	g_5267	g_1021
ptg000013l	2214037	2216691	2654	g_1021	g_24432
ptg000013l	2227380	2229793	2413	g_24432	g_27105
ptg000013l	2230672	2239671	8999	g_27105	g_34957
ptg000013l	2241754	2245749	3995	g_34957	g_11939
ptg000013l	2246677	2250544	3867	g_11939	g_9997
ptg000013l	2260791	2261456	665	g_9997	g_22497
ptg000013l	2265866	2289988	24122	g_22497	g_17288
ptg000013l	2295456	2300076	4620	g_17288	g_10678
ptg000013l	2301589	2351271	49682	g_10678	g_36457
ptg000013l	2352596	2352689	93	g_36457	g_21376
ptg000013l	2373058	2390319	17261	g_21376	g_5629
ptg000013l	2394085	2397182	3097	g_5629	g_1309
ptg000013l	2420222	2420285	63	g_1309	g_10197
ptg000013l	2432231	2491540	59309	g_10197	g_24536
ptg000013l	2497253	2563812	66559	g_24536	g_37291
ptg000013l	2564171	2564235	64	g_37291	g_3751
ptg000013l	2564492	2564583	91	g_3751	g_29049
ptg000013l	2565353	2592160	26807	g_29049	g_17234
ptg000013l	2602817	2607586	4769	g_17234	g_31432
ptg000013l	2618296	2619513	1217	g_31432	g_33622
ptg000013l	2624208	2655173	30965	g_33622	g_6931
ptg000013l	2656834	2719059	62225	g_6931	g_38807
ptg000013l	2719931	2745859	25928	g_38807	g_2655
ptg000013l	2746224	2750707	4483	g_2655	g_32909
ptg000013l	2751819	2773561	21742	g_32909	g_30629
ptg000013l	2783155	2785692	2537	g_30629	g_20188
ptg000013l	2790064	2791837	1773	g_20188	g_8154
ptg000013l	2792664	2792877	213	g_8154	g_22753
ptg000013l	2793593	2794495	902	g_22753	g_40229
ptg000013l	2799314	2803185	3871	g_40229	g_22288
ptg000013l	2804254	2808941	4687	g_22288	g_24703
ptg000013l	2812933	2815208	2275	g_24703	g_11977
ptg000013l	2816294	2826491	10197	g_11977	g_38108
ptg000013l	2828736	2830956	2220	g_38108	g_20240
ptg000013l	2837745	2863058	25313	g_20240	g_1424
ptg000013l	2880016	2889717	9701	g_1424	g_32990
ptg000013l	2900492	2907960	7468	g_32990	g_3294
ptg000013l	2923275	2930344	7069	g_3294	g_16091
ptg000013l	2940688	2942220	1532	g_16091	g_3109
ptg000013l	2946670	2947508	838	g_3109	g_2149
ptg000013l	2954036	2956356	2320	g_2149	g_2679
ptg000013l	2958794	2959745	951	g_2679	g_16079
ptg000013l	2960392	2979077	18685	g_16079	g_17105
ptg000013l	2982743	2989933	7190	g_22279	g_40168
ptg000013l	2996126	2998347	2221	g_40168	g_1256
ptg000013l	3000171	3002498	2327	g_1256	g_26077
ptg000013l	3018170	3041536	23366	g_26077	g_22084
ptg000013l	3050753	3059336	8583	g_22084	g_10822
ptg000013l	3066420	3074354	7934	g_10822	g_9492
ptg000013l	3075200	3076638	1438	g_9492	g_36113
ptg000013l	3079232	3080937	1705	g_36113	g_19404
ptg000013l	3081728	3083574	1846	g_19404	g_30572
ptg000013l	3085064	3086729	1665	g_30572	g_30086
ptg000013l	3093077	3106112	13035	g_30086	g_34845
ptg000013l	3116118	3118664	2546	g_34845	g_4099
ptg000013l	3125513	3130294	4781	g_4099	g_8260
ptg000013l	3134644	3146145	11501	g_8260	g_31074
ptg000013l	3160292	3174528	14236	g_31074	g_28780
ptg000013l	3175918	3184822	8904	g_28780	g_12554
ptg000013l	3187424	3191131	3707	g_12554	g_5780
ptg000013l	3196264	3197255	991	g_5780	g_11715
ptg000013l	3202946	3212851	9905	g_11715	g_23413
ptg000013l	3216038	3232473	16435	g_23413	g_34898
ptg000013l	3243865	3248262	4397	g_34898	g_11064
ptg000013l	3263241	3282052	18811	g_11064	g_24448
ptg000013l	3288490	3306141	17651	g_24448	g_1520
ptg000013l	3307832	3316745	8913	g_1520	g_18557
ptg000013l	3317329	3318643	1314	g_18557	g_16709
ptg000013l	3320395	3323867	3472	g_16709	g_14397
ptg000013l	3327107	3337523	10416	g_14397	g_3510
ptg000013l	3337888	3589670	251782	g_3510	g_17928
ptg000013l	3590149	3594116	3967	g_17928	g_2973
ptg000013l	3595381	3598982	3601	g_2973	g_9627
ptg000013l	3610783	3614252	3469	g_9627	g_9054
ptg000013l	3628036	3630793	2757	g_9054	g_32011
ptg000013l	3635665	3637214	1549	g_32011	g_14259
ptg000013l	3640408	3643190	2782	g_14259	g_38067
ptg000013l	3643450	3654672	11222	g_38067	g_35797
ptg000013l	3676008	3679412	3404	g_35797	g_7010
ptg000013l	3685865	3743166	57301	g_7010	g_19690
ptg000013l	3747543	3758649	11106	g_19690	g_17376
ptg000013l	3760069	3765072	5003	g_17376	g_38212
ptg000013l	3766349	3772815	6466	g_38212	g_36896
ptg000013l	3777878	3780059	2181	g_36896	g_36302
ptg000013l	3799244	3808706	9462	g_36302	g_23757
ptg000013l	3809050	3839405	30355	g_23757	g_30168
ptg000013l	3840763	3841600	837	g_30168	g_9244
ptg000013l	3842361	3844057	1696	g_9244	g_9563
ptg000013l	3853164	3869370	16206	g_9563	g_4092
ptg000013l	3881423	3886528	5105	g_4092	g_27507
ptg000013l	3912580	3918712	6132	g_27507	g_17375
ptg000013l	3919602	3960285	40683	g_17375	g_21745
ptg000013l	3965652	3984144	18492	g_21745	g_30748
ptg000013l	3987682	3992621	4939	g_30748	g_7407
ptg000013l	3994189	4077816	83627	g_7407	g_16642
ptg000013l	4098198	4101563	3365	g_16642	g_595
ptg000013l	4104052	4106936	2884	g_595	g_30401
ptg000013l	4115296	4155779	40483	g_30401	g_5843
ptg000013l	4159753	4178677	18924	g_5843	g_11791
ptg000013l	4187503	4190891	3388	g_11791	g_35942
ptg000013l	4193460	4194598	1138	g_35942	g_974
ptg000013l	4196235	4203610	7375	g_974	g_28499
ptg000013l	4215747	4229520	13773	g_28499	g_19290
ptg000013l	4234124	4238033	3909	g_19290	g_33005
ptg000013l	4239419	4244963	5544	g_33005	g_11734
ptg000013l	4247144	4251124	3980	g_11734	g_6576
ptg000013l	4253892	4263467	9575	g_6576	g_22166
ptg000013l	4271323	4283517	12194	g_22166	g_34895
ptg000013l	4295563	4300921	5358	g_34895	g_10422
ptg000013l	4303092	4307318	4226	g_10422	g_33906
ptg000013l	4313522	4314934	1412	g_33906	g_4977
ptg000013l	4334024	4336514	2490	g_4977	g_26840
ptg000013l	4336801	4467350	130549	g_26840	g_31515
ptg000013l	4467577	4486042	18465	g_31515	g_2700
ptg000013l	4488390	4490063	1673	g_2700	g_26121
ptg000013l	4493475	4498325	4850	g_26121	g_19349
ptg000013l	4499467	4501731	2264	g_19349	g_6090
ptg000013l	4505045	4510587	5542	g_6090	g_24998
ptg000013l	4510916	4513483	2567	g_24998	g_29430
ptg000013l	4518771	4519718	947	g_29430	g_23366
ptg000013l	4524788	4525890	1102	g_23366	g_25658
ptg000013l	4531929	4532945	1016	g_25658	g_13558
ptg000013l	4534460	4538921	4461	g_13558	g_36050
ptg000013l	4545810	4549826	4016	g_36050	g_12060
ptg000013l	4553447	4555919	2472	g_12060	g_37786
ptg000013l	4557762	4562315	4553	g_37786	g_24336
ptg000013l	4567603	4580560	12957	g_24336	g_3539
ptg000013l	4584355	4584959	604	g_3539	g_5546
ptg000013l	4593002	4642372	49370	g_5546	g_4655
ptg000013l	4661236	4730808	69572	g_4655	g_6059
ptg000013l	4731020	4755111	24091	g_6059	g_36441
ptg000013l	4757330	4767241	9911	g_36441	g_7118
ptg000013l	4788822	4838440	49618	g_7118	g_28392
ptg000013l	4840031	4840451	420	g_28392	g_16736
ptg000013l	4848308	4856439	8131	g_16736	g_36803
ptg000013l	4857806	4896574	38768	g_36803	g_32147
ptg000013l	4896900	4979107	82207	g_32147	g_13439
ptg000013l	4984495	4992296	7801	g_13439	g_32919
ptg000013l	4993953	5004354	10401	g_32919	g_21109
ptg000013l	5020689	5063108	42419	g_21109	g_29494
ptg000013l	5072309	5077391	5082	g_29494	g_19673
ptg000013l	5082795	5085302	2507	g_19673	g_11656
ptg000013l	5090203	5093243	3040	g_11656	g_39578
ptg000013l	5094976	5109708	14732	g_39578	g_12122
ptg000013l	5110287	5224054	113767	g_12122	g_33333
ptg000013l	5226059	5246960	20901	g_33333	g_6496
ptg000013l	5252337	5261570	9233	g_6496	g_21323
ptg000013l	5287658	5312320	24662	g_21323	g_7688
ptg000013l	5316444	5379677	63233	g_7688	g_34501
ptg000013l	5402013	5461053	59040	g_34501	g_38838
ptg000013l	5461298	5465507	4209	g_38838	g_17318
ptg000013l	5468484	5469114	630	g_17318	g_37448
ptg000013l	5471471	5472852	1381	g_37448	g_32221
ptg000013l	5473328	5504687	31359	g_32221	g_17969
ptg000013l	5505891	5521998	16107	g_17969	g_37442
ptg000013l	5535210	5555835	20625	g_37442	g_28308
ptg000013l	5569439	5569653	214	g_28308	g_29313
ptg000013l	5578345	5628986	50641	g_29313	g_37835
ptg000013l	5629432	5638335	8903	g_37835	g_7303
ptg000013l	5640134	5642386	2252	g_7303	g_5739
ptg000013l	5644177	5677813	33636	g_5739	g_22743
ptg000013l	5679461	5750547	71086	g_22743	g_17489
ptg000013l	5752187	5804629	52442	g_17489	g_21265
ptg000013l	5814109	5851805	37696	g_21265	g_21236
ptg000013l	5869700	5885552	15852	g_21236	g_5299
ptg000013l	5885782	5977864	92082	g_5299	g_23081
ptg000013l	5978571	6045991	67420	g_23081	g_32931
ptg000013l	6047127	6047944	817	g_32931	g_30357
ptg000013l	6059384	6066228	6844	g_30357	g_26713
ptg000013l	6067871	6107853	39982	g_26713	g_20909
ptg000013l	6113171	6159381	46210	g_20909	g_15014
ptg000013l	6159908	6175706	15798	g_15014	g_14205
ptg000013l	6179697	6186165	6468	g_14205	g_21790
ptg000013l	6194055	6198205	4150	g_21790	g_33706
ptg000013l	6199084	6204496	5412	g_33706	g_15003
ptg000013l	6214494	6222865	8371	g_15003	g_20453
ptg000013l	6224319	6231033	6714	g_20453	g_762
ptg000013l	6237109	6247030	9921	g_762	g_27142
ptg000013l	6258987	6264148	5161	g_27142	g_11288
ptg000013l	6266469	6291113	24644	g_11288	g_11439
ptg000013l	6294173	6294747	574	g_11439	g_6823
ptg000013l	6298735	6304162	5427	g_6823	g_21588
ptg000013l	6309383	6312123	2740	g_21588	g_25530
ptg000013l	6315145	6325301	10156	g_25530	g_928
ptg000013l	6327953	6349299	21346	g_928	g_5093
ptg000013l	6352668	6363535	10867	g_5093	g_4386
ptg000013l	6365256	6371488	6232	g_4386	g_400
ptg000013l	6393684	6411646	17962	g_400	g_28720
ptg000013l	6419261	6425253	5992	g_28720	g_7813
ptg000013l	6432872	6466413	33541	g_7813	g_6802
ptg000013l	6491864	6521239	29375	g_6802	g_31209
ptg000013l	6522663	6528420	5757	g_31209	g_11463
ptg000013l	6528662	6662666	134004	g_11463	g_29691
ptg000013l	6662911	6831674	168763	g_29691	g_28738
ptg000013l	6842396	6863391	20995	g_28738	g_16196
ptg000013l	6866597	6871772	5175	g_16196	g_2236
ptg000013l	6872080	6906958	34878	g_2236	g_40131
ptg000013l	6924310	6924318	8	g_40131	g_14257
ptg000013l	6924611	6927129	2518	g_14257	g_26894
ptg000013l	6928564	6939025	10461	g_26894	g_6584
ptg000013l	6944014	6949449	5435	g_6584	g_28190
ptg000013l	6963163	6964493	1330	g_28190	g_35813
ptg000013l	6967300	6969134	1834	g_35813	g_21799
ptg000013l	6976150	6979926	3776	g_21799	g_5298
ptg000013l	6988239	6991126	2887	g_5298	g_4958
ptg000013l	6998573	7011673	13100	g_4958	g_5451
ptg000013l	7037864	7054009	16145	g_5451	g_19460
ptg000013l	7055423	7056867	1444	g_19460	g_16062
ptg000013l	7059471	7064511	5040	g_16062	g_12856
ptg000013l	7069687	7112808	43121	g_12856	g_28998
ptg000013l	7117969	7123733	5764	g_28998	g_12733
ptg000013l	7126218	7150426	24208	g_12733	g_15688
ptg000013l	7182752	7267598	84846	g_15688	g_11051
ptg000013l	7267867	7335191	67324	g_11051	g_33375
ptg000013l	7335490	7343511	8021	g_33375	g_15256
ptg000013l	7343939	7349127	5188	g_15256	g_6905
ptg000013l	7363192	7374299	11107	g_6905	g_12892
ptg000013l	7394658	7407743	13085	g_12892	g_26250
ptg000013l	7408762	7410604	1842	g_26250	g_21636
ptg000013l	7418778	7420582	1804	g_21636	g_4751
ptg000013l	7423253	7425175	1922	g_4751	g_36557
ptg000013l	7429783	7432624	2841	g_36557	g_3011
ptg000013l	7438512	7440711	2199	g_3011	g_17794
ptg000013l	7441836	7455631	13795	g_17794	g_10671
ptg000013l	7459660	7462055	2395	g_10671	g_40094
ptg000013l	7474867	7475907	1040	g_40094	g_11262
ptg000013l	7476110	7499319	23209	g_11262	g_506
ptg000013l	7513244	7519637	6393	g_506	g_34792
ptg000013l	7528245	7537854	9609	g_34792	g_25369
ptg000013l	7542638	7545820	3182	g_25369	g_495
ptg000013l	7546661	7551802	5141	g_495	g_37875
ptg000013l	7552191	7564699	12508	g_37875	g_23997
ptg000013l	7565088	7576014	10926	g_23997	g_37907
ptg000013l	7576604	7605239	28635	g_37907	g_14356
ptg000013l	7605721	7611267	5546	g_14356	g_11451
ptg000013l	7613476	7628917	15441	g_11451	g_475
ptg000013l	7632574	7647439	14865	g_19656	g_15467
ptg000013l	7651826	7658920	7094	g_15467	g_5290
ptg000013l	7662403	7664627	2224	g_5290	g_5719
ptg000013l	7675260	7696953	21693	g_5719	g_8111
ptg000013l	7707250	7726066	18816	g_8111	g_6566
ptg000013l	7735130	7804956	69826	g_6566	g_28787
ptg000013l	7805528	7816609	11081	g_28787	g_25953
ptg000013l	7824270	7825524	1254	g_25953	g_8870
ptg000013l	7826495	7846189	19694	g_8870	g_34692
ptg000013l	7853719	7883777	30058	g_34692	g_14174
ptg000013l	7904056	7904306	250	g_14174	g_23024
ptg000013l	7904593	7912617	8024	g_23024	g_14852
ptg000013l	7922998	7926256	3258	g_14852	g_11512
ptg000013l	7926591	7933922	7331	g_11512	g_26899
ptg000013l	7938566	7969273	30707	g_26899	g_307
ptg000013l	7973047	7974145	1098	g_307	g_15720
ptg000013l	7976770	7987063	10293	g_15720	g_37662
ptg000013l	7991879	7994626	2747	g_37662	g_29476
ptg000013l	7994829	7994978	149	g_29476	g_23644
ptg000013l	7996360	8030792	34432	g_23644	g_9808
ptg000013l	8031205	8033781	2576	g_9808	g_17897
ptg000013l	8034107	8199330	165223	g_17897	g_34507
ptg000013l	8222658	8246872	24214	g_34507	g_15657
ptg000013l	8250241	8250744	503	g_15657	g_29976
ptg000013l	8257370	8259865	2495	g_29976	g_36560
ptg000013l	8268004	8271944	3940	g_36560	g_28562
ptg000013l	8272192	8280898	8706	g_28562	g_32113
ptg000013l	8297308	8304526	7218	g_32113	g_15111
ptg000013l	8305085	8340173	35088	g_15111	g_39080
ptg000013l	8340553	8340587	34	g_39080	g_39453
ptg000013l	8341012	8393107	52095	g_39453	g_30179
ptg000013l	8405668	8410880	5212	g_30179	g_10746
ptg000013l	8411719	8417992	6273	g_10746	g_6650
ptg000013l	8434577	8439787	5210	g_6650	g_24270
ptg000013l	8442174	8456019	13845	g_24270	g_21307
ptg000013l	8457191	8457729	538	g_21307	g_27983
ptg000013l	8459318	8475177	15859	g_27983	g_27460
ptg000013l	8475476	8479231	3755	g_27460	g_8533
ptg000013l	8480296	8485579	5283	g_8533	g_17607
ptg000013l	8486130	8492370	6240	g_17607	g_37608
ptg000013l	8496991	8501851	4860	g_37608	g_24022
ptg000013l	8505513	8510430	4917	g_24022	g_35890
ptg000013l	8517400	8521925	4525	g_35890	g_3114
ptg000013l	8536434	8539432	2998	g_3114	g_6556
ptg000013l	8545242	8550813	5571	g_6556	g_14247
ptg000013l	8556096	8570050	13954	g_14247	g_11122
ptg000013l	8572757	8574206	1449	g_11122	g_34753
ptg000013l	8576697	8602307	25610	g_34753	g_26803
ptg000013l	8615335	8656048	40713	g_26803	g_20564
ptg000013l	8656251	8673916	17665	g_20564	g_19734
ptg000013l	8674191	8931981	257790	g_19734	g_29763
ptg000013l	8934180	8941631	7451	g_29763	g_27096
ptg000013l	8946949	8950528	3579	g_27096	g_6402
ptg000013l	8959303	8964895	5592	g_6402	g_26912
ptg000013l	8985969	8988120	2151	g_26912	g_35218
ptg000013l	8988332	9003369	15037	g_35218	g_39977
ptg000013l	9004428	9008636	4208	g_39977	g_4518
ptg000013l	9029627	9038215	8588	g_4518	g_11739
ptg000013l	9042727	9047885	5158	g_11739	g_1436
ptg000013l	9048898	9050583	1685	g_1436	g_23393
ptg000013l	9053174	9058146	4972	g_23393	g_39925
ptg000013l	9063440	9067255	3815	g_39925	g_21308
ptg000013l	9068445	9124892	56447	g_21308	g_22439
ptg000013l	9127324	9165888	38564	g_22439	g_838
ptg000013l	9167204	9168792	1588	g_838	g_27878
ptg000013l	9171767	9174057	2290	g_27878	g_8282
ptg000013l	9175882	9223777	47895	g_8282	g_11238
ptg000013l	9230402	9241824	11422	g_11238	g_26454
ptg000013l	9246625	9256292	9667	g_26454	g_10199
ptg000013l	9260112	9262594	2482	g_10199	g_4496
ptg000013l	9279017	9340447	61430	g_4496	g_3780
ptg000013l	9341472	9384244	42772	g_3780	g_25390
ptg000013l	9392003	9509013	117010	g_25390	g_29439
ptg000013l	9541569	9585064	43495	g_29439	g_21342
ptg000013l	9606798	9648733	41935	g_21342	g_3494
ptg000013l	9649881	9785208	135327	g_3494	g_31293
ptg000013l	9788951	9790897	1946	g_31293	g_2492
ptg000013l	9792384	9794925	2541	g_2492	g_13423
ptg000013l	9803271	9815877	12606	g_13423	g_1783
ptg000013l	9817088	9830569	13481	g_1783	g_3174
ptg000013l	9852174	9967491	115317	g_3174	g_5907
ptg000013l	9985000	9991892	6892	g_5907	g_3053
ptg000013l	10000744	10062076	61332	g_3053	g_26805
ptg000013l	10064282	10071195	6913	g_26805	g_16755
ptg000013l	10073446	10106780	33334	g_16755	g_8274
ptg000013l	10107382	10115876	8494	g_8274	g_12308
ptg000013l	10121839	10130455	8616	g_12308	g_19844
ptg000013l	10132305	10135685	3380	g_19844	g_23005
ptg000013l	10142310	10145347	3037	g_23005	g_12838
ptg000013l	10145757	10186531	40774	g_12838	g_16760
ptg000013l	10187481	10189205	1724	g_16760	g_34016
ptg000013l	10189936	10252885	62949	g_34016	g_16960
ptg000013l	10259191	10263092	3901	g_16960	g_18905
ptg000013l	10264118	10322789	58671	g_18905	g_23985
ptg000013l	10323433	10381197	57764	g_23985	g_4670
ptg000013l	10386914	10389946	3032	g_4670	g_33915
ptg000013l	10398451	10399368	917	g_33915	g_32669
ptg000013l	10402116	10412390	10274	g_32669	g_31955
ptg000013l	10431393	10434585	3192	g_31955	g_34181
ptg000013l	10438104	10440528	2424	g_34181	g_35424
ptg000013l	10444623	10456499	11876	g_35424	g_13463
ptg000013l	10469604	10646860	177256	g_13463	g_8594
ptg000013l	10647069	10651436	4367	g_8594	g_34244
ptg000013l	10651699	10653334	1635	g_34244	g_17898
ptg000013l	10670805	10678153	7348	g_17898	g_10699
ptg000013l	10700817	10722199	21382	g_10699	g_2479
ptg000013l	10722492	10828755	106263	g_2479	g_699
ptg000013l	10842421	10887684	45263	g_699	g_24520
ptg000013l	10911984	10978614	66630	g_24520	g_36915
ptg000013l	10983293	10987055	3762	g_36915	g_2611
ptg000013l	10999295	11077606	78311	g_2611	g_15529
ptg000013l	11099791	11111855	12064	g_15529	g_39764
ptg000013l	11133577	11240098	106521	g_39764	g_2643
ptg000013l	11240412	11389377	148965	g_2643	g_22276
ptg000013l	11410011	11412926	2915	g_22276	g_383
ptg000013l	11424769	11426571	1802	g_383	g_37631
ptg000013l	11431101	11461194	30093	g_37631	g_38207
ptg000013l	11463833	11511742	47909	g_38207	g_13937
ptg000013l	11521358	11528094	6736	g_13937	g_12833
ptg000013l	11528300	11530094	1794	g_12833	g_27761
ptg000013l	11545710	11548470	2760	g_27761	g_3598
ptg000013l	11557164	11561869	4705	g_3598	g_2948
ptg000013l	11563783	11565678	1895	g_2948	g_14180
ptg000013l	11577461	11584427	6966	g_14180	g_548
ptg000013l	11594806	11602056	7250	g_548	g_17331
ptg000013l	11611677	11664090	52413	g_17331	g_2128
ptg000013l	11664296	11669920	5624	g_2128	g_6522
ptg000013l	11677336	11688423	11087	g_6522	g_32229
ptg000013l	11688821	11692687	3866	g_32229	g_24113
ptg000013l	11697183	11702483	5300	g_24113	g_22872
ptg000013l	11706833	11708437	1604	g_22872	g_24802
ptg000013l	11710591	11711602	1011	g_24802	g_1503
ptg000013l	11718475	11719153	678	g_1503	g_19628
ptg000013l	11726583	11731862	5279	g_19628	g_35400
ptg000013l	11732242	11742305	10063	g_35400	g_24804
ptg000013l	11742529	11752597	10068	g_24804	g_26885
ptg000013l	11754090	11776307	22217	g_26885	g_29761
ptg000013l	11782144	11794190	12046	g_29761	g_517
ptg000013l	11797204	11799649	2445	g_517	g_20314
ptg000013l	11801470	11802956	1486	g_20314	g_23952
ptg000013l	11809540	11820059	10519	g_23952	g_2549
ptg000013l	11862808	11863713	905	g_2549	g_11399
ptg000013l	11882961	11887913	4952	g_11399	g_5721
ptg000013l	11898701	11902997	4296	g_5721	g_28783
ptg000013l	11905142	11906067	925	g_28783	g_30252
ptg000013l	11909810	11930723	20913	g_30252	g_26541
ptg000013l	11939050	11942013	2963	g_26541	g_8127
ptg000013l	11944825	11948136	3311	g_8127	g_16895
ptg000013l	11959397	11961768	2371	g_16895	g_2947
ptg000013l	11964301	11994113	29812	g_2947	g_25948
ptg000013l	11995993	11997974	1981	g_25948	g_31400
ptg000013l	12008066	12021603	13537	g_31400	g_1462
ptg000013l	12022112	12042652	20540	g_1462	g_6714
ptg000013l	12066466	12079390	12924	g_6714	g_24687
ptg000013l	12082575	12276227	193652	g_24687	g_9467
ptg000013l	12276577	12361581	85004	g_9467	g_24055
ptg000013l	12363856	12372134	8278	g_24055	g_19755
ptg000013l	12373351	12394857	21506	g_19755	g_6080
ptg000013l	12410172	12438760	28588	g_6080	g_15527
ptg000013l	12449934	12456683	6749	g_15527	g_7299
ptg000013l	12457300	12458223	923	g_7299	g_15339
ptg000013l	12458471	12461725	3254	g_15339	g_19305
ptg000013l	12462249	12522616	60367	g_19305	g_12406
ptg000013l	12532937	12538481	5544	g_12406	g_14593
ptg000013l	12538699	12549229	10530	g_14593	g_5212
ptg000013l	12549447	12576198	26751	g_5212	g_35197
ptg000013l	12587676	12594251	6575	g_35197	g_19243
ptg000013l	12594493	12606077	11584	g_19243	g_22656
ptg000013l	12626594	12632274	5680	g_22656	g_13410
ptg000013l	12635269	12636482	1213	g_13410	g_7285
ptg000013l	12652936	12655546	2610	g_7285	g_13994
ptg000013l	12670126	12692976	22850	g_13994	g_7643
ptg000013l	12695562	12700969	5407	g_7643	g_28749
ptg000013l	12706897	12720834	13937	g_28749	g_24150
ptg000013l	12732574	12737295	4721	g_24150	g_1670
ptg000013l	12740943	12753593	12650	g_1670	g_37779
ptg000013l	12762481	12785940	23459	g_37779	g_21066
ptg000013l	12786914	12790811	3897	g_21066	g_34043
ptg000013l	12793329	12795498	2169	g_34043	g_31921
ptg000013l	12798454	12801279	2825	g_31921	g_13208
ptg000013l	12802972	12808572	5600	g_13208	g_35220
ptg000013l	12811354	12819149	7795	g_35220	g_15117
ptg000013l	12821476	12823750	2274	g_15117	g_30427
ptg000013l	12837367	12842895	5528	g_30427	g_27111
ptg000013l	12843251	12843355	104	g_27111	g_40264
ptg000013l	12845582	12854320	8738	g_40264	g_4809
ptg000013l	12856808	12866151	9343	g_4809	g_6327
ptg000013l	12867951	12869702	1751	g_6327	g_40013
ptg000013l	12875668	12877522	1854	g_40013	g_13199
ptg000013l	12885686	12894205	8519	g_13199	g_37963
ptg000013l	12901796	12933614	31818	g_37963	g_19923
ptg000013l	12941885	12947169	5284	g_19923	g_12695
ptg000013l	12957378	12960141	2763	g_12695	g_718
ptg000013l	12970282	12973342	3060	g_718	g_7705
ptg000013l	12991120	12992822	1702	g_7705	g_815
ptg000013l	12997520	13000026	2506	g_815	g_20936
ptg000013l	13006282	13014349	8067	g_20936	g_15275
ptg000013l	13030796	13129599	98803	g_15275	g_31577
ptg000013l	13139042	13153007	13965	g_31577	g_5131
ptg000013l	13175900	13293416	117516	g_5131	g_34278
ptg000013l	13298157	13303042	4885	g_34278	g_20531
ptg000013l	13306204	13314577	8373	g_20531	g_25384
ptg000013l	13316466	13321088	4622	g_25384	g_15078
ptg000013l	13425735	13457532	31797	g_15078	g_35541
ptg000013l	13459685	13470590	10905	g_35541	g_21340
ptg000013l	13470823	13534747	63924	g_21340	g_10489
ptg000013l	13538204	13566787	28583	g_10489	g_6456
ptg000013l	13568814	13569536	722	g_6456	g_5991
ptg000013l	13578220	13578866	646	g_5991	g_9589
ptg000013l	13583891	13640271	56380	g_9589	g_36786
ptg000013l	13640552	13688479	47927	g_36786	g_19262
ptg000013l	13693618	13696370	2752	g_19262	g_26904
ptg000013l	13701856	13709625	7769	g_26904	g_3998
ptg000013l	13721300	13801587	80287	g_3998	g_7420
ptg000013l	13841653	13944260	102607	g_7420	g_30145
ptg000013l	13944640	13945478	838	g_30145	g_6106
ptg000013l	13945834	13994570	48736	g_6106	g_22633
ptg000013l	14002312	14006824	4512	g_22633	g_35727
ptg000013l	14007963	14068774	60811	g_35727	g_27713
ptg000013l	14077501	14091278	13777	g_27713	g_7765
ptg000013l	14099322	14196137	96815	g_7765	g_29278
ptg000013l	14196715	14240645	43930	g_29278	g_1794
ptg000013l	14260999	14263403	2404	g_1794	g_27000
ptg000013l	14272768	14507528	234760	g_27000	g_21934
ptg000013l	14534937	14557892	22955	g_21934	g_35079
ptg000013l	14558203	14615792	57589	g_35079	g_30949
ptg000013l	14616112	14641383	25271	g_30949	g_34851
ptg000013l	14643563	14768428	124865	g_34851	g_37913
ptg000013l	14768833	14821001	52168	g_37913	g_37700
ptg000013l	14821237	14976316	155079	g_37700	g_15447
ptg000013l	15013541	15232804	219263	g_15447	g_10325
ptg000013l	15244267	15269967	25700	g_10325	g_28862
ptg000013l	15288140	15365902	77762	g_28862	g_6476
ptg000013l	15372411	15387028	14617	g_6476	g_25688
ptg000013l	15387438	15404145	16707	g_25688	g_15944
ptg000013l	15410548	15411746	1198	g_15944	g_31519
ptg000013l	15419591	15433650	14059	g_31519	g_34598
ptg000013l	15444990	15453042	8052	g_34598	g_17410
ptg000013l	15455649	15457128	1479	g_17410	g_17765
ptg000013l	15468688	15487771	19083	g_17765	g_13751
ptg000013l	15494921	15553588	58667	g_13751	g_21807
ptg000013l	15600764	15640634	39870	g_21807	g_29803
ptg000013l	15640882	15747531	106649	g_29803	g_20581
ptg000013l	15757849	15812171	54322	g_20581	g_9427
ptg000013l	15825283	16038083	212800	g_9427	g_37494
ptg000013l	16059709	16084009	24300	g_37494	g_1735
ptg000013l	16110219	16116127	5908	g_1735	g_24653
ptg000013l	16124786	16144210	19424	g_24653	g_16170
ptg000013l	16163566	16171367	7801	g_16170	g_2615
ptg000013l	16188566	16236686	48120	g_39868	g_1388
ptg000013l	16237744	16320472	82728	g_1388	g_31908
ptg000013l	16328523	16367516	38993	g_31908	g_33790
ptg000013l	16368427	16374955	6528	g_33790	g_13655
ptg000013l	16390822	16403789	12967	g_13655	g_20914
ptg000013l	16404526	16429357	24831	g_20914	g_18884
ptg000013l	16429701	16490064	60363	g_18884	g_7063
ptg000013l	16513106	16516871	3765	g_7063	g_18758
ptg000013l	16528649	16569885	41236	g_18758	g_17426
ptg000013l	16628436	16635219	6783	g_17426	g_14799
ptg000013l	16638713	16641021	2308	g_14799	g_10574
ptg000013l	16641334	16829937	188603	g_10574	g_21478
ptg000013l	16840643	16847842	7199	g_21478	g_4200
ptg000013l	16852141	16858054	5913	g_4200	g_36224
ptg000013l	16862716	16864034	1318	g_36224	g_11073
ptg000013l	16868501	16868962	461	g_11073	g_7243
ptg000013l	16869450	16870960	1510	g_7243	g_24550
ptg000013l	16888587	16894601	6014	g_24550	g_30571
ptg000013l	16909314	16925691	16377	g_30571	g_19311
ptg000013l	16932964	16944285	11321	g_19311	g_20920
ptg000013l	16957863	17036618	78755	g_20920	g_2195
ptg000013l	17038559	17043716	5157	g_2195	g_2756
ptg000013l	17045425	17050564	5139	g_2756	g_2214
ptg000013l	17052260	17057308	5048	g_2214	g_5634
ptg000013l	17059004	17064639	5635	g_5634	g_14359
ptg000013l	17066335	17071692	5357	g_14359	g_34057
ptg000013l	17073390	17078593	5203	g_34057	g_35636
ptg000013l	17080332	17085508	5176	g_35636	g_26171
ptg000013l	17087204	17092720	5516	g_26171	g_26760
ptg000013l	17094416	17099683	5267	g_26760	g_26478
ptg000013l	17101385	17106752	5367	g_26478	g_34108
ptg000013l	17108661	17122549	13888	g_34108	g_12064
ptg000013l	17124044	17131615	7571	g_12064	g_12048
ptg000013l	17132370	17140829	8459	g_12048	g_37761
ptg000013l	17142402	17150554	8152	g_37761	g_5346
ptg000013l	17153345	17155778	2433	g_5346	g_5636
ptg000013l	17158053	17168422	10369	g_5636	g_9913
ptg000013l	17169950	17176541	6591	g_9913	g_40029
ptg000013l	17178739	17207878	29139	g_40029	g_7214
ptg000013l	17210645	17413256	202611	g_7214	g_3027
ptg000013l	17421725	17429616	7891	g_3027	g_18225
ptg000013l	17439221	17474739	35518	g_18225	g_24656
ptg000013l	17489396	17499511	10115	g_24656	g_29470
ptg000013l	17506931	17578225	71294	g_29470	g_28972
ptg000013l	17592972	17614952	21980	g_28972	g_39265
ptg000013l	17615233	17813552	198319	g_39265	g_17107
ptg000013l	17842841	17848950	6109	g_17107	g_19617
ptg000013l	17865443	17881094	15651	g_19617	g_32265
ptg000013l	17901417	17943470	42053	g_32265	g_20641
ptg000013l	17944921	17951209	6288	g_20641	g_10263
ptg000013l	17951538	17951868	330	g_10263	g_24717
ptg000013l	17960313	17992899	32586	g_24717	g_5305
ptg000013l	17993315	18033488	40173	g_5305	g_24431
ptg000013l	18033751	18070267	36516	g_24431	g_30141
ptg000013l	18089260	18090136	876	g_30141	g_11628
ptg000013l	18100586	18113382	12796	g_11628	g_10755
ptg000013l	18115434	18123580	8146	g_10755	g_23842
ptg000013l	18129158	18146092	16934	g_23842	g_35987
ptg000013l	18149940	18196156	46216	g_35987	g_6602
ptg000013l	18200468	18208979	8511	g_6602	g_34931
ptg000013l	18210156	18237180	27024	g_34931	g_36479
ptg000013l	18237809	18246043	8234	g_36479	g_35857
ptg000013l	18249883	18306596	56713	g_35857	g_36976
ptg000013l	18310526	18388043	77517	g_36976	g_27445
ptg000013l	18397234	18397692	458	g_27445	g_25057
ptg000013l	18398804	18398855	51	g_25057	g_28628
ptg000013l	18400765	18408066	7301	g_28628	g_17702
ptg000013l	18411836	18418200	6364	g_17702	g_16811
ptg000013l	18424536	18426693	2157	g_16811	g_14132
ptg000013l	18444346	18445448	1102	g_14132	g_6257
ptg000013l	18467075	18477121	10046	g_6257	g_16944
ptg000013l	18477348	18522340	44992	g_16944	g_10328
ptg000013l	18524756	18526177	1421	g_10328	g_17193
ptg000013l	18534792	18537414	2622	g_17193	g_10037
ptg000013l	18543562	18559972	16410	g_10037	g_1688
ptg000013l	18571162	18578955	7793	g_1688	g_22607
ptg000013l	18584994	18623475	38481	g_22607	g_23946
ptg000013l	18630708	18676794	46086	g_23946	g_5695
ptg000013l	18705791	18706847	1056	g_5695	g_40001
ptg000013l	18713533	18728710	15177	g_40001	g_31156
ptg000013l	18729204	18910880	181676	g_31156	g_4880
ptg000013l	18914319	18986832	72513	g_4880	g_12664
ptg000013l	18989219	18991813	2594	g_12664	g_31855
ptg000013l	18992538	18995260	2722	g_31855	g_35266
ptg000013l	19012117	19100475	88358	g_35266	g_6400
ptg000013l	19110476	19115326	4850	g_6400	g_9103
ptg000013l	19115721	19149009	33288	g_9103	g_19926
ptg000013l	19149473	19176285	26812	g_19926	g_19379
ptg000013l	19180774	19195536	14762	g_19379	g_35555
ptg000013l	19195736	19198430	2694	g_35555	g_30484
ptg000013l	19204937	19209480	4543	g_30484	g_20497
ptg000013l	19213966	19230578	16612	g_20497	g_32504
ptg000013l	19234909	19240474	5565	g_32504	g_12978
ptg000014l	93240	95225	1985	g_37903	g_6739
ptg000014l	95467	110429	14962	g_6739	g_9526
ptg000014l	141170	229768	88598	g_9526	g_4972
ptg000014l	240996	255297	14301	g_4972	g_29956
ptg000014l	268891	269859	968	g_29956	g_5138
ptg000014l	284133	285860	1727	g_5138	g_31873
ptg000014l	288744	295076	6332	g_31873	g_28689
ptg000014l	295882	312990	17108	g_28689	g_2274
ptg000014l	313262	386865	73603	g_2274	g_27125
ptg000014l	399952	401798	1846	g_27125	g_1201
ptg000014l	402478	403997	1519	g_1201	g_8100
ptg000014l	404323	416202	11879	g_8100	g_38473
ptg000014l	417175	439411	22236	g_38473	g_20495
ptg000014l	449064	452990	3926	g_20495	g_35426
ptg000014l	470102	498517	28415	g_35426	g_10301
ptg000014l	499779	545728	45949	g_10301	g_36950
ptg000014l	545979	554072	8093	g_36950	g_20962
ptg000014l	554674	585955	31281	g_20962	g_34005
ptg000014l	588115	597163	9048	g_34005	g_11755
ptg000014l	610427	761288	150861	g_11755	g_14921
ptg000014l	787876	792974	5098	g_14921	g_35808
ptg000014l	797767	798498	731	g_35808	g_38226
ptg000014l	805485	892436	86951	g_38226	g_37003
ptg000014l	904986	1018822	113836	g_37003	g_23360
ptg000014l	1085526	1433850	348324	g_23360	g_27948
ptg000014l	1445677	1458413	12736	g_27948	g_531
ptg000014l	1458652	1473026	14374	g_531	g_24275
ptg000014l	1481731	1494770	13039	g_24275	g_36151
ptg000014l	1497289	1500815	3526	g_36151	g_18662
ptg000014l	1505094	1507393	2299	g_18662	g_35951
ptg000014l	1518347	1525146	6799	g_35951	g_38223
ptg000014l	1532964	1537165	4201	g_38223	g_36657
ptg000014l	1541997	1557361	15364	g_36657	g_4667
ptg000014l	1578627	1587013	8386	g_4667	g_2693
ptg000014l	1617685	1622300	4615	g_2693	g_12334
ptg000014l	1634238	1754354	120116	g_12334	g_9010
ptg000014l	1755403	1779845	24442	g_9010	g_29367
ptg000014l	1807094	1814431	7337	g_29367	g_29841
ptg000014l	1818326	1855585	37259	g_29841	g_21624
ptg000014l	1868578	1872064	3486	g_21624	g_4170
ptg000014l	1879113	1887741	8628	g_4170	g_20519
ptg000014l	1891222	1892428	1206	g_20519	g_15682
ptg000014l	1902146	1915400	13254	g_15682	g_1039
ptg000014l	1927293	1971220	43927	g_1039	g_38071
ptg000014l	1971597	2021749	50152	g_38071	g_32225
ptg000014l	2022714	2026059	3345	g_32225	g_3302
ptg000014l	2026532	2091622	65090	g_3302	g_28654
ptg000014l	2092665	2136852	44187	g_28654	g_15088
ptg000014l	2137445	2176517	39072	g_15088	g_25002
ptg000014l	2183677	2249119	65442	g_25002	g_10225
ptg000014l	2269530	2384911	115381	g_10225	g_5381
ptg000014l	2386113	2409430	23317	g_5381	g_28286
ptg000014l	2423962	2499540	75578	g_28286	g_15703
ptg000014l	2512094	2532445	20351	g_15703	g_28507
ptg000014l	2533056	2538482	5426	g_28507	g_12641
ptg000014l	2554993	2677212	122219	g_12641	g_30218
ptg000014l	2677601	2714798	37197	g_30218	g_31009
ptg000014l	2715442	2846852	131410	g_31009	g_2311
ptg000014l	2847055	3025591	178536	g_2311	g_11838
ptg000014l	3027030	3027337	307	g_11838	g_15996
ptg000014l	3027738	3028731	993	g_15996	g_22482
ptg000014l	3029867	3035571	5704	g_22482	g_31950
ptg000014l	3036857	3047503	10646	g_31950	g_11915
ptg000014l	3048045	3080403	32358	g_11915	g_32579
ptg000014l	3080690	3430312	349622	g_32579	g_34235
ptg000014l	3430653	3487598	56945	g_34235	g_25009
ptg000014l	3487813	3566672	78859	g_25009	g_995
ptg000014l	3569140	3570612	1472	g_995	g_20889
ptg000014l	3572741	3583769	11028	g_20889	g_10684
ptg000014l	3601905	3652868	50963	g_10684	g_10830
ptg000014l	3653299	3665843	12544	g_10830	g_20746
ptg000014l	3666907	3669650	2743	g_20746	g_20663
ptg000014l	3672265	3686555	14290	g_20663	g_30740
ptg000014l	3690787	3736292	45505	g_30740	g_25949
ptg000014l	3741310	3761102	19792	g_25949	g_2571
ptg000014l	3761323	3791869	30546	g_2571	g_8476
ptg000014l	3805439	3928759	123320	g_8476	g_20221
ptg000014l	3929088	4044758	115670	g_20221	g_2384
ptg000014l	4058319	4094149	35830	g_2384	g_22169
ptg000014l	4099188	4100572	1384	g_22169	g_1838
ptg000014l	4101868	4107234	5366	g_1838	g_7594
ptg000014l	4107725	4110971	3246	g_7594	g_5535
ptg000014l	4114970	4120917	5947	g_5535	g_13013
ptg000014l	4124786	4126123	1337	g_13013	g_17775
ptg000014l	4127413	4132841	5428	g_17775	g_32162
ptg000014l	4133332	4136100	2768	g_32162	g_16284
ptg000014l	4140209	4171376	31167	g_16284	g_25945
ptg000014l	4192789	4217972	25183	g_25945	g_10904
ptg000014l	4221082	4222005	923	g_10904	g_6467
ptg000014l	4228971	4251924	22953	g_6467	g_12983
ptg000014l	4257698	4261858	4160	g_12983	g_32142
ptg000014l	4277879	4473671	195792	g_32142	g_26596
ptg000014l	4474288	4485570	11282	g_26596	g_24107
ptg000014l	4486187	4539456	53269	g_24107	g_27315
ptg000014l	4540055	4560241	20186	g_27315	g_14599
ptg000014l	4561527	4615121	53594	g_14599	g_23358
ptg000014l	4615894	4808077	192183	g_23358	g_34337
ptg000014l	4809027	4850977	41950	g_34337	g_2736
ptg000014l	4851699	4887414	35715	g_2736	g_25468
ptg000014l	4887704	4887812	108	g_25468	g_26845
ptg000014l	4888054	5003300	115246	g_26845	g_9871
ptg000014l	5004313	5005234	921	g_9871	g_40076
ptg000014l	5030820	5068633	37813	g_40076	g_32454
ptg000014l	5073148	5102612	29464	g_32454	g_13880
ptg000014l	5103190	5111469	8279	g_13880	g_26665
ptg000014l	5111846	5114781	2935	g_26665	g_28531
ptg000014l	5121872	5167352	45480	g_28531	g_37703
ptg000014l	5169169	5171459	2290	g_37703	g_30460
ptg000014l	5172745	5172927	182	g_30460	g_22265
ptg000014l	5174387	5178492	4105	g_22265	g_6230
ptg000014l	5180309	5183906	3597	g_6230	g_18025
ptg000014l	5185723	5213216	27493	g_18025	g_33186
ptg000014l	5214502	5217344	2842	g_33186	g_16549
ptg000014l	5219161	5234324	15163	g_16549	g_34667
ptg000014l	5236141	5303582	67441	g_34667	g_31888
ptg000014l	5305021	5305204	183	g_31888	g_24912
ptg000014l	5307021	5329537	22516	g_24912	g_23295
ptg000014l	5330991	5364304	33313	g_23295	g_11650
ptg000014l	5365354	5545196	179842	g_11650	g_25862
ptg000014l	5548480	5551283	2803	g_25862	g_30500
ptg000014l	5553801	5554335	534	g_30500	g_35441
ptg000014l	5579102	5604258	25156	g_35441	g_21300
ptg000014l	5606946	5609690	2744	g_21300	g_254
ptg000014l	5623709	5675971	52262	g_254	g_5594
ptg000015l	261937	312416	50479	g_10873	g_6077
ptg000015l	312817	353741	40924	g_6077	g_31029
ptg000015l	354358	450098	95740	g_31029	g_8704
ptg000015l	450622	495009	44387	g_8704	g_38040
ptg000015l	495263	504686	9423	g_38040	g_769
ptg000015l	505453	505492	39	g_769	g_30812
ptg000015l	507873	541873	34000	g_30812	g_9750
ptg000015l	542112	547228	5116	g_9750	g_11618
ptg000015l	548964	566707	17743	g_11618	g_21935
ptg000015l	581917	611801	29884	g_21935	g_24839
ptg000015l	627515	665894	38379	g_24839	g_16286
ptg000015l	666403	666803	400	g_16286	g_11517
ptg000015l	667333	672946	5613	g_11517	g_33129
ptg000015l	673410	812327	138917	g_33129	g_12360
ptg000015l	812605	813225	620	g_12360	g_14226
ptg000015l	813428	899543	86115	g_14226	g_32929
ptg000015l	899896	914115	14219	g_32929	g_24708
ptg000015l	924497	978086	53589	g_24708	g_25174
ptg000015l	979027	980524	1497	g_25174	g_33832
ptg000015l	981048	981566	518	g_33832	g_17810
ptg000015l	982039	991342	9303	g_17810	g_17797
ptg000015l	991605	1014052	22447	g_17797	g_11695
ptg000015l	1017103	1114359	97256	g_11695	g_12518
ptg000015l	1116463	1119111	2648	g_12518	g_8602
ptg000015l	1120069	1262535	142466	g_8602	g_14773
ptg000015l	1262879	1327123	64244	g_14773	g_16213
ptg000015l	1341139	1387702	46563	g_16213	g_2294
ptg000015l	1389108	1396437	7329	g_2294	g_17939
ptg000015l	1401086	1410183	9097	g_17939	g_20166
ptg000015l	1425161	1495467	70306	g_20166	g_37156
ptg000015l	1514498	1581833	67335	g_37156	g_13400
ptg000015l	1597171	1603094	5923	g_13400	g_5085
ptg000015l	1607179	1620253	13074	g_5085	g_33071
ptg000015l	1620696	1632021	11325	g_33071	g_29340
ptg000015l	1638712	1651603	12891	g_29340	g_23688
ptg000015l	1652718	1688246	35528	g_23688	g_22775
ptg000015l	1689088	1710322	21234	g_22775	g_4969
ptg000015l	1712106	1734864	22758	g_4969	g_38683
ptg000015l	1739671	1741711	2040	g_17842	g_2216
ptg000015l	1749662	1754250	4588	g_2216	g_8007
ptg000015l	1762632	1765263	2631	g_8007	g_10750
ptg000015l	1770694	1780401	9707	g_10750	g_37398
ptg000015l	1783593	1787998	4405	g_37398	g_37099
ptg000015l	1805477	1829855	24378	g_37099	g_8828
ptg000015l	1836884	1848279	11395	g_8828	g_35443
ptg000015l	1848554	1870841	22287	g_35443	g_2170
ptg000015l	1872034	1885635	13601	g_2170	g_13742
ptg000015l	1891419	2011415	119996	g_13742	g_30818
ptg000015l	2014832	2073589	58757	g_30818	g_35404
ptg000015l	2074467	2095934	21467	g_35404	g_1314
ptg000015l	2097331	2119752	22421	g_1314	g_19306
ptg000015l	2128571	2139482	10911	g_19306	g_10178
ptg000015l	2140279	2537970	397691	g_10178	g_11091
ptg000015l	2538233	2733644	195411	g_11091	g_27493
ptg000015l	2733937	2750698	16761	g_27493	g_38304
ptg000015l	2750901	3085758	334857	g_38304	g_38666
ptg000015l	3086825	3112524	25699	g_38666	g_30979
ptg000015l	3112799	3134338	21539	g_30979	g_16638
ptg000015l	3135546	3137600	2054	g_16638	g_38237
ptg000015l	3138244	3272305	134061	g_38237	g_15086
ptg000015l	3281352	3306790	25438	g_15086	g_1320
ptg000015l	3307011	3392845	85834	g_1320	g_17165
ptg000015l	3394029	3394094	65	g_17165	g_20782
ptg000015l	3394366	3433151	38785	g_20782	g_27852
ptg000015l	3433465	3459324	25859	g_27852	g_17518
ptg000015l	3464525	3465618	1093	g_17518	g_20116
ptg000015l	3465827	3471507	5680	g_20116	g_18955
ptg000015l	3471731	3473882	2151	g_18955	g_23130
ptg000015l	3484947	3500182	15235	g_23130	g_24052
ptg000015l	3506555	3520864	14309	g_24052	g_3261
ptg000015l	3539551	3543028	3477	g_3261	g_17743
ptg000015l	3543255	3550244	6989	g_17743	g_36149
ptg000015l	3567125	3574135	7010	g_36149	g_1401
ptg000015l	3578021	3607631	29610	g_1401	g_34385
ptg000015l	3631574	3634952	3378	g_34385	g_36342
ptg000015l	3640138	3656106	15968	g_36342	g_36489
ptg000015l	3668594	3675263	6669	g_36489	g_29876
ptg000015l	3676752	3735481	58729	g_29876	g_13143
ptg000015l	3736161	3754695	18534	g_13143	g_37334
ptg000015l	3759279	3781624	22345	g_37334	g_11749
ptg000015l	3783264	3783312	48	g_11749	g_27080
ptg000015l	3783905	3798525	14620	g_27080	g_6003
ptg000015l	3798974	3811004	12030	g_6003	g_2589
ptg000015l	3812982	3822339	9357	g_2589	g_23430
ptg000015l	3823370	3830161	6791	g_23430	g_13304
ptg000015l	3841906	3851537	9631	g_13304	g_15506
ptg000015l	3862769	3984841	122072	g_15506	g_8747
ptg000015l	3993255	3998321	5066	g_8747	g_6108
ptg000015l	4016956	4018044	1088	g_6108	g_14377
ptg000015l	4018748	4023877	5129	g_14377	g_9001
ptg000015l	4039807	4142210	102403	g_9001	g_11667
ptg000015l	4142545	4150107	7562	g_11667	g_6057
ptg000015l	4157495	4172488	14993	g_6057	g_40008
ptg000015l	4209398	4263150	53752	g_40008	g_10284
ptg000015l	4266082	4312362	46280	g_10284	g_15184
ptg000015l	4312925	4331090	18165	g_15184	g_17951
ptg000015l	4332133	4336363	4230	g_17951	g_26961
ptg000015l	4346716	4456338	109622	g_26961	g_5134
ptg000015l	4472102	4474506	2404	g_5134	g_1316
ptg000015l	4479306	4491248	11942	g_1316	g_14603
ptg000015l	4495294	4499221	3927	g_14603	g_38266
ptg000015l	4500141	4518159	18018	g_38266	g_33493
ptg000015l	4529594	4558936	29342	g_33493	g_29324
ptg000015l	4562030	4577835	15805	g_29324	g_12578
ptg000015l	4594403	4601509	7106	g_12578	g_16035
ptg000015l	4601787	4606486	4699	g_16035	g_4733
ptg000015l	4625231	4628182	2951	g_4733	g_2335
ptg000015l	4637174	4645460	8286	g_2335	g_665
ptg000015l	4648337	4650148	1811	g_665	g_1200
ptg000015l	4664907	4872927	208020	g_1200	g_35740
ptg000015l	4877232	4897557	20325	g_35740	g_3422
ptg000015l	4897943	4975663	77720	g_3422	g_834
ptg000015l	4988002	5121154	133152	g_834	g_14914
ptg000015l	5123601	5139200	15599	g_14914	g_8599
ptg000015l	5139742	5251624	111882	g_8599	g_30922
ptg000015l	5252175	5272359	20184	g_30922	g_36162
ptg000015l	5284420	5288267	3847	g_36162	g_13548
ptg000015l	5290487	5293707	3220	g_13548	g_25771
ptg000015l	5307806	5314035	6229	g_25771	g_29210
ptg000015l	5320815	5326417	5602	g_29210	g_37319
ptg000015l	5335006	5350061	15055	g_37319	g_16140
ptg000015l	5358859	5363293	4434	g_16140	g_25829
ptg000015l	5368886	5371546	2660	g_25829	g_28322
ptg000015l	5373982	5381876	7894	g_28322	g_28448
ptg000015l	5387818	5457224	69406	g_28448	g_27669
ptg000015l	5475763	5493957	18194	g_27669	g_33935
ptg000015l	5505389	5508452	3063	g_33935	g_589
ptg000015l	5530435	5555491	25056	g_589	g_26951
ptg000015l	5556396	5571062	14666	g_26951	g_22149
ptg000015l	5572917	5657493	84576	g_38393	g_33422
ptg000015l	5671004	5804677	133673	g_33422	g_22669
ptg000015l	5804913	5976376	171463	g_22669	g_29374
ptg000015l	5977434	6004059	26625	g_29374	g_32422
ptg000015l	6024376	6136737	112361	g_32422	g_19344
ptg000015l	6148450	6278548	130098	g_19344	g_26178
ptg000015l	6279306	6279330	24	g_26178	g_37791
ptg000015l	6280436	6333144	52708	g_37791	g_25772
ptg000015l	6340019	6420093	80074	g_25772	g_15548
ptg000015l	6427979	6622071	194092	g_15548	g_23731
ptg000015l	6622307	6749967	127660	g_23731	g_4529
ptg000015l	6750413	6800358	49945	g_4529	g_18749
ptg000015l	6800804	6864053	63249	g_18749	g_36380
ptg000015l	6864262	6940596	76334	g_36380	g_32247
ptg000015l	6941474	7124981	183507	g_32247	g_3098
ptg000015l	7137100	7335587	198487	g_3098	g_22954
ptg000015l	7336024	7351260	15236	g_22954	g_11403
ptg000015l	7352294	7352341	47	g_11403	g_1136
ptg000015l	7353840	7405485	51645	g_1136	g_7439
ptg000015l	7468891	7583974	115083	g_7439	g_17985
ptg000015l	7585436	7609279	23843	g_17985	g_7691
ptg000015l	7609593	7834619	225026	g_7691	g_35070
ptg000015l	7835549	7843756	8207	g_35070	g_1799
ptg000015l	7844136	7875267	31131	g_1799	g_17708
ptg000015l	7875611	8017608	141997	g_17708	g_24137
ptg000015l	8025621	8040963	15342	g_24137	g_29484
ptg000015l	8057330	8065371	8041	g_29484	g_28276
ptg000015l	8068683	8097594	28911	g_28276	g_4474
ptg000015l	8103776	8106947	3171	g_4474	g_36800
ptg000015l	8131757	8134509	2752	g_36800	g_20509
ptg000015l	8135959	8366632	230673	g_20509	g_10722
ptg000015l	8372502	8386163	13661	g_10722	g_26915
ptg000015l	8407157	8418779	11622	g_26915	g_34270
ptg000015l	8423071	8426895	3824	g_34270	g_4504
ptg000015l	8434543	8461513	26970	g_2443	g_9298
ptg000015l	8469256	8473916	4660	g_9298	g_29446
ptg000015l	8478640	8490954	12314	g_29446	g_23156
ptg000015l	8493170	8508703	15533	g_23156	g_10060
ptg000015l	8518683	8569568	50885	g_10060	g_15550
ptg000015l	8593553	8607261	13708	g_15550	g_24307
ptg000015l	8608877	8609753	876	g_24307	g_32373
ptg000015l	8616167	8618872	2705	g_32373	g_35998
ptg000015l	8629970	8635044	5074	g_35998	g_17914
ptg000015l	8635442	8652640	17198	g_17914	g_2900
ptg000015l	8653440	8654554	1114	g_2900	g_17463
ptg000015l	8659080	8665219	6139	g_17463	g_6693
ptg000015l	8668132	8694345	26213	g_6693	g_3290
ptg000015l	8697045	8780820	83775	g_3290	g_39770
ptg000015l	8782994	8784348	1354	g_39770	g_135
ptg000015l	8797845	8861273	63428	g_135	g_17414
ptg000015l	8862670	8894801	32131	g_17414	g_33451
ptg000015l	8906477	8920169	13692	g_33451	g_36871
ptg000015l	8925030	9121121	196091	g_36871	g_14176
ptg000015l	9121927	9294919	172992	g_14176	g_30799
ptg000015l	9295242	9553462	258220	g_30799	g_26963
ptg000015l	9554028	9741813	187785	g_26963	g_21110
ptg000015l	9742241	9768098	25857	g_21110	g_24659
ptg000015l	9768709	9771232	2523	g_24659	g_2504
ptg000015l	9771687	9778082	6395	g_2504	g_19430
ptg000015l	9779947	9906828	126881	g_19430	g_4428
ptg000015l	9913779	10260732	346953	g_4428	g_1
ptg000015l	10276768	10713075	436307	g_1	g_626
ptg000015l	10716819	10717957	1138	g_626	g_35539
ptg000015l	10740883	10744923	4040	g_35539	g_26161
ptg000015l	10830752	10838432	7680	g_26161	g_554
ptg000015l	10858752	10908660	49908	g_554	g_14630
ptg000015l	10922954	11003785	80831	g_14630	g_17163
ptg000015l	11019963	11054829	34866	g_17163	g_36893
ptg000015l	11068489	11082615	14126	g_36893	g_30372
ptg000015l	11106723	11121155	14432	g_30372	g_11559
ptg000015l	11130146	11141635	11489	g_11559	g_28064
ptg000015l	11141898	11185397	43499	g_28064	g_32241
ptg000015l	11186333	11187862	1529	g_32241	g_36335
ptg000015l	11190017	11192935	2918	g_36335	g_11798
ptg000015l	11193141	11213452	20311	g_11798	g_25409
ptg000015l	11213889	11258787	44898	g_25409	g_930
ptg000015l	11260136	11383612	123476	g_930	g_8122
ptg000015l	11383860	11386187	2327	g_8122	g_32745
ptg000015l	11397985	11408035	10050	g_32745	g_23674
ptg000015l	11430517	11432355	1838	g_23674	g_13232
ptg000015l	11432780	11441163	8383	g_13232	g_24694
ptg000015l	11453086	11481677	28591	g_24694	g_15845
ptg000015l	11493704	11499891	6187	g_15845	g_10503
ptg000015l	11512437	11558003	45566	g_10503	g_328
ptg000015l	11558653	11558897	244	g_328	g_28655
ptg000015l	11567236	11642368	75132	g_28655	g_28927
ptg000015l	11642667	11644458	1791	g_28927	g_12129
ptg000015l	11649605	11652540	2935	g_12129	g_2323
ptg000015l	11661576	11693764	32188	g_2323	g_6321
ptg000015l	11694786	11696483	1697	g_6321	g_18703
ptg000015l	11700000	11759685	59685	g_18703	g_20413
ptg000015l	11762416	11773810	11394	g_20413	g_11727
ptg000015l	11786235	11789108	2873	g_11727	g_35691
ptg000015l	11791038	11795935	4897	g_35691	g_31491
ptg000015l	11797049	11799297	2248	g_31491	g_26151
ptg000015l	11799739	11800737	998	g_26151	g_24710
ptg000015l	11806676	11816189	9513	g_24710	g_1978
ptg000015l	11832323	11835367	3044	g_1978	g_24423
ptg000015l	11842859	11847035	4176	g_24423	g_21381
ptg000015l	11865810	11880747	14937	g_21381	g_28057
ptg000015l	11882618	11892541	9923	g_28057	g_14098
ptg000015l	11893794	11909286	15492	g_14098	g_27312
ptg000015l	11912408	11923212	10804	g_27312	g_28833
ptg000015l	11940910	11941814	904	g_28833	g_10312
ptg000015l	11950662	11954485	3823	g_10312	g_16767
ptg000015l	11963136	11970001	6865	g_16767	g_27434
ptg000015l	11972274	11976230	3956	g_27434	g_18481
ptg000015l	11987659	11991871	4212	g_18481	g_34842
ptg000015l	12004840	12007073	2233	g_34842	g_36589
ptg000015l	12013125	12014985	1860	g_36589	g_9310
ptg000015l	12019090	12023927	4837	g_9310	g_26691
ptg000015l	12048231	12058915	10684	g_26691	g_19398
ptg000015l	12060702	12062309	1607	g_19398	g_13817
ptg000015l	12086293	12106402	20109	g_13817	g_4074
ptg000015l	12108145	12121645	13500	g_4074	g_30011
ptg000015l	12127327	12130624	3297	g_30011	g_10718
ptg000015l	12133707	12322476	188769	g_10718	g_11020
ptg000015l	12322703	12442318	119615	g_11020	g_2659
ptg000015l	12458615	12475044	16429	g_2659	g_29406
ptg000015l	12482865	12511916	29051	g_29406	g_9055
ptg000015l	12513414	12540480	27066	g_9055	g_19207
ptg000015l	12551822	12641211	89389	g_19207	g_16818
ptg000015l	12641792	12789589	147797	g_16818	g_24721
ptg000015l	12791607	12797943	6336	g_24721	g_13284
ptg000015l	12798341	12831438	33097	g_13284	g_40194
ptg000015l	12832594	12832814	220	g_40194	g_18880
ptg000015l	12844577	12850648	6071	g_18880	g_1446
ptg000015l	12869547	12873949	4402	g_1446	g_28394
ptg000015l	12898809	12900095	1286	g_28394	g_12098
ptg000015l	12903245	12908969	5724	g_12098	g_19790
ptg000015l	12912868	12929044	16176	g_19790	g_534
ptg000015l	12935104	12936225	1121	g_534	g_5377
ptg000015l	12954156	12957093	2937	g_5377	g_12254
ptg000015l	12964827	12994776	29949	g_12254	g_26444
ptg000015l	12996956	13014460	17504	g_26444	g_35382
ptg000015l	13035731	13084627	48896	g_35382	g_12704
ptg000015l	13086129	13087603	1474	g_12704	g_1572
ptg000015l	13093058	13118701	25643	g_1572	g_252
ptg000015l	13118982	13119965	983	g_252	g_12787
ptg000015l	13126476	13127979	1503	g_12787	g_30655
ptg000015l	13129973	13132535	2562	g_30655	g_28393
ptg000015l	13135604	13161747	26143	g_28393	g_9670
ptg000015l	13176185	13225356	49171	g_9670	g_32577
ptg000015l	13226718	13237346	10628	g_32577	g_4319
ptg000015l	13240274	13241348	1074	g_4319	g_19473
ptg000015l	13249075	13259288	10213	g_19473	g_5618
ptg000015l	13262097	13305810	43713	g_5618	g_11342
ptg000015l	13307896	13315111	7215	g_11342	g_23905
ptg000015l	13323534	13389231	65697	g_23905	g_20720
ptg000015l	13397990	13400686	2696	g_20720	g_34609
ptg000015l	13410992	13432780	21788	g_34609	g_2300
ptg000015l	13449988	13460061	10073	g_2300	g_18420
ptg000015l	13468606	13493446	24840	g_18420	g_34843
ptg000015l	13502674	13505814	3140	g_34843	g_26052
ptg000015l	13513800	13514908	1108	g_26052	g_7257
ptg000015l	13518943	13525558	6615	g_7257	g_9776
ptg000015l	13532110	13537069	4959	g_9776	g_15470
ptg000015l	13537644	13540469	2825	g_15470	g_17812
ptg000015l	13542384	13546174	3790	g_17812	g_37923
ptg000015l	13553744	13582910	29166	g_37923	g_4873
ptg000015l	13594395	13596632	2237	g_4873	g_22339
ptg000015l	13605517	13614548	9031	g_22339	g_13257
ptg000015l	13640214	13648922	8708	g_13257	g_8548
ptg000015l	13650681	13657210	6529	g_8548	g_8442
ptg000015l	13662407	13680957	18550	g_8442	g_5981
ptg000015l	13681568	13701769	20201	g_5981	g_10289
ptg000015l	13704812	13707457	2645	g_10289	g_18494
ptg000015l	13717836	13727352	9516	g_18494	g_9229
ptg000015l	13743018	13744584	1566	g_9229	g_5048
ptg000015l	13745505	13746899	1394	g_5048	g_3124
ptg000015l	13753630	13755586	1956	g_3124	g_32549
ptg000015l	13763736	13794155	30419	g_32549	g_16348
ptg000015l	13794949	13801656	6707	g_16348	g_23377
ptg000015l	13817841	13822385	4544	g_23377	g_787
ptg000015l	13834421	13837997	3576	g_787	g_29200
ptg000015l	13839367	13840805	1438	g_29200	g_11746
ptg000015l	13842541	13845366	2825	g_11746	g_19342
ptg000015l	13859321	13860420	1099	g_19342	g_22088
ptg000015l	13865934	13868537	2603	g_22088	g_16423
ptg000015l	13887611	13892495	4884	g_16423	g_4378
ptg000015l	13901191	13920374	19183	g_4378	g_13028
ptg000015l	13922807	13926359	3552	g_13028	g_40005
ptg000015l	13927214	13927874	660	g_40005	g_6013
ptg000015l	13950525	13994687	44162	g_6013	g_34129
ptg000015l	14003449	14019171	15722	g_34129	g_35611
ptg000015l	14019449	14055030	35581	g_35611	g_33725
ptg000015l	14056404	14064229	7825	g_33725	g_31017
ptg000015l	14067882	14076087	8205	g_31017	g_32697
ptg000015l	14080183	14081276	1093	g_32697	g_10019
ptg000015l	14083890	14085517	1627	g_10019	g_9350
ptg000015l	14090824	14095051	4227	g_9350	g_38694
ptg000015l	14095400	14106849	11449	g_38694	g_16168
ptg000015l	14119848	14122948	3100	g_16168	g_4273
ptg000015l	14127166	14129551	2385	g_4273	g_25642
ptg000015l	14135234	14136668	1434	g_25642	g_19695
ptg000015l	14140944	14170664	29720	g_19695	g_13605
ptg000015l	14175236	14202757	27521	g_13605	g_27267
ptg000015l	14207151	14215327	8176	g_27267	g_12449
ptg000015l	14220430	14238658	18228	g_12449	g_401
ptg000015l	14248355	14290830	42475	g_401	g_22852
ptg000015l	14292442	14309927	17485	g_22852	g_22552
ptg000015l	14310736	14345088	34352	g_22552	g_28472
ptg000015l	14354256	14406421	52165	g_28472	g_35128
ptg000015l	14423276	14489246	65970	g_35128	g_36150
ptg000015l	14492000	14493441	1441	g_36150	g_36211
ptg000015l	14505184	14528821	23637	g_36211	g_27950
ptg000015l	14532233	14549756	17523	g_27950	g_111
ptg000015l	14572347	14599514	27167	g_111	g_16152
ptg000015l	14601145	14642637	41492	g_16152	g_16371
ptg000015l	14645792	14649237	3445	g_16371	g_12222
ptg000015l	14661459	14665133	3674	g_12222	g_12563
ptg000015l	14666326	14680504	14178	g_12563	g_26095
ptg000015l	14680845	14683347	2502	g_26095	g_37918
ptg000015l	14691527	14695574	4047	g_37918	g_13494
ptg000015l	14698231	14699693	1462	g_13494	g_18621
ptg000015l	14709436	14716102	6666	g_18621	g_33026
ptg000015l	14720168	14744144	23976	g_33026	g_27309
ptg000015l	14762287	14765541	3254	g_27309	g_22089
ptg000015l	14769895	14789162	19267	g_22089	g_2965
ptg000015l	14789461	14801062	11601	g_2965	g_20324
ptg000015l	14808571	14817822	9251	g_20324	g_3902
ptg000015l	14836871	14848221	11350	g_3902	g_22683
ptg000015l	14849853	14852950	3097	g_22683	g_37783
ptg000015l	14853827	14858750	4923	g_37783	g_22742
ptg000015l	14869019	14901118	32099	g_22742	g_2849
ptg000015l	14905661	14906603	942	g_2849	g_21606
ptg000015l	14913717	14921404	7687	g_21606	g_13616
ptg000015l	14931964	14955450	23486	g_13616	g_20046
ptg000015l	14965934	14977724	11790	g_20046	g_10240
ptg000015l	14983135	14987009	3874	g_10240	g_21570
ptg000015l	15002659	15009874	7215	g_21570	g_26308
ptg000015l	15011793	15077469	65676	g_26308	g_21155
ptg000015l	15102957	15122039	19082	g_21155	g_3499
ptg000015l	15126777	15127021	244	g_3499	g_32942
ptg000015l	15127236	15130170	2934	g_32942	g_31166
ptg000015l	15134253	15229324	95071	g_31166	g_33710
ptg000015l	15229623	15229654	31	g_33710	g_31799
ptg000015l	15230211	15243943	13732	g_31799	g_36497
ptg000015l	15255727	15259553	3826	g_36497	g_8895
ptg000015l	15269692	15505931	236239	g_8895	g_23964
ptg000015l	15510495	15528146	17651	g_23964	g_5372
ptg000015l	15539609	15604112	64503	g_5372	g_20011
ptg000015l	15611684	15612835	1151	g_20011	g_28533
ptg000015l	15613645	15622492	8847	g_28533	g_34535
ptg000015l	15630082	15640449	10367	g_34535	g_20408
ptg000015l	15641708	15718280	76572	g_20408	g_2580
ptg000015l	15719576	15720876	1300	g_2580	g_28119
ptg000015l	15721571	15723210	1639	g_28119	g_3692
ptg000015l	15723893	15724018	125	g_3692	g_33289
ptg000015l	15724680	15732200	7520	g_33289	g_16557
ptg000015l	15758044	15762408	4364	g_16557	g_23019
ptg000015l	15767435	15771189	3754	g_23019	g_7373
ptg000015l	15772583	15805510	32927	g_7373	g_24266
ptg000015l	15809098	15833663	24565	g_24266	g_37032
ptg000015l	15839202	15978921	139719	g_37032	g_33363
ptg000015l	15980938	15999996	19058	g_33363	g_37816
ptg000015l	16000220	16005902	5682	g_37816	g_3939
ptg000015l	16009181	16011090	1909	g_3939	g_18513
ptg000015l	16011749	16013791	2042	g_18513	g_21179
ptg000015l	16016177	16019457	3280	g_21179	g_24467
ptg000015l	16029887	16043108	13221	g_24467	g_32317
ptg000015l	16047615	16056395	8780	g_32317	g_4216
ptg000015l	16057154	16078199	21045	g_4216	g_36354
ptg000015l	16087337	16094682	7345	g_36354	g_19600
ptg000015l	16101168	16153845	52677	g_19600	g_8486
ptg000015l	16167065	16174078	7013	g_8486	g_5182
ptg000015l	16198419	16200412	1993	g_5182	g_1929
ptg000015l	16209923	16217501	7578	g_1929	g_8001
ptg000015l	16244228	16269391	25163	g_8001	g_10599
ptg000015l	16270554	16550478	279924	g_10599	g_30304
ptg000015l	16551203	16802273	251070	g_30304	g_7760
ptg000015l	16819732	16835618	15886	g_7760	g_7949
ptg000015l	16843090	16895504	52414	g_7949	g_37218
ptg000015l	16895836	16951247	55411	g_37218	g_26235
ptg000015l	16952846	16956025	3179	g_26235	g_13846
ptg000015l	16958815	16976872	18057	g_13846	g_29174
ptg000015l	16983787	17062693	78906	g_29174	g_13073
ptg000015l	17068285	17075594	7309	g_13073	g_14296
ptg000015l	17089404	17124681	35277	g_14296	g_23248
ptg000015l	17137758	17148662	10904	g_23248	g_15905
ptg000015l	17158043	17164034	5991	g_15905	g_3765
ptg000015l	17164402	17175313	10911	g_3765	g_1193
ptg000015l	17181494	17217545	36051	g_1193	g_5220
ptg000015l	17217790	17225165	7375	g_5220	g_4669
ptg000015l	17229120	17326673	97553	g_4669	g_29014
ptg000015l	17328543	17343312	14769	g_29014	g_22205
ptg000015l	17350798	17352881	2083	g_22205	g_31861
ptg000015l	17366229	17370297	4068	g_31861	g_21514
ptg000015l	17375244	17377071	1827	g_21514	g_21821
ptg000015l	17381935	17390376	8441	g_21821	g_10476
ptg000015l	17394723	17395712	989	g_10476	g_13936
ptg000015l	17396359	17505183	108824	g_13936	g_23330
ptg000015l	17508787	17539136	30349	g_23330	g_6130
ptg000015l	17545245	17590911	45666	g_6130	g_16885
ptg000015l	17592131	17644941	52810	g_16885	g_5814
ptg000015l	17650699	17664937	14238	g_5814	g_19641
ptg000015l	17667939	17669816	1877	g_19641	g_23359
ptg000015l	17691387	17724852	33465	g_23359	g_17737
ptg000015l	17725241	17913556	188315	g_17737	g_18075
ptg000015l	17914176	17919145	4969	g_18075	g_3618
ptg000015l	17920734	17955921	35187	g_3618	g_29842
ptg000015l	17956130	18137302	181172	g_29842	g_25681
ptg000015l	18137511	18277240	139729	g_25681	g_37643
ptg000015l	18278817	18318598	39781	g_37643	g_22436
ptg000015l	18318861	18403222	84361	g_22436	g_33717
ptg000015l	18411146	18580367	169221	g_33717	g_38185
ptg000015l	18587686	18597434	9748	g_38185	g_12915
ptg000015l	18598510	18704494	105984	g_12915	g_33972
ptg000015l	18714708	18749548	34840	g_33972	g_24025
ptg000015l	18781290	18789298	8008	g_24025	g_22129
ptg000015l	18790323	18851016	60693	g_22129	g_25204
ptg000015l	18851621	18855394	3773	g_25204	g_36653
ptg000015l	18856044	18871949	15905	g_36653	g_23970
ptg000015l	18885453	18904447	18994	g_23970	g_22664
ptg000015l	18917851	18925086	7235	g_22664	g_36410
ptg000015l	18934738	19000341	65603	g_36410	g_26823
ptg000015l	19019473	19036295	16822	g_26823	g_34897
ptg000015l	19048781	19050993	2212	g_34897	g_29975
ptg000015l	19060749	19084346	23597	g_29975	g_21440
ptg000015l	19091953	19096895	4942	g_21440	g_12123
ptg000015l	19111091	19114179	3088	g_12123	g_35146
ptg000015l	19118347	19120568	2221	g_35146	g_7389
ptg000015l	19123998	19124927	929	g_7389	g_30403
ptg000015l	19127450	19129569	2119	g_30403	g_30703
ptg000015l	19132914	19196283	63369	g_30703	g_17459
ptg000015l	19203353	19217100	13747	g_17459	g_22138
ptg000015l	19226124	19247046	20922	g_22138	g_30012
ptg000015l	19265907	19287093	21186	g_30012	g_7929
ptg000015l	19287915	19300096	12181	g_7929	g_22372
ptg000015l	19305312	19352509	47197	g_22372	g_16870
ptg000015l	19372875	19439963	67088	g_16870	g_27840
ptg000015l	19449806	19533983	84177	g_27840	g_18798
ptg000015l	19543307	19581823	38516	g_18798	g_22724
ptg000015l	19613241	19615708	2467	g_22724	g_20600
ptg000015l	19616598	19616679	81	g_20600	g_7038
ptg000015l	19617937	19630343	12406	g_7038	g_10449
ptg000015l	19631713	19635625	3912	g_10449	g_25865
ptg000015l	19636104	19639482	3378	g_25865	g_22513
ptg000015l	19644622	19650848	6226	g_22513	g_8440
ptg000015l	19651417	19654903	3486	g_8440	g_22805
ptg000015l	19665594	19669921	4327	g_22805	g_6355
ptg000015l	19690424	19693578	3154	g_6355	g_37041
ptg000015l	19697086	19699333	2247	g_37041	g_24044
ptg000015l	19701806	19712799	10993	g_24044	g_1922
ptg000015l	19717415	19718778	1363	g_1922	g_23417
ptg000015l	19723918	19725050	1132	g_23417	g_24264
ptg000015l	19728781	19733414	4633	g_24264	g_22647
ptg000015l	19744546	19746123	1577	g_22647	g_6232
ptg000015l	19759994	19765598	5604	g_6232	g_16353
ptg000015l	19790001	19823570	33569	g_16353	g_25972
ptg000015l	19829808	19872922	43114	g_25972	g_643
ptg000015l	19915838	19916753	915	g_643	g_2309
ptg000015l	19926167	19929000	2833	g_2309	g_20253
ptg000015l	19944967	20047388	102421	g_20253	g_9142
ptg000015l	20056271	20061806	5535	g_9142	g_7668
ptg000015l	20069121	20072877	3756	g_7668	g_35844
ptg000015l	20082626	20103817	21191	g_35844	g_333
ptg000015l	20114644	20116460	1816	g_333	g_28023
ptg000015l	20119148	20127653	8505	g_28023	g_16575
ptg000015l	20130057	20131132	1075	g_16575	g_34265
ptg000015l	20136134	20150862	14728	g_34265	g_3507
ptg000015l	20151566	20195782	44216	g_3507	g_29344
ptg000015l	20199310	20246640	47330	g_29344	g_8724
ptg000015l	20270881	20287071	16190	g_8724	g_18570
ptg000015l	20289050	20310778	21728	g_18570	g_30202
ptg000015l	20315692	20319494	3802	g_30202	g_17046
ptg000015l	20326880	20332274	5394	g_17046	g_25355
ptg000015l	20340412	20576639	236227	g_25355	g_17099
ptg000015l	20587895	20591434	3539	g_17099	g_19067
ptg000015l	20596281	20598098	1817	g_19067	g_5740
ptg000015l	20604153	20608966	4813	g_5740	g_13777
ptg000015l	20618374	20821792	203418	g_13777	g_18473
ptg000015l	20827109	20831415	4306	g_18473	g_7452
ptg000015l	20836413	21040557	204144	g_7452	g_909
ptg000015l	21063070	21069617	6547	g_909	g_8531
ptg000015l	21089719	21092198	2479	g_8531	g_3817
ptg000015l	21101792	21103869	2077	g_3817	g_30379
ptg000015l	21105226	21113664	8438	g_30379	g_12697
ptg000015l	21126220	21131671	5451	g_12697	g_10522
ptg000015l	21145993	21152995	7002	g_10522	g_31896
ptg000015l	21160862	21170260	9398	g_31896	g_26279
ptg000015l	21170709	21189078	18369	g_26279	g_360
ptg000015l	21192375	21195965	3590	g_360	g_29444
ptg000015l	21198313	21202295	3982	g_29444	g_16202
ptg000015l	21207585	21215371	7786	g_16202	g_33613
ptg000015l	21216584	21237807	21223	g_33613	g_35926
ptg000015l	21238152	21241035	2883	g_35926	g_19703
ptg000015l	21241380	21245164	3784	g_19703	g_31408
ptg000015l	21245734	21250060	4326	g_31408	g_26679
ptg000015l	21263574	21303631	40057	g_26679	g_9566
ptg000015l	21306811	21308405	1594	g_9566	g_13881
ptg000015l	21312302	21319418	7116	g_13881	g_20299
ptg000015l	21321180	21417511	96331	g_20299	g_18164
ptg000015l	21418230	21472298	54068	g_18164	g_23542
ptg000015l	21472840	21514220	41380	g_23542	g_40129
ptg000015l	21521679	21524563	2884	g_40129	g_13879
ptg000015l	21524814	21528736	3922	g_13879	g_26468
ptg000015l	21528936	21540292	11356	g_26468	g_22630
ptg000015l	21551888	21553141	1253	g_22630	g_8391
ptg000015l	21554257	21556804	2547	g_8391	g_21089
ptg000015l	21561809	21565512	3703	g_21089	g_26153
ptg000015l	21572468	21573989	1521	g_26153	g_25849
ptg000015l	21574973	21575632	659	g_25849	g_15532
ptg000015l	21581791	21599746	17955	g_15532	g_18910
ptg000015l	21601610	21617280	15670	g_18910	g_36757
ptg000015l	21619330	21622532	3202	g_36757	g_24515
ptg000015l	21624971	21626258	1287	g_24515	g_12379
ptg000015l	21626470	21676076	49606	g_12379	g_35329
ptg000015l	21703599	21709024	5425	g_35329	g_23304
ptg000015l	21713242	21715949	2707	g_23304	g_23126
ptg000015l	21733552	21739796	6244	g_23126	g_33751
ptg000015l	21750879	21757599	6720	g_33751	g_22736
ptg000015l	21762580	21763731	1151	g_22736	g_40228
ptg000015l	21765495	21773488	7993	g_40228	g_13311
ptg000015l	21777234	21781415	4181	g_13311	g_36372
ptg000015l	21787337	21797489	10152	g_36372	g_11229
ptg000015l	21798700	21828345	29645	g_11229	g_27902
ptg000015l	21830827	21870414	39587	g_27902	g_36310
ptg000015l	21873818	21890531	16713	g_36310	g_11490
ptg000015l	21892066	21893956	1890	g_11490	g_934
ptg000015l	21897092	21911155	14063	g_934	g_1084
ptg000015l	21929718	21929820	102	g_1084	g_16225
ptg000015l	21930137	21940599	10462	g_16225	g_33953
ptg000015l	21940865	21965465	24600	g_33953	g_28875
ptg000015l	21965680	21983609	17929	g_28875	g_18673
ptg000015l	21983812	22033860	50048	g_18673	g_25869
ptg000015l	22035064	22041816	6752	g_25869	g_12372
ptg000015l	22050901	22058148	7247	g_12372	g_21926
ptg000015l	22063830	22159358	95528	g_21926	g_19411
ptg000015l	22171373	22177263	5890	g_19411	g_9739
ptg000015l	22177832	22181036	3204	g_9739	g_19366
ptg000015l	22181656	22186959	5303	g_19366	g_4431
ptg000015l	22188077	22237239	49162	g_4431	g_28202
ptg000015l	22253480	22310035	56555	g_28202	g_27030
ptg000015l	22310262	22311720	1458	g_27030	g_28521
ptg000015l	22319032	22320670	1638	g_28521	g_30314
ptg000015l	22330533	22341556	11023	g_30314	g_17285
ptg000015l	22344220	22348760	4540	g_17285	g_12732
ptg000015l	22349722	22355215	5493	g_12732	g_34503
ptg000015l	22366770	22381594	14824	g_34503	g_6977
ptg000015l	22382043	22420568	38525	g_6977	g_7458
ptg000015l	22435630	22439507	3877	g_7458	g_8738
ptg000015l	22444777	22451248	6471	g_8738	g_10912
ptg000015l	22454970	22462855	7885	g_10912	g_317
ptg000015l	22487361	22583667	96306	g_317	g_35380
ptg000015l	22598097	22652353	54256	g_35380	g_31005
ptg000015l	22652715	22687559	34844	g_31005	g_25900
ptg000015l	22696126	22697603	1477	g_25900	g_32581
ptg000015l	22699773	22702117	2344	g_32581	g_20791
ptg000015l	22711976	22818797	106821	g_20791	g_33074
ptg000015l	22820737	22858185	37448	g_33074	g_26434
ptg000015l	22873448	22885545	12097	g_26434	g_5932
ptg000015l	22891838	22925891	34053	g_5932	g_11636
ptg000015l	22947596	22977106	29510	g_11636	g_37808
ptg000015l	22978197	22991491	13294	g_37808	g_37404
ptg000015l	23002779	23014238	11459	g_37404	g_27696
ptg000015l	23034886	23040112	5226	g_27696	g_28950
ptg000015l	23048713	23068522	19809	g_28950	g_13651
ptg000015l	23078466	23082247	3781	g_13651	g_8171
ptg000015l	23082873	23113659	30786	g_8171	g_22942
ptg000015l	23114039	23114249	210	g_22942	g_38345
ptg000015l	23114572	23254223	139651	g_38345	g_14940
ptg000015l	23271202	23313439	42237	g_14940	g_34640
ptg000015l	23317026	23332869	15843	g_34640	g_33402
ptg000015l	23333336	23344829	11493	g_33402	g_20202
ptg000015l	23349403	23350864	1461	g_20202	g_17211
ptg000015l	23355949	23370355	14406	g_17211	g_6025
ptg000015l	23383984	23389820	5836	g_6025	g_6302
ptg000015l	23391409	23419899	28490	g_6302	g_36841
ptg000015l	23420524	23423419	2895	g_36841	g_14087
ptg000015l	23423918	23461871	37953	g_14087	g_13622
ptg000015l	23462370	23501541	39171	g_13622	g_1692
ptg000015l	23502040	23514330	12290	g_1692	g_1899
ptg000015l	23516749	23525867	9118	g_1899	g_23641
ptg000015l	23535592	23606719	71127	g_23641	g_33780
ptg000015l	23626508	23629801	3293	g_33780	g_833
ptg000015l	23641056	23655839	14783	g_833	g_10063
ptg000015l	23675910	23680283	4373	g_10063	g_10453
ptg000015l	23683983	23686257	2274	g_10453	g_26779
ptg000015l	23686553	23696509	9956	g_26779	g_10618
ptg000015l	23707500	23709219	1719	g_10618	g_20571
ptg000015l	23726048	23903079	177031	g_20571	g_18257
ptg000015l	23903330	23913122	9792	g_18257	g_14547
ptg000015l	23915645	23918625	2980	g_14547	g_34052
ptg000015l	23933338	23951951	18613	g_34052	g_29086
ptg000015l	23962272	23963065	793	g_29086	g_18418
ptg000015l	23966818	23967080	262	g_18418	g_27357
ptg000015l	23969889	23971346	1457	g_27357	g_5289
ptg000015l	23986240	23991659	5419	g_5289	g_21919
ptg000015l	24005664	24006737	1073	g_21919	g_29140
ptg000015l	24010242	24011955	1713	g_29140	g_19316
ptg000015l	24022927	24219347	196420	g_19316	g_17840
ptg000015l	24225384	24290123	64739	g_17840	g_11252
ptg000015l	24294528	24299270	4742	g_11252	g_13648
ptg000015l	24308766	24312563	3797	g_13648	g_19679
ptg000015l	24348790	24359764	10974	g_19679	g_36914
ptg000015l	24363936	24371509	7573	g_36914	g_36049
ptg000015l	24375837	24381295	5458	g_36049	g_28020
ptg000015l	24385650	24387317	1667	g_28020	g_20785
ptg000015l	24388438	24390363	1925	g_39267	g_19730
ptg000015l	24398057	24399021	964	g_19730	g_1225
ptg000015l	24402403	24402867	464	g_1225	g_15397
ptg000015l	24406291	24410513	4222	g_15397	g_8427
ptg000015l	24415048	24428286	13238	g_8427	g_4389
ptg000015l	24428840	24431932	3092	g_4389	g_4877
ptg000015l	24434837	24440339	5502	g_4877	g_13431
ptg000015l	24455105	24467233	12128	g_13431	g_1985
ptg000015l	24468829	24483970	15141	g_1985	g_37655
ptg000015l	24495439	24497687	2248	g_37655	g_18500
ptg000015l	24505320	24530863	25543	g_18500	g_20028
ptg000015l	24532640	24557203	24563	g_20028	g_16687
ptg000015l	24558908	24574700	15792	g_16687	g_22511
ptg000015l	24590533	24592101	1568	g_22511	g_18294
ptg000015l	24595745	24605184	9439	g_18294	g_3299
ptg000015l	24611235	24617943	6708	g_3299	g_6499
ptg000015l	24621208	24623065	1857	g_6499	g_11557
ptg000015l	24627459	24629357	1898	g_11557	g_36145
ptg000015l	24637191	24655132	17941	g_36145	g_31295
ptg000015l	24665109	24676697	11588	g_31295	g_32520
ptg000015l	24682981	24686555	3574	g_32520	g_24190
ptg000015l	24689819	24698971	9152	g_24190	g_25108
ptg000015l	24709456	24743801	34345	g_25108	g_9580
ptg000015l	24751929	24764365	12436	g_9580	g_36345
ptg000015l	24781444	24799532	18088	g_36345	g_5178
ptg000015l	24800667	24845421	44754	g_5178	g_37122
ptg000015l	24849989	24853995	4006	g_37122	g_31823
ptg000015l	24867494	24913319	45825	g_31823	g_11575
ptg000015l	24913591	24927140	13549	g_11575	g_16729
ptg000015l	24941568	24962730	21162	g_16729	g_32775
ptg000015l	24965037	24968805	3768	g_32775	g_15248
ptg000015l	24973859	24977607	3748	g_15248	g_1384
ptg000015l	24982788	25008525	25737	g_1384	g_14489
ptg000015l	25014685	25021876	7191	g_14489	g_4790
ptg000015l	25025304	25180100	154796	g_4790	g_26413
ptg000015l	25186355	25247929	61574	g_26413	g_10017
ptg000015l	25250449	25251922	1473	g_10017	g_16900
ptg000015l	25261035	25262305	1270	g_16900	g_38068
ptg000015l	25263168	25267832	4664	g_38068	g_23790
ptg000015l	25273026	25275629	2603	g_23790	g_19238
ptg000015l	25280023	25286937	6914	g_19238	g_40196
ptg000015l	25288846	25292604	3758	g_40196	g_20419
ptg000015l	25292864	25295897	3033	g_20419	g_4168
ptg000015l	25315543	25320068	4525	g_4168	g_10253
ptg000015l	25330988	25333317	2329	g_10253	g_1285
ptg000015l	25338747	25340589	1842	g_1285	g_26524
ptg000015l	25345370	25353540	8170	g_26524	g_32213
ptg000015l	25354967	25362393	7426	g_32213	g_34271
ptg000015l	25454901	25649966	195065	g_34271	g_24201
ptg000015l	25665396	25665430	34	g_24201	g_4838
ptg000015l	25665651	25677120	11469	g_4838	g_8435
ptg000015l	25689709	25691591	1882	g_8435	g_21341
ptg000015l	25697680	25704792	7112	g_21341	g_3216
ptg000015l	25710992	25719009	8017	g_3216	g_13027
ptg000015l	25725535	25735552	10017	g_13027	g_8849
ptg000015l	25743855	25746619	2764	g_8849	g_34433
ptg000015l	25751004	25754134	3130	g_34433	g_13716
ptg000015l	25761819	25768109	6290	g_13716	g_3397
ptg000015l	25768417	25810114	41697	g_3397	g_23048
ptg000015l	25810951	25824020	13069	g_23048	g_16946
ptg000015l	25846660	25853344	6684	g_16946	g_20625
ptg000015l	25857360	25941450	84090	g_20625	g_3661
ptg000015l	25946032	25947028	996	g_3661	g_16947
ptg000015l	25951738	25960480	8742	g_16947	g_20403
ptg000015l	25965680	25978242	12562	g_20403	g_25982
ptg000015l	25993732	26027038	33306	g_25982	g_15045
ptg000015l	26034261	26059850	25589	g_15045	g_11871
ptg000015l	26072087	26091911	19824	g_11871	g_36365
ptg000015l	26101282	26103133	1851	g_36365	g_337
ptg000015l	26119066	26127077	8011	g_337	g_15172
ptg000015l	26129811	26134703	4892	g_15172	g_17037
ptg000015l	26136081	26145776	9695	g_17037	g_31274
ptg000015l	26146072	26184936	38864	g_31274	g_1991
ptg000015l	26190005	26193485	3480	g_1991	g_11890
ptg000015l	26197100	26201771	4671	g_11890	g_33217
ptg000015l	26202784	26204116	1332	g_33217	g_3726
ptg000015l	26205647	26215199	9552	g_3726	g_34933
ptg000015l	26216293	26227037	10744	g_34933	g_35427
ptg000015l	26246796	26315293	68497	g_35427	g_31682
ptg000015l	26318554	26320893	2339	g_31682	g_13503
ptg000015l	26325401	26336038	10637	g_13503	g_37794
ptg000015l	26342150	26374875	32725	g_37794	g_16801
ptg000015l	26375447	26435408	59961	g_16801	g_29859
ptg000015l	26436328	26533962	97634	g_29859	g_15576
ptg000015l	26547769	26644161	96392	g_15576	g_22594
ptg000015l	26647247	26823146	175899	g_22594	g_7427
ptg000015l	26832314	26848370	16056	g_7427	g_1180
ptg000015l	26852637	26854251	1614	g_1180	g_27462
ptg000015l	26880026	26881979	1953	g_27462	g_34707
ptg000015l	26884300	26887062	2762	g_34707	g_31050
ptg000015l	26894304	26898586	4282	g_31050	g_38088
ptg000015l	26902958	26905696	2738	g_38088	g_24195
ptg000015l	26906043	26913322	7279	g_24195	g_18351
ptg000015l	26921000	26926753	5753	g_18351	g_35655
ptg000015l	26954130	26980436	26306	g_35655	g_30134
ptg000015l	26994379	26997594	3215	g_30134	g_32754
ptg000015l	27000426	27003821	3395	g_32754	g_18463
ptg000015l	27011601	27014197	2596	g_18463	g_38055
ptg000015l	27017760	27018517	757	g_38055	g_32012
ptg000015l	27023888	27025875	1987	g_32012	g_26117
ptg000015l	27027720	27032138	4418	g_26117	g_15101
ptg000015l	27042750	27046988	4238	g_15101	g_24148
ptg000015l	27069969	27079917	9948	g_24148	g_34387
ptg000015l	27080897	27086797	5900	g_34387	g_34302
ptg000015l	27087486	27094874	7388	g_34302	g_15305
ptg000015l	27102775	27121941	19166	g_15305	g_18862
ptg000015l	27126216	27128724	2508	g_18862	g_3122
ptg000015l	27140215	27198728	58513	g_3122	g_1004
ptg000015l	27201509	27204844	3335	g_1004	g_4375
ptg000015l	27211820	27315965	104145	g_4375	g_32913
ptg000015l	27340242	27403343	63101	g_32913	g_17805
ptg000015l	27404151	27454846	50695	g_17805	g_272
ptg000015l	27455379	27456297	918	g_272	g_32971
ptg000015l	27472589	27475766	3177	g_32971	g_15383
ptg000015l	27489190	27519912	30722	g_15383	g_24231
ptg000015l	27523306	27637948	114642	g_24231	g_36401
ptg000015l	27639027	27639417	390	g_36401	g_33547
ptg000015l	27639626	27656142	16516	g_33547	g_5053
ptg000015l	27673731	27685400	11669	g_5053	g_24144
ptg000015l	27712522	27715812	3290	g_24144	g_20871
ptg000015l	27752937	27778842	25905	g_20871	g_4684
ptg000015l	27779177	27800759	21582	g_4684	g_9189
ptg000015l	27802570	27838364	35794	g_9189	g_37414
ptg000015l	27864245	27924559	60314	g_37414	g_9830
ptg000015l	27934137	27935549	1412	g_9830	g_22082
ptg000015l	27939314	27946345	7031	g_22082	g_34335
ptg000015l	27954108	27999342	45234	g_34335	g_37250
ptg000015l	27999629	28037919	38290	g_37250	g_1483
ptg000015l	28039359	28161467	122108	g_1483	g_33764
ptg000015l	28162946	28205364	42418	g_33764	g_5050
ptg000015l	28205588	28217811	12223	g_5050	g_14759
ptg000015l	28236983	28237353	370	g_14759	g_6159
ptg000015l	28238354	28254162	15808	g_6159	g_27963
ptg000015l	28260992	28264572	3580	g_27963	g_25788
ptg000015l	28271231	28275460	4229	g_25788	g_35774
ptg000015l	28275660	28296944	21284	g_35774	g_17470
ptg000015l	28301908	28351209	49301	g_17470	g_13469
ptg000015l	28351454	28386279	34825	g_13469	g_13146
ptg000015l	28386503	28387720	1217	g_13146	g_36968
ptg000015l	28395678	28413267	17589	g_36968	g_10165
ptg000015l	28418843	28444220	25377	g_10165	g_26953
ptg000015l	28456199	28458506	2307	g_26953	g_9211
ptg000015l	28465386	28504995	39609	g_9211	g_20173
ptg000015l	28519272	28519905	633	g_20173	g_16718
ptg000015l	28522368	28805277	282909	g_16718	g_38103
ptg000015l	28810733	28840485	29752	g_38103	g_20431
ptg000015l	28854440	28855271	831	g_20431	g_12042
ptg000015l	28872899	28878053	5154	g_12042	g_7598
ptg000015l	28882642	28883685	1043	g_7598	g_26567
ptg000015l	28887690	28909679	21989	g_26567	g_9297
ptg000015l	28916076	28916149	73	g_9297	g_40067
ptg000015l	28927243	28939942	12699	g_40067	g_192
ptg000015l	28948582	28992333	43751	g_192	g_10171
ptg000015l	29002378	29007067	4689	g_10171	g_12560
ptg000015l	29026911	29030867	3956	g_12560	g_11197
ptg000015l	29037188	29043685	6497	g_11197	g_28397
ptg000015l	29057457	29059580	2123	g_28397	g_14159
ptg000015l	29070022	29074885	4863	g_14159	g_14048
ptg000015l	29081754	29088304	6550	g_14048	g_28958
ptg000015l	29109180	29121296	12116	g_28958	g_39663
ptg000015l	29121643	29135555	13912	g_39663	g_25375
ptg000015l	29148981	29154473	5492	g_25375	g_34239
ptg000015l	29160095	29165760	5665	g_34239	g_4312
ptg000015l	29170197	29172533	2336	g_4312	g_6147
ptg000015l	29182235	29193333	11098	g_6147	g_31999
ptg000015l	29194427	29231211	36784	g_31999	g_14130
ptg000015l	29241879	29527886	286007	g_14130	g_22316
ptg000015l	29528125	29548242	20117	g_22316	g_9348
ptg000015l	29548589	29594141	45552	g_9348	g_2553
ptg000015l	29594356	29627025	32669	g_2553	g_14321
ptg000015l	29627309	29634405	7096	g_14321	g_11909
ptg000015l	29638727	29640818	2091	g_11909	g_19401
ptg000015l	29646486	29649666	3180	g_19401	g_3333
ptg000015l	29654093	29659064	4971	g_3333	g_26017
ptg000015l	29666764	29668409	1645	g_26017	g_6176
ptg000015l	29671261	29679082	7821	g_6176	g_6934
ptg000015l	29681178	29684037	2859	g_6934	g_4407
ptg000015l	29702895	29712199	9304	g_4407	g_379
ptg000015l	29712597	29770473	57876	g_379	g_12393
ptg000015l	29786579	29797925	11346	g_12393	g_12049
ptg000015l	29802292	29805248	2956	g_12049	g_11441
ptg000015l	29809669	29810824	1155	g_11441	g_40097
ptg000015l	29815395	29821361	5966	g_40097	g_26376
ptg000015l	29838687	29874367	35680	g_26376	g_23410
ptg000015l	29885531	29975565	90034	g_23410	g_8150
ptg000015l	29978063	29996053	17990	g_8150	g_15206
ptg000015l	30004721	30008308	3587	g_15206	g_27064
ptg000015l	30012778	30020412	7634	g_27064	g_13085
ptg000015l	30030989	30040390	9401	g_13085	g_21753
ptg000015l	30041502	30044536	3034	g_21753	g_7344
ptg000015l	30050884	30169554	118670	g_7344	g_18851
ptg000015l	30171891	30172679	788	g_18851	g_29283
ptg000015l	30188609	30191233	2624	g_29283	g_5616
ptg000015l	30196546	30199937	3391	g_5616	g_6626
ptg000015l	30200983	30201163	180	g_6626	g_17003
ptg000015l	30206571	30377151	170580	g_17003	g_32907
ptg000015l	30379573	30381957	2384	g_32907	g_35572
ptg000015l	30394866	30396643	1777	g_35572	g_35534
ptg000015l	30398997	30400697	1700	g_35534	g_17129
ptg000015l	30401719	30402685	966	g_17129	g_13244
ptg000015l	30405225	30406835	1610	g_13244	g_9666
ptg000015l	30410917	30428622	17705	g_9666	g_20973
ptg000015l	30434692	30438687	3995	g_20973	g_24784
ptg000015l	30460877	30482337	21460	g_24784	g_19830
ptg000015l	30501431	30509435	8004	g_19830	g_11001
ptg000015l	30512547	30515866	3319	g_11001	g_28156
ptg000015l	30516108	30626062	109954	g_28156	g_7672
ptg000015l	30632296	30650355	18059	g_7672	g_12146
ptg000015l	30656128	30688817	32689	g_12146	g_2882
ptg000015l	30694558	30767155	72597	g_2882	g_6296
ptg000015l	30783279	30831105	47826	g_6296	g_6369
ptg000015l	30831863	30986346	154483	g_6369	g_26369
ptg000015l	30993189	31105643	112454	g_26369	g_28120
ptg000015l	31106323	31167775	61452	g_28120	g_7583
ptg000015l	31180353	31206503	26150	g_7583	g_15755
ptg000015l	31207063	31210413	3350	g_15755	g_22948
ptg000015l	31215098	31236955	21857	g_22948	g_2974
ptg000015l	31253979	31312027	58048	g_2974	g_36456
ptg000015l	31312257	31332464	20207	g_36456	g_5866
ptg000015l	31341452	31347065	5613	g_5866	g_1470
ptg000015l	31362937	31366425	3488	g_1470	g_3387
ptg000015l	31377838	31378940	1102	g_3387	g_26547
ptg000015l	31389201	31447178	57977	g_26547	g_1090
ptg000015l	31457444	31459264	1820	g_1090	g_20726
ptg000015l	31460505	31477827	17322	g_20726	g_15815
ptg000015l	31478051	31501386	23335	g_15815	g_8272
ptg000015l	31516356	31524145	7789	g_8272	g_29152
ptg000015l	31529293	31529635	342	g_29152	g_25729
ptg000015l	31529907	31530627	720	g_25729	g_19363
ptg000015l	31538759	31713022	174263	g_19363	g_37044
ptg000015l	31713303	31729342	16039	g_37044	g_6177
ptg000015l	31729623	31736897	7274	g_6177	g_35656
ptg000015l	31737590	31801084	63494	g_35656	g_27340
ptg000015l	31806211	31816178	9967	g_20310	g_20623
ptg000015l	31817368	31854377	37009	g_20623	g_15593
ptg000015l	31854763	31862480	7717	g_15593	g_40149
ptg000015l	31869642	31870743	1101	g_40149	g_3733
ptg000015l	31871087	31874357	3270	g_3733	g_40150
ptg000015l	31889332	31943644	54312	g_40150	g_15987
ptg000015l	31957702	31969823	12121	g_15987	g_38264
ptg000015l	31987685	32027991	40306	g_38264	g_34149
ptg000015l	32036003	32040638	4635	g_34149	g_36926
ptg000015l	32047133	32158414	111281	g_36926	g_16977
ptg000015l	32170246	32180159	9913	g_16977	g_13117
ptg000015l	32203323	32220344	17021	g_13117	g_14433
ptg000015l	32233248	32325726	92478	g_14433	g_32727
ptg000015l	32330220	32348198	17978	g_32727	g_4967
ptg000015l	32367317	32373897	6580	g_4967	g_33895
ptg000015l	32389022	32490126	101104	g_33895	g_9584
ptg000015l	32511856	32519252	7396	g_9584	g_21709
ptg000015l	32528333	32582731	54398	g_21709	g_23907
ptg000015l	32591791	32592741	950	g_23907	g_25564
ptg000015l	32595209	32595998	789	g_25564	g_3178
ptg000015l	32602076	32686001	83925	g_3178	g_28800
ptg000015l	32688703	32695958	7255	g_28800	g_21509
ptg000015l	32699204	32706464	7260	g_21509	g_9723
ptg000015l	32720984	32804793	83809	g_9723	g_17604
ptg000015l	32807385	32841807	34422	g_17604	g_21125
ptg000015l	32842094	32873486	31392	g_21125	g_17803
ptg000015l	32877855	32920474	42619	g_17803	g_40235
ptg000015l	32928857	32934883	6026	g_40235	g_23225
ptg000015l	32937838	32942506	4668	g_23225	g_22197
ptg000015l	32947829	32949115	1286	g_22197	g_21187
ptg000015l	32950609	32956431	5822	g_21187	g_9073
ptg000015l	32957663	32958874	1211	g_9073	g_932
ptg000015l	32965109	32967457	2348	g_932	g_38123
ptg000015l	32977181	33000268	23087	g_38123	g_26769
ptg000015l	33030747	33033428	2681	g_26769	g_19751
ptg000015l	33041958	33048053	6095	g_19751	g_22980
ptg000015l	33052455	33083157	30702	g_22980	g_4146
ptg000015l	33087027	33089683	2656	g_4146	g_20657
ptg000015l	33090916	33092713	1797	g_20657	g_2687
ptg000015l	33095541	33122692	27151	g_2687	g_6634
ptg000015l	33127000	33134073	7073	g_6634	g_15147
ptg000015l	33134381	33318719	184338	g_15147	g_20832
ptg000015l	33335483	33412303	76820	g_20832	g_9086
ptg000015l	33419757	33429878	10121	g_9086	g_7665
ptg000015l	33435247	33456749	21502	g_7665	g_22716
ptg000015l	33457795	33464891	7096	g_22716	g_15371
ptg000015l	33480273	33528697	48424	g_15371	g_26216
ptg000015l	33536625	33557944	21319	g_26216	g_28638
ptg000015l	33565482	33568880	3398	g_28638	g_1748
ptg000015l	33582750	33587004	4254	g_1748	g_7710
ptg000015l	33598032	33639893	41861	g_7710	g_17991
ptg000015l	33646824	33666871	20047	g_17991	g_37605
ptg000015l	33667071	33674163	7092	g_37605	g_33804
ptg000015l	33674567	33732785	58218	g_33804	g_34221
ptg000015l	33733981	33741208	7227	g_34221	g_5486
ptg000015l	33752246	33983474	231228	g_5486	g_15880
ptg000015l	34007699	34025584	17885	g_15880	g_27719
ptg000015l	34038377	34040480	2103	g_27719	g_259
ptg000015l	34045780	34047605	1825	g_259	g_20042
ptg000015l	34052726	34058770	6044	g_20042	g_18233
ptg000015l	34083023	34193842	110819	g_18233	g_33076
ptg000015l	34209272	34216274	7002	g_33076	g_5958
ptg000015l	34260837	34266647	5810	g_5958	g_10756
ptg000015l	34270807	34308019	37212	g_10756	g_34463
ptg000015l	34313448	34319786	6338	g_34463	g_5559
ptg000015l	34325332	34336311	10979	g_5559	g_29865
ptg000015l	34337738	34340298	2560	g_29865	g_12899
ptg000015l	34352405	34411987	59582	g_12899	g_35108
ptg000015l	34413480	34413630	150	g_35108	g_3334
ptg000015l	34414205	34429995	15790	g_3334	g_34155
ptg000015l	34450575	34473717	23142	g_34155	g_29329
ptg000015l	34475122	34489585	14463	g_29329	g_18994
ptg000015l	34496477	34538580	42103	g_18994	g_30999
ptg000015l	34548589	34550807	2218	g_30999	g_32178
ptg000015l	34565265	34583874	18609	g_32178	g_25160
ptg000015l	34606831	34622394	15563	g_25160	g_18817
ptg000015l	34631019	34778165	147146	g_18817	g_26902
ptg000015l	34785617	34785849	232	g_26902	g_27738
ptg000015l	34794255	34847413	53158	g_27738	g_2927
ptg000015l	34856509	34870078	13569	g_2927	g_8062
ptg000015l	34880435	34885646	5211	g_8062	g_30292
ptg000015l	34933541	35026559	93018	g_30292	g_11390
ptg000016l	145723	222763	77040	g_31294	g_8040
ptg000016l	240994	263650	22656	g_8040	g_622
ptg000016l	263919	284938	21019	g_622	g_16579
ptg000016l	285729	300679	14950	g_16579	g_20974
ptg000016l	399688	522502	122814	g_20974	g_14621
ptg000016l	534205	627617	93412	g_14621	g_8250
ptg000016l	652566	722897	70331	g_8250	g_30413
ptg000016l	723529	733651	10122	g_30413	g_31109
ptg000016l	734295	838160	103865	g_31109	g_10038
ptg000016l	838807	838918	111	g_10038	g_12687
ptg000016l	839163	847310	8147	g_12687	g_35702
ptg000016l	847768	888337	40569	g_35702	g_36793
ptg000016l	890314	999715	109401	g_36793	g_35104
ptg000016l	999975	1032341	32366	g_35104	g_18796
ptg000016l	1032703	1361996	329293	g_18796	g_10564
ptg000016l	1362502	1404260	41758	g_10564	g_16234
ptg000016l	1405062	2110639	705577	g_16234	g_772
ptg000016l	2110989	2111035	46	g_772	g_28047
ptg000016l	2111748	2138409	26661	g_28047	g_490
ptg000016l	2145749	2147838	2089	g_490	g_2857
ptg000016l	2153385	2153993	608	g_2857	g_35495
ptg000016l	2156297	2161702	5405	g_35495	g_28900
ptg000016l	2162909	2167956	5047	g_28900	g_22976
ptg000016l	2188749	2191946	3197	g_22976	g_22652
ptg000016l	2200778	2229641	28863	g_22652	g_37905
ptg000016l	2231938	2236699	4761	g_37905	g_13913
ptg000016l	2270660	2297644	26984	g_13913	g_35315
ptg000016l	2298261	2299266	1005	g_35315	g_21990
ptg000016l	2309407	2326185	16778	g_21990	g_5984
ptg000016l	2343703	2399187	55484	g_5984	g_30526
ptg000016l	2429048	2431954	2906	g_30526	g_35977
ptg000016l	2433219	2434193	974	g_35977	g_3744
ptg000016l	2441675	2449806	8131	g_3744	g_1857
ptg000016l	2452309	2466818	14509	g_1857	g_19169
ptg000016l	2467867	2469216	1349	g_19169	g_2712
ptg000016l	2469929	2510451	40522	g_2712	g_20449
ptg000016l	2515637	2615127	99490	g_20449	g_32341
ptg000016l	2616242	2632596	16354	g_32341	g_40279
ptg000016l	2642399	2647278	4879	g_40279	g_29850
ptg000016l	2647730	2660535	12805	g_29850	g_10729
ptg000016l	2671096	2675932	4836	g_10729	g_36846
ptg000016l	2676384	2708741	32357	g_36846	g_29452
ptg000016l	2718976	2765197	46221	g_29452	g_3498
ptg000016l	2766096	2911558	145462	g_3498	g_37532
ptg000016l	2917278	2928759	11481	g_37532	g_1710
ptg000016l	2929154	3007808	78654	g_1710	g_2052
ptg000016l	3008281	3080234	71953	g_2052	g_666
ptg000016l	3086155	3195461	109306	g_666	g_20686
ptg000016l	3214916	3218578	3662	g_20686	g_840
ptg000016l	3218877	3219890	1013	g_840	g_39915
ptg000016l	3220426	3234334	13908	g_39915	g_26208
ptg000016l	3240176	3240280	104	g_26208	g_13663
ptg000016l	3245247	3279171	33924	g_13663	g_19029
ptg000016l	3280763	3323412	42649	g_19029	g_33677
ptg000016l	3337873	3340905	3032	g_33677	g_5863
ptg000016l	3345906	3370141	24235	g_5863	g_12772
ptg000016l	3390321	3390646	325	g_12772	g_37440
ptg000016l	3390981	3391315	334	g_37440	g_9541
ptg000016l	3391938	3393463	1525	g_9541	g_56
ptg000016l	3394086	3394411	325	g_56	g_13553
ptg000016l	3394998	3396811	1813	g_13553	g_27479
ptg000016l	3397866	3398191	325	g_27479	g_37027
ptg000016l	3398613	3398887	274	g_37027	g_23942
ptg000016l	3410167	3421338	11171	g_23942	g_11029
ptg000016l	3432142	3434506	2364	g_11029	g_25237
ptg000016l	3442033	3455917	13884	g_25237	g_8906
ptg000016l	3466481	3467200	719	g_8906	g_28079
ptg000016l	3468377	3615412	147035	g_28079	g_11280
ptg000016l	3621074	3664983	43909	g_11280	g_1473
ptg000016l	3665423	3701113	35690	g_1473	g_8864
ptg000016l	3701496	3714541	13045	g_8864	g_18889
ptg000016l	3730029	3844865	114836	g_18889	g_19106
ptg000016l	3845266	3845440	174	g_19106	g_40195
ptg000016l	3845895	3863565	17670	g_40195	g_31257
ptg000016l	3863882	3947825	83943	g_31257	g_30587
ptg000016l	3973761	4024140	50379	g_30587	g_27068
ptg000016l	4030443	4033148	2705	g_27068	g_29587
ptg000016l	4042745	4056351	13606	g_29587	g_12221
ptg000016l	4058720	4062703	3983	g_12221	g_6291
ptg000016l	4062945	4100436	37491	g_6291	g_20292
ptg000016l	4100699	4206978	106279	g_20292	g_13808
ptg000016l	4216101	4224083	7982	g_13808	g_28914
ptg000016l	4225285	4227497	2212	g_28914	g_35806
ptg000016l	4228459	4233068	4609	g_35806	g_13203
ptg000016l	4243858	4247444	3586	g_13203	g_30234
ptg000016l	4255610	4257163	1553	g_30234	g_14530
ptg000016l	4261287	4274093	12806	g_14530	g_28525
ptg000016l	4275553	4280922	5369	g_28525	g_17344
ptg000016l	4284705	4339516	54811	g_17344	g_9945
ptg000016l	4340127	4342025	1898	g_9945	g_12215
ptg000016l	4342429	4387370	44941	g_12215	g_20755
ptg000016l	4390325	4518729	128404	g_20755	g_31357
ptg000016l	4519523	4588567	69044	g_31357	g_4298
ptg000016l	4589319	4633083	43764	g_4298	g_7005
ptg000016l	4633523	4732809	99286	g_7005	g_1108
ptg000016l	4733198	4836307	103109	g_1108	g_3863
ptg000016l	4836510	4862010	25500	g_3863	g_32695
ptg000016l	4863230	4863291	61	g_32695	g_11733
ptg000016l	4863734	4892542	28808	g_11733	g_28033
ptg000016l	4895799	4921005	25206	g_28033	g_18804
ptg000016l	4922816	5086340	163524	g_18804	g_2239
ptg000016l	5086744	5217159	130415	g_2239	g_13317
ptg000016l	5217536	5323248	105712	g_13317	g_37781
ptg000016l	5323532	5348500	24968	g_37781	g_16461
ptg000016l	5352052	5352085	33	g_16461	g_20960
ptg000016l	5352369	5393792	41423	g_20960	g_25583
ptg000016l	5400127	5497610	97483	g_25583	g_20319
ptg000016l	5500967	5508451	7484	g_20319	g_5800
ptg000016l	5515645	5532530	16885	g_5800	g_25171
ptg000016l	5534300	5537173	2873	g_25171	g_11068
ptg000016l	5537409	5549184	11775	g_11068	g_14814
ptg000016l	5553992	5568728	14736	g_14814	g_30441
ptg000016l	5586833	5589388	2555	g_30441	g_30658
ptg000016l	5593778	5606517	12739	g_30658	g_2980
ptg000016l	5627647	5631913	4266	g_2980	g_23018
ptg000016l	5632533	5641955	9422	g_23018	g_13909
ptg000016l	5646244	5654530	8286	g_13909	g_5691
ptg000016l	5655027	5662752	7725	g_5691	g_18451
ptg000016l	5672400	5694335	21935	g_18451	g_18993
ptg000016l	5695225	5697059	1834	g_18993	g_7091
ptg000016l	5701775	5756190	54415	g_7091	g_4034
ptg000016l	5756735	5773150	16415	g_4034	g_35785
ptg000016l	5773359	5805998	32639	g_35785	g_14719
ptg000016l	5806315	5907462	101147	g_14719	g_17198
ptg000016l	5922844	5927713	4869	g_17198	g_31537
ptg000016l	5939787	5997343	57556	g_31537	g_18208
ptg000016l	5997558	6012588	15030	g_18208	g_19621
ptg000016l	6012992	6042902	29910	g_19621	g_9254
ptg000016l	6053382	6057292	3910	g_9254	g_16167
ptg000016l	6058476	6063492	5016	g_16167	g_25682
ptg000016l	6077875	6107594	29719	g_25682	g_14984
ptg000016l	6107812	6121734	13922	g_14984	g_8779
ptg000016l	6122639	6173796	51157	g_8779	g_18782
ptg000016l	6174236	6298528	124292	g_18782	g_39313
ptg000016l	6298866	6380222	81356	g_39313	g_7328
ptg000016l	6383561	6451200	67639	g_7328	g_31466
ptg000016l	6452178	6487090	34912	g_31466	g_22022
ptg000016l	6487635	6629024	141389	g_22022	g_11972
ptg000016l	6629563	6637936	8373	g_11972	g_29441
ptg000016l	6638196	6643860	5664	g_29441	g_7961
ptg000016l	6644111	6700305	56194	g_7961	g_39329
ptg000016l	6701234	6725283	24049	g_39329	g_28856
ptg000016l	6725714	6825368	99654	g_28856	g_8722
ptg000016l	6826432	6834593	8161	g_8722	g_18129
ptg000016l	6846870	7090664	243794	g_18129	g_23789
ptg000016l	7090885	7094896	4011	g_23789	g_14373
ptg000016l	7095183	7118937	23754	g_14373	g_27853
ptg000016l	7126355	7191386	65031	g_27853	g_25640
ptg000016l	7191658	7206004	14346	g_25640	g_38466
ptg000016l	7206849	7207328	479	g_38466	g_3023
ptg000016l	7225468	7249778	24310	g_3023	g_7104
ptg000016l	7250128	7268179	18051	g_7104	g_15229
ptg000016l	7282099	7326997	44898	g_15229	g_20835
ptg000016l	7339648	7342099	2451	g_20835	g_1451
ptg000016l	7345370	7364508	19138	g_1451	g_39926
ptg000016l	7371667	7372991	1324	g_39926	g_37087
ptg000016l	7385536	7478252	92716	g_37087	g_21778
ptg000016l	7478701	7478756	55	g_21778	g_8108
ptg000017l	86884	99400	12516	g_21972	g_19915
ptg000017l	100290	109499	9209	g_19915	g_232
ptg000017l	111813	168644	56831	g_232	g_30889
ptg000017l	169429	494774	325345	g_30889	g_3250
ptg000017l	501572	692460	190888	g_3250	g_6463
ptg000017l	699066	707333	8267	g_6463	g_36370
ptg000017l	716663	721647	4984	g_36370	g_23115
ptg000017l	746444	757779	11335	g_23115	g_30687
ptg000017l	758939	764784	5845	g_30687	g_22490
ptg000017l	768249	773050	4801	g_22490	g_16246
ptg000017l	793943	802294	8351	g_16246	g_35838
ptg000017l	802494	841697	39203	g_35838	g_23412
ptg000017l	842197	942127	99930	g_23412	g_38023
ptg000017l	944019	951710	7691	g_38023	g_22632
ptg000017l	964766	1011570	46804	g_22632	g_10943
ptg000017l	1023020	1024266	1246	g_10943	g_34917
ptg000017l	1025926	1083233	57307	g_34917	g_15108
ptg000017l	1084045	1094816	10771	g_15108	g_8883
ptg000017l	1095079	1302561	207482	g_8883	g_8075
ptg000017l	1303463	1388693	85230	g_8075	g_22923
ptg000017l	1388902	1440896	51994	g_22923	g_12164
ptg000017l	1441240	1508005	66765	g_12164	g_13409
ptg000017l	1514291	1726427	212136	g_13409	g_22866
ptg000017l	1727161	1856804	129643	g_22866	g_21567
ptg000017l	1857193	2199687	342494	g_21567	g_31014
ptg000017l	2200154	2248254	48100	g_31014	g_6951
ptg000017l	2270894	2283818	12924	g_6951	g_2426
ptg000017l	2313252	2514501	201249	g_2426	g_39934
ptg000017l	2534067	2556521	22454	g_39934	g_1756
ptg000017l	2570092	2602355	32263	g_1756	g_13434
ptg000017l	2607063	2716944	109881	g_13434	g_22296
ptg000017l	2719041	2785207	66166	g_22296	g_35765
ptg000017l	2794108	2797031	2923	g_35765	g_23437
ptg000017l	2797288	2797885	597	g_23437	g_32334
ptg000017l	2821063	2822499	1436	g_32334	g_38240
ptg000017l	2822735	2828181	5446	g_38240	g_28978
ptg000017l	2845906	2856426	10520	g_28978	g_11542
ptg000017l	2869999	2877476	7477	g_11542	g_4089
ptg000017l	2906513	2926864	20351	g_4089	g_8513
ptg000017l	2961473	3014921	53448	g_8513	g_17102
ptg000017l	3015649	3033112	17463	g_17102	g_22453
ptg000017l	3033378	3162917	129539	g_22453	g_32806
ptg000017l	3163519	3241922	78403	g_32806	g_85
ptg000017l	3246287	3261171	14884	g_85	g_29204
ptg000017l	3283666	3298989	15323	g_29204	g_30559
ptg000017l	3306882	3320177	13295	g_30559	g_31161
ptg000017l	3320686	3350513	29827	g_31161	g_23695
ptg000017l	3351316	3353814	2498	g_23695	g_23868
ptg000017l	3354626	3357128	2502	g_23868	g_14870
ptg000017l	3357937	3367554	9617	g_14870	g_11693
ptg000017l	3368360	3370861	2501	g_11693	g_27124
ptg000017l	3371667	3374168	2501	g_27124	g_27810
ptg000017l	3374968	3377469	2501	g_27810	g_31222
ptg000017l	3378272	3380768	2496	g_31222	g_23588
ptg000017l	3381577	3384066	2489	g_23588	g_6961
ptg000017l	3384878	3387380	2502	g_6961	g_8570
ptg000017l	3388225	3397446	9221	g_8570	g_35431
ptg000017l	3397970	3450058	52088	g_35431	g_19540
ptg000017l	3451242	3493081	41839	g_19540	g_33097
ptg000017l	3495992	3518727	22735	g_33097	g_20511
ptg000017l	3519684	3520058	374	g_20511	g_17337
ptg000017l	3520636	3532685	12049	g_17337	g_3437
ptg000017l	3538844	3540974	2130	g_3437	g_36960
ptg000017l	3579581	3582212	2631	g_36960	g_7978
ptg000017l	3585480	3592438	6958	g_7978	g_5707
ptg000017l	3595297	3607509	12212	g_5707	g_37040
ptg000017l	3610233	3614268	4035	g_37040	g_19851
ptg000017l	3615821	3625232	9411	g_19851	g_28623
ptg000017l	3629652	3640832	11180	g_28623	g_2265
ptg000017l	3642826	3645249	2423	g_2265	g_37505
ptg000017l	3645638	3658026	12388	g_37505	g_31668
ptg000017l	3681202	3725859	44657	g_31668	g_27987
ptg000017l	3737719	3741620	3901	g_27987	g_20491
ptg000017l	3742018	3761992	19974	g_20491	g_29986
ptg000017l	3762786	3803036	40250	g_29986	g_38892
ptg000017l	3804446	3887785	83339	g_38892	g_31761
ptg000017l	3894427	3903036	8609	g_31761	g_32611
ptg000017l	3909186	4050526	141340	g_32611	g_33452
ptg000017l	4051101	4077446	26345	g_33452	g_27699
ptg000017l	4099850	4101464	1614	g_27699	g_8164
ptg000017l	4106933	4109333	2400	g_8164	g_34582
ptg000017l	4114669	4117336	2667	g_34582	g_19652
ptg000017l	4121308	4127726	6418	g_19652	g_10707
ptg000017l	4139528	4159378	19850	g_10707	g_5119
ptg000017l	4169867	4207746	37879	g_5119	g_2322
ptg000017l	4239207	4253629	14422	g_2322	g_3487
ptg000017l	4260974	4267381	6407	g_3487	g_24096
ptg000017l	4275295	4290417	15122	g_24096	g_35357
ptg000017l	4308018	4313467	5449	g_35357	g_11815
ptg000017l	4335235	4342184	6949	g_11815	g_6451
ptg000017l	4346069	4347070	1001	g_6451	g_25129
ptg000017l	4352733	4398262	45529	g_25129	g_2754
ptg000017l	4398951	4400609	1658	g_2754	g_7700
ptg000017l	4413629	4448302	34673	g_7700	g_9803
ptg000017l	4455086	4467127	12041	g_23232	g_24335
ptg000017l	4467852	4470448	2596	g_24335	g_25957
ptg000017l	4470678	4489472	18794	g_25957	g_23385
ptg000017l	4490305	4560800	70495	g_23385	g_31333
ptg000017l	4562399	4584494	22095	g_31333	g_15718
ptg000017l	4589437	4689354	99917	g_15718	g_38322
ptg000017l	4691530	4702505	10975	g_38322	g_22365
ptg000017l	4707405	4709202	1797	g_22365	g_40221
ptg000017l	4714375	4716579	2204	g_40221	g_35854
ptg000017l	4717001	4717656	655	g_35854	g_37821
ptg000017l	4718990	4732726	13736	g_37821	g_11449
ptg000017l	4741592	4742111	519	g_11449	g_12589
ptg000017l	4744684	4749791	5107	g_12589	g_17136
ptg000017l	4755442	4756081	639	g_17136	g_13209
ptg000017l	4758193	4769357	11164	g_13209	g_10726
ptg000017l	4792599	4922931	130332	g_10726	g_35985
ptg000017l	4971634	4978851	7217	g_35985	g_33549
ptg000017l	4980911	5014267	33356	g_33549	g_28725
ptg000017l	5015188	5024917	9729	g_28725	g_11045
ptg000017l	5026754	5027584	830	g_11045	g_11349
ptg000017l	5034765	5095748	60983	g_11349	g_8099
ptg000017l	5106753	5115381	8628	g_8099	g_29316
ptg000017l	5142582	5159511	16929	g_29316	g_40062
ptg000017l	5163988	5164133	145	g_40062	g_8938
ptg000017l	5164765	5209465	44700	g_8938	g_29856
ptg000017l	5218635	5272294	53659	g_29856	g_14728
ptg000017l	5280113	5305137	25024	g_14728	g_405
ptg000017l	5315526	5325516	9990	g_405	g_20290
ptg000017l	5330665	5339049	8384	g_20290	g_145
ptg000017l	5339429	5339641	212	g_145	g_35752
ptg000017l	5350933	5357326	6393	g_35752	g_16389
ptg000017l	5359083	5364668	5585	g_16389	g_12898
ptg000017l	5373467	5377577	4110	g_12898	g_2412
ptg000017l	5382110	5408273	26163	g_2412	g_5683
ptg000017l	5409202	5444735	35533	g_5683	g_31314
ptg000017l	5448233	5449895	1662	g_31314	g_31933
ptg000017l	5453923	5466574	12651	g_31933	g_30261
ptg000017l	5470231	5481134	10903	g_30261	g_10020
ptg000017l	5481415	5485825	4410	g_10020	g_31095
ptg000017l	5495053	5499817	4764	g_31095	g_19594
ptg000017l	5500062	5555699	55637	g_19594	g_14177
ptg000017l	5569976	5580639	10663	g_14177	g_1561
ptg000017l	5596164	5600903	4739	g_1561	g_843
ptg000017l	5602093	5635728	33635	g_843	g_38194
ptg000017l	5646542	5709132	62590	g_38194	g_33583
ptg000017l	5718992	5721318	2326	g_33583	g_13239
ptg000017l	5723679	5725466	1787	g_13239	g_39625
ptg000017l	5726683	5727228	545	g_39625	g_40121
ptg000017l	5728651	5749264	20613	g_40121	g_15697
ptg000017l	5750217	5751687	1470	g_15697	g_39324
ptg000017l	5752193	5752967	774	g_39324	g_15696
ptg000017l	5755932	5769777	13845	g_15696	g_22714
ptg000017l	5775178	5779582	4404	g_22714	g_36082
ptg000017l	5793713	5843306	49593	g_36082	g_10133
ptg000017l	5843533	5982807	139274	g_10133	g_7564
ptg000017l	5995206	5996688	1482	g_7564	g_31844
ptg000017l	6000094	6003063	2969	g_31844	g_34049
ptg000017l	6009123	6124874	115751	g_34049	g_36706
ptg000017l	6125098	6174168	49070	g_36706	g_4856
ptg000017l	6184848	6197361	12513	g_4856	g_15916
ptg000017l	6227460	6230506	3046	g_15916	g_19828
ptg000017l	6233128	6266661	33533	g_19828	g_21735
ptg000017l	6269102	6301384	32282	g_21735	g_26635
ptg000017l	6301746	6329157	27411	g_26635	g_36677
ptg000017l	6351383	6630916	279533	g_36677	g_20093
ptg000017l	6633898	6788476	154578	g_20093	g_1140
ptg000017l	6805738	6889152	83414	g_1140	g_4154
ptg000017l	6911722	6914846	3124	g_4154	g_27471
ptg000017l	6915271	7142786	227515	g_27471	g_15943
ptg000017l	7143862	7147985	4123	g_15943	g_27371
ptg000017l	7149027	7231721	82694	g_27371	g_15406
ptg000017l	7233709	7323471	89762	g_15406	g_36079
ptg000017l	7324745	7548665	223920	g_36079	g_5650
ptg000017l	7552202	7584782	32580	g_5650	g_6862
ptg000017l	7593617	7596663	3046	g_6862	g_26282
ptg000017l	7599555	7614394	14839	g_26282	g_13781
ptg000017l	7621146	7693389	72243	g_13781	g_7157
ptg000017l	7695284	7777023	81739	g_7157	g_34526
ptg000017l	7777259	7779328	2069	g_34526	g_21891
ptg000017l	7797059	7813576	16517	g_21891	g_18080
ptg000017l	7835795	7836750	955	g_18080	g_10188
ptg000017l	7840373	7842351	1978	g_10188	g_34346
ptg000017l	7863916	7870053	6137	g_34346	g_10843
ptg000017l	7871873	7874772	2899	g_10843	g_22776
ptg000017l	7875393	7877858	2465	g_22776	g_25046
ptg000017l	7878127	7942038	63911	g_25046	g_33373
ptg000017l	7943639	7962450	18811	g_33373	g_32045
ptg000017l	7963748	7986853	23105	g_32045	g_31905
ptg000017l	7988700	8139708	151008	g_31905	g_36687
ptg000017l	8144732	8261221	116489	g_36687	g_33815
ptg000017l	8261553	8261620	67	g_33815	g_40286
ptg000017l	8263090	8399079	135989	g_40286	g_30272
ptg000017l	8399663	8405481	5818	g_30272	g_15549
ptg000017l	8421642	8478954	57312	g_15549	g_7065
ptg000017l	8483787	8513978	30191	g_7065	g_2224
ptg000017l	8514811	8525548	10737	g_2224	g_22361
ptg000017l	8527629	8644428	116799	g_22361	g_19428
ptg000017l	8644658	8648709	4051	g_19428	g_10215
ptg000017l	8665442	8670914	5472	g_10215	g_16315
ptg000017l	8674796	8760784	85988	g_16315	g_14696
ptg000017l	8807931	8845799	37868	g_14696	g_10524
ptg000017l	8846131	8890133	44002	g_10524	g_4748
ptg000017l	8898671	8914103	15432	g_4748	g_4747
ptg000017l	8916981	8926810	9829	g_4747	g_912
ptg000017l	8938943	8941051	2108	g_912	g_28854
ptg000017l	8947720	8952223	4503	g_28854	g_14794
ptg000017l	8953566	8956099	2533	g_14794	g_20748
ptg000017l	8958519	8981987	23468	g_20748	g_31207
ptg000017l	8990176	9023990	33814	g_31207	g_24697
ptg000017l	9029829	9034953	5124	g_24697	g_5392
ptg000017l	9053270	9061903	8633	g_5392	g_29205
ptg000017l	9068251	9277680	209429	g_29205	g_13560
ptg000017l	9291911	9293690	1779	g_13560	g_5582
ptg000017l	9298542	9302553	4011	g_5582	g_8413
ptg000017l	9310242	9407368	97126	g_8413	g_24744
ptg000017l	9408033	9412781	4748	g_24744	g_3024
ptg000017l	9414136	9454817	40681	g_3024	g_27729
ptg000017l	9471872	9523480	51608	g_27729	g_15846
ptg000017l	9523722	9587931	64209	g_15846	g_18224
ptg000017l	9588161	9601545	13384	g_18224	g_30541
ptg000017l	9606091	9607614	1523	g_30541	g_26166
ptg000017l	9625941	9629849	3908	g_26166	g_35115
ptg000017l	9637292	9640320	3028	g_35115	g_17821
ptg000017l	9642968	9705930	62962	g_17821	g_36080
ptg000017l	9707060	9825701	118641	g_36080	g_31251
ptg000017l	9842089	9845411	3322	g_31251	g_38062
ptg000017l	9849319	9921984	72665	g_38062	g_16031
ptg000017l	9935593	9960839	25246	g_16031	g_40058
ptg000017l	9967037	9969254	2217	g_40058	g_8767
ptg000017l	9979137	10037145	58008	g_8767	g_4563
ptg000017l	10037438	10067385	29947	g_4563	g_35979
ptg000017l	10067594	10250612	183018	g_35979	g_20523
ptg000017l	10270062	10292898	22836	g_20523	g_30546
ptg000017l	10300166	10306383	6217	g_30546	g_35251
ptg000017l	10307369	10312303	4934	g_35251	g_7029
ptg000017l	10335803	10361991	26188	g_7029	g_22612
ptg000017l	10368147	10421032	52885	g_22612	g_32509
ptg000017l	10434588	10457049	22461	g_32509	g_7267
ptg000017l	10465073	10517088	52015	g_7267	g_11728
ptg000017l	10517306	10519762	2456	g_11728	g_19550
ptg000017l	10520547	10535881	15334	g_19550	g_26826
ptg000017l	10539430	10540186	756	g_26826	g_3269
ptg000017l	10544010	10549454	5444	g_3269	g_25292
ptg000017l	10552459	10557490	5031	g_25292	g_18364
ptg000017l	10572522	10574446	1924	g_18364	g_4522
ptg000017l	10585980	10589628	3648	g_4522	g_6099
ptg000017l	10591723	10596791	5068	g_6099	g_37644
ptg000017l	10599008	10613762	14754	g_37644	g_3825
ptg000017l	10622671	10628326	5655	g_3825	g_26120
ptg000017l	10633170	10635190	2020	g_26120	g_31252
ptg000017l	10647146	10647817	671	g_31252	g_35850
ptg000017l	10649914	10662109	12195	g_35850	g_10160
ptg000017l	10665995	10689293	23298	g_10160	g_22720
ptg000017l	10694571	10695380	809	g_22720	g_20210
ptg000017l	10711519	10800565	89046	g_20210	g_9944
ptg000017l	10803173	10805892	2719	g_9944	g_36965
ptg000017l	10817568	10823064	5496	g_36965	g_18422
ptg000017l	10823309	10827561	4252	g_18422	g_14967
ptg000017l	10838904	10839986	1082	g_14967	g_33918
ptg000017l	10845008	10858935	13927	g_33918	g_26188
ptg000017l	10860023	10886342	26319	g_26188	g_6068
ptg000017l	10896973	11171855	274882	g_6068	g_13642
ptg000017l	11174006	11175236	1230	g_25800	g_14674
ptg000017l	11180874	11191635	10761	g_14674	g_12564
ptg000017l	11194469	11203664	9195	g_12564	g_24768
ptg000017l	11204107	11265818	61711	g_24768	g_32951
ptg000017l	11273464	11280364	6900	g_32951	g_1885
ptg000017l	11288318	11317086	28768	g_1885	g_21720
ptg000017l	11326491	11341466	14975	g_21720	g_36470
ptg000017l	11351982	11359137	7155	g_36470	g_15810
ptg000017l	11363546	11363912	366	g_15810	g_14477
ptg000017l	11368726	11370653	1927	g_14477	g_15073
ptg000017l	11378107	11380226	2119	g_15073	g_6482
ptg000017l	11383458	11417205	33747	g_6482	g_11580
ptg000017l	11432911	11441190	8279	g_11580	g_21587
ptg000017l	11446299	11478160	31861	g_21587	g_29899
ptg000017l	11496553	11516570	20017	g_29899	g_10563
ptg000017l	11522055	11523371	1316	g_10563	g_37321
ptg000017l	11527551	11531402	3851	g_37321	g_38188
ptg000017l	11534233	11536097	1864	g_38188	g_35162
ptg000017l	11540352	11543124	2772	g_35162	g_24169
ptg000017l	11556420	11561127	4707	g_24169	g_33144
ptg000017l	11567629	11569995	2366	g_33144	g_21183
ptg000017l	11578619	11585024	6405	g_21183	g_34026
ptg000017l	11588079	11592418	4339	g_34026	g_10514
ptg000017l	11609305	11628285	18980	g_10514	g_24348
ptg000017l	11634370	11644185	9815	g_24348	g_18962
ptg000017l	11648665	11668608	19943	g_18962	g_15542
ptg000017l	11678673	11716592	37919	g_15542	g_2644
ptg000017l	11726532	11733519	6987	g_2644	g_12245
ptg000017l	11737013	11753696	16683	g_12245	g_8376
ptg000017l	11764112	11787574	23462	g_8376	g_17368
ptg000017l	11796994	11800792	3798	g_17368	g_342
ptg000017l	11804608	11831373	26765	g_342	g_21948
ptg000017l	11836277	11844210	7933	g_21948	g_10434
ptg000017l	11849691	11907666	57975	g_10434	g_5918
ptg000017l	11907878	11932637	24759	g_5918	g_33768
ptg000017l	11932849	11947707	14858	g_33768	g_22096
ptg000017l	11949658	11952013	2355	g_22096	g_30248
ptg000017l	11956429	11978662	22233	g_30248	g_38091
ptg000017l	11981977	11989791	7814	g_38091	g_28631
ptg000017l	11998361	11999843	1482	g_28631	g_28620
ptg000017l	12019452	12036847	17395	g_28620	g_28680
ptg000017l	12040355	12048139	7784	g_28680	g_35253
ptg000017l	12059513	12066736	7223	g_35253	g_35338
ptg000017l	12074922	12076884	1962	g_35338	g_25836
ptg000017l	12095763	12099664	3901	g_25836	g_22746
ptg000017l	12122647	12125033	2386	g_22746	g_1480
ptg000017l	12131170	12213067	81897	g_1480	g_33072
ptg000017l	12220932	12222772	1840	g_33072	g_3480
ptg000017l	12226369	12260959	34590	g_3480	g_12226
ptg000017l	12267143	12267697	554	g_12226	g_20379
ptg000017l	12270020	12270553	533	g_20379	g_12476
ptg000017l	12279562	12282303	2741	g_12476	g_29616
ptg000017l	12291451	12297034	5583	g_29616	g_26312
ptg000017l	12306230	12338994	32764	g_26312	g_24038
ptg000017l	12339194	12345830	6636	g_24038	g_11606
ptg000017l	12349980	12351758	1778	g_11606	g_8951
ptg000017l	12353288	12384001	30713	g_8951	g_4048
ptg000017l	12384258	12424152	39894	g_4048	g_18134
ptg000017l	12424391	12493478	69087	g_18134	g_18238
ptg000017l	12496576	12640143	143567	g_18238	g_28650
ptg000017l	12640445	12707551	67106	g_28650	g_39659
ptg000017l	12707880	12775460	67580	g_39659	g_29019
ptg000017l	12775804	13181797	405993	g_29019	g_29702
ptg000017l	13192949	13286603	93654	g_29702	g_10283
ptg000017l	13308183	13355442	47259	g_10283	g_20313
ptg000017l	13355753	13526265	170512	g_20313	g_4741
ptg000017l	13526534	13537157	10623	g_4741	g_39330
ptg000017l	13537792	13597047	59255	g_39330	g_18196
ptg000017l	13597613	13886693	289080	g_18196	g_29054
ptg000017l	13889388	13894483	5095	g_29054	g_12743
ptg000017l	13899827	13906954	7127	g_12743	g_26814
ptg000017l	13908122	13908623	501	g_26814	g_30195
ptg000017l	13910170	13915208	5038	g_30195	g_30810
ptg000017l	13924014	13926250	2236	g_30810	g_775
ptg000017l	13927420	13936472	9052	g_775	g_14688
ptg000017l	13947901	13996938	49037	g_14688	g_28095
ptg000017l	14005807	14008373	2566	g_28095	g_17225
ptg000017l	14020609	14040126	19517	g_17225	g_19901
ptg000017l	14044392	14048398	4006	g_19901	g_22278
ptg000017l	14055702	14059131	3429	g_22278	g_12499
ptg000017l	14061550	14064697	3147	g_12499	g_34978
ptg000017l	14064900	14065277	377	g_34978	g_3133
ptg000017l	14069397	14077293	7896	g_3133	g_24257
ptg000017l	14084277	14086322	2045	g_24257	g_25230
ptg000017l	14092872	14095825	2953	g_25230	g_623
ptg000017l	14101502	14102206	704	g_623	g_39911
ptg000017l	14103783	14105400	1617	g_39911	g_15377
ptg000017l	14119057	14130703	11646	g_15377	g_28722
ptg000017l	14132285	14327371	195086	g_28722	g_18794
ptg000017l	14330689	14362297	31608	g_18794	g_12806
ptg000017l	14362665	14575081	212416	g_12806	g_39884
ptg000017l	14575341	14586840	11499	g_39884	g_14508
ptg000017l	14587640	14600555	12915	g_14508	g_29246
ptg000017l	14605158	14610319	5161	g_29246	g_26448
ptg000017l	14613653	14616338	2685	g_26448	g_6381
ptg000017l	14634105	14636053	1948	g_6381	g_16896
ptg000017l	14637222	14641365	4143	g_16896	g_12136
ptg000017l	14654389	14714696	60307	g_12136	g_27945
ptg000017l	14719700	14726503	6803	g_27945	g_4948
ptg000017l	14728486	14730009	1523	g_4948	g_36214
ptg000017l	14752455	14768613	16158	g_36214	g_37007
ptg000017l	14773741	14775203	1462	g_37007	g_4931
ptg000017l	14780170	14802277	22107	g_4931	g_38122
ptg000017l	14802789	14811854	9065	g_38122	g_8558
ptg000017l	14822992	14828015	5023	g_8558	g_28629
ptg000017l	14840698	14844907	4209	g_28629	g_31160
ptg000017l	14850746	14851223	477	g_31160	g_13756
ptg000017l	14852680	14857365	4685	g_13756	g_24007
ptg000017l	14874538	14875164	626	g_24007	g_13907
ptg000017l	14875664	14888879	13215	g_13907	g_9123
ptg000017l	14899708	15042949	143241	g_39646	g_8109
ptg000017l	15053913	15055545	1632	g_8109	g_2269
ptg000017l	15060009	15138005	77996	g_2269	g_35051
ptg000017l	15157287	15157549	262	g_35051	g_18550
ptg000017l	15158151	15170291	12140	g_18550	g_6326
ptg000017l	15173098	15181866	8768	g_6326	g_2718
ptg000017l	15191376	15193203	1827	g_2718	g_13904
ptg000017l	15195474	15217521	22047	g_13904	g_22172
ptg000017l	15223629	15236964	13335	g_22172	g_8095
ptg000017l	15238532	15273172	34640	g_8095	g_65
ptg000017l	15276663	15280320	3657	g_65	g_10939
ptg000017l	15287469	15289302	1833	g_10939	g_22888
ptg000017l	15291104	15292641	1537	g_22888	g_32898
ptg000017l	15295093	15305728	10635	g_32898	g_29727
ptg000017l	15306874	15314189	7315	g_29727	g_33082
ptg000017l	15317926	15321363	3437	g_33082	g_32017
ptg000017l	15322172	15410316	88144	g_32017	g_286
ptg000017l	15428290	15482382	54092	g_286	g_5895
ptg000017l	15512873	15525794	12921	g_5895	g_15067
ptg000017l	15544130	15547545	3415	g_15067	g_30990
ptg000017l	15554681	15570441	15760	g_30990	g_37872
ptg000017l	15584614	15587416	2802	g_37872	g_29555
ptg000017l	15587718	15587796	78	g_29555	g_28962
ptg000017l	15593544	15598243	4699	g_28962	g_5226
ptg000017l	15607824	15626044	18220	g_5226	g_17051
ptg000017l	15637605	15644796	7191	g_17051	g_29596
ptg000017l	15654507	15711553	57046	g_29596	g_9894
ptg000017l	15736334	15752445	16111	g_9894	g_8113
ptg000017l	15752864	15786141	33277	g_8113	g_6260
ptg000017l	15789925	15793371	3446	g_6260	g_28673
ptg000017l	15811075	15815253	4178	g_28673	g_21900
ptg000017l	15820270	15824479	4209	g_21900	g_12659
ptg000017l	15833285	15836005	2720	g_12659	g_9058
ptg000017l	15855348	15930349	75001	g_9058	g_5253
ptg000017l	15951167	16041623	90456	g_5253	g_9396
ptg000017l	16043434	16044569	1135	g_9396	g_24202
ptg000017l	16047849	16115432	67583	g_24202	g_11481
ptg000017l	16116778	16227853	111075	g_11481	g_19860
ptg000017l	16230911	16237943	7032	g_19860	g_19168
ptg000017l	16238501	16242204	3703	g_19168	g_11976
ptg000017l	16242536	16263069	20533	g_11976	g_5237
ptg000017l	16280457	16284646	4189	g_5237	g_9676
ptg000017l	16302716	16307803	5087	g_9676	g_21828
ptg000017l	16322961	16351090	28129	g_21828	g_20901
ptg000017l	16356473	16358972	2499	g_20901	g_18901
ptg000017l	16365155	16412759	47604	g_18901	g_20622
ptg000017l	16438506	16712865	274359	g_20622	g_17065
ptg000017l	16713710	16744728	31018	g_17065	g_30759
ptg000017l	16747805	16752534	4729	g_30759	g_31013
ptg000017l	16762312	16804926	42614	g_31013	g_24987
ptg000017l	16812897	16828250	15353	g_24987	g_18828
ptg000017l	16845468	16888699	43231	g_18828	g_32545
ptg000017l	16907912	16961392	53480	g_32545	g_37104
ptg000017l	16961697	17090702	129005	g_37104	g_30932
ptg000017l	17099819	17178899	79080	g_30932	g_37372
ptg000017l	17182990	17184529	1539	g_37372	g_2116
ptg000017l	17188694	17207983	19289	g_2116	g_8999
ptg000017l	17209605	17247214	37609	g_8999	g_17712
ptg000017l	17251811	17255902	4091	g_17712	g_7867
ptg000017l	17270458	17272605	2147	g_7867	g_15785
ptg000017l	17281549	17289124	7575	g_15785	g_7730
ptg000017l	17352736	17391774	39038	g_7730	g_12755
ptg000017l	17397054	17440297	43243	g_12755	g_29950
ptg000017l	17449309	17454307	4998	g_29950	g_8061
ptg000017l	17460983	17492621	31638	g_8061	g_12621
ptg000017l	17503945	17519466	15521	g_12621	g_30125
ptg000017l	17540773	17648575	107802	g_30125	g_16475
ptg000017l	17651966	17676603	24637	g_16475	g_8791
ptg000017l	17677913	17684649	6736	g_8791	g_34
ptg000017l	17689660	17783476	93816	g_34	g_35422
ptg000017l	17802201	17804175	1974	g_35422	g_25295
ptg000017l	17805364	17808169	2805	g_25295	g_7812
ptg000017l	17816967	17820211	3244	g_7812	g_28444
ptg000017l	17837297	17840539	3242	g_28444	g_35063
ptg000017l	17840925	17857233	16308	g_35063	g_168
ptg000017l	17870840	17875611	4771	g_168	g_38662
ptg000017l	17876134	17881493	5359	g_38662	g_10231
ptg000017l	17887649	17900766	13117	g_10231	g_37948
ptg000017l	17904322	17909840	5518	g_37948	g_31572
ptg000017l	17913519	17919378	5859	g_31572	g_25263
ptg000017l	17949723	18014042	64319	g_25263	g_1132
ptg000017l	18030924	18388486	357562	g_1132	g_15288
ptg000017l	18388692	18467589	78897	g_15288	g_26463
ptg000017l	18467822	18538701	70879	g_26463	g_2707
ptg000017l	18549349	18558275	8926	g_2707	g_17994
ptg000017l	18571592	18573275	1683	g_17994	g_34896
ptg000017l	18574024	18574206	182	g_34896	g_19472
ptg000017l	18574847	18581884	7037	g_19472	g_14206
ptg000017l	18582162	18584368	2206	g_14206	g_38749
ptg000017l	18584964	18620403	35439	g_38749	g_27930
ptg000017l	18620681	18630361	9680	g_27930	g_25247
ptg000017l	18642454	18657241	14787	g_25247	g_387
ptg000017l	18663517	18672085	8568	g_387	g_32933
ptg000017l	18676894	18681706	4812	g_32933	g_9926
ptg000017l	18699835	18754311	54476	g_9926	g_22136
ptg000017l	18775207	18781498	6291	g_22136	g_32134
ptg000017l	18794021	18800352	6331	g_32134	g_35917
ptg000017l	18819846	18830410	10564	g_35917	g_16957
ptg000017l	18848006	18851478	3472	g_16957	g_26316
ptg000017l	18864419	18870778	6359	g_26316	g_3108
ptg000017l	18879935	18883248	3313	g_3108	g_16362
ptg000017l	18904134	18931788	27654	g_16362	g_37745
ptg000017l	18934544	18938653	4109	g_37745	g_5071
ptg000017l	18947735	18968616	20881	g_5071	g_17772
ptg000017l	18993885	19005128	11243	g_17772	g_4857
ptg000017l	19026997	19069759	42762	g_4857	g_12635
ptg000017l	19079458	19088157	8699	g_12635	g_13269
ptg000017l	19106724	19106979	255	g_13269	g_34855
ptg000017l	19111179	19114239	3060	g_34855	g_32868
ptg000017l	19128479	19137323	8844	g_32868	g_16970
ptg000017l	19163446	19207503	44057	g_16970	g_5953
ptg000017l	19215760	19216280	520	g_5953	g_11779
ptg000017l	19222307	19234653	12346	g_11779	g_18291
ptg000017l	19238053	19278581	40528	g_18291	g_23436
ptg000017l	19282925	19290687	7762	g_23436	g_14168
ptg000017l	19291664	19293880	2216	g_14168	g_9109
ptg000017l	19299635	19300850	1215	g_9109	g_40066
ptg000017l	19308138	19316058	7920	g_40066	g_35261
ptg000017l	19321901	19325207	3306	g_35261	g_25239
ptg000017l	19332329	19335900	3571	g_25239	g_5971
ptg000017l	19346071	19347646	1575	g_5971	g_18237
ptg000017l	19348600	19355647	7047	g_18237	g_29947
ptg000017l	19357953	19361357	3404	g_29947	g_15835
ptg000017l	19362184	19375105	12921	g_15835	g_19249
ptg000017l	19382169	19412734	30565	g_19249	g_22761
ptg000017l	19424206	19433844	9638	g_22761	g_10804
ptg000017l	19443580	19447060	3480	g_10804	g_6417
ptg000017l	19453172	19455309	2137	g_6417	g_15645
ptg000017l	19459686	19462055	2369	g_15645	g_8245
ptg000017l	19465322	19473544	8222	g_8245	g_23870
ptg000017l	19489493	19527644	38151	g_23870	g_25445
ptg000017l	19570498	19576627	6129	g_25445	g_27252
ptg000017l	19593051	19602254	9203	g_27252	g_5306
ptg000017l	19606797	19634595	27798	g_5306	g_3260
ptg000017l	19643840	19649730	5890	g_3260	g_7405
ptg000017l	19655457	19728720	73263	g_7405	g_16477
ptg000017l	19729377	19731069	1692	g_16477	g_17738
ptg000017l	19732957	19735071	2114	g_17738	g_40175
ptg000017l	19740108	19748649	8541	g_40175	g_38007
ptg000017l	19750626	19754320	3694	g_38007	g_1725
ptg000017l	19772950	19776525	3575	g_1725	g_12010
ptg000017l	19777502	19794840	17338	g_12010	g_11796
ptg000017l	19800015	19802419	2404	g_11796	g_23273
ptg000017l	19815904	19849834	33930	g_23273	g_21026
ptg000017l	19855775	19859958	4183	g_21026	g_7276
ptg000017l	19862302	19921985	59683	g_7276	g_36680
ptg000017l	19922221	19958186	35965	g_36680	g_16385
ptg000017l	19961224	19965679	4455	g_16385	g_31084
ptg000017l	19974968	19976439	1471	g_31084	g_17009
ptg000017l	19978023	19979707	1684	g_17009	g_36853
ptg000017l	19981597	19984184	2587	g_36853	g_37718
ptg000017l	19986856	19989981	3125	g_37718	g_19426
ptg000017l	19997603	20028075	30472	g_19426	g_17397
ptg000017l	20028437	20091357	62920	g_17397	g_28625
ptg000017l	20091599	20148794	57195	g_28625	g_574
ptg000017l	20151298	20182876	31578	g_574	g_4106
ptg000017l	20183799	20189680	5881	g_4106	g_12968
ptg000017l	20196329	20211522	15193	g_12968	g_25289
ptg000017l	20222023	20393032	171009	g_25289	g_28076
ptg000017l	20393313	20396121	2808	g_28076	g_24920
ptg000017l	20396405	20497834	101429	g_24920	g_9600
ptg000017l	20498148	20509128	10980	g_9600	g_14063
ptg000017l	20510099	20573009	62910	g_14063	g_9995
ptg000017l	20588843	20602348	13505	g_9995	g_16874
ptg000017l	20619209	20657811	38602	g_16874	g_855
ptg000017l	20670097	20729340	59243	g_855	g_32434
ptg000017l	20730683	20731251	568	g_32434	g_30444
ptg000017l	20732012	20795740	63728	g_30444	g_39929
ptg000017l	20801036	20801963	927	g_39929	g_1499
ptg000017l	20817132	20885792	68660	g_1499	g_243
ptg000017l	20887093	20897619	10526	g_243	g_8216
ptg000017l	20907758	20910146	2388	g_8216	g_5215
ptg000017l	20914353	20925575	11222	g_5215	g_11161
ptg000017l	20927150	20927450	300	g_11161	g_40092
ptg000017l	20935566	20937643	2077	g_40092	g_20207
ptg000017l	20939493	20944321	4828	g_39078	g_1459
ptg000017l	20950666	20959945	9279	g_1459	g_36999
ptg000017l	20963450	20976147	12697	g_36999	g_19196
ptg000017l	20980380	21007794	27414	g_19196	g_6480
ptg000017l	21018405	21080904	62499	g_6480	g_26133
ptg000017l	21087066	21132171	45105	g_26133	g_9817
ptg000017l	21146370	21149591	3221	g_9817	g_17936
ptg000017l	21153650	21160292	6642	g_17936	g_5278
ptg000017l	21186251	21659051	472800	g_5278	g_11721
ptg000017l	21681812	21683678	1866	g_11721	g_15079
ptg000017l	21691980	21699569	7589	g_15079	g_5153
ptg000017l	21702003	21703933	1930	g_5153	g_1804
ptg000017l	21711038	21721214	10176	g_1804	g_29983
ptg000017l	21725810	21727487	1677	g_29983	g_23804
ptg000017l	21732234	21736428	4194	g_23804	g_40243
ptg000017l	21744188	21745826	1638	g_40243	g_8264
ptg000017l	21756621	21763111	6490	g_8264	g_14302
ptg000017l	21784253	21787980	3727	g_14302	g_23103
ptg000017l	21798852	21856158	57306	g_23103	g_16260
ptg000017l	21856430	21857699	1269	g_16260	g_1014
ptg000017l	21857929	21872847	14918	g_39552	g_7573
ptg000017l	21875960	21877892	1932	g_7573	g_1940
ptg000017l	21880310	21886440	6130	g_1940	g_4192
ptg000017l	21905546	21911358	5812	g_4192	g_33772
ptg000017l	21914152	21964771	50619	g_33772	g_17283
ptg000017l	21971139	21995101	23962	g_17283	g_24352
ptg000017l	21996763	21997899	1136	g_24352	g_34684
ptg000017l	22006542	22024392	17850	g_34684	g_20609
ptg000017l	22027773	22080102	52329	g_20609	g_36753
ptg000017l	22080875	22097043	16168	g_36753	g_9081
ptg000017l	22102688	22104291	1603	g_9081	g_23371
ptg000017l	22112742	22117459	4717	g_23371	g_30971
ptg000017l	22125336	22138285	12949	g_30971	g_36239
ptg000017l	22166574	22207491	40917	g_36239	g_29936
ptg000017l	22212061	22214226	2165	g_29936	g_15581
ptg000017l	22220728	22244313	23585	g_15581	g_18883
ptg000017l	22250390	22288152	37762	g_18883	g_581
ptg000017l	22289663	22289812	149	g_581	g_39910
ptg000017l	22298251	22305398	7147	g_39910	g_3162
ptg000017l	22326238	22366875	40637	g_3162	g_24470
ptg000017l	22386434	22388685	2251	g_24470	g_19835
ptg000017l	22399393	22408675	9282	g_19835	g_14945
ptg000017l	22411477	22414103	2626	g_14945	g_24090
ptg000017l	22415662	22420218	4556	g_24090	g_26122
ptg000017l	22422904	22424097	1193	g_26122	g_40204
ptg000017l	22432933	22434958	2025	g_40204	g_19785
ptg000017l	22436808	22438477	1669	g_19785	g_14007
ptg000017l	22440100	22441487	1387	g_14007	g_28748
ptg000017l	22446091	22455020	8929	g_28748	g_31456
ptg000017l	22472540	22512966	40426	g_31456	g_24108
ptg000017l	22523585	22643812	120227	g_24108	g_26389
ptg000017l	22662056	22667770	5714	g_26389	g_8232
ptg000017l	22674616	22685089	10473	g_8232	g_7633
ptg000017l	22691495	22709536	18041	g_7633	g_31334
ptg000017l	22709871	22714139	4268	g_31334	g_38301
ptg000017l	22717326	22726135	8809	g_38301	g_4672
ptg000017l	22740234	22742712	2478	g_4672	g_23374
ptg000017l	22752205	22983267	231062	g_23374	g_24799
ptg000017l	23003703	23270660	266957	g_24799	g_12649
ptg000017l	23288329	23298620	10291	g_12649	g_67
ptg000017l	23312188	23344441	32253	g_67	g_11473
ptg000017l	23344977	23361573	16596	g_11473	g_10961
ptg000017l	23362109	23373563	11454	g_10961	g_18725
ptg000017l	23375565	23377924	2359	g_18725	g_37148
ptg000017l	23379902	23394788	14886	g_37148	g_17647
ptg000017l	23399393	23416615	17222	g_17647	g_17039
ptg000017l	23417355	23434592	17237	g_17039	g_11389
ptg000017l	23447102	23457754	10652	g_11389	g_22862
ptg000017l	23472457	23892223	419766	g_22862	g_30622
ptg000017l	23896878	23902624	5746	g_30622	g_27093
ptg000017l	23903901	23908299	4398	g_27093	g_25178
ptg000017l	23917000	23919533	2533	g_25178	g_413
ptg000017l	23920558	23921300	742	g_413	g_40091
ptg000017l	23922388	23926588	4200	g_40091	g_10976
ptg000017l	23943741	24015054	71313	g_10976	g_14986
ptg000017l	24016751	24127765	111014	g_14986	g_7627
ptg000017l	24128502	24130806	2304	g_7627	g_22610
ptg000017l	24137353	24150523	13170	g_22610	g_35524
ptg000017l	24150774	24177183	26409	g_35524	g_34286
ptg000017l	24192425	24207921	15496	g_34286	g_7984
ptg000017l	24211593	24308629	97036	g_7984	g_25733
ptg000017l	24313765	24316420	2655	g_25733	g_10052
ptg000017l	24320475	24334757	14282	g_10052	g_28667
ptg000017l	24341306	24347381	6075	g_28667	g_40128
ptg000017l	24356117	24357791	1674	g_40128	g_13750
ptg000017l	24357997	24365216	7219	g_13750	g_39903
ptg000017l	24369029	24383330	14301	g_39903	g_284
ptg000017l	24383815	24507330	123515	g_284	g_17139
ptg000017l	24526443	24531238	4795	g_17139	g_20984
ptg000017l	24539053	24562230	23177	g_20984	g_40081
ptg000017l	24566147	24570107	3960	g_40081	g_10152
ptg000017l	24594883	24607322	12439	g_10152	g_4018
ptg000017l	24608491	24624590	16099	g_4018	g_11158
ptg000017l	24632446	24633900	1454	g_11158	g_23406
ptg000017l	24637052	24638604	1552	g_23406	g_21184
ptg000017l	24643813	24648344	4531	g_21184	g_10196
ptg000017l	24657224	24731452	74228	g_10196	g_30770
ptg000017l	24749676	24786701	37025	g_30770	g_3339
ptg000017l	24810457	24824667	14210	g_3339	g_7331
ptg000017l	24828574	24848704	20130	g_7331	g_15471
ptg000017l	24866695	24935168	68473	g_15471	g_33896
ptg000017l	24937509	24943885	6376	g_33896	g_3253
ptg000017l	24954479	25055403	100924	g_3253	g_25232
ptg000017l	25057929	25060980	3051	g_25232	g_27632
ptg000017l	25079234	25113908	34674	g_27632	g_8974
ptg000017l	25119685	25125029	5344	g_8974	g_20031
ptg000017l	25125247	25131470	6223	g_20031	g_1335
ptg000017l	25131772	25147562	15790	g_1335	g_36984
ptg000017l	25147819	25230815	82996	g_36984	g_19831
ptg000017l	25232326	25297028	64702	g_19831	g_1245
ptg000017l	25297246	25317418	20172	g_1245	g_25775
ptg000017l	25383935	25386633	2698	g_25775	g_15995
ptg000017l	25403625	25499946	96321	g_15995	g_37551
ptg000017l	25505581	25510935	5354	g_37551	g_26940
ptg000017l	25511138	25513066	1928	g_26940	g_23017
ptg000017l	25513410	25518761	5351	g_23017	g_26957
ptg000017l	25531771	25773675	241904	g_26957	g_137
ptg000017l	25777593	25820729	43136	g_137	g_33687
ptg000017l	25824883	25889652	64769	g_33687	g_9236
ptg000017l	25889885	25928122	38237	g_9236	g_27397
ptg000017l	25928616	25975343	46727	g_27397	g_1552
ptg000017l	25975570	25980717	5147	g_1552	g_4657
ptg000017l	25993298	26013472	20174	g_4657	g_16584
ptg000017l	26018915	26023536	4621	g_16584	g_16399
ptg000017l	26030972	26039027	8055	g_16399	g_2896
ptg000017l	26040783	26043148	2365	g_2896	g_36532
ptg000017l	26049508	26053464	3956	g_36532	g_15519
ptg000017l	26054303	26056327	2024	g_15519	g_13016
ptg000017l	26057142	26060570	3428	g_13016	g_17668
ptg000017l	26061382	26063812	2430	g_17668	g_23525
ptg000017l	26065389	26081751	16362	g_23525	g_557
ptg000017l	26091010	26111492	20482	g_557	g_4466
ptg000017l	26112196	26190126	77930	g_4466	g_39790
ptg000017l	26190932	26236432	45500	g_39790	g_18632
ptg000017l	26239765	26241142	1377	g_18632	g_6733
ptg000017l	26249381	26255461	6080	g_6733	g_30950
ptg000017l	26256958	26259398	2440	g_30950	g_18944
ptg000017l	26262197	26265517	3320	g_18944	g_23585
ptg000017l	26268514	26284008	15494	g_23585	g_17053
ptg000017l	26288179	26289860	1681	g_17053	g_10391
ptg000017l	26303601	26311630	8029	g_10391	g_21403
ptg000017l	26334764	26380399	45635	g_21403	g_14110
ptg000017l	26390944	26437168	46224	g_14110	g_37694
ptg000017l	26437416	26489410	51994	g_37694	g_22498
ptg000017l	26506707	26530041	23334	g_22498	g_25628
ptg000017l	26530259	26552136	21877	g_25628	g_31226
ptg000017l	26552546	26555516	2970	g_31226	g_21716
ptg000017l	26555903	26597554	41651	g_21716	g_19953
ptg000017l	26605133	26628521	23388	g_19953	g_7409
ptg000017l	26657797	26676959	19162	g_7409	g_14143
ptg000017l	26700098	26709136	9038	g_14143	g_10825
ptg000017l	26720201	26723241	3040	g_10825	g_1594
ptg000017l	26737440	26785283	47843	g_1594	g_28409
ptg000017l	26789262	26926881	137619	g_28409	g_3714
ptg000017l	26929793	26974633	44840	g_3714	g_1139
ptg000017l	26974953	27123417	148464	g_1139	g_34837
ptg000017l	27125285	27257667	132382	g_34837	g_39545
ptg000017l	27258059	27349026	90967	g_39545	g_8399
ptg000017l	27355037	27383014	27977	g_8399	g_19786
ptg000017l	27435923	27627836	191913	g_19786	g_21159
ptg000017l	27646055	27857677	211622	g_21159	g_17022
ptg000017l	27858030	27890528	32498	g_17022	g_3987
ptg000017l	27895182	27922165	26983	g_3987	g_3678
ptg000017l	27922365	27987467	65102	g_3678	g_1471
ptg000017l	28010155	28013524	3369	g_1471	g_22662
ptg000017l	28020777	28046459	25682	g_22662	g_9306
ptg000017l	28046731	28049042	2311	g_9306	g_16
ptg000017l	28052266	28307325	255059	g_16	g_4812
ptg000017l	28307855	28342472	34617	g_4812	g_7546
ptg000017l	28348207	28349640	1433	g_7546	g_6608
ptg000017l	28350512	28356577	6065	g_6608	g_21822
ptg000017l	28357452	28388440	30988	g_21822	g_8806
ptg000017l	28390518	28400862	10344	g_8806	g_22549
ptg000017l	28401431	28401970	539	g_22549	g_28694
ptg000017l	28402683	28406624	3941	g_28694	g_31944
ptg000017l	28427282	28429047	1765	g_31944	g_3148
ptg000017l	28436768	28569513	132745	g_3148	g_29443
ptg000017l	28587342	28591653	4311	g_29443	g_6256
ptg000017l	28620044	28949975	329931	g_6256	g_10098
ptg000017l	28950526	29046813	96287	g_10098	g_27090
ptg000017l	29047163	29157967	110804	g_27090	g_37515
ptg000017l	29167704	29175946	8242	g_37515	g_4602
ptg000017l	29213810	29236355	22545	g_4602	g_23015
ptg000017l	29247351	29299478	52127	g_23015	g_6272
ptg000017l	29300933	29304898	3965	g_6272	g_11184
ptg000017l	29307842	29319754	11912	g_11184	g_16141
ptg000017l	29338139	29416914	78775	g_16141	g_39190
ptg000017l	29418176	29429649	11473	g_39190	g_11797
ptg000017l	29429852	29524576	94724	g_11797	g_33334
ptg000017l	29524800	29684499	159699	g_33334	g_23041
ptg000017l	29686128	29690779	4651	g_23041	g_26452
ptg000017l	29691492	29821702	130210	g_26452	g_2315
ptg000017l	29821989	29879855	57866	g_2315	g_17958
ptg000017l	29899504	29904827	5323	g_17958	g_13614
ptg000017l	29918855	29932430	13575	g_13614	g_31846
ptg000017l	29940754	30011950	71196	g_31846	g_40179
ptg000017l	30014686	30017576	2890	g_40179	g_18018
ptg000017l	30018082	30029310	11228	g_18018	g_449
ptg000017l	30029711	30109125	79414	g_449	g_31046
ptg000017l	30111630	30117881	6251	g_31046	g_13383
ptg000017l	30136615	30139726	3111	g_13383	g_13217
ptg000017l	30143239	30569607	426368	g_13217	g_22707
ptg000017l	30570185	31061805	491620	g_22707	g_16842
ptg000017l	31062032	31102206	40174	g_16842	g_3121
ptg000017l	31102799	31111573	8774	g_3121	g_2022
ptg000017l	31139373	31157575	18202	g_2022	g_9768
ptg000017l	31171428	31233114	61686	g_9768	g_5146
ptg000017l	31241873	31246081	4208	g_5146	g_6004
ptg000017l	31255865	31263546	7681	g_6004	g_4519
ptg000017l	31263896	31264666	770	g_4519	g_35392
ptg000017l	31274824	31340826	66002	g_35392	g_532
ptg000017l	31353089	31359800	6711	g_532	g_5734
ptg000017l	31363364	31409418	46054	g_5734	g_34483
ptg000017l	31412982	31449259	36277	g_34483	g_27352
ptg000017l	31451538	31597283	145745	g_27352	g_34683
ptg000017l	31608814	31616228	7414	g_34683	g_24319
ptg000017l	31638390	31855015	216625	g_24319	g_2053
ptg000017l	31855314	31972751	117437	g_2053	g_36015
ptg000017l	31973500	31983545	10045	g_36015	g_33663
ptg000017l	31983922	31983941	19	g_33663	g_21597
ptg000017l	31984807	32132490	147683	g_21597	g_4060
ptg000017l	32137453	32208798	71345	g_4060	g_27830
ptg000017l	32215380	32478495	263115	g_27830	g_33864
ptg000017l	32501014	32584541	83527	g_33864	g_22157
ptg000017l	32584963	32667567	82604	g_22157	g_14787
ptg000017l	32668169	32721029	52860	g_14787	g_26237
ptg000017l	32726030	32727798	1768	g_26237	g_22402
ptg000017l	32728334	32846500	118166	g_22402	g_34889
ptg000017l	32846802	32978019	131217	g_34889	g_18382
ptg000017l	32978321	32988399	10078	g_18382	g_6625
ptg000017l	32989067	33096130	107063	g_6625	g_34274
ptg000017l	33097314	33136557	39243	g_34274	g_28113
ptg000017l	33136766	33245786	109020	g_28113	g_29007
ptg000017l	33246832	33308280	61448	g_29007	g_29541
ptg000017l	33328894	33337455	8561	g_29541	g_14832
ptg000017l	33337997	33401856	63859	g_14832	g_371
ptg000017l	33403644	33437871	34227	g_371	g_31733
ptg000017l	33438689	33507326	68637	g_31733	g_16491
ptg000017l	33508447	33517417	8970	g_16491	g_20724
ptg000018l	34372	61769	27397	g_23230	g_22059
ptg000018l	62695	158398	95703	g_22059	g_15681
ptg000018l	158649	159193	544	g_15681	g_37246
ptg000018l	159609	189657	30048	g_37246	g_9965
ptg000018l	207964	251147	43183	g_9965	g_24234
ptg000018l	251389	252670	1281	g_24234	g_27165
ptg000018l	253539	270655	17116	g_27165	g_17818
ptg000018l	272874	280044	7170	g_17818	g_14025
ptg000018l	280874	287018	6144	g_14025	g_15615
ptg000018l	295985	396868	100883	g_15615	g_33408
ptg000018l	397527	406352	8825	g_33408	g_5627
ptg000018l	413915	422647	8732	g_5627	g_31807
ptg000018l	431830	433990	2160	g_31807	g_32152
ptg000018l	446933	452617	5684	g_32152	g_38272
ptg000018l	461733	464560	2827	g_38272	g_455
ptg000018l	466332	468290	1958	g_455	g_10405
ptg000018l	477600	481488	3888	g_10405	g_28382
ptg000018l	497499	515642	18143	g_28382	g_1413
ptg000018l	522206	538037	15831	g_1413	g_12231
ptg000018l	540536	544654	4118	g_12231	g_11457
ptg000018l	570942	585750	14808	g_36993	g_521
ptg000018l	595747	600958	5211	g_521	g_28881
ptg000018l	619015	620802	1787	g_28881	g_24200
ptg000018l	625090	643947	18857	g_24200	g_8757
ptg000018l	645844	652676	6832	g_8757	g_27256
ptg000018l	655455	669192	13737	g_27256	g_35669
ptg000018l	685625	687764	2139	g_35669	g_21493
ptg000018l	697451	714732	17281	g_21493	g_24356
ptg000018l	716906	724754	7848	g_24356	g_29647
ptg000018l	725739	736386	10647	g_29647	g_17831
ptg000018l	755440	758159	2719	g_17831	g_21214
ptg000018l	775365	777608	2243	g_21214	g_23738
ptg000018l	798712	824074	25362	g_23738	g_12057
ptg000018l	829307	836625	7318	g_12057	g_19263
ptg000018l	843368	981861	138493	g_19263	g_712
ptg000018l	982715	992456	9741	g_712	g_18340
ptg000018l	1062134	1103916	41782	g_18340	g_39893
ptg000018l	1105379	1125053	19674	g_39893	g_6036
ptg000018l	1143590	1164019	20429	g_6036	g_31007
ptg000018l	1165068	1177335	12267	g_31007	g_30097
ptg000018l	1178087	1228230	50143	g_30097	g_8935
ptg000018l	1243571	1254181	10610	g_8935	g_10468
ptg000018l	1255206	1271015	15809	g_10468	g_10438
ptg000018l	1271902	1301863	29961	g_10438	g_6425
ptg000018l	1316076	1332235	16159	g_6425	g_5054
ptg000018l	1335423	1341737	6314	g_5054	g_25246
ptg000018l	1344808	1416070	71262	g_25246	g_11008
ptg000018l	1419246	1448087	28841	g_11008	g_36344
ptg000018l	1469714	1685988	216274	g_36344	g_36196
ptg000018l	1686308	1754724	68416	g_36196	g_14264
ptg000018l	1755287	1770695	15408	g_14264	g_32779
ptg000018l	1789590	1814783	25193	g_32779	g_14911
ptg000018l	1825625	1835169	9544	g_14911	g_33469
ptg000018l	1836293	1841513	5220	g_33469	g_31812
ptg000018l	1937803	2169024	231221	g_31812	g_5763
ptg000018l	2169266	2176344	7078	g_5763	g_6892
ptg000018l	2180369	2196832	16463	g_6892	g_12877
ptg000018l	2239339	2247901	8562	g_12877	g_14160
ptg000018l	2253314	2284809	31495	g_14160	g_24106
ptg000018l	2295315	2398755	103440	g_24106	g_14037
ptg000018l	2399450	2399557	107	g_14037	g_36220
ptg000018l	2400334	2629659	229325	g_33962	g_6757
ptg000018l	2630111	2821534	191423	g_6757	g_604
ptg000018l	2821893	2837224	15331	g_604	g_20910
ptg000018l	2841169	2871623	30454	g_20910	g_12036
ptg000018l	2873077	2876367	3290	g_12036	g_13670
ptg000018l	2876681	2880991	4310	g_13670	g_36868
ptg000018l	2881353	3021438	140085	g_36868	g_12866
ptg000018l	3026176	3037003	10827	g_12866	g_26975
ptg000018l	3039453	3056430	16977	g_26975	g_28724
ptg000018l	3081213	3136167	54954	g_28724	g_25924
ptg000018l	3137492	3167996	30504	g_25924	g_17248
ptg000018l	3177193	3179922	2729	g_17248	g_26210
ptg000018l	3184375	3187557	3182	g_26210	g_18493
ptg000018l	3190623	3289469	98846	g_18493	g_31974
ptg000018l	3289750	3335691	45941	g_31974	g_39771
ptg000018l	3337535	3384624	47089	g_39771	g_36235
ptg000018l	3386547	3425120	38573	g_36235	g_22141
ptg000018l	3426635	3428617	1982	g_22141	g_10731
ptg000018l	3435431	3448203	12772	g_10731	g_29403
ptg000018l	3466105	3482023	15918	g_29403	g_29468
ptg000018l	3482259	3483131	872	g_29468	g_3954
ptg000018l	3490740	3507404	16664	g_3954	g_22122
ptg000018l	3508162	3512764	4602	g_22122	g_15016
ptg000018l	3534509	3801037	266528	g_15016	g_20284
ptg000018l	3803973	3816203	12230	g_20284	g_31625
ptg000018l	3828242	3860280	32038	g_31625	g_20673
ptg000018l	3872805	3900246	27441	g_20673	g_28342
ptg000018l	3911908	3920617	8709	g_28342	g_18641
ptg000018l	3922707	3929894	7187	g_18641	g_9843
ptg000018l	3942704	3953788	11084	g_9843	g_17044
ptg000018l	3960670	3973169	12499	g_17044	g_13601
ptg000018l	3979071	3983105	4034	g_13601	g_5463
ptg000018l	3986088	3988087	1999	g_5463	g_18039
ptg000018l	3989192	3992590	3398	g_18039	g_18793
ptg000018l	3993896	4038318	44422	g_18793	g_13228
ptg000018l	4047843	4077959	30116	g_13228	g_23253
ptg000018l	4085880	4094587	8707	g_23253	g_35198
ptg000018l	4103327	4105831	2504	g_35198	g_34665
ptg000018l	4112100	4116896	4796	g_34665	g_20181
ptg000018l	4125491	4136515	11024	g_20181	g_37993
ptg000018l	4139662	4141770	2108	g_37993	g_29863
ptg000018l	4142492	4144910	2418	g_29863	g_30602
ptg000018l	4145602	4145666	64	g_30602	g_7408
ptg000018l	4146529	4155421	8892	g_7408	g_9285
ptg000018l	4158819	4179023	20204	g_9285	g_3940
ptg000018l	4181068	4250431	69363	g_3940	g_10705
ptg000018l	4255122	4258466	3344	g_10705	g_10094
ptg000018l	4268339	4271690	3351	g_10094	g_24139
ptg000018l	4279657	4345837	66180	g_24139	g_31354
ptg000018l	4346079	4401589	55510	g_31354	g_21080
ptg000018l	4416944	4419085	2141	g_21080	g_34529
ptg000018l	4422503	4436675	14172	g_34529	g_21798
ptg000018l	4444175	4567750	123575	g_21798	g_30672
ptg000018l	4582484	4586026	3542	g_30672	g_16535
ptg000018l	4589896	4676045	86149	g_16535	g_8686
ptg000018l	4686764	4689673	2909	g_8686	g_19826
ptg000018l	4701681	4777167	75486	g_19826	g_27617
ptg000018l	4778681	4782062	3381	g_27617	g_34762
ptg000018l	4783663	4787417	3754	g_34762	g_31326
ptg000018l	4788106	4795519	7413	g_31326	g_33683
ptg000018l	4803834	4805303	1469	g_33683	g_15226
ptg000018l	4805635	4807384	1749	g_15226	g_11350
ptg000018l	4811367	4830642	19275	g_11350	g_39489
ptg000018l	4832336	4863160	30824	g_39489	g_32705
ptg000018l	4870963	4877573	6610	g_32705	g_2762
ptg000018l	4893077	4893883	806	g_2762	g_28298
ptg000018l	4894368	4894550	182	g_28298	g_33759
ptg000018l	4895194	4918753	23559	g_33759	g_25580
ptg000018l	4926851	4928912	2061	g_25580	g_4626
ptg000018l	4945885	4947668	1783	g_4626	g_12284
ptg000018l	4955611	4978530	22919	g_12284	g_34121
ptg000018l	4978760	4979485	725	g_34121	g_37595
ptg000018l	4987003	5000378	13375	g_37595	g_23201
ptg000018l	5014406	5052479	38073	g_23201	g_20964
ptg000018l	5060224	5070165	9941	g_20964	g_11117
ptg000018l	5096181	5101015	4834	g_11117	g_29466
ptg000018l	5101386	5109221	7835	g_29466	g_36234
ptg000018l	5122843	5182555	59712	g_36234	g_20554
ptg000018l	5182839	5194589	11750	g_20554	g_140
ptg000018l	5194816	5224258	29442	g_140	g_29944
ptg000018l	5224749	5227540	2791	g_29944	g_7234
ptg000018l	5228922	5332015	103093	g_7234	g_34095
ptg000018l	5342069	5366861	24792	g_34095	g_22158
ptg000018l	5370973	5411537	40564	g_22158	g_18335
ptg000018l	5411878	5476037	64159	g_18335	g_35440
ptg000018l	5480235	5483567	3332	g_35440	g_23309
ptg000018l	5491124	5505893	14769	g_23309	g_15575
ptg000018l	5509873	5518154	8281	g_15575	g_31580
ptg000018l	5521986	5526441	4455	g_31580	g_24452
ptg000018l	5547218	5585328	38110	g_24452	g_31372
ptg000018l	5586524	5612930	26406	g_31372	g_10040
ptg000018l	5640174	5649716	9542	g_10040	g_10319
ptg000018l	5659912	5738368	78456	g_10319	g_17695
ptg000018l	5740689	5742220	1531	g_17695	g_8331
ptg000018l	5755463	5758343	2880	g_8331	g_29792
ptg000018l	5759825	5767405	7580	g_32141	g_37941
ptg000018l	5774052	5824731	50679	g_37941	g_28952
ptg000018l	5850903	5867550	16647	g_28952	g_31497
ptg000018l	5871813	5876313	4500	g_31497	g_34619
ptg000018l	5881179	5887204	6025	g_34619	g_14513
ptg000018l	5892486	5896693	4207	g_14513	g_32078
ptg000018l	5898248	5924082	25834	g_32078	g_23627
ptg000018l	5956615	5959812	3197	g_23627	g_22767
ptg000018l	5960327	6048856	88529	g_22767	g_17751
ptg000018l	6056174	6059805	3631	g_17751	g_28102
ptg000018l	6064617	6189985	125368	g_28102	g_10259
ptg000018l	6205957	6349227	143270	g_10259	g_9716
ptg000018l	6349517	6363103	13586	g_9716	g_17579
ptg000018l	6363510	6601896	238386	g_17579	g_6979
ptg000018l	6614911	6631216	16305	g_6979	g_9730
ptg000018l	6646007	6666572	20565	g_9730	g_31639
ptg000018l	6668737	6692405	23668	g_31639	g_31065
ptg000018l	6693835	6701213	7378	g_31065	g_8855
ptg000018l	6701575	6717828	16253	g_8855	g_25947
ptg000018l	6746367	6758912	12545	g_25947	g_12481
ptg000018l	6767669	6768708	1039	g_12481	g_23860
ptg000018l	6774606	6776196	1590	g_23860	g_30247
ptg000018l	6782475	6785392	2917	g_30247	g_18127
ptg000018l	6788920	6789989	1069	g_18127	g_18689
ptg000018l	6791083	6794404	3321	g_18689	g_4577
ptg000018l	6795384	6806127	10743	g_4577	g_10872
ptg000018l	6815871	6822945	7074	g_10872	g_10435
ptg000018l	6840808	6843457	2649	g_10435	g_403
ptg000018l	6847147	6857296	10149	g_403	g_10811
ptg000018l	6858635	6870714	12079	g_10811	g_5206
ptg000018l	6872006	6877680	5674	g_5206	g_10224
ptg000018l	6882013	6886669	4656	g_10224	g_1171
ptg000018l	6898129	6928491	30362	g_1171	g_4294
ptg000018l	6929104	6970518	41414	g_4294	g_33299
ptg000018l	6983067	6995836	12769	g_33299	g_27021
ptg000018l	6996069	6997528	1459	g_27021	g_5333
ptg000018l	7005367	7011365	5998	g_5333	g_7971
ptg000018l	7013676	7033303	19627	g_7971	g_40037
ptg000018l	7047437	7051405	3968	g_40037	g_40038
ptg000018l	7052643	7062248	9605	g_40038	g_8577
ptg000018l	7072073	7084413	12340	g_8577	g_1292
ptg000018l	7091147	7163555	72408	g_1292	g_34280
ptg000018l	7169024	7174914	5890	g_34280	g_19141
ptg000018l	7180154	7198886	18732	g_19141	g_153
ptg000018l	7202661	7212435	9774	g_153	g_27099
ptg000018l	7214062	7250721	36659	g_27099	g_40134
ptg000018l	7258671	7261293	2622	g_40134	g_14636
ptg000018l	7264107	7264294	187	g_14636	g_27278
ptg000018l	7266341	7269392	3051	g_27278	g_4689
ptg000018l	7271288	7278812	7524	g_4689	g_34421
ptg000018l	7284170	7302325	18155	g_34421	g_215
ptg000018l	7309049	7324880	15831	g_215	g_22528
ptg000018l	7328980	7331532	2552	g_22528	g_6542
ptg000018l	7335621	7337827	2206	g_6542	g_18326
ptg000018l	7339270	7342529	3259	g_18326	g_17398
ptg000018l	7344241	7346700	2459	g_17398	g_25994
ptg000018l	7350320	7381766	31446	g_25994	g_13015
ptg000018l	7391373	7395799	4426	g_13015	g_21035
ptg000018l	7400778	7403833	3055	g_21035	g_36411
ptg000018l	7407466	7410093	2627	g_36411	g_29768
ptg000018l	7412681	7423818	11137	g_29768	g_6186
ptg000018l	7446865	7475974	29109	g_6186	g_7554
ptg000018l	7486482	7502763	16281	g_7554	g_21598
ptg000018l	7509183	7582345	73162	g_21598	g_7398
ptg000018l	7594448	7620258	25810	g_7398	g_6222
ptg000018l	7644063	7657446	13383	g_6222	g_28606
ptg000018l	7657688	7705712	48024	g_28606	g_30700
ptg000018l	7706023	7734311	28288	g_30700	g_3807
ptg000018l	7755956	7772239	16283	g_3807	g_39452
ptg000018l	7772793	7782246	9453	g_39452	g_30522
ptg000018l	7782479	7802846	20367	g_30522	g_14678
ptg000018l	7822503	7861618	39115	g_14678	g_2569
ptg000018l	7868091	7875233	7142	g_2569	g_25138
ptg000018l	7887885	7948855	60970	g_25138	g_22224
ptg000018l	7974886	7989692	14806	g_22224	g_36685
ptg000018l	8020527	8342288	321761	g_36685	g_27370
ptg000018l	8342947	8343275	328	g_27370	g_20789
ptg000018l	8343670	8343925	255	g_20789	g_26030
ptg000018l	8344923	8493600	148677	g_26030	g_18068
ptg000018l	8494055	8615740	121685	g_18068	g_22734
ptg000018l	8617461	8619045	1584	g_22734	g_25300
ptg000018l	8620778	8773416	152638	g_25300	g_35578
ptg000018l	8790413	8791731	1318	g_35578	g_16425
ptg000018l	8794128	8797367	3239	g_16425	g_31249
ptg000018l	8802088	8804654	2566	g_31249	g_1571
ptg000018l	8806426	8909488	103062	g_1571	g_7983
ptg000018l	8919935	8930868	10933	g_7983	g_40039
ptg000018l	8937217	8951266	14049	g_40039	g_39121
ptg000018l	8951709	9088935	137226	g_39121	g_6471
ptg000018l	9089225	9138917	49692	g_6471	g_15781
ptg000018l	9157062	9158030	968	g_15781	g_30318
ptg000018l	9158350	9191531	33181	g_30318	g_10320
ptg000018l	9192331	9234826	42495	g_10320	g_15659
ptg000018l	9236283	9303289	67006	g_15659	g_31790
ptg000018l	9310550	9316119	5569	g_31790	g_15952
ptg000018l	9317673	9355498	37825	g_15952	g_37755
ptg000018l	9358573	9379589	21016	g_37755	g_28973
ptg000018l	9380020	9501605	121585	g_28973	g_18330
ptg000018l	9508081	9527632	19551	g_18330	g_9216
ptg000018l	9533373	9549274	15901	g_9216	g_23067
ptg000018l	9550863	9555355	4492	g_23067	g_17716
ptg000018l	9555732	9565383	9651	g_17716	g_28137
ptg000018l	9573847	9575446	1599	g_28137	g_4908
ptg000018l	9581107	9592540	11433	g_4908	g_25021
ptg000018l	9594469	9617462	22993	g_25021	g_15452
ptg000018l	9620002	9642826	22824	g_15452	g_18720
ptg000018l	9645512	9666829	21317	g_18720	g_1121
ptg000018l	9684452	9722722	38270	g_1121	g_10032
ptg000018l	9730036	9821167	91131	g_10032	g_3332
ptg000018l	9865482	9881085	15603	g_26746	g_19615
ptg000018l	9881516	10357346	475830	g_19615	g_17864
ptg000018l	10362763	10364706	1943	g_17864	g_28617
ptg000018l	10370304	10435761	65457	g_28617	g_14594
ptg000018l	10465203	10468440	3237	g_14594	g_17171
ptg000018l	10470854	10473210	2356	g_17171	g_35519
ptg000018l	10482061	10499097	17036	g_35519	g_29554
ptg000018l	10508350	10510784	2434	g_29554	g_14885
ptg000018l	10511887	10599268	87381	g_14885	g_31507
ptg000018l	10618707	10674454	55747	g_31507	g_24565
ptg000018l	10676304	10708298	31994	g_24565	g_17643
ptg000018l	10710598	10723422	12824	g_17643	g_28880
ptg000018l	10726958	10732694	5736	g_28880	g_16967
ptg000018l	10754593	10759281	4688	g_16967	g_29071
ptg000018l	10761987	10764786	2799	g_29071	g_339
ptg000018l	10767559	10780797	13238	g_339	g_9206
ptg000018l	10781408	10795864	14456	g_9206	g_20647
ptg000018l	10799476	10825058	25582	g_20647	g_8596
ptg000018l	10830860	10880622	49762	g_8596	g_6879
ptg000018l	10881170	10944259	63089	g_6879	g_12791
ptg000018l	10955721	10971196	15475	g_12791	g_34229
ptg000018l	10982859	10987940	5081	g_34229	g_23600
ptg000018l	11019469	11033474	14005	g_23600	g_19975
ptg000018l	11033941	11051604	17663	g_19975	g_27725
ptg000018l	11060272	11074259	13987	g_27725	g_19027
ptg000018l	11086493	11125663	39170	g_19027	g_4465
ptg000018l	11140574	11153547	12973	g_4465	g_25763
ptg000018l	11172782	11187068	14286	g_25763	g_9705
ptg000018l	11221542	11296204	74662	g_9705	g_37818
ptg000018l	11298329	11301027	2698	g_37818	g_4007
ptg000018l	11340157	11344170	4013	g_4007	g_18370
ptg000018l	11368107	11382849	14742	g_18370	g_4388
ptg000018l	11386426	11528312	141886	g_4388	g_1917
ptg000018l	11529658	11542103	12445	g_1917	g_28820
ptg000018l	11570536	11610900	40364	g_28820	g_29337
ptg000018l	11626609	11653689	27080	g_29337	g_21244
ptg000018l	11654738	11682211	27473	g_21244	g_29832
ptg000018l	11704484	12022837	318353	g_29832	g_10005
ptg000018l	12028789	12034318	5529	g_10005	g_36991
ptg000018l	12053645	12064016	10371	g_36991	g_14386
ptg000018l	12065449	12072666	7217	g_14386	g_19538
ptg000018l	12081571	12107058	25487	g_19538	g_26612
ptg000018l	12120654	12141838	21184	g_26612	g_28215
ptg000018l	12155898	12158751	2853	g_28215	g_3181
ptg000018l	12168256	12172136	3880	g_3181	g_30623
ptg000018l	12177187	12178106	919	g_30623	g_10299
ptg000018l	12185023	12240533	55510	g_10299	g_19098
ptg000018l	12241672	12284032	42360	g_19098	g_16589
ptg000018l	12285541	12448007	162466	g_16589	g_35872
ptg000018l	12449248	12477555	28307	g_35872	g_11435
ptg000018l	12480743	12494914	14171	g_11435	g_5213
ptg000018l	12495747	12682011	186264	g_5213	g_6964
ptg000018l	12683546	12704012	20466	g_6964	g_4652
ptg000018l	12719686	12724579	4893	g_4652	g_3399
ptg000018l	12737614	12743669	6055	g_3399	g_39964
ptg000018l	12745102	12757058	11956	g_39964	g_32272
ptg000018l	12778716	12801950	23234	g_32272	g_35414
ptg000018l	12803341	12813008	9667	g_35414	g_1867
ptg000018l	12813772	13039461	225689	g_1867	g_18469
ptg000018l	13063742	13112779	49037	g_18469	g_28544
ptg000018l	13113204	13151417	38213	g_28544	g_15539
ptg000018l	13152992	13169073	16081	g_15539	g_21501
ptg000018l	13178574	13194614	16040	g_21501	g_18754
ptg000018l	13198382	13200230	1848	g_18754	g_30513
ptg000018l	13203399	13218534	15135	g_30513	g_19548
ptg000018l	13224587	13229996	5409	g_19548	g_38066
ptg000018l	13232530	13235179	2649	g_38066	g_25839
ptg000018l	13238793	13243598	4805	g_25839	g_38702
ptg000018l	13263476	13270725	7249	g_30898	g_125
ptg000018l	13273885	13277194	3309	g_125	g_19468
ptg000018l	13279943	13281031	1088	g_19468	g_21287
ptg000018l	13294944	13298206	3262	g_21287	g_21839
ptg000018l	13301726	13348127	46401	g_21839	g_36103
ptg000018l	13349112	13350809	1697	g_36103	g_4905
ptg000018l	13362054	13366734	4680	g_4905	g_4942
ptg000018l	13384822	13420872	36050	g_4942	g_430
ptg000018l	13421138	13421487	349	g_430	g_19347
ptg000018l	13430740	13434073	3333	g_19347	g_26433
ptg000018l	13452366	13518049	65683	g_26433	g_8799
ptg000018l	13525567	13545970	20403	g_8799	g_17628
ptg000018l	13555196	13566418	11222	g_17628	g_4029
ptg000018l	13569971	13581280	11309	g_4029	g_9271
ptg000018l	13585749	13591348	5599	g_9271	g_5175
ptg000018l	13592034	13592271	237	g_5175	g_39993
ptg000018l	13607313	13641591	34278	g_39993	g_19694
ptg000018l	13667525	13703348	35823	g_19694	g_6941
ptg000018l	13706311	13734533	28222	g_6941	g_17172
ptg000018l	13737857	13739109	1252	g_17172	g_3864
ptg000018l	13740470	13744535	4065	g_3864	g_31744
ptg000018l	13749320	13751000	1680	g_31744	g_23325
ptg000018l	13754767	13764798	10031	g_23325	g_1709
ptg000018l	13774804	13789606	14802	g_1709	g_40126
ptg000018l	13796409	13797704	1295	g_40126	g_13653
ptg000018l	13811764	13827397	15633	g_13653	g_25439
ptg000018l	13829046	13834634	5588	g_25439	g_12213
ptg000018l	13835892	13841178	5286	g_12213	g_40107
ptg000018l	13842133	13843483	1350	g_40107	g_38065
ptg000018l	13848019	13854022	6003	g_38065	g_35551
ptg000018l	13855285	13860462	5177	g_35551	g_28440
ptg000018l	13861814	13866548	4734	g_28440	g_28413
ptg000018l	13871608	13880093	8485	g_28413	g_38292
ptg000018l	13886675	13897732	11057	g_38292	g_21684
ptg000018l	13901490	13904853	3363	g_21684	g_10970
ptg000018l	13912422	13914880	2458	g_10970	g_24456
ptg000018l	13916060	13931545	15485	g_24456	g_17918
ptg000018l	13932646	13934459	1813	g_17918	g_33459
ptg000018l	13941968	13963218	21250	g_33459	g_6652
ptg000018l	13973532	13975440	1908	g_6652	g_34828
ptg000018l	13978657	13979334	677	g_34828	g_30227
ptg000018l	13984440	13985814	1374	g_30227	g_28147
ptg000018l	13989885	13991183	1298	g_28147	g_3008
ptg000018l	13993353	13999062	5709	g_3008	g_24778
ptg000018l	14010557	14019726	9169	g_24778	g_25304
ptg000018l	14026285	14033890	7605	g_25304	g_8580
ptg000018l	14047006	14050508	3502	g_8580	g_2007
ptg000018l	14056073	14057819	1746	g_2007	g_18751
ptg000018l	14067259	14118138	50879	g_18751	g_12097
ptg000018l	14119116	14119908	792	g_12097	g_21079
ptg000018l	14124505	14127333	2828	g_21079	g_32436
ptg000018l	14134255	14135782	1527	g_32436	g_7478
ptg000018l	14139645	14142224	2579	g_7478	g_22437
ptg000018l	14146702	14148973	2271	g_22437	g_12289
ptg000018l	14153264	14160062	6798	g_12289	g_38149
ptg000018l	14160712	14164424	3712	g_38149	g_21565
ptg000018l	14165095	14171460	6365	g_21565	g_33843
ptg000018l	14172104	14173668	1564	g_33843	g_25926
ptg000018l	14174306	14176254	1948	g_25926	g_3525
ptg000018l	14176889	14180045	3156	g_3525	g_26501
ptg000018l	14181634	14187051	5417	g_26501	g_5911
ptg000018l	14187674	14188597	923	g_5911	g_29635
ptg000018l	14189244	14190204	960	g_29635	g_21261
ptg000018l	14190836	14191907	1071	g_21261	g_19952
ptg000018l	14192404	14193364	960	g_19952	g_34013
ptg000018l	14193996	14194983	987	g_34013	g_25379
ptg000018l	14195615	14196753	1138	g_25379	g_27250
ptg000018l	14197310	14201642	4332	g_27250	g_11217
ptg000018l	14202274	14204259	1985	g_11217	g_24632
ptg000018l	14205221	14209362	4141	g_24632	g_8919
ptg000018l	14211044	14213288	2244	g_8919	g_39919
ptg000018l	14224724	14227467	2743	g_39919	g_1124
ptg000018l	14227793	14252540	24747	g_1124	g_28501
ptg000018l	14252884	14253549	665	g_28501	g_14248
ptg000018l	14273106	14278597	5491	g_14248	g_15556
ptg000018l	14281344	14283847	2503	g_15556	g_28816
ptg000018l	14299034	14301513	2479	g_28816	g_14360
ptg000018l	14306791	14308710	1919	g_14360	g_9891
ptg000018l	14308952	14310122	1170	g_9891	g_30579
ptg000018l	14313559	14318956	5397	g_30579	g_17870
ptg000018l	14321640	14341976	20336	g_17870	g_2657
ptg000018l	14345441	14357455	12014	g_2657	g_9691
ptg000018l	14366871	14372916	6045	g_9691	g_32055
ptg000018l	14383714	14385827	2113	g_32055	g_15639
ptg000018l	14386983	14391854	4871	g_15639	g_31288
ptg000018l	14398777	14403915	5138	g_31288	g_31348
ptg000018l	14409962	14412064	2102	g_31348	g_14097
ptg000018l	14413506	14416212	2706	g_14097	g_32573
ptg000018l	14416904	14420549	3645	g_32573	g_5452
ptg000018l	14430321	14441029	10708	g_5452	g_15521
ptg000018l	14451923	14468328	16405	g_15521	g_18600
ptg000018l	14469582	14517509	47927	g_18600	g_31741
ptg000018l	14518123	14627183	109060	g_31741	g_34107
ptg000018l	14657929	14659723	1794	g_34107	g_15028
ptg000018l	14664772	14678202	13430	g_15028	g_25496
ptg000018l	14679272	14707370	28098	g_25496	g_29573
ptg000018l	14707852	14708034	182	g_29573	g_1307
ptg000018l	14708852	14720155	11303	g_1307	g_30886
ptg000018l	14720406	14785545	65139	g_30886	g_2327
ptg000018l	14789573	14834006	44433	g_2327	g_20043
ptg000018l	14835138	14842112	6974	g_20043	g_22496
ptg000018l	14853681	14856506	2825	g_22496	g_30702
ptg000018l	14859766	14887772	28006	g_30702	g_1293
ptg000018l	14888706	14943418	54712	g_1293	g_15114
ptg000018l	14944719	14948489	3770	g_15114	g_9655
ptg000018l	14964894	14981624	16730	g_9655	g_43
ptg000018l	15025796	15028851	3055	g_43	g_9267
ptg000018l	15030385	15040411	10026	g_9267	g_30472
ptg000018l	15064192	15069409	5217	g_30472	g_14570
ptg000018l	15078249	15079281	1032	g_14570	g_35591
ptg000018l	15081979	15113711	31732	g_35591	g_12685
ptg000018l	15129566	15143705	14139	g_12685	g_3056
ptg000018l	15144037	15169528	25491	g_3056	g_558
ptg000018l	15229524	15232729	3205	g_558	g_322
ptg000018l	15233070	15257327	24257	g_322	g_40041
ptg000018l	15265724	15266774	1050	g_40041	g_8313
ptg000018l	15270142	15323938	53796	g_8313	g_6555
ptg000018l	15325349	15327378	2029	g_6555	g_4240
ptg000018l	15331344	15337214	5870	g_4240	g_32927
ptg000018l	15341140	15342033	893	g_32927	g_6516
ptg000018l	15345199	15346083	884	g_6516	g_21542
ptg000018l	15362197	15419393	57196	g_21542	g_19259
ptg000018l	15436830	15441688	4858	g_19259	g_33361
ptg000018l	15461236	15578031	116795	g_33361	g_14862
ptg000018l	15582972	15587986	5014	g_14862	g_22341
ptg000018l	15598682	15616394	17712	g_22341	g_3254
ptg000018l	15621776	15627363	5587	g_3254	g_19710
ptg000018l	15636838	15661716	24878	g_19710	g_24389
ptg000018l	15662114	15682078	19964	g_24389	g_34857
ptg000018l	15704625	15786246	81621	g_34857	g_27682
ptg000018l	15800268	15805777	5509	g_27682	g_7898
ptg000018l	15851024	15852715	1691	g_7898	g_33319
ptg000018l	15857712	15863718	6006	g_33319	g_4476
ptg000018l	15869974	15871931	1957	g_4476	g_3310
ptg000018l	15880298	15890968	10670	g_3310	g_16852
ptg000018l	15898683	15911291	12608	g_16852	g_1366
ptg000018l	15925256	15930101	4845	g_1366	g_34347
ptg000018l	15930661	15930781	120	g_34347	g_4616
ptg000018l	15931893	15936149	4256	g_4616	g_20336
ptg000018l	15939309	15942003	2694	g_20336	g_37481
ptg000018l	15948249	15949970	1721	g_37481	g_29335
ptg000018l	15954519	15956892	2373	g_29335	g_15596
ptg000018l	15961967	15973658	11691	g_15596	g_29252
ptg000018l	15973984	15998298	24314	g_29252	g_34452
ptg000018l	16003711	16006350	2639	g_34452	g_9860
ptg000018l	16009777	16011305	1528	g_9860	g_35213
ptg000018l	16012355	16013520	1165	g_35213	g_6287
ptg000018l	16013858	16015844	1986	g_6287	g_23727
ptg000018l	16019911	16030454	10543	g_23727	g_10622
ptg000018l	16034370	16038182	3812	g_10622	g_4392
ptg000018l	16042906	16045144	2238	g_4392	g_18388
ptg000018l	16048819	16082112	33293	g_18388	g_37848
ptg000018l	16082949	16090204	7255	g_37848	g_4868
ptg000018l	16099890	16106045	6155	g_4868	g_2621
ptg000018l	16113271	16117396	4125	g_2621	g_22840
ptg000018l	16121497	16133053	11556	g_22840	g_6072
ptg000018l	16140518	16145156	4638	g_6072	g_14524
ptg000018l	16151303	16154623	3320	g_14524	g_19434
ptg000018l	16159167	16222456	63289	g_19434	g_28549
ptg000018l	16222899	16228220	5321	g_28549	g_24996
ptg000018l	16230200	16243760	13560	g_24996	g_27695
ptg000018l	16247282	16323903	76621	g_27695	g_19212
ptg000018l	16341394	16373166	31772	g_19212	g_14893
ptg000018l	16391313	16402939	11626	g_14893	g_21140
ptg000018l	16403232	16407982	4750	g_21140	g_4171
ptg000018l	16423376	16429007	5631	g_4171	g_9288
ptg000018l	16430349	16444305	13956	g_9288	g_30494
ptg000018l	16450041	16451632	1591	g_30494	g_20985
ptg000018l	16455404	16470819	15415	g_20985	g_21372
ptg000018l	16471109	16502589	31480	g_21372	g_11047
ptg000018l	16515075	16519094	4019	g_11047	g_8178
ptg000018l	16529156	16539163	10007	g_8178	g_12494
ptg000018l	16557177	16572145	14968	g_12494	g_16798
ptg000018l	16579013	16600170	21157	g_16798	g_28682
ptg000018l	16621517	16628249	6732	g_28682	g_1642
ptg000018l	16628545	16633867	5322	g_1642	g_22427
ptg000018l	16642426	16643634	1208	g_22427	g_7967
ptg000018l	16653920	16676747	22827	g_7967	g_26150
ptg000018l	16688863	16691871	3008	g_20597	g_39860
ptg000018l	16692323	16703554	11231	g_39860	g_25362
ptg000018l	16704291	16709509	5218	g_25362	g_37792
ptg000018l	16711381	16731219	19838	g_37792	g_21764
ptg000018l	16749185	16821376	72191	g_21764	g_1968
ptg000018l	16829774	16832453	2679	g_1968	g_18322
ptg000018l	16836162	16840454	4292	g_18322	g_27157
ptg000018l	16847728	16973650	125922	g_27157	g_37349
ptg000018l	16974575	16976116	1541	g_37349	g_8530
ptg000018l	16976860	16978365	1505	g_8530	g_36255
ptg000018l	16982643	16984679	2036	g_36255	g_11090
ptg000018l	16986826	16988143	1317	g_11090	g_35662
ptg000018l	16991049	16993002	1953	g_35662	g_17027
ptg000018l	16999623	17010523	10900	g_17027	g_30244
ptg000018l	17020232	17023203	2971	g_30244	g_13611
ptg000018l	17028096	17042949	14853	g_13611	g_20051
ptg000018l	17049823	17070041	20218	g_20051	g_25116
ptg000018l	17071416	17075237	3821	g_25116	g_3822
ptg000018l	17075974	17081469	5495	g_3822	g_26987
ptg000018l	17098398	17099420	1022	g_26987	g_10969
ptg000018l	17108955	17111595	2640	g_10969	g_8953
ptg000018l	17117225	17121197	3972	g_8953	g_14218
ptg000018l	17128213	17135305	7092	g_14218	g_34298
ptg000018l	17142351	17143739	1388	g_34298	g_11199
ptg000018l	17145867	17147091	1224	g_11199	g_27760
ptg000018l	17152930	17154788	1858	g_27760	g_11760
ptg000018l	17166202	17168343	2141	g_11760	g_16843
ptg000018l	17168715	17171945	3230	g_16843	g_18821
ptg000018l	17174680	17176210	1530	g_18821	g_29779
ptg000018l	17180420	17183302	2882	g_29779	g_17326
ptg000018l	17183583	17186252	2669	g_17326	g_22661
ptg000018l	17189385	17196053	6668	g_22661	g_33228
ptg000018l	17201951	17203017	1066	g_33228	g_4093
ptg000018l	17210921	17226505	15584	g_4093	g_3428
ptg000018l	17236083	17240183	4100	g_3428	g_28235
ptg000018l	17246842	17282897	36055	g_28235	g_24711
ptg000018l	17284927	17299147	14220	g_24711	g_35103
ptg000018l	17301788	17304697	2909	g_35103	g_10531
ptg000018l	17307823	17310831	3008	g_10531	g_34718
ptg000018l	17315623	17344542	28919	g_34718	g_15263
ptg000018l	17352764	17355775	3011	g_15263	g_17730
ptg000018l	17373288	17375698	2410	g_17730	g_5781
ptg000018l	17382444	17385112	2668	g_5781	g_25173
ptg000018l	17401722	17596319	194597	g_25173	g_38082
ptg000018l	17596522	17814038	217516	g_38082	g_14899
ptg000018l	17823742	17831579	7837	g_14899	g_6255
ptg000018l	17838532	17884748	46216	g_6255	g_2103
ptg000018l	17890138	17892614	2476	g_2103	g_22227
ptg000018l	17903306	17904196	890	g_22227	g_20886
ptg000018l	17909978	17920498	10520	g_20886	g_37269
ptg000018l	17922130	17924503	2373	g_37269	g_17478
ptg000018l	17929016	17930757	1741	g_17478	g_39897
ptg000018l	17935921	17937431	1510	g_39897	g_156
ptg000018l	17943569	17947390	3821	g_156	g_39898
ptg000018l	17948942	17951977	3035	g_39898	g_39899
ptg000018l	17952396	18028490	76094	g_39899	g_5784
ptg000018l	18028738	18099334	70596	g_5784	g_35196
ptg000018l	18109997	18112261	2264	g_35196	g_10261
ptg000018l	18115042	18118642	3600	g_10261	g_15794
ptg000018l	18139348	18143875	4527	g_15794	g_8743
ptg000018l	18147709	18153887	6178	g_8743	g_14781
ptg000018l	18158015	18211557	53542	g_14781	g_13326
ptg000018l	18222875	18287525	64650	g_13326	g_5174
ptg000018l	18289861	18297915	8054	g_5174	g_11623
ptg000018l	18301839	18340307	38468	g_11623	g_24635
ptg000018l	18342355	18345342	2987	g_24635	g_13506
ptg000018l	18370795	18372847	2052	g_13506	g_17655
ptg000018l	18376646	18382097	5451	g_17655	g_649
ptg000018l	18382880	18384535	1655	g_649	g_24773
ptg000018l	18385030	18393819	8789	g_24773	g_24605
ptg000018l	18402361	18402636	275	g_24605	g_10626
ptg000018l	18406526	18410522	3996	g_10626	g_18510
ptg000018l	18416507	18420121	3614	g_18510	g_5490
ptg000018l	18446613	18462572	15959	g_5490	g_22621
ptg000018l	18462871	18477043	14172	g_22621	g_15735
ptg000018l	18477258	18544081	66823	g_15735	g_31077
ptg000018l	18544938	18573937	28999	g_31077	g_15145
ptg000018l	18609211	18614329	5118	g_15145	g_40141
ptg000018l	18620174	18624567	4393	g_40141	g_16861
ptg000018l	18633298	18635603	2305	g_16861	g_26058
ptg000018l	18643274	18649605	6331	g_26058	g_34521
ptg000018l	18660429	18712501	52072	g_34521	g_26014
ptg000018l	18737910	18800318	62408	g_26014	g_17530
ptg000018l	18820979	18829234	8255	g_17530	g_36243
ptg000018l	18853663	18861893	8230	g_36243	g_28938
ptg000018l	18879833	18900353	20520	g_28938	g_11065
ptg000018l	18914448	18919739	5291	g_11065	g_13253
ptg000018l	18932665	18944826	12161	g_13253	g_25099
ptg000018l	18951093	18952952	1859	g_25099	g_19433
ptg000018l	18957854	18958944	1090	g_19433	g_37055
ptg000018l	18977226	18979364	2138	g_37055	g_3012
ptg000018l	18979792	19024948	45156	g_3012	g_31031
ptg000018l	19026819	19040918	14099	g_31031	g_3392
ptg000018l	19052436	19122331	69895	g_3392	g_7414
ptg000018l	19131415	19133527	2112	g_7414	g_38263
ptg000018l	19142180	19163706	21526	g_38263	g_34909
ptg000018l	19163963	19228278	64315	g_34909	g_33756
ptg000018l	19250821	19253147	2326	g_33756	g_5317
ptg000018l	19261939	19273363	11424	g_5317	g_15706
ptg000018l	19274945	19306855	31910	g_15706	g_12745
ptg000018l	19307436	19309585	2149	g_12745	g_22293
ptg000018l	19313779	19315554	1775	g_22293	g_25685
ptg000018l	19321691	19326308	4617	g_25685	g_26062
ptg000018l	19326604	19328672	2068	g_26062	g_10532
ptg000018l	19332745	19334422	1677	g_10532	g_37679
ptg000018l	19337540	19344800	7260	g_37679	g_35376
ptg000019l	11760	19196	7436	g_11738	g_17520
ptg000019l	19429	151438	132009	g_17520	g_35168
ptg000019l	151710	186506	34796	g_35168	g_9744
ptg000019l	200198	253446	53248	g_9744	g_8090
ptg000019l	253766	253816	50	g_8090	g_21383
ptg000019l	254562	259710	5148	g_21383	g_29083
ptg000019l	260105	276584	16479	g_29083	g_9130
ptg000019l	277210	329504	52294	g_9130	g_24218
ptg000019l	352635	387196	34561	g_24218	g_23438
ptg000019l	387453	414572	27119	g_23438	g_35864
ptg000019l	414886	418973	4087	g_35864	g_38142
ptg000019l	421686	439463	17777	g_38142	g_20396
ptg000019l	458983	477861	18878	g_20396	g_31677
ptg000019l	479183	479231	48	g_31677	g_16772
ptg000019l	481579	500060	18481	g_16772	g_4678
ptg000019l	500578	502955	2377	g_4678	g_10587
ptg000019l	509304	549170	39866	g_10587	g_32288
ptg000019l	549550	579789	30239	g_32288	g_27418
ptg000019l	580865	603631	22766	g_27418	g_11860
ptg000019l	603852	673491	69639	g_11860	g_26722
ptg000019l	677746	699103	21357	g_26722	g_31102
ptg000019l	699642	702850	3208	g_31102	g_31816
ptg000019l	703413	730388	26975	g_31816	g_957
ptg000019l	730744	741973	11229	g_957	g_13826
ptg000019l	760868	805054	44186	g_13826	g_3856
ptg000019l	805446	856669	51223	g_3856	g_14303
ptg000019l	857490	881853	24363	g_14303	g_26249
ptg000019l	885233	897344	12111	g_26249	g_23243
ptg000019l	897868	933090	35222	g_23243	g_18810
ptg000019l	953936	963938	10002	g_18810	g_21326
ptg000019l	988986	996504	7518	g_21326	g_32349
ptg000019l	996749	1026611	29862	g_32349	g_6949
ptg000019l	1027510	1036706	9196	g_6949	g_35023
ptg000019l	1042026	1087170	45144	g_35023	g_6088
ptg000019l	1107337	1225849	118512	g_6088	g_7807
ptg000019l	1226397	1247501	21104	g_7807	g_33570
ptg000019l	1273721	1289357	15636	g_33570	g_14307
ptg000019l	1314353	1354577	40224	g_14307	g_8497
ptg000019l	1355050	1467627	112577	g_8497	g_33614
ptg000019l	1468364	1468625	261	g_33614	g_6988
ptg000019l	1469071	1487567	18496	g_6988	g_7333
ptg000019l	1521997	1545384	23387	g_7333	g_31737
ptg000019l	1546790	1643894	97104	g_31737	g_29523
ptg000019l	1657801	1753125	95324	g_29523	g_37375
ptg000019l	1766698	1768386	1688	g_37375	g_25214
ptg000019l	1770525	1933394	162869	g_25214	g_1195
ptg000019l	1948419	1974502	26083	g_1195	g_16621
ptg000019l	1985363	1989789	4426	g_16621	g_16974
ptg000019l	2004430	2050773	46343	g_16974	g_19839
ptg000019l	2056680	2080407	23727	g_19839	g_1543
ptg000019l	2085779	2251904	166125	g_1543	g_29799
ptg000019l	2252626	2285503	32877	g_29799	g_34098
ptg000019l	2285796	2311615	25819	g_34098	g_7377
ptg000019l	2312849	2313929	1080	g_7377	g_8263
ptg000019l	2314165	2336348	22183	g_8263	g_1661
ptg000019l	2356531	2377511	20980	g_1661	g_16659
ptg000019l	2388082	2490625	102543	g_16659	g_858
ptg000019l	2490915	2490960	45	g_858	g_16454
ptg000019l	2501819	2542037	40218	g_16454	g_24729
ptg000019l	2544408	2557865	13457	g_24729	g_28786
ptg000019l	2558194	2625306	67112	g_28786	g_20939
ptg000019l	2625623	2631461	5838	g_20939	g_14340
ptg000019l	2632057	2874672	242615	g_14340	g_4759
ptg000019l	2875844	2918238	42394	g_4759	g_21993
ptg000019l	2918489	3010600	92111	g_21993	g_12840
ptg000019l	3011190	3035360	24170	g_12840	g_12415
ptg000019l	3035683	3036115	432	g_12415	g_32654
ptg000019l	3037230	3085392	48162	g_32654	g_28812
ptg000019l	3086231	3215381	129150	g_28812	g_11132
ptg000019l	3215683	3296318	80635	g_11132	g_18739
ptg000019l	3299698	3310681	10983	g_18739	g_8200
ptg000019l	3311382	3407447	96065	g_8200	g_21130
ptg000019l	3407959	3409049	1090	g_21130	g_7428
ptg000019l	3409825	3428744	18919	g_7428	g_23812
ptg000019l	3452771	3456184	3413	g_23812	g_38249
ptg000019l	3469963	3476429	6466	g_38249	g_7977
ptg000019l	3477181	3481848	4667	g_7977	g_427
ptg000019l	3482696	3506538	23842	g_427	g_38537
ptg000019l	3507137	3568072	60935	g_38537	g_30406
ptg000019l	3569541	3722031	152490	g_30406	g_34041
ptg000019l	3724203	3736393	12190	g_34041	g_20534
ptg000019l	3737360	3786363	49003	g_20534	g_3129
ptg000019l	3798022	3800601	2579	g_3129	g_17767
ptg000019l	3802599	3830617	28018	g_17767	g_37176
ptg000019l	3848325	3951368	103043	g_37176	g_9014
ptg000019l	3960970	3964948	3978	g_9014	g_2620
ptg000019l	3969830	3979444	9614	g_2620	g_31885
ptg000019l	3981772	3984339	2567	g_31885	g_17591
ptg000019l	4003414	4003937	523	g_17591	g_37117
ptg000019l	4008919	4014341	5422	g_37117	g_17487
ptg000019l	4021847	4058361	36514	g_17487	g_35629
ptg000019l	4064990	4078422	13432	g_35629	g_20812
ptg000019l	4080947	4096982	16035	g_20812	g_28188
ptg000019l	4106483	4173203	66720	g_28188	g_22043
ptg000019l	4173664	4185629	11965	g_22043	g_28955
ptg000019l	4193399	4196037	2638	g_28955	g_32083
ptg000019l	4202731	4206209	3478	g_32083	g_808
ptg000019l	4206937	4219846	12909	g_808	g_13945
ptg000019l	4229809	4232482	2673	g_13945	g_25871
ptg000019l	4240657	4243192	2535	g_25871	g_15511
ptg000019l	4246534	4271197	24663	g_15511	g_34250
ptg000019l	4273526	4278949	5423	g_34250	g_36308
ptg000019l	4284340	4290932	6592	g_36308	g_31390
ptg000019l	4297600	4303900	6300	g_31390	g_6472
ptg000019l	4331197	4332966	1769	g_6472	g_19351
ptg000019l	4341141	4346898	5757	g_19351	g_14204
ptg000019l	4368239	4379347	11108	g_14204	g_34162
ptg000019l	4380992	4390162	9170	g_34162	g_7012
ptg000019l	4391727	4440512	48785	g_7012	g_14199
ptg000019l	4444686	4447206	2520	g_14199	g_19354
ptg000019l	4454066	4454741	675	g_19354	g_37776
ptg000019l	4455043	4455216	173	g_37776	g_32847
ptg000019l	4457519	4461356	3837	g_32847	g_27313
ptg000019l	4469130	4478101	8971	g_27313	g_1237
ptg000019l	4481650	4482912	1262	g_1237	g_31622
ptg000019l	4486664	4489000	2336	g_31622	g_24308
ptg000019l	4494908	4497484	2576	g_24308	g_15372
ptg000019l	4499256	4500056	800	g_15372	g_13580
ptg000019l	4510349	4516105	5756	g_13580	g_35496
ptg000019l	4518942	4572257	53315	g_35496	g_5987
ptg000019l	4586338	4596864	10526	g_5987	g_30177
ptg000019l	4606233	4628798	22565	g_30177	g_28675
ptg000019l	4630201	4686781	56580	g_28675	g_34691
ptg000019l	4705989	4750979	44990	g_34691	g_21025
ptg000019l	4751527	4780708	29181	g_21025	g_17250
ptg000019l	4780971	4805554	24583	g_17250	g_13589
ptg000019l	4808035	4809032	997	g_13589	g_21273
ptg000019l	4809874	4813760	3886	g_21273	g_32987
ptg000019l	4816565	4849869	33304	g_32987	g_26583
ptg000019l	4850150	4882964	32814	g_26583	g_7448
ptg000019l	4884121	4915020	30899	g_7448	g_12239
ptg000019l	4928934	4931942	3008	g_12239	g_18244
ptg000019l	4944272	4975666	31394	g_18244	g_24683
ptg000019l	4994029	5026462	32433	g_24683	g_24547
ptg000019l	5039684	5068546	28862	g_24547	g_13325
ptg000019l	5068761	5076128	7367	g_13325	g_21407
ptg000019l	5110055	5155571	45516	g_21407	g_29245
ptg000019l	5158299	5177105	18806	g_29245	g_8863
ptg000019l	5182209	5189649	7440	g_8863	g_2903
ptg000019l	5196208	5239029	42821	g_2903	g_26792
ptg000019l	5240750	5250950	10200	g_26792	g_29778
ptg000019l	5251936	5258714	6778	g_29778	g_34023
ptg000019l	5262609	5275174	12565	g_34023	g_22635
ptg000019l	5278005	5295488	17483	g_22635	g_15624
ptg000019l	5304157	5307945	3788	g_15624	g_30573
ptg000019l	5316116	5348194	32078	g_30573	g_16714
ptg000019l	5356590	5360546	3956	g_16714	g_308
ptg000019l	5361805	5362647	842	g_308	g_22739
ptg000019l	5373565	5375029	1464	g_22739	g_33800
ptg000019l	5376916	5585546	208630	g_33800	g_19510
ptg000019l	5586886	5656616	69730	g_19510	g_21176
ptg000019l	5657566	5679935	22369	g_21176	g_14560
ptg000019l	5699480	5710861	11381	g_14560	g_28885
ptg000019l	5728145	5729834	1689	g_28885	g_28265
ptg000019l	5735149	5736891	1742	g_28265	g_17910
ptg000019l	5749977	5753412	3435	g_17910	g_25738
ptg000019l	5758725	5764126	5401	g_25738	g_30953
ptg000019l	5772173	5778199	6026	g_30953	g_19299
ptg000019l	5780846	5786359	5513	g_19299	g_30009
ptg000019l	5803041	5837376	34335	g_30009	g_26388
ptg000019l	5841670	5852400	10730	g_26388	g_25146
ptg000019l	5858269	5863038	4769	g_25146	g_17472
ptg000019l	5863640	5867489	3849	g_17472	g_40171
ptg000019l	5867824	5868474	650	g_40171	g_9151
ptg000019l	5883522	5885961	2439	g_9151	g_3266
ptg000019l	5891619	5899019	7400	g_3266	g_4286
ptg000019l	5903148	5909188	6040	g_4286	g_19650
ptg000019l	5920388	5921038	650	g_19650	g_18916
ptg000019l	5926318	5932708	6390	g_18916	g_4402
ptg000019l	5966294	5979091	12797	g_4402	g_13449
ptg000019l	5993312	6004536	11224	g_13449	g_36431
ptg000019l	6004751	6037106	32355	g_36431	g_55
ptg000019l	6037363	6110904	73541	g_55	g_3370
ptg000019l	6111407	6114766	3359	g_3370	g_24040
ptg000019l	6115481	6118126	2645	g_24040	g_8088
ptg000019l	6118821	6307856	189035	g_8088	g_1747
ptg000019l	6309376	6332926	23550	g_1747	g_32507
ptg000019l	6333534	6338282	4748	g_32507	g_18679
ptg000019l	6343725	6346813	3088	g_18679	g_30151
ptg000019l	6355895	6360904	5009	g_30151	g_6842
ptg000019l	6363310	6369162	5852	g_6842	g_2961
ptg000019l	6369437	6447747	78310	g_2961	g_4776
ptg000019l	6448100	6452266	4166	g_4776	g_8071
ptg000019l	6457756	6469303	11547	g_8071	g_20156
ptg000019l	6482668	6483463	795	g_20156	g_6579
ptg000019l	6493934	6503951	10017	g_6579	g_19275
ptg000019l	6505336	6513406	8070	g_19275	g_16817
ptg000019l	6523594	6537232	13638	g_16817	g_15585
ptg000019l	6551232	6558567	7335	g_15585	g_34479
ptg000019l	6563176	6579544	16368	g_34479	g_27516
ptg000019l	6580479	6603375	22896	g_27516	g_3377
ptg000019l	6606816	6607413	597	g_3377	g_9035
ptg000019l	6607625	6691785	84160	g_9035	g_14655
ptg000019l	6692039	6763777	71738	g_14655	g_26211
ptg000019l	6783164	6787834	4670	g_26211	g_22553
ptg000019l	6799739	6800213	474	g_22553	g_35780
ptg000019l	6806571	6851871	45300	g_35780	g_32245
ptg000019l	6867631	6874200	6569	g_32245	g_15779
ptg000019l	6884072	6885601	1529	g_15779	g_17032
ptg000019l	6894974	6915378	20404	g_17032	g_34252
ptg000019l	6925849	6933812	7963	g_34252	g_24814
ptg000019l	6934015	6985196	51181	g_24814	g_14014
ptg000019l	7005204	7080428	75224	g_14014	g_37028
ptg000019l	7081477	7124780	43303	g_37028	g_512
ptg000019l	7126076	7158333	32257	g_512	g_20204
ptg000019l	7158713	7243532	84819	g_20204	g_12950
ptg000019l	7243744	7386182	142438	g_12950	g_36173
ptg000019l	7403847	7406388	2541	g_36173	g_4367
ptg000019l	7418034	7461017	42983	g_4367	g_10691
ptg000019l	7464870	7466216	1346	g_10691	g_2153
ptg000019l	7469357	7471618	2261	g_2153	g_8093
ptg000019l	7481899	7561681	79782	g_8093	g_13429
ptg000019l	7568496	7574328	5832	g_13429	g_29186
ptg000019l	7580956	7674362	93406	g_29186	g_4027
ptg000019l	7674700	7674989	289	g_4027	g_9352
ptg000019l	7675543	7686140	10597	g_9352	g_29786
ptg000019l	7686991	7699265	12274	g_29786	g_33340
ptg000019l	7706344	7719948	13604	g_33340	g_34720
ptg000019l	7720256	7750997	30741	g_34720	g_27404
ptg000019l	7753452	7771296	17844	g_27404	g_5029
ptg000019l	7771706	7786723	15017	g_5029	g_19175
ptg000019l	7874271	8118879	244608	g_19175	g_12517
ptg000019l	8119574	8187942	68368	g_12517	g_29705
ptg000019l	8196059	8196934	875	g_29705	g_16853
ptg000019l	8197968	8199043	1075	g_16853	g_22185
ptg000019l	8206640	8223143	16503	g_22185	g_182
ptg000019l	8232930	8235925	2995	g_182	g_16634
ptg000019l	8257003	8258522	1519	g_16634	g_29791
ptg000019l	8259759	8268061	8302	g_29791	g_37491
ptg000019l	8271768	8273364	1596	g_37491	g_30887
ptg000019l	8275343	8278512	3169	g_30887	g_3700
ptg000019l	8281327	8318352	37025	g_3700	g_1142
ptg000019l	8319637	8320204	567	g_1142	g_5255
ptg000019l	8339800	8349175	9375	g_5255	g_12101
ptg000019l	8360368	8363091	2723	g_12101	g_19715
ptg000019l	8367376	8382957	15581	g_19715	g_38158
ptg000019l	8384807	8388655	3848	g_38158	g_38257
ptg000019l	8413954	8416250	2296	g_38257	g_3263
ptg000019l	8424561	8454511	29950	g_3263	g_26418
ptg000019l	8460975	8464369	3394	g_26418	g_35064
ptg000019l	8468291	8469313	1022	g_35064	g_30883
ptg000019l	8475841	8476891	1050	g_30883	g_32993
ptg000019l	8478498	8496959	18461	g_32993	g_22611
ptg000019l	8512798	8515389	2591	g_22611	g_15541
ptg000019l	8521058	8524803	3745	g_15541	g_9530
ptg000019l	8531496	8534262	2766	g_9530	g_21941
ptg000019l	8550084	8556809	6725	g_21941	g_35937
ptg000019l	8567177	8572552	5375	g_35937	g_2086
ptg000019l	8586881	8589975	3094	g_2086	g_22291
ptg000019l	8596425	8598101	1676	g_22291	g_37078
ptg000019l	8602669	8618751	16082	g_37078	g_11574
ptg000019l	8625010	8629078	4068	g_11574	g_2047
ptg000019l	8638493	8669971	31478	g_2047	g_3798
ptg000019l	8675020	8677415	2395	g_3798	g_7332
ptg000019l	8682755	8685045	2290	g_7332	g_12819
ptg000019l	8695196	8704001	8805	g_12819	g_6021
ptg000019l	8737351	8746399	9048	g_6021	g_7769
ptg000019l	8755539	8759070	3531	g_7769	g_3496
ptg000019l	8780801	8799800	18999	g_3496	g_6793
ptg000019l	8810042	8811130	1088	g_6793	g_20885
ptg000019l	8812615	8840907	28292	g_20885	g_13532
ptg000019l	8844705	8853767	9062	g_13532	g_30586
ptg000019l	8855323	8855774	451	g_30586	g_10947
ptg000019l	8858028	8860417	2389	g_10947	g_33342
ptg000019l	8864095	8866075	1980	g_33342	g_24904
ptg000019l	8866440	8866612	172	g_24904	g_7277
ptg000019l	8873559	8882701	9142	g_7277	g_8472
ptg000019l	8883063	8887122	4059	g_8472	g_20249
ptg000019l	8888535	8894463	5928	g_20249	g_34839
ptg000019l	8903496	8907730	4234	g_34839	g_13367
ptg000019l	8911326	8916933	5607	g_13367	g_22967
ptg000019l	8930266	8979718	49452	g_22967	g_34186
ptg000019l	8980098	9046266	66168	g_34186	g_25773
ptg000019l	9047078	9087410	40332	g_25773	g_4002
ptg000019l	9092461	9120910	28449	g_4002	g_27276
ptg000019l	9126959	9163339	36380	g_27276	g_15939
ptg000019l	9177527	9181909	4382	g_15939	g_22213
ptg000019l	9187444	9190711	3267	g_22213	g_13585
ptg000019l	9200712	9206181	5469	g_13585	g_24428
ptg000019l	9212980	9214015	1035	g_24428	g_653
ptg000019l	9240389	9243383	2994	g_653	g_15026
ptg000019l	9255772	9270229	14457	g_15026	g_10198
ptg000019l	9284712	9289096	4384	g_10198	g_15252
ptg000019l	9294608	9296875	2267	g_15252	g_17144
ptg000019l	9298333	9330902	32569	g_17144	g_6672
ptg000019l	9335863	9373473	37610	g_6672	g_5176
ptg000019l	9378005	9478200	100195	g_5176	g_9605
ptg000019l	9479784	9705510	225726	g_9605	g_23290
ptg000019l	9706169	9875968	169799	g_23290	g_20038
ptg000019l	9877592	9888889	11297	g_20038	g_23514
ptg000019l	9899405	9909971	10566	g_23514	g_2798
ptg000019l	9924999	9965488	40489	g_2798	g_37545
ptg000019l	9966036	9998138	32102	g_37545	g_37278
ptg000019l	9998362	10017700	19338	g_37278	g_15797
ptg000019l	10018874	10034101	15227	g_15797	g_33303
ptg000019l	10042293	10042390	97	g_33303	g_21463
ptg000019l	10042590	10048098	5508	g_21463	g_36122
ptg000019l	10050941	10051740	799	g_36122	g_4989
ptg000019l	10056066	10063605	7539	g_4989	g_8606
ptg000019l	10076068	10185757	109689	g_8606	g_12286
ptg000019l	10264634	10271219	6585	g_12286	g_1319
ptg000019l	10277046	10284337	7291	g_1319	g_23758
ptg000019l	10297534	10298517	983	g_23758	g_40242
ptg000019l	10300050	10301415	1365	g_40242	g_29942
ptg000019l	10312286	10315244	2958	g_29942	g_5011
ptg000019l	10316507	10323087	6580	g_5011	g_3704
ptg000019l	10323296	10342348	19052	g_3704	g_15872
ptg000019l	10350355	10364685	14330	g_15872	g_31653
ptg000019l	10389760	10444982	55222	g_31653	g_30160
ptg000019l	10447838	10458118	10280	g_30160	g_26878
ptg000019l	10479592	10482342	2750	g_26878	g_24054
ptg000019l	10500052	10550902	50850	g_24054	g_25128
ptg000019l	10578074	10586622	8548	g_25128	g_17551
ptg000019l	10609419	10751458	142039	g_17551	g_23478
ptg000019l	10751904	10794477	42573	g_23478	g_10719
ptg000019l	10794680	10807022	12342	g_10719	g_36012
ptg000019l	10807378	10831238	23860	g_36012	g_5993
ptg000019l	10838628	10853302	14674	g_5993	g_8319
ptg000019l	10874343	11022004	147661	g_8319	g_32528
ptg000019l	11022414	11239332	216918	g_32528	g_15151
ptg000019l	11241152	11255754	14602	g_15151	g_1627
ptg000019l	11261003	11339752	78749	g_1627	g_30811
ptg000019l	11340147	11405283	65136	g_30811	g_14590
ptg000019l	11405699	11475245	69546	g_14590	g_20447
ptg000019l	11480127	11503759	23632	g_20447	g_6615
ptg000019l	11508551	11546789	38238	g_6615	g_14983
ptg000019l	11546992	11575039	28047	g_14983	g_20538
ptg000019l	11576361	11632650	56289	g_20538	g_20113
ptg000019l	11632922	11635439	2517	g_20113	g_13496
ptg000019l	11655669	11660508	4839	g_13496	g_1368
ptg000019l	11671610	11686435	14825	g_1368	g_3774
ptg000019l	11688012	11692269	4257	g_3774	g_1218
ptg000019l	11699980	11716327	16347	g_1218	g_20170
ptg000019l	11723610	11772722	49112	g_20170	g_36396
ptg000019l	11774801	11782712	7911	g_36396	g_7789
ptg000019l	11787194	11787480	286	g_7789	g_33096
ptg000019l	11789838	11790718	880	g_33096	g_3768
ptg000019l	11799516	11820367	20851	g_3768	g_7314
ptg000019l	11821928	11830094	8166	g_7314	g_31476
ptg000019l	11830324	11851008	20684	g_31476	g_31614
ptg000019l	11869451	11877875	8424	g_31614	g_6218
ptg000019l	11888035	11909905	21870	g_6218	g_6309
ptg000019l	11917368	11918346	978	g_6309	g_9620
ptg000019l	11919170	11928607	9437	g_9620	g_13813
ptg000019l	11937290	11941844	4554	g_13813	g_27776
ptg000019l	11943629	11948798	5169	g_27776	g_9490
ptg000019l	11949055	11950297	1242	g_9490	g_24004
ptg000019l	11951745	11954439	2694	g_24004	g_15115
ptg000019l	11957063	11962093	5030	g_15115	g_19873
ptg000019l	11963169	11963721	552	g_19873	g_21794
ptg000019l	11975413	11993970	18557	g_21794	g_9680
ptg000019l	11998237	12014270	16033	g_9680	g_24373
ptg000019l	12019780	12034915	15135	g_24373	g_36334
ptg000019l	12038492	12053879	15387	g_36334	g_4641
ptg000019l	12056745	12059590	2845	g_4641	g_39979
ptg000019l	12061177	12131709	70532	g_39979	g_38039
ptg000019l	12135511	12136733	1222	g_38039	g_36201
ptg000019l	12137983	12155589	17606	g_36201	g_29912
ptg000019l	12160779	12164913	4134	g_29912	g_20505
ptg000019l	12175228	12177996	2768	g_20505	g_25539
ptg000019l	12180918	12184895	3977	g_25539	g_10460
ptg000019l	12190289	12217040	26751	g_10460	g_21135
ptg000019l	12221549	12225552	4003	g_21135	g_38928
ptg000019l	12226782	12229936	3154	g_38928	g_19821
ptg000019l	12231672	12241144	9472	g_19821	g_3040
ptg000019l	12264203	12272116	7913	g_3040	g_24756
ptg000019l	12272487	12301676	29189	g_24756	g_29597
ptg000019l	12304759	12316927	12168	g_29597	g_34179
ptg000019l	12317193	12333205	16012	g_34179	g_6557
ptg000019l	12357188	12362677	5489	g_6557	g_35321
ptg000019l	12367849	12371284	3435	g_35321	g_11151
ptg000019l	12372198	12374962	2764	g_11151	g_8875
ptg000019l	12377008	12379438	2430	g_8875	g_17734
ptg000019l	12392329	12425689	33360	g_17734	g_27110
ptg000019l	12431452	12437360	5908	g_27110	g_14069
ptg000019l	12437635	12446360	8725	g_14069	g_18990
ptg000019l	12455538	12457410	1872	g_18990	g_11898
ptg000019l	12462634	12465405	2771	g_11898	g_138
ptg000019l	12467434	12475001	7567	g_138	g_5664
ptg000019l	12488978	12524577	35599	g_5664	g_8908
ptg000019l	12552589	12638090	85501	g_8908	g_28080
ptg000019l	12638668	12721075	82407	g_28080	g_11335
ptg000019l	12723441	12728642	5201	g_11335	g_1951
ptg000019l	12736705	12738374	1669	g_1951	g_15171
ptg000019l	12750800	12754072	3272	g_15171	g_17209
ptg000019l	12768472	12771870	3398	g_17209	g_36253
ptg000019l	12779108	12791233	12125	g_36253	g_29193
ptg000019l	12796504	12798514	2010	g_29193	g_5542
ptg000019l	12807315	12810490	3175	g_5542	g_34570
ptg000019l	12814751	12833849	19098	g_34570	g_23754
ptg000019l	12859992	12877510	17518	g_23754	g_32901
ptg000019l	12877818	12881513	3695	g_32901	g_39966
ptg000019l	12896499	12903581	7082	g_39966	g_3553
ptg000019l	12913977	12915005	1028	g_3553	g_25074
ptg000019l	12946089	13077408	131319	g_25074	g_32595
ptg000019l	13079093	13157911	78818	g_32595	g_18447
ptg000019l	13158321	13167635	9314	g_18447	g_19080
ptg000019l	13168408	13175475	7067	g_19080	g_18410
ptg000019l	13175780	13176905	1125	g_18410	g_38244
ptg000019l	13177273	13178869	1596	g_38244	g_11578
ptg000019l	13202633	13214357	11724	g_11578	g_9734
ptg000019l	13229198	13231346	2148	g_9734	g_8419
ptg000019l	13232981	13233018	37	g_8419	g_30083
ptg000019l	13233393	13256396	23003	g_30083	g_14486
ptg000019l	13257831	13261352	3521	g_14486	g_3111
ptg000019l	13263205	13353953	90748	g_3111	g_28920
ptg000019l	13357166	13375631	18465	g_28920	g_5677
ptg000019l	13389376	13393211	3835	g_5677	g_29795
ptg000019l	13394077	13401851	7774	g_29795	g_17298
ptg000019l	13416481	13421413	4932	g_17298	g_11985
ptg000019l	13428162	13431168	3006	g_11985	g_34465
ptg000019l	13434492	13438221	3729	g_34465	g_8327
ptg000019l	13443736	13444653	917	g_8327	g_35161
ptg000019l	13450667	13451933	1266	g_35161	g_21936
ptg000019l	13453911	13456832	2921	g_21936	g_25290
ptg000019l	13467234	13473908	6674	g_25290	g_2913
ptg000019l	13475777	13483651	7874	g_2913	g_31626
ptg000019l	13486120	13511803	25683	g_31626	g_9029
ptg000019l	13523556	13525765	2209	g_9029	g_34092
ptg000019l	13529532	13536081	6549	g_34092	g_21280
ptg000019l	13563982	13571309	7327	g_21280	g_31824
ptg000019l	13574915	13589176	14261	g_31824	g_2420
ptg000019l	13604984	13612733	7749	g_2420	g_1724
ptg000019l	13616345	13618552	2207	g_1724	g_39933
ptg000019l	13623854	13634723	10869	g_39933	g_667
ptg000019l	13646304	13658524	12220	g_667	g_3623
ptg000019l	13660878	13725921	65043	g_3623	g_18775
ptg000019l	13727960	13730068	2108	g_18775	g_30838
ptg000019l	13732753	13736137	3384	g_30838	g_16632
ptg000019l	13743694	13755764	12070	g_16632	g_17869
ptg000019l	13760469	13810907	50438	g_17869	g_1871
ptg000019l	13812109	13815315	3206	g_1871	g_18646
ptg000019l	13820125	13820588	463	g_18646	g_36200
ptg000019l	13829612	13830422	810	g_36200	g_2895
ptg000019l	13835344	13835523	179	g_2895	g_37689
ptg000019l	13841734	13863576	21842	g_37689	g_12870
ptg000019l	13867896	13869690	1794	g_12870	g_20195
ptg000019l	13871817	13878906	7089	g_20195	g_6633
ptg000019l	13882792	13885231	2439	g_6633	g_124
ptg000019l	13893538	13908027	14489	g_124	g_10679
ptg000019l	13910806	13914700	3894	g_10679	g_9482
ptg000019l	13919076	13934438	15362	g_9482	g_18588
ptg000019l	13934680	14016324	81644	g_18588	g_15831
ptg000019l	14019299	14024966	5667	g_15831	g_29904
ptg000019l	14026035	14050225	24190	g_29904	g_35764
ptg000019l	14070696	14075437	4741	g_35764	g_956
ptg000019l	14077852	14084070	6218	g_956	g_23162
ptg000019l	14089372	14091292	1920	g_23162	g_14333
ptg000019l	14099638	14101796	2158	g_14333	g_35970
ptg000019l	14106214	14145730	39516	g_35970	g_16628
ptg000019l	14149147	14168813	19666	g_16628	g_5231
ptg000019l	14174270	14176409	2139	g_5231	g_29570
ptg000019l	14186644	14224292	37648	g_29570	g_1040
ptg000019l	14226040	14254801	28761	g_1040	g_24795
ptg000019l	14261143	14262459	1316	g_24795	g_37274
ptg000019l	14267059	14271759	4700	g_37274	g_9405
ptg000019l	14273099	14275028	1929	g_9405	g_26986
ptg000019l	14280596	14311826	31230	g_26986	g_22368
ptg000019l	14312709	14312897	188	g_22368	g_40222
ptg000019l	14316247	14317055	808	g_40222	g_17769
ptg000019l	14320466	14327937	7471	g_17769	g_11980
ptg000019l	14328792	14410102	81310	g_11980	g_23277
ptg000019l	14431941	14438239	6298	g_23277	g_1890
ptg000019l	14452032	14458302	6270	g_1890	g_23217
ptg000019l	14459258	14477293	18035	g_23217	g_13070
ptg000019l	14500708	14523615	22907	g_13070	g_15890
ptg000019l	14523857	14553680	29823	g_15890	g_33867
ptg000019l	14554228	14562981	8753	g_33867	g_11564
ptg000019l	14569314	14590473	21159	g_11564	g_13519
ptg000019l	14590679	14603453	12774	g_13519	g_10472
ptg000019l	14603683	14605102	1419	g_10472	g_40086
ptg000019l	14614475	14615479	1004	g_40086	g_1078
ptg000019l	14618295	14618380	85	g_1078	g_33086
ptg000019l	14622051	14623754	1703	g_33086	g_34362
ptg000019l	14625556	14637015	11459	g_34362	g_37082
ptg000019l	14642992	14651852	8860	g_37082	g_30263
ptg000019l	14652505	14658896	6391	g_30263	g_26982
ptg000019l	14679106	14950815	271709	g_26982	g_21974
ptg000019l	14964364	15029060	64696	g_21974	g_8964
ptg000019l	15053057	15146999	93942	g_8964	g_25200
ptg000019l	15147310	15174240	26930	g_25200	g_24896
ptg000019l	15174956	15188331	13375	g_24896	g_32596
ptg000019l	15197254	15209679	12425	g_32596	g_28513
ptg000019l	15225191	15268925	43734	g_28513	g_28468
ptg000019l	15271728	15284748	13020	g_28468	g_4570
ptg000019l	15303800	15322172	18372	g_4570	g_38211
ptg000019l	15325357	15326799	1442	g_38211	g_32407
ptg000019l	15328218	15329670	1452	g_32407	g_21988
ptg000019l	15332255	15336970	4715	g_21988	g_812
ptg000019l	15345710	15348885	3175	g_812	g_36656
ptg000019l	15350108	15353883	3775	g_36656	g_11391
ptg000019l	15354293	15364414	10121	g_11391	g_17249
ptg000019l	15366791	15378652	11861	g_17249	g_5228
ptg000019l	15384829	15394924	10095	g_5228	g_19178
ptg000019l	15395454	15396369	915	g_19178	g_1018
ptg000019l	15396887	15400108	3221	g_1018	g_25458
ptg000019l	15402969	15409053	6084	g_25458	g_19850
ptg000019l	15417188	15452298	35110	g_19850	g_12984
ptg000019l	15455306	15482146	26840	g_12984	g_28427
ptg000019l	15484098	15494490	10392	g_28427	g_32575
ptg000019l	15496010	15566808	70798	g_32575	g_30763
ptg000019l	15580256	15596215	15959	g_30763	g_37116
ptg000019l	15622893	15623031	138	g_37116	g_17066
ptg000019l	15623309	15634100	10791	g_17066	g_11478
ptg000019l	15659921	15680050	20129	g_11478	g_24476
ptg000019l	15688332	15692389	4057	g_24476	g_15429
ptg000019l	15693927	15694577	650	g_15429	g_23581
ptg000019l	15702870	15753616	50746	g_23581	g_37730
ptg000019l	15760360	15762650	2290	g_37730	g_16006
ptg000019l	15766044	15766389	345	g_16006	g_40154
ptg000019l	15766825	15795716	28891	g_40154	g_24
ptg000019l	15820440	15829141	8701	g_24	g_15368
ptg000019l	15829458	15849835	20377	g_15368	g_21192
ptg000019l	15864360	16074509	210149	g_21192	g_20669
ptg000019l	16080054	16094822	14768	g_20669	g_15152
ptg000019l	16099999	16104375	4376	g_15152	g_14633
ptg000019l	16109888	16122851	12963	g_14633	g_8654
ptg000019l	16143046	16144486	1440	g_8654	g_33259
ptg000019l	16144686	16148201	3515	g_33259	g_9583
ptg000019l	16152214	16152703	489	g_9583	g_20191
ptg000019l	16156141	16158152	2011	g_20191	g_37295
ptg000019l	16165263	16172963	7700	g_37295	g_32508
ptg000019l	16175089	16177497	2408	g_32508	g_16231
ptg000019l	16180617	16192965	12348	g_16231	g_28273
ptg000019l	16196471	16199353	2882	g_28273	g_20025
ptg000019l	16207533	16214450	6917	g_20025	g_20134
ptg000019l	16221520	16227824	6304	g_20134	g_13878
ptg000019l	16243269	16257127	13858	g_13878	g_629
ptg000019l	16278469	16278951	482	g_629	g_28947
ptg000019l	16281158	16301173	20015	g_28947	g_23712
ptg000019l	16309202	16326498	17296	g_23712	g_1252
ptg000019l	16338202	16342674	4472	g_1252	g_11903
ptg000019l	16343913	16346445	2532	g_11903	g_24742
ptg000019l	16350786	16366742	15956	g_24742	g_22975
ptg000019l	16379978	16400857	20879	g_22975	g_6405
ptg000019l	16401477	16444778	43301	g_6405	g_19580
ptg000019l	16446921	16536425	89504	g_19580	g_7168
ptg000019l	16546397	16565079	18682	g_7168	g_20919
ptg000019l	16584322	16587967	3645	g_20919	g_8325
ptg000019l	16611391	16684964	73573	g_8325	g_13204
ptg000019l	16741172	16745225	4053	g_13204	g_9903
ptg000019l	16764782	16772456	7674	g_9903	g_14558
ptg000019l	16792093	16796033	3940	g_14558	g_4610
ptg000019l	16800245	16803859	3614	g_4610	g_941
ptg000019l	16811501	16870902	59401	g_941	g_32741
ptg000019l	16878296	16881063	2767	g_32741	g_15777
ptg000019l	16899464	16908127	8663	g_15777	g_30764
ptg000019l	16913797	16978957	65160	g_30764	g_18139
ptg000019l	16979265	16993359	14094	g_18139	g_4903
ptg000019l	16993649	17010471	16822	g_4903	g_26834
ptg000019l	17010758	17031786	21028	g_26834	g_10358
ptg000019l	17032010	17034029	2019	g_10358	g_25274
ptg000019l	17042028	17042812	784	g_25274	g_12332
ptg000019l	17045567	17068339	22772	g_12332	g_1984
ptg000019l	17074813	17087140	12327	g_1984	g_20126
ptg000019l	17089806	17181156	91350	g_20126	g_3799
ptg000019l	17201369	17331165	129796	g_3799	g_29529
ptg000019l	17337101	17341098	3997	g_29529	g_10891
ptg000019l	17347869	17353003	5134	g_10891	g_8516
ptg000019l	17356949	17390547	33598	g_8516	g_6888
ptg000019l	17390864	17401864	11000	g_6888	g_11907
ptg000019l	17413415	17422270	8855	g_11907	g_2967
ptg000019l	17446139	17463232	17093	g_2967	g_26496
ptg000019l	17464404	17510818	46414	g_26496	g_7343
ptg000019l	17517497	17558983	41486	g_7343	g_12543
ptg000019l	17560617	17581356	20739	g_12543	g_30585
ptg000019l	17597493	17599216	1723	g_30585	g_2954
ptg000019l	17606250	17620547	14297	g_2954	g_12429
ptg000019l	17633575	17638616	5041	g_12429	g_17306
ptg000019l	17642784	17645308	2524	g_17306	g_16289
ptg000019l	17655702	17686676	30974	g_16289	g_17882
ptg000019l	17687506	17689468	1962	g_17882	g_6064
ptg000019l	17692020	17701602	9582	g_6064	g_7113
ptg000019l	17703023	17799619	96596	g_7113	g_25055
ptg000019l	17799873	17840914	41041	g_25055	g_3242
ptg000019l	17857139	17874166	17027	g_3242	g_24341
ptg000019l	17880385	17883735	3350	g_24341	g_9765
ptg000019l	17892634	17893104	470	g_9765	g_22470
ptg000019l	17897345	17898851	1506	g_22470	g_24013
ptg000019l	17904332	17906013	1681	g_24013	g_29884
ptg000019l	17910760	17911942	1182	g_29884	g_26428
ptg000019l	17913844	17915843	1999	g_26428	g_20339
ptg000019l	17924991	18014394	89403	g_20339	g_19916
ptg000019l	18014681	18078244	63563	g_19916	g_5747
ptg000019l	18079248	18079877	629	g_5747	g_36844
ptg000019l	18089595	18091635	2040	g_36844	g_21945
ptg000019l	18093460	18093514	54	g_21945	g_34910
ptg000019l	18093828	18095019	1191	g_34910	g_31312
ptg000019l	18098789	18102801	4012	g_31312	g_16859
ptg000019l	18106297	18109610	3313	g_16859	g_22825
ptg000019l	18111054	18113713	2659	g_22825	g_9200
ptg000019l	18137875	18151242	13367	g_9200	g_20840
ptg000019l	18152016	18161416	9400	g_20840	g_6432
ptg000019l	18161829	18169210	7381	g_6432	g_10145
ptg000019l	18183231	18238544	55313	g_10145	g_31330
ptg000019l	18244956	18286523	41567	g_31330	g_5989
ptg000019l	18287398	18291308	3910	g_5989	g_35508
ptg000019l	18298271	18300809	2538	g_35508	g_21324
ptg000019l	18304907	18350763	45856	g_21324	g_36609
ptg000019l	18351101	18363660	12559	g_36609	g_1609
ptg000019l	18365010	18381192	16182	g_1609	g_14531
ptg000019l	18402283	18409315	7032	g_14531	g_36781
ptg000019l	18414459	18481503	67044	g_36781	g_21069
ptg000019l	18482399	18492561	10162	g_21069	g_24417
ptg000019l	18492938	18532651	39713	g_24417	g_2287
ptg000019l	18554644	18578294	23650	g_2287	g_17514
ptg000019l	18590529	18609903	19374	g_17514	g_34467
ptg000019l	18611434	18623538	12104	g_34467	g_35152
ptg000019l	18623967	18712501	88534	g_35152	g_26486
ptg000019l	18727838	18735420	7582	g_26486	g_27970
ptg000019l	18739275	18740900	1625	g_27970	g_40269
ptg000019l	18745404	18747128	1724	g_40269	g_6913
ptg000019l	18756339	18839066	82727	g_6913	g_1494
ptg000019l	18840154	18843107	2953	g_1494	g_19732
ptg000019l	18844679	18848443	3764	g_19732	g_30566
ptg000019l	18851429	18854718	3289	g_30566	g_9183
ptg000019l	18855650	18871828	16178	g_9183	g_32756
ptg000019l	18883458	18970276	86818	g_32756	g_14952
ptg000019l	18975117	18976452	1335	g_14952	g_30517
ptg000019l	18978795	18979300	505	g_30517	g_32912
ptg000019l	18982037	18984808	2771	g_32912	g_20858
ptg000019l	18986049	18997624	11575	g_20858	g_5492
ptg000019l	18999159	19022026	22867	g_5492	g_11314
ptg000019l	19027195	19036049	8854	g_11314	g_25671
ptg000019l	19057208	19105213	48005	g_25671	g_36376
ptg000019l	19108014	19114906	6892	g_36376	g_19931
ptg000019l	19118328	19164020	45692	g_19931	g_39145
ptg000019l	19165207	19215927	50720	g_39145	g_28633
ptg000019l	19217858	19230848	12990	g_28633	g_22882
ptg000019l	19236536	19237573	1037	g_22882	g_19577
ptg000019l	19244691	19281692	37001	g_19577	g_9701
ptg000019l	19281970	19302535	20565	g_9701	g_8393
ptg000019l	19323919	19329864	5945	g_8393	g_21292
ptg000019l	19340551	19343508	2957	g_21292	g_804
ptg000019l	19389961	19393310	3349	g_804	g_20592
ptg000019l	19396105	19417471	21366	g_20592	g_6020
ptg000019l	19420969	19455702	34733	g_6020	g_33044
ptg000019l	19456268	19459643	3375	g_33044	g_14016
ptg000019l	19473746	19481911	8165	g_14016	g_4023
ptg000019l	19493764	19543695	49931	g_4023	g_592
ptg000019l	19556886	19597495	40609	g_592	g_16086
ptg000019l	19597701	19599902	2201	g_16086	g_12495
ptg000019l	19602752	19604398	1646	g_12495	g_2863
ptg000019l	19605483	19613710	8227	g_2863	g_5046
ptg000019l	19626936	19629860	2924	g_5046	g_22780
ptg000019l	19631167	19633215	2048	g_22780	g_31834
ptg000019l	19633982	19634638	656	g_31834	g_12080
ptg000019l	19639011	19642186	3175	g_12080	g_37248
ptg000019l	19645789	19647635	1846	g_37248	g_12223
ptg000019l	19649313	19654589	5276	g_12223	g_25858
ptg000019l	19656459	19667721	11262	g_25858	g_32517
ptg000019l	19669428	19669743	315	g_32517	g_33716
ptg000019l	19672064	19732945	60881	g_33716	g_35144
ptg000019l	19747413	19783800	36387	g_35144	g_34122
ptg000019l	19788143	19808858	20715	g_34122	g_31246
ptg000019l	19809271	19930055	120784	g_31246	g_27815
ptg000019l	19931884	19971103	39219	g_27815	g_14800
ptg000019l	19978265	19981419	3154	g_14800	g_4086
ptg000019l	19982117	19984309	2192	g_4086	g_1559
ptg000019l	19985447	19992490	7043	g_1559	g_39930
ptg000019l	19996667	20001151	4484	g_39930	g_21679
ptg000019l	20005868	20007024	1156	g_21679	g_40215
ptg000019l	20007671	20025785	18114	g_40215	g_18472
ptg000019l	20041793	20047467	5674	g_18472	g_30985
ptg000019l	20063998	20070776	6778	g_30985	g_5038
ptg000019l	20071066	20100480	29414	g_5038	g_23873
ptg000019l	20115103	20150196	35093	g_23873	g_38965
ptg000019l	20150767	20204641	53874	g_38965	g_22152
ptg000019l	20205633	20316140	110507	g_22152	g_22304
ptg000019l	20324361	20354494	30133	g_22304	g_22774
ptg000019l	20360183	20364513	4330	g_22774	g_40057
ptg000019l	20366845	20372496	5651	g_40057	g_8727
ptg000019l	20372702	20375470	2768	g_8727	g_8186
ptg000019l	20393796	20403965	10169	g_8186	g_11799
ptg000019l	20407159	20411558	4399	g_11799	g_21240
ptg000019l	20415241	20417746	2505	g_21240	g_5432
ptg000019l	20421795	20423459	1664	g_5432	g_7108
ptg000019l	20425396	20428964	3568	g_7108	g_4979
ptg000019l	20450041	20460377	10336	g_4979	g_27532
ptg000019l	20480716	20485417	4701	g_27532	g_671
ptg000019l	20503509	20588684	85175	g_671	g_3433
ptg000019l	20588890	20629906	41016	g_3433	g_28483
ptg000019l	20630121	20635182	5061	g_28483	g_29202
ptg000019l	20637531	20656990	19459	g_29202	g_748
ptg000019l	20673844	20719972	46128	g_748	g_32493
ptg000019l	20728694	20732548	3854	g_32493	g_10436
ptg000019l	20739309	20747283	7974	g_10436	g_21468
ptg000019l	20747501	20765915	18414	g_21468	g_29814
ptg000019l	20779942	20798003	18061	g_29814	g_21987
ptg000019l	20807441	20816437	8996	g_21987	g_36778
ptg000019l	20862108	20882165	20057	g_36778	g_11363
ptg000019l	20889953	20895763	5810	g_11363	g_689
ptg000019l	20910961	20918126	7165	g_689	g_12814
ptg000019l	20932015	20967297	35282	g_12814	g_15561
ptg000019l	20969542	21036416	66874	g_15561	g_10213
ptg000019l	21037528	21043235	5707	g_10213	g_29213
ptg000019l	21052282	21053226	944	g_29213	g_8181
ptg000019l	21070936	21156246	85310	g_8181	g_39645
ptg000019l	21160915	21162071	1156	g_39645	g_27100
ptg000019l	21163682	21170952	7270	g_27100	g_33311
ptg000019l	21172845	21176127	3282	g_33311	g_17600
ptg000019l	21178386	21188972	10586	g_17600	g_30057
ptg000019l	21193895	21194900	1005	g_30057	g_27605
ptg000019l	21204492	21210950	6458	g_27605	g_16779
ptg000019l	21221953	21233655	11702	g_16779	g_13156
ptg000019l	21234542	21321785	87243	g_13156	g_29280
ptg000019l	21326412	21330756	4344	g_29280	g_16570
ptg000019l	21345106	21396351	51245	g_16570	g_25678
ptg000019l	21397943	21418076	20133	g_25678	g_26018
ptg000019l	21421227	21444806	23579	g_26018	g_10876
ptg000019l	21445676	21463870	18194	g_10876	g_35368
ptg000019l	21467521	21481976	14455	g_35368	g_32963
ptg000019l	21486101	21491216	5115	g_32963	g_23039
ptg000019l	21493266	21500400	7134	g_23039	g_32311
ptg000019l	21505448	21544469	39021	g_32311	g_6065
ptg000019l	21545338	21551454	6116	g_6065	g_9546
ptg000019l	21571427	21573103	1676	g_9546	g_21043
ptg000019l	21587852	21629775	41923	g_21043	g_28091
ptg000019l	21650942	21659211	8269	g_28091	g_34078
ptg000019l	21669948	21674078	4130	g_34078	g_34599
ptg000019l	21681323	21698615	17292	g_34599	g_4339
ptg000019l	21709902	21711536	1634	g_4339	g_14851
ptg000019l	21713903	21717172	3269	g_14851	g_5400
ptg000019l	21720709	21722361	1652	g_5400	g_20164
ptg000019l	21725935	21727059	1124	g_20164	g_2788
ptg000019l	21728868	21731308	2440	g_2788	g_6112
ptg000019l	21736361	21740869	4508	g_6112	g_8553
ptg000019l	21743627	21749275	5648	g_8553	g_14929
ptg000019l	21762610	21781348	18738	g_14929	g_518
ptg000019l	21782515	21946330	163815	g_518	g_26202
ptg000019l	21946653	21981925	35272	g_26202	g_12486
ptg000019l	21982170	22143755	161585	g_12486	g_9039
ptg000019l	22147532	22147875	343	g_9039	g_35786
ptg000019l	22149753	22150500	747	g_35786	g_33479
ptg000019l	22153338	22155205	1867	g_33479	g_35302
ptg000019l	22157013	22158027	1014	g_35302	g_18596
ptg000019l	22160498	22162545	2047	g_18596	g_40011
ptg000019l	22163306	22163811	505	g_40011	g_6227
ptg000019l	22170122	22175213	5091	g_6227	g_31817
ptg000019l	22180123	22280012	99889	g_31817	g_23565
ptg000019l	22280647	22299234	18587	g_23565	g_24499
ptg000019l	22299638	22326139	26501	g_24499	g_4173
ptg000019l	22326360	22373469	47109	g_4173	g_33066
ptg000019l	22379583	22495062	115479	g_33066	g_37757
ptg000019l	22507542	22527709	20167	g_37757	g_34671
ptg000019l	22556064	22560237	4173	g_34671	g_23592
ptg000019l	22567248	22570740	3492	g_23592	g_5662
ptg000019l	22590021	22605944	15923	g_5662	g_9587
ptg000019l	22619681	22619952	271	g_9587	g_1408
ptg000019l	22621976	22623935	1959	g_1408	g_21704
ptg000019l	22624960	22626986	2026	g_21704	g_7312
ptg000019l	22632750	22642100	9350	g_7312	g_13476
ptg000019l	22642999	22829049	186050	g_13476	g_10441
ptg000019l	22830590	22850491	19901	g_10441	g_23881
ptg000019l	22875703	22890712	15009	g_23881	g_20732
ptg000019l	22891878	22931492	39614	g_20732	g_1219
ptg000019l	22931725	22934777	3052	g_1219	g_36813
ptg000019l	22947350	22950628	3278	g_36813	g_3301
ptg000019l	22965468	22970828	5360	g_3301	g_31696
ptg000019l	22977614	22980309	2695	g_31696	g_14126
ptg000019l	22989825	22994018	4193	g_14126	g_10723
ptg000019l	23008576	23012379	3803	g_10723	g_15505
ptg000019l	23031303	23048195	16892	g_15505	g_13715
ptg000019l	23054682	23055718	1036	g_13715	g_7511
ptg000019l	23069748	23143101	73353	g_7511	g_28275
ptg000019l	23149530	23152529	2999	g_28275	g_32458
ptg000019l	23158046	23171507	13461	g_32458	g_33165
ptg000019l	23175276	23180112	4836	g_33165	g_21550
ptg000019l	23193562	23277096	83534	g_21550	g_7887
ptg000019l	23281772	23286584	4812	g_7887	g_7750
ptg000019l	23296079	23301464	5385	g_7750	g_24500
ptg000019l	23309957	23320062	10105	g_24500	g_11112
ptg000019l	23335653	23350046	14393	g_11112	g_11944
ptg000019l	23359792	23360251	459	g_11944	g_1962
ptg000019l	23361198	23364908	3710	g_1962	g_22946
ptg000019l	23366147	23366934	787	g_22946	g_10625
ptg000019l	23371673	23395858	24185	g_10625	g_17253
ptg000019l	23419376	23427840	8464	g_17253	g_20970
ptg000019l	23428139	23429484	1345	g_20970	g_30437
ptg000019l	23432339	23434279	1940	g_30437	g_12003
ptg000019l	23438161	23440239	2078	g_12003	g_37216
ptg000019l	23445147	23462443	17296	g_37216	g_33631
ptg000019l	23466107	23467255	1148	g_33631	g_24345
ptg000019l	23478310	23479756	1446	g_24345	g_40249
ptg000019l	23487336	23498396	11060	g_40249	g_24494
ptg000019l	23509763	23515906	6143	g_24494	g_32101
ptg000019l	23534726	23543851	9125	g_32101	g_36698
ptg000019l	23557355	23661574	104219	g_36698	g_26625
ptg000019l	23678915	23744732	65817	g_26625	g_5419
ptg000019l	23748807	23821602	72795	g_5419	g_23338
ptg000019l	23828130	23853331	25201	g_23338	g_29638
ptg000019l	23861358	23862609	1251	g_29638	g_11429
ptg000019l	23863355	23871303	7948	g_11429	g_37313
ptg000019l	23874743	23878923	4180	g_37313	g_22366
ptg000019l	23888661	23890348	1687	g_22366	g_16951
ptg000019l	23895411	23901205	5794	g_16951	g_8188
ptg000019l	23902416	23958462	56046	g_8188	g_1865
ptg000019l	23962301	23966738	4437	g_1865	g_24571
ptg000019l	23973366	23986717	13351	g_24571	g_26400
ptg000019l	23997167	24091482	94315	g_26400	g_7342
ptg000019l	24097298	24113414	16116	g_7342	g_7388
ptg000019l	24114181	24114841	660	g_7388	g_13662
ptg000019l	24117150	24131318	14168	g_13662	g_20212
ptg000019l	24135928	24137375	1447	g_20212	g_12462
ptg000019l	24153750	24156242	2492	g_12462	g_8824
ptg000019l	24162937	24163614	677	g_8824	g_14400
ptg000019l	24166674	24182093	15419	g_14400	g_28506
ptg000019l	24199826	24206043	6217	g_28506	g_24304
ptg000019l	24206924	24218574	11650	g_24304	g_26934
ptg000019l	24222649	24224920	2271	g_26934	g_3141
ptg000019l	24240575	24274161	33586	g_3141	g_20045
ptg000019l	24280234	24288143	7909	g_20045	g_9487
ptg000019l	24310222	24312386	2164	g_9487	g_19738
ptg000019l	24315571	24361308	45737	g_19738	g_22658
ptg000019l	24370677	24395892	25215	g_22658	g_35502
ptg000019l	24409896	24429654	19758	g_35502	g_33741
ptg000019l	24441501	24558033	116532	g_33741	g_35784
ptg000019l	24559616	24673531	113915	g_35784	g_27551
ptg000019l	24673824	24689020	15196	g_27551	g_24518
ptg000019l	24692881	24796064	103183	g_24518	g_3941
ptg000019l	24800653	24858078	57425	g_3941	g_6991
ptg000019l	24865669	24944910	79241	g_6991	g_24739
ptg000019l	24945191	24947425	2234	g_24739	g_26737
ptg000019l	24947751	24973528	25777	g_26737	g_24501
ptg000019l	24990999	24996528	5529	g_24501	g_33006
ptg000019l	24997088	24998555	1467	g_33006	g_5354
ptg000019l	25002381	25005239	2858	g_5354	g_28328
ptg000019l	25017206	25074545	57339	g_28328	g_29535
ptg000019l	25074823	25075127	304	g_29535	g_14557
ptg000019l	25075831	25076101	270	g_14557	g_13462
ptg000019l	25076607	25114637	38030	g_13462	g_21009
ptg000019l	25122217	25129093	6876	g_21009	g_16210
ptg000020l	257376	338062	80686	g_30289	g_6854
ptg000020l	338304	338851	547	g_6854	g_22039
ptg000020l	339165	345137	5972	g_22039	g_11764
ptg000020l	346378	355261	8883	g_11764	g_23582
ptg000020l	356250	367093	10843	g_23582	g_26236
ptg000020l	368196	451275	83079	g_26236	g_10048
ptg000020l	451526	615405	163879	g_10048	g_1753
ptg000020l	615713	734659	118946	g_1753	g_38130
ptg000020l	735039	765509	30470	g_38130	g_36008
ptg000020l	766117	766467	350	g_36008	g_31496
ptg000020l	766736	872323	105587	g_31496	g_5276
ptg000020l	872604	1043487	170883	g_5276	g_26341
ptg000020l	1044035	1045285	1250	g_26341	g_13823
ptg000020l	1045929	1146655	100726	g_13823	g_34141
ptg000020l	1146927	1148431	1504	g_34141	g_19
ptg000020l	1149432	1428554	279122	g_19	g_29826
ptg000020l	1429072	1437346	8274	g_29826	g_2013
ptg000020l	1437711	1437928	217	g_2013	g_17043
ptg000020l	1438617	1499032	60415	g_17043	g_1144
ptg000020l	1499265	1748011	248746	g_1144	g_31243
ptg000020l	1748253	1756648	8395	g_31243	g_33292
ptg000020l	1760087	1769489	9402	g_33292	g_10807
ptg000020l	1771561	1784268	12707	g_10807	g_2910
ptg000020l	1786095	1789603	3508	g_2910	g_28718
ptg000020l	1789818	1862097	72279	g_28718	g_10106
ptg000020l	1863686	1896036	32350	g_10106	g_4021
ptg000020l	1902562	1965783	63221	g_4021	g_12437
ptg000020l	1967079	1985634	18555	g_12437	g_26084
ptg000020l	1985996	2002711	16715	g_26084	g_11887
ptg000020l	2018627	2037525	18898	g_11887	g_18336
ptg000020l	2037749	2056397	18648	g_18336	g_20481
ptg000020l	2057296	2102850	45554	g_20481	g_2773
ptg000020l	2103236	2161845	58609	g_2773	g_32302
ptg000020l	2162099	2171760	9661	g_32302	g_26338
ptg000020l	2174634	2293143	118509	g_26338	g_2456
ptg000020l	2301646	2326963	25317	g_2456	g_35264
ptg000020l	2327397	2382914	55517	g_35264	g_24194
ptg000020l	2383507	2383608	101	g_24194	g_11809
ptg000020l	2384024	2468925	84901	g_11809	g_14233
ptg000020l	2469590	2472407	2817	g_14233	g_14490
ptg000020l	2476091	2518749	42658	g_14490	g_33163
ptg000020l	2521062	2553005	31943	g_33163	g_7031
ptg000020l	2555859	2589968	34109	g_7031	g_15031
ptg000020l	2590363	2618566	28203	g_15031	g_21399
ptg000020l	2626470	2639640	13170	g_21399	g_37516
ptg000020l	2648605	2669440	20835	g_37516	g_5525
ptg000020l	2679582	2687269	7687	g_5525	g_39999
ptg000020l	2691367	2722798	31431	g_39999	g_29599
ptg000020l	2734201	2735072	871	g_29599	g_5804
ptg000020l	2743030	2783817	40787	g_5804	g_7435
ptg000020l	2786779	2842758	55979	g_7435	g_8970
ptg000020l	2843000	2917408	74408	g_8970	g_12166
ptg000020l	2917962	2932396	14434	g_12166	g_24005
ptg000020l	2933061	2948251	15190	g_24005	g_35855
ptg000020l	2948613	2980674	32061	g_35855	g_20468
ptg000020l	2997124	3039468	42344	g_20468	g_7279
ptg000020l	3041380	3090018	48638	g_7279	g_14352
ptg000020l	3092223	3097731	5508	g_14352	g_40133
ptg000020l	3116535	3122356	5821	g_40133	g_20498
ptg000020l	3128514	3141009	12495	g_20498	g_24954
ptg000020l	3152922	3281735	128813	g_24954	g_20656
ptg000020l	3348017	3386706	38689	g_20656	g_25519
ptg000020l	3388082	3485895	97813	g_25519	g_16344
ptg000020l	3510150	3516325	6175	g_16344	g_36373
ptg000020l	3526239	3537253	11014	g_36373	g_9524
ptg000020l	3540385	3544987	4602	g_9524	g_3910
ptg000020l	3549379	3560386	11007	g_3910	g_31426
ptg000020l	3566078	3605694	39616	g_31426	g_11011
ptg000020l	3621482	3624285	2803	g_11011	g_5488
ptg000020l	3626378	3679782	53404	g_5488	g_32783
ptg000020l	3680057	3698876	18819	g_32783	g_32467
ptg000020l	3699898	3711497	11599	g_32467	g_10206
ptg000020l	3712243	3754108	41865	g_10206	g_33517
ptg000020l	3768562	3778802	10240	g_33517	g_7792
ptg000020l	3779182	3780257	1075	g_7792	g_26510
ptg000020l	3781881	3791635	9754	g_26510	g_7928
ptg000020l	3796415	3798716	2301	g_7928	g_15190
ptg000020l	3809636	3832922	23286	g_15190	g_7369
ptg000020l	3834691	3853703	19012	g_7369	g_35348
ptg000020l	3856822	3869845	13023	g_35348	g_11895
ptg000020l	3870078	3959970	89892	g_11895	g_34724
ptg000020l	3960221	4025577	65356	g_34724	g_10841
ptg000020l	4028486	4046880	18394	g_10841	g_25831
ptg000020l	4063492	4087987	24495	g_25831	g_32696
ptg000020l	4100874	4105404	4530	g_32696	g_15516
ptg000020l	4119324	4121916	2592	g_15516	g_40146
ptg000020l	4134767	4145907	11140	g_40146	g_13827
ptg000020l	4147612	4240921	93309	g_13827	g_18086
ptg000020l	4264760	4301305	36545	g_18086	g_27745
ptg000020l	4302372	4322175	19803	g_27745	g_26352
ptg000020l	4329068	4392595	63527	g_26352	g_31822
ptg000020l	4393071	4533602	140531	g_31822	g_39410
ptg000020l	4533976	4578071	44095	g_39410	g_37098
ptg000020l	4579252	4579475	223	g_37098	g_33172
ptg000020l	4579798	4932592	352794	g_33172	g_20613
ptg000020l	4934079	4974310	40231	g_20613	g_6144
ptg000020l	4979301	5096581	117280	g_6144	g_33205
ptg000020l	5097150	5127439	30289	g_33205	g_3147
ptg000020l	5130579	5157812	27233	g_3147	g_23173
ptg000020l	5158165	5168795	10630	g_23173	g_36686
ptg000020l	5170582	5193170	22588	g_36686	g_17191
ptg000020l	5193679	5195467	1788	g_17191	g_16110
ptg000020l	5195937	5198249	2312	g_16110	g_36430
ptg000020l	5199016	5231935	32919	g_36430	g_30347
ptg000020l	5250339	5263429	13090	g_30347	g_19042
ptg000020l	5282415	5311159	28744	g_19042	g_37358
ptg000020l	5317387	5430086	112699	g_37358	g_11329
ptg000020l	5445746	5515782	70036	g_11329	g_12972
ptg000020l	5530804	5542941	12137	g_12972	g_1690
ptg000020l	5554740	5643710	88970	g_1690	g_5642
ptg000020l	5644219	5688339	44120	g_5642	g_30597
ptg000020l	5707473	5740734	33261	g_30597	g_13029
ptg000020l	5744901	5831996	87095	g_13029	g_12859
ptg000020l	5836510	5844599	8089	g_12859	g_2853
ptg000020l	5845087	5908196	63109	g_2853	g_37263
ptg000020l	5911150	5913041	1891	g_37263	g_28661
ptg000020l	5914333	6038115	123782	g_28661	g_8976
ptg000020l	6038549	6162518	123969	g_8976	g_3534
ptg000020l	6184890	6201360	16470	g_3534	g_18652
ptg000020l	6213542	6292911	79369	g_18652	g_4588
ptg000020l	6306417	6330442	24025	g_4588	g_11355
ptg000020l	6333447	6495193	161746	g_11355	g_9242
ptg000020l	6495615	6612719	117104	g_9242	g_13091
ptg000020l	6612958	6729144	116186	g_13091	g_19423
ptg000020l	6743447	6891974	148527	g_19423	g_8291
ptg000020l	6892921	6959047	66126	g_8291	g_12279
ptg000020l	6959421	7030043	70622	g_12279	g_15379
ptg000020l	7030480	7141706	111226	g_15379	g_17352
ptg000020l	7142521	7144127	1606	g_17352	g_818
ptg000020l	7145341	7366133	220792	g_818	g_6820
ptg000020l	7366615	7405584	38969	g_6820	g_37853
ptg000020l	7406054	7408494	2440	g_37853	g_5657
ptg000020l	7408961	7447295	38334	g_5657	g_3786
ptg000020l	7447696	7448337	641	g_3786	g_38208
ptg000020l	7448744	7757908	309164	g_38208	g_16193
ptg000020l	7766772	7980257	213485	g_16193	g_27280
ptg000020l	7981513	8072034	90521	g_27280	g_39040
ptg000020l	8072258	8088210	15952	g_39040	g_2428
ptg000020l	8088668	8114678	26010	g_2428	g_37584
ptg000020l	8180438	8251528	71090	g_37584	g_18490
ptg000020l	8251764	8294609	42845	g_18490	g_9374
ptg000020l	8314943	8324485	9542	g_9374	g_17244
ptg000020l	8339035	8343947	4912	g_17244	g_26739
ptg000020l	8344210	8385699	41489	g_26739	g_12354
ptg000020l	8390812	8431942	41130	g_12354	g_20513
ptg000020l	8440792	8444961	4169	g_20513	g_31332
ptg000020l	8451945	8458683	6738	g_31332	g_19693
ptg000020l	8468800	8578782	109982	g_19693	g_32921
ptg000020l	8579684	8580870	1186	g_32921	g_27763
ptg000020l	8602824	8649290	46466	g_27763	g_2886
ptg000020l	8665021	8681410	16389	g_2886	g_18122
ptg000020l	8689322	8692795	3473	g_18122	g_33075
ptg000020l	8704603	8705505	902	g_33075	g_20277
ptg000020l	8710930	8732501	21571	g_20277	g_21978
ptg000020l	8749074	8771151	22077	g_21978	g_8074
ptg000020l	8787420	8802990	15570	g_8074	g_7043
ptg000020l	8803445	8809467	6022	g_7043	g_10096
ptg000020l	8809895	8823154	13259	g_10096	g_29362
ptg000020l	8823462	8847213	23751	g_29362	g_7625
ptg000020l	8848923	8922544	73621	g_7625	g_28809
ptg000020l	8933334	8946796	13462	g_28809	g_1410
ptg000020l	8956887	8960005	3118	g_1410	g_39924
ptg000020l	8962056	8976922	14866	g_39924	g_24396
ptg000020l	8981220	8986335	5115	g_24396	g_458
ptg000020l	8995721	8999524	3803	g_458	g_30660
ptg000020l	9000294	9015999	15705	g_30660	g_6086
ptg000020l	9021751	9026237	4486	g_6086	g_26627
ptg000020l	9039218	9042717	3499	g_26627	g_30189
ptg000020l	9045004	9046749	1745	g_30189	g_29125
ptg000020l	9047225	9082526	35301	g_29125	g_20088
ptg000020l	9083362	9142575	59213	g_20088	g_850
ptg000020l	9148253	9210343	62090	g_850	g_33665
ptg000020l	9211413	9373835	162422	g_33665	g_15610
ptg000020l	9374353	9409620	35267	g_15610	g_30710
ptg000020l	9410438	9418948	8510	g_30710	g_17745
ptg000020l	9443181	9445872	2691	g_17745	g_37571
ptg000020l	9446495	9462436	15941	g_37571	g_9366
ptg000020l	9470053	9474888	4835	g_9366	g_35684
ptg000020l	9479542	9482956	3414	g_35684	g_21689
ptg000020l	9491698	9502365	10667	g_21689	g_28882
ptg000020l	9516548	9533925	17377	g_28882	g_23287
ptg000020l	9551965	9569398	17433	g_23287	g_14220
ptg000020l	9574568	9603574	29006	g_14220	g_33297
ptg000020l	9603801	9609545	5744	g_33297	g_31197
ptg000020l	9615394	9643924	28530	g_31197	g_28160
ptg000020l	9654156	9654987	831	g_28160	g_12931
ptg000020l	9659545	9679562	20017	g_12931	g_14256
ptg000020l	9679903	9789330	109427	g_14256	g_4196
ptg000020l	9789659	9813432	23773	g_4196	g_10821
ptg000020l	9813644	9825696	12052	g_10821	g_2041
ptg000020l	9825986	9992638	166652	g_2041	g_24874
ptg000020l	10001817	10007870	6053	g_24874	g_30054
ptg000020l	10011426	10034784	23358	g_30054	g_29862
ptg000020l	10045234	10051437	6203	g_29862	g_33185
ptg000020l	10054142	10061907	7765	g_33185	g_34373
ptg000020l	10070653	10128092	57439	g_34373	g_35945
ptg000020l	10150700	10150782	82	g_35945	g_13248
ptg000020l	10151075	10156036	4961	g_13248	g_28830
ptg000020l	10163774	10190988	27214	g_28830	g_1696
ptg000020l	10201374	10212862	11488	g_1696	g_21156
ptg000020l	10222455	10239361	16906	g_21156	g_27378
ptg000020l	10249015	10300489	51474	g_27378	g_11223
ptg000020l	10302425	10307618	5193	g_11223	g_12802
ptg000020l	10320368	10347486	27118	g_12802	g_20847
ptg000020l	10347994	10351538	3544	g_20847	g_2519
ptg000020l	10352105	10355638	3533	g_2519	g_6413
ptg000020l	10356205	10359749	3544	g_6413	g_19371
ptg000020l	10360317	10369923	9606	g_19371	g_14836
ptg000020l	10370521	10380876	10355	g_14836	g_6925
ptg000020l	10381444	10385182	3738	g_6925	g_34063
ptg000020l	10385750	10389773	4023	g_34063	g_12078
ptg000020l	10390431	10401441	11010	g_12078	g_3797
ptg000020l	10402029	10405663	3634	g_3797	g_12848
ptg000020l	10406261	10408426	2165	g_12848	g_13484
ptg000020l	10421855	10460185	38330	g_13484	g_18057
ptg000020l	10468931	10482573	13642	g_18057	g_36268
ptg000020l	10504349	10505416	1067	g_36268	g_20868
ptg000020l	10506750	10511224	4474	g_20868	g_3806
ptg000020l	10515014	10849384	334370	g_3806	g_9836
ptg000020l	10849790	10891143	41353	g_9836	g_8756
ptg000020l	10891517	11157580	266063	g_8756	g_620
ptg000020l	11187321	11204195	16874	g_620	g_32094
ptg000020l	11206465	11208751	2286	g_32094	g_12148
ptg000020l	11210499	11216181	5682	g_12148	g_22934
ptg000020l	11224493	11267140	42647	g_22934	g_26980
ptg000020l	11267376	11281836	14460	g_26980	g_29745
ptg000020l	11282471	11332682	50211	g_29745	g_33105
ptg000020l	11332987	11334981	1994	g_33105	g_2198
ptg000020l	11353844	11386703	32859	g_2198	g_14100
ptg000020l	11386954	11521667	134713	g_14100	g_33655
ptg000020l	11521915	11531351	9436	g_33655	g_8407
ptg000020l	11532886	11538647	5761	g_8407	g_32227
ptg000020l	11543711	11547188	3477	g_32227	g_12668
ptg000020l	11550436	11633294	82858	g_12668	g_30959
ptg000020l	11647724	11663165	15441	g_30959	g_13104
ptg000020l	11696520	11725845	29325	g_13104	g_31869
ptg000020l	11752828	11767921	15093	g_31869	g_22483
ptg000020l	11772116	11785723	13607	g_22483	g_19260
ptg000020l	11787405	11806053	18648	g_19260	g_4542
ptg000020l	11807219	11810822	3603	g_4542	g_16532
ptg000020l	11828990	11830483	1493	g_16532	g_18049
ptg000020l	11840649	11843201	2552	g_18049	g_12054
ptg000020l	11844142	11849192	5050	g_12054	g_9446
ptg000020l	11850148	11891140	40992	g_9446	g_10334
ptg000020l	11891382	11892735	1353	g_10334	g_9406
ptg000020l	11963229	11984335	21106	g_9406	g_29708
ptg000020l	11989592	11992224	2632	g_29708	g_7788
ptg000020l	11992922	12018677	25755	g_7788	g_38850
ptg000020l	12025745	12199513	173768	g_38850	g_8367
ptg000020l	12219242	12221562	2320	g_8367	g_30373
ptg000020l	12241283	12257815	16532	g_30373	g_23808
ptg000020l	12271179	12453754	182575	g_23808	g_62
ptg000020l	12463107	12551161	88054	g_62	g_4064
ptg000020l	12551394	12551598	204	g_4064	g_2320
ptg000020l	12572010	12591498	19488	g_2320	g_31199
ptg000020l	12591824	12609021	17197	g_31199	g_16117
ptg000020l	12612902	12616531	3629	g_16117	g_1454
ptg000020l	12624186	12667758	43572	g_1454	g_20624
ptg000020l	12674353	12695925	21572	g_20624	g_20049
ptg000020l	12699122	12703559	4437	g_20049	g_33941
ptg000020l	12708566	12753573	45007	g_33941	g_19764
ptg000020l	12754133	12767745	13612	g_19764	g_4304
ptg000020l	12768704	12938872	170168	g_4304	g_34261
ptg000020l	12941147	13008204	67057	g_34261	g_40201
ptg000020l	13013660	13017348	3688	g_40201	g_19635
ptg000020l	13027161	13037270	10109	g_19635	g_19077
ptg000020l	13064684	13088239	23555	g_19077	g_6246
ptg000020l	13094452	13118721	24269	g_6246	g_33905
ptg000020l	13119161	13130072	10911	g_33905	g_2805
ptg000020l	13139893	13143429	3536	g_2805	g_11321
ptg000020l	13172878	13220250	47372	g_11321	g_26353
ptg000020l	13222457	13226185	3728	g_26353	g_23276
ptg000020l	13226736	13237213	10477	g_23276	g_15097
ptg000020l	13239851	13252761	12910	g_15097	g_30466
ptg000020l	13268031	13270960	2929	g_30466	g_205
ptg000020l	13276184	13281291	5107	g_205	g_21064
ptg000020l	13300914	13317597	16683	g_21064	g_36104
ptg000020l	13323327	13347323	23996	g_36104	g_28463
ptg000020l	13348549	13376978	28429	g_28463	g_34518
ptg000020l	13377751	13395294	17543	g_34518	g_9999
ptg000020l	13396979	13420693	23714	g_9999	g_21594
ptg000020l	13422177	13435288	13111	g_21594	g_2946
ptg000020l	13436736	13534772	98036	g_2946	g_20440
ptg000020l	13535359	13541427	6068	g_20440	g_4955
ptg000020l	13544669	13552247	7578	g_4955	g_25048
ptg000020l	13555962	13560634	4672	g_25048	g_36934
ptg000020l	13561719	13563720	2001	g_36934	g_34591
ptg000020l	13569894	13582076	12182	g_34591	g_15443
ptg000020l	13587697	13603636	15939	g_15443	g_31874
ptg000020l	13604766	13700373	95607	g_31874	g_1768
ptg000020l	13700621	13825150	124529	g_1768	g_17300
ptg000020l	13838715	13850118	11403	g_17300	g_1836
ptg000020l	13853821	13856863	3042	g_1836	g_33028
ptg000020l	13871682	13873897	2215	g_33028	g_20200
ptg000020l	13878254	13887579	9325	g_20200	g_36957
ptg000020l	13888037	13888079	42	g_36957	g_27984
ptg000020l	13891276	14079252	187976	g_27984	g_29091
ptg000020l	14079641	14090646	11005	g_29091	g_10338
ptg000020l	14090999	14091349	350	g_10338	g_34094
ptg000020l	14091915	14129302	37387	g_34094	g_26754
ptg000020l	14129973	14153298	23325	g_26754	g_12680
ptg000020l	14159907	14165832	5925	g_12680	g_24076
ptg000020l	14176391	14181551	5160	g_24076	g_29156
ptg000020l	14181754	14188818	7064	g_29156	g_9287
ptg000020l	14198636	14202747	4111	g_9287	g_15445
ptg000020l	14203046	14263605	60559	g_15445	g_14008
ptg000020l	14280875	14286348	5473	g_14008	g_32821
ptg000020l	14295885	14299199	3314	g_32821	g_25943
ptg000020l	14313809	14316775	2966	g_25943	g_1460
ptg000020l	14318944	14321949	3005	g_1460	g_9420
ptg000020l	14334875	14344640	9765	g_38376	g_7831
ptg000020l	14350080	14353222	3142	g_7831	g_30025
ptg000020l	14366710	14425388	58678	g_30025	g_25941
ptg000020l	14426059	14560700	134641	g_25941	g_37450
ptg000020l	14560975	14564391	3416	g_37450	g_16671
ptg000020l	14566859	14584729	17870	g_16671	g_29008
ptg000020l	14592191	14593396	1205	g_29008	g_713
ptg000020l	14603652	14605688	2036	g_713	g_15545
ptg000020l	14608269	14610827	2558	g_15545	g_25104
ptg000020l	14613524	14615911	2387	g_25104	g_13554
ptg000020l	14628429	14632730	4301	g_13554	g_14344
ptg000020l	14634770	14647601	12831	g_14344	g_36958
ptg000020l	14664026	14705706	41680	g_36958	g_26003
ptg000020l	14707416	14728821	21405	g_26003	g_31384
ptg000020l	14735851	14957944	222093	g_31384	g_8573
ptg000020l	14958495	15225078	266583	g_8573	g_21175
ptg000020l	15240348	15240696	348	g_21175	g_40211
ptg000020l	15240932	15245117	4185	g_40211	g_18212
ptg000020l	15250686	15253682	2996	g_18212	g_8637
ptg000020l	15259144	15282145	23001	g_8637	g_26542
ptg000020l	15300990	15330474	29484	g_26542	g_31437
ptg000020l	15337999	15399279	61280	g_31437	g_31997
ptg000020l	15403951	15419485	15534	g_31997	g_13680
ptg000020l	15429582	15556869	127287	g_13680	g_3895
ptg000020l	15570001	15579357	9356	g_3895	g_15808
ptg000020l	15588969	15595697	6728	g_15808	g_28473
ptg000020l	15609204	15629825	20621	g_28473	g_1849
ptg000020l	15630931	15686193	55262	g_1849	g_14188
ptg000020l	15699389	15717229	17840	g_14188	g_1151
ptg000020l	15718449	15758389	39940	g_1151	g_23876
ptg000020l	15765391	15775701	10310	g_23876	g_12026
ptg000020l	15779492	15798660	19168	g_12026	g_9802
ptg000020l	15816196	15822997	6801	g_9802	g_23467
ptg000020l	15847736	15853593	5857	g_23467	g_23101
ptg000020l	15855329	15858325	2996	g_23101	g_22899
ptg000020l	15861375	15863236	1861	g_22899	g_3335
ptg000020l	15867614	15887466	19852	g_3335	g_27246
ptg000020l	15890205	15933839	43634	g_27246	g_4055
ptg000020l	15934276	16027081	92805	g_4055	g_30409
ptg000020l	16035889	16044670	8781	g_30409	g_10302
ptg000020l	16051384	16069257	17873	g_10302	g_35347
ptg000020l	16072396	16088950	16554	g_35347	g_14417
ptg000020l	16113002	16115745	2743	g_14417	g_16001
ptg000020l	16118043	16133519	15476	g_16001	g_22598
ptg000020l	16133725	16257466	123741	g_22598	g_22312
ptg000020l	16257723	16259299	1576	g_22312	g_37159
ptg000020l	16265173	16328269	63096	g_37159	g_31985
ptg000020l	16329773	16381796	52023	g_31985	g_375
ptg000020l	16392796	16407346	14550	g_39217	g_14850
ptg000020l	16407828	16480265	72437	g_14850	g_19742
ptg000020l	16496848	16498369	1521	g_19742	g_3782
ptg000020l	16499506	16508780	9274	g_3782	g_18216
ptg000020l	16519776	16584737	64961	g_18216	g_22073
ptg000020l	16584982	16608841	23859	g_22073	g_36747
ptg000020l	16619328	16639937	20609	g_36747	g_31663
ptg000020l	16642962	16652621	9659	g_31663	g_6711
ptg000020l	16656834	16658486	1652	g_6711	g_12548
ptg000020l	16665565	16670931	5366	g_12548	g_2911
ptg000020l	16676420	16692983	16563	g_2911	g_4492
ptg000020l	16693183	16696491	3308	g_4492	g_35318
ptg000020l	16701480	16708167	6687	g_35318	g_37499
ptg000020l	16721877	16733832	11955	g_37499	g_63
ptg000020l	16752467	16758167	5700	g_63	g_2422
ptg000020l	16759021	16839246	80225	g_2422	g_27008
ptg000020l	16839494	16852508	13014	g_27008	g_33351
ptg000020l	16871976	16932942	60966	g_33351	g_31785
ptg000020l	16934920	16941240	6320	g_31785	g_6285
ptg000020l	16959441	16983108	23667	g_6285	g_11237
ptg000020l	16987193	16992199	5006	g_11237	g_25985
ptg000020l	16995032	16999639	4607	g_25985	g_20611
ptg000020l	17003840	17016746	12906	g_20611	g_13659
ptg000020l	17018340	17040604	22264	g_13659	g_7107
ptg000020l	17043323	17048338	5015	g_7107	g_22338
ptg000020l	17058472	17060803	2331	g_22338	g_8834
ptg000020l	17066834	17079429	12595	g_8834	g_14780
ptg000020l	17080618	17084578	3960	g_14780	g_32811
ptg000020l	17096377	17101779	5402	g_32811	g_19551
ptg000020l	17112248	17116250	4002	g_19551	g_37857
ptg000020l	17124241	17125911	1670	g_37857	g_35510
ptg000020l	17128903	17130031	1128	g_35510	g_19664
ptg000020l	17136076	17137988	1912	g_19664	g_8934
ptg000020l	17156026	17158796	2770	g_8934	g_40061
ptg000020l	17160049	17163650	3601	g_40061	g_33576
ptg000020l	17167664	17195488	27824	g_33576	g_6263
ptg000020l	17196594	17214460	17866	g_6263	g_15312
ptg000020l	17219158	17230878	11720	g_15312	g_27758
ptg000020l	17231300	17234134	2834	g_27758	g_1349
ptg000020l	17237439	17240481	3042	g_1349	g_25635
ptg000020l	17248950	17252039	3089	g_25635	g_27504
ptg000020l	17254609	17257810	3201	g_27504	g_38172
ptg000020l	17261762	17268744	6982	g_38172	g_21090
ptg000020l	17274393	17280589	6196	g_21090	g_18914
ptg000020l	17285646	17287921	2275	g_18914	g_29396
ptg000020l	17295960	17309535	13575	g_29396	g_24971
ptg000020l	17312663	17314634	1971	g_24971	g_31581
ptg000020l	17319992	17335458	15466	g_31581	g_40265
ptg000020l	17339402	17343810	4408	g_40265	g_27240
ptg000020l	17349327	17358290	8963	g_27240	g_3819
ptg000020l	17366774	17369042	2268	g_3819	g_13796
ptg000020l	17374523	17384020	9497	g_13796	g_30400
ptg000020l	17390615	17394796	4181	g_30400	g_5752
ptg000020l	17410742	17415024	4282	g_5752	g_3337
ptg000020l	17427720	17434820	7100	g_3337	g_9788
ptg000020l	17449996	17472937	22941	g_9788	g_21875
ptg000020l	17487377	17494933	7556	g_21875	g_40256
ptg000020l	17510292	17512896	2604	g_40256	g_25449
ptg000020l	17518840	17523525	4685	g_25449	g_2459
ptg000020l	17537375	17568853	31478	g_2459	g_29400
ptg000020l	17577139	17583605	6466	g_29400	g_27172
ptg000020l	17586728	17592451	5723	g_27172	g_22020
ptg000020l	17613732	17695764	82032	g_22020	g_23014
ptg000020l	17696780	17698978	2198	g_23014	g_10217
ptg000020l	17716254	17733747	17493	g_10217	g_29735
ptg000020l	17734098	17751834	17736	g_29735	g_4470
ptg000020l	17759914	17761190	1276	g_4470	g_31620
ptg000020l	17763904	17765108	1204	g_31620	g_24037
ptg000020l	17766749	17767291	542	g_24037	g_16982
ptg000020l	17771828	17834192	62364	g_16982	g_13018
ptg000020l	17836333	17838202	1869	g_13018	g_30217
ptg000020l	17845912	17846904	992	g_30217	g_4762
ptg000020l	17910401	17914324	3923	g_4762	g_29723
ptg000020l	17916760	17919993	3233	g_29723	g_2433
ptg000021l	82686	131134	48448	g_22818	g_874
ptg000021l	137881	142384	4503	g_874	g_15070
ptg000021l	148855	157278	8423	g_15070	g_29520
ptg000021l	161220	162874	1654	g_29520	g_9629
ptg000021l	169872	176488	6616	g_9629	g_40073
ptg000021l	184864	189143	4279	g_40073	g_36911
ptg000021l	189616	196506	6890	g_36911	g_27990
ptg000021l	198553	205624	7071	g_27990	g_13167
ptg000021l	209119	209434	315	g_13167	g_11030
ptg000021l	224692	227483	2791	g_11030	g_6910
ptg000021l	231687	324659	92972	g_6910	g_36938
ptg000021l	328754	354320	25566	g_36938	g_13678
ptg000021l	370505	421959	51454	g_13678	g_32268
ptg000021l	430839	433952	3113	g_32268	g_11687
ptg000021l	443867	449152	5285	g_11687	g_14695
ptg000021l	451524	453185	1661	g_14695	g_12673
ptg000021l	454471	468678	14207	g_12673	g_30905
ptg000021l	473097	487682	14585	g_30905	g_26396
ptg000021l	492943	502737	9794	g_26396	g_11725
ptg000021l	503864	505313	1449	g_11725	g_494
ptg000021l	505861	507545	1684	g_494	g_26268
ptg000021l	508504	521242	12738	g_26268	g_6915
ptg000021l	523967	525064	1097	g_6915	g_33176
ptg000021l	532838	637373	104535	g_33176	g_24988
ptg000021l	638221	651485	13264	g_24988	g_2941
ptg000021l	654394	656185	1791	g_2941	g_7923
ptg000021l	661628	664183	2555	g_7923	g_17830
ptg000021l	665466	711884	46418	g_17830	g_4479
ptg000021l	713903	717522	3619	g_4479	g_312
ptg000021l	725356	745434	20078	g_312	g_26110
ptg000021l	747078	855734	108656	g_26110	g_30104
ptg000021l	856222	866849	10627	g_30104	g_13229
ptg000021l	868843	1038106	169263	g_13229	g_37290
ptg000021l	1045340	1081235	35895	g_37290	g_29134
ptg000021l	1090767	1113964	23197	g_29134	g_38351
ptg000021l	1135511	1278610	143099	g_38351	g_21499
ptg000021l	1298569	1303917	5348	g_21499	g_25005
ptg000021l	1315155	1339275	24120	g_25005	g_33102
ptg000021l	1344449	1346532	2083	g_33102	g_8534
ptg000021l	1350420	1351515	1095	g_8534	g_40234
ptg000021l	1354413	1356639	2226	g_40234	g_23127
ptg000021l	1356881	1368546	11665	g_23127	g_6011
ptg000021l	1371633	1388794	17161	g_6011	g_10189
ptg000021l	1390547	1393301	2754	g_10189	g_28657
ptg000021l	1395705	1398921	3216	g_28657	g_9842
ptg000021l	1404296	1408216	3920	g_9842	g_11762
ptg000021l	1425485	1433785	8300	g_11762	g_38087
ptg000021l	1437576	1441579	4003	g_38087	g_35626
ptg000021l	1457817	1472434	14617	g_35626	g_23554
ptg000021l	1476900	1477664	764	g_23554	g_6331
ptg000021l	1487007	1508090	21083	g_6331	g_27578
ptg000021l	1509727	1520071	10344	g_27578	g_32752
ptg000021l	1521497	1529174	7677	g_32752	g_16933
ptg000021l	1533915	1550731	16816	g_16933	g_30183
ptg000021l	1556583	1557885	1302	g_30183	g_13652
ptg000021l	1565545	1566577	1032	g_13652	g_25559
ptg000021l	1571602	1582767	11165	g_25559	g_5885
ptg000021l	1599527	1638896	39369	g_5885	g_8368
ptg000021l	1666346	1680587	14241	g_8368	g_9476
ptg000021l	1686608	1728567	41959	g_9476	g_35166
ptg000021l	1742919	1745486	2567	g_35166	g_7406
ptg000021l	1748275	1749011	736	g_7406	g_40031
ptg000021l	1752581	1755294	2713	g_40031	g_37241
ptg000021l	1760218	1765185	4967	g_37241	g_28969
ptg000021l	1775296	1789458	14162	g_28969	g_12519
ptg000021l	1789766	1854463	64697	g_12519	g_21569
ptg000021l	1856503	1858835	2332	g_21569	g_21951
ptg000021l	1860853	1938490	77637	g_21951	g_8386
ptg000021l	1951624	2073568	121944	g_8386	g_28184
ptg000021l	2073867	2102926	29059	g_28184	g_10125
ptg000021l	2103129	2105508	2379	g_10125	g_1551
ptg000021l	2105741	2160808	55067	g_1551	g_31322
ptg000021l	2164951	2290024	125073	g_31322	g_18474
ptg000021l	2290233	2356467	66234	g_18474	g_11753
ptg000021l	2357913	2439920	82007	g_11753	g_39972
ptg000021l	2445910	2445932	22	g_39972	g_4113
ptg000021l	2446471	2450432	3961	g_4113	g_967
ptg000021l	2468139	2481989	13850	g_967	g_39517
ptg000021l	2483351	2488645	5294	g_39517	g_26495
ptg000021l	2497630	2503655	6025	g_26495	g_30100
ptg000021l	2508926	2625493	116567	g_30100	g_13380
ptg000021l	2626244	2646026	19782	g_13380	g_19527
ptg000021l	2649528	2678540	29012	g_19527	g_27438
ptg000021l	2680469	2707316	26847	g_27438	g_24519
ptg000021l	2715977	2719455	3478	g_24519	g_15008
ptg000021l	2738946	2798385	59439	g_15008	g_6517
ptg000021l	2803664	2805607	1943	g_6517	g_32315
ptg000021l	2817457	2829466	12009	g_32315	g_1273
ptg000021l	2832452	2833624	1172	g_1273	g_32658
ptg000021l	2835201	2874810	39609	g_32658	g_4786
ptg000021l	2893281	2896979	3698	g_4786	g_10245
ptg000021l	2899579	2900414	835	g_10245	g_3650
ptg000021l	2910283	2915169	4886	g_3650	g_10537
ptg000021l	2918220	2968549	50329	g_10537	g_8241
ptg000021l	2975551	2978505	2954	g_8241	g_35107
ptg000021l	2980553	2984704	4151	g_35107	g_22286
ptg000021l	2987919	2989669	1750	g_22286	g_3045
ptg000021l	2998857	3008582	9725	g_3045	g_14203
ptg000021l	3012258	3012958	700	g_14203	g_26469
ptg000021l	3013785	3014662	877	g_26469	g_2502
ptg000021l	3018589	3022876	4287	g_2502	g_3791
ptg000021l	3025869	3028362	2493	g_3791	g_13677
ptg000021l	3034558	3035167	609	g_13677	g_40127
ptg000021l	3036738	3038376	1638	g_40127	g_20569
ptg000021l	3082080	3097539	15459	g_20569	g_4199
ptg000021l	3101296	3102980	1684	g_4199	g_784
ptg000021l	3109046	3110541	1495	g_784	g_8926
ptg000021l	3128219	3142421	14202	g_8926	g_9225
ptg000021l	3151539	3153668	2129	g_9225	g_6927
ptg000021l	3162691	3254937	92246	g_6927	g_12736
ptg000021l	3256283	3272426	16143	g_12736	g_36949
ptg000021l	3272677	3298155	25478	g_36949	g_18771
ptg000021l	3298427	3501535	203108	g_18771	g_82
ptg000021l	3504840	3536200	31360	g_82	g_35136
ptg000021l	3537141	3564723	27582	g_35136	g_12939
ptg000021l	3573622	3575081	1459	g_12939	g_10523
ptg000021l	3576355	3610514	34159	g_10523	g_32655
ptg000021l	3629802	3643638	13836	g_32655	g_17964
ptg000021l	3655409	3673963	18554	g_17964	g_6953
ptg000021l	3691738	3693005	1267	g_6953	g_10330
ptg000021l	3695291	3697273	1982	g_10330	g_39187
ptg000021l	3698506	3699141	635	g_39187	g_26682
ptg000021l	3701805	3704809	3004	g_26682	g_33171
ptg000021l	3708355	3709473	1118	g_33171	g_22680
ptg000021l	3713156	3714257	1101	g_22680	g_40226
ptg000021l	3717195	3718762	1567	g_40226	g_10031
ptg000021l	3724283	3733355	9072	g_10031	g_35521
ptg000021l	3744612	3751668	7056	g_35521	g_2415
ptg000021l	3759638	3760766	1128	g_2415	g_39942
ptg000021l	3762075	3772343	10268	g_39942	g_27505
ptg000021l	3777138	3808914	31776	g_27505	g_23667
ptg000021l	3813385	3818189	4804	g_23667	g_23979
ptg000021l	3825353	3838269	12916	g_23979	g_2817
ptg000021l	3842737	3850649	7912	g_2817	g_37471
ptg000021l	3857729	3858025	296	g_37471	g_19585
ptg000021l	3860567	3862064	1497	g_19585	g_40199
ptg000021l	3864390	3867504	3114	g_40199	g_30310
ptg000021l	3875270	3888056	12786	g_30310	g_34893
ptg000021l	3888967	3899490	10523	g_34893	g_868
ptg000021l	3901604	3903937	2333	g_868	g_19906
ptg000021l	3915575	3961576	46001	g_19906	g_15778
ptg000021l	3964201	3964643	442	g_15778	g_20518
ptg000021l	3967829	3968997	1168	g_20518	g_8639
ptg000021l	3971186	3976387	5201	g_8639	g_13445
ptg000021l	3982386	3984255	1869	g_13445	g_27657
ptg000021l	3996205	4000049	3844	g_27657	g_33871
ptg000021l	4000927	4021713	20786	g_33871	g_19593
ptg000021l	4025919	4026205	286	g_19593	g_30815
ptg000021l	4029996	4030858	862	g_30815	g_3065
ptg000021l	4034775	4040134	5359	g_3065	g_836
ptg000021l	4045628	4047804	2176	g_836	g_27303
ptg000021l	4065694	4078781	13087	g_27303	g_33429
ptg000021l	4103596	4167176	63580	g_33429	g_4514
ptg000021l	4175434	4178391	2957	g_4514	g_5782
ptg000021l	4180561	4180920	359	g_5782	g_357
ptg000021l	4184188	4185565	1377	g_357	g_9978
ptg000021l	4189342	4189962	620	g_9978	g_3718
ptg000021l	4194478	4196270	1792	g_3718	g_11659
ptg000021l	4197868	4204969	7101	g_11659	g_4127
ptg000021l	4205169	4264829	59660	g_4127	g_25655
ptg000021l	4265395	4290129	24734	g_25655	g_37095
ptg000021l	4299113	4301433	2320	g_37095	g_10732
ptg000021l	4303899	4326542	22643	g_10732	g_9751
ptg000021l	4327118	4348491	21373	g_9751	g_15350
ptg000021l	4348691	4362437	13746	g_15350	g_14270
ptg000021l	4368430	4372099	3669	g_14270	g_1542
ptg000021l	4377264	4380987	3723	g_1542	g_6282
ptg000021l	4384520	4437731	53211	g_6282	g_15767
ptg000021l	4440194	4449503	9309	g_15767	g_40152
ptg000021l	4455018	4514989	59971	g_40152	g_6787
ptg000021l	4533603	4535067	1464	g_6787	g_11509
ptg000021l	4539398	4542519	3121	g_11509	g_36316
ptg000021l	4544984	4546783	1799	g_36316	g_40248
ptg000021l	4553163	4555393	2230	g_40248	g_24293
ptg000021l	4558783	4559029	246	g_24293	g_8125
ptg000021l	4564713	4565694	981	g_8125	g_27461
ptg000021l	4568556	4569354	798	g_27461	g_36880
ptg000021l	4571587	4572236	649	g_36880	g_26959
ptg000021l	4583484	4586793	3309	g_26959	g_20050
ptg000021l	4588239	4589551	1312	g_20050	g_3321
ptg000021l	4591031	4627363	36332	g_3321	g_31139
ptg000021l	4644334	4651553	7219	g_31139	g_35916
ptg000021l	4655244	4659766	4522	g_35916	g_29902
ptg000021l	4660950	4680131	19181	g_29902	g_11105
ptg000021l	4689490	4760968	71478	g_11105	g_29739
ptg000021l	4764894	4771999	7105	g_29739	g_32328
ptg000021l	4781372	4784085	2713	g_32328	g_11207
ptg000021l	4789779	4793922	4143	g_11207	g_12038
ptg000021l	4797915	4813375	15460	g_12038	g_2574
ptg000021l	4822919	4837063	14144	g_2574	g_5568
ptg000021l	4838555	4839114	559	g_5568	g_14841
ptg000021l	4842864	4854977	12113	g_14841	g_12118
ptg000021l	4861428	4864975	3547	g_12118	g_24094
ptg000021l	4875839	4878951	3112	g_24094	g_18612
ptg000021l	4883942	4904386	20444	g_18612	g_11742
ptg000021l	4910346	4912133	1787	g_11742	g_24941
ptg000021l	4934523	4938757	4234	g_24941	g_4716
ptg000021l	4946618	4955490	8872	g_4716	g_116
ptg000021l	4959616	4960911	1295	g_116	g_16776
ptg000021l	4969310	4974206	4896	g_16776	g_30445
ptg000021l	4985106	4987436	2330	g_30445	g_35654
ptg000021l	4995000	5002904	7904	g_35654	g_8663
ptg000021l	5016048	5055416	39368	g_8663	g_10785
ptg000021l	5071475	5073731	2256	g_10785	g_14629
ptg000021l	5074771	5075838	1067	g_14629	g_12082
ptg000021l	5084999	5093274	8275	g_12082	g_4394
ptg000021l	5094302	5099319	5017	g_4394	g_275
ptg000021l	5111589	5167484	55895	g_275	g_28146
ptg000021l	5168113	5172636	4523	g_28146	g_36660
ptg000021l	5174154	5180514	6360	g_36660	g_8721
ptg000021l	5186006	5186626	620	g_8721	g_7127
ptg000021l	5189202	5191298	2096	g_7127	g_15975
ptg000021l	5199191	5218263	19072	g_15975	g_5083
ptg000021l	5221966	5224469	2503	g_5083	g_1441
ptg000021l	5230232	5230550	318	g_1441	g_703
ptg000021l	5233694	5235413	1719	g_703	g_15360
ptg000021l	5239208	5240396	1188	g_15360	g_29650
ptg000021l	5243434	5253943	10509	g_38933	g_25587
ptg000021l	5269721	5272114	2393	g_25587	g_21792
ptg000021l	5273004	5274376	1372	g_21792	g_25363
ptg000021l	5276414	5279759	3345	g_25363	g_30866
ptg000021l	5295550	5298737	3187	g_30866	g_3492
ptg000021l	5303281	5303798	517	g_3492	g_27227
ptg000021l	5308083	5316833	8750	g_27227	g_16337
ptg000021l	5326397	5341801	15404	g_16337	g_29952
ptg000021l	5346009	5353239	7230	g_29952	g_27003
ptg000021l	5364546	5366091	1545	g_27003	g_4968
ptg000021l	5372800	5375753	2953	g_4968	g_5573
ptg000021l	5381869	5383913	2044	g_5573	g_34123
ptg000021l	5385277	5386525	1248	g_34123	g_32796
ptg000021l	5399227	5431958	32731	g_32796	g_29594
ptg000021l	5432287	5446121	13834	g_29594	g_18323
ptg000021l	5465411	5469678	4267	g_18323	g_17255
ptg000021l	5476572	5484923	8351	g_17255	g_14564
ptg000021l	5486377	5494978	8601	g_14564	g_37933
ptg000021l	5511433	5513777	2344	g_37933	g_3230
ptg000021l	5517900	5519413	1513	g_3230	g_4359
ptg000021l	5527824	5533881	6057	g_4359	g_6740
ptg000021l	5536996	5541125	4129	g_6740	g_672
ptg000021l	5548117	5551262	3145	g_672	g_7515
ptg000021l	5553174	5556096	2922	g_7515	g_35369
ptg000021l	5559213	5562656	3443	g_35369	g_32535
ptg000021l	5566365	5571803	5438	g_32535	g_21702
ptg000021l	5579562	5584424	4862	g_21702	g_5832
ptg000021l	5584681	5588155	3474	g_5832	g_21788
ptg000021l	5602334	5607486	5152	g_21788	g_21182
ptg000021l	5620796	5623880	3084	g_21182	g_19885
ptg000021l	5629046	5634869	5823	g_19885	g_24779
ptg000021l	5640865	5642514	1649	g_24779	g_21232
ptg000021l	5643164	5644443	1279	g_21232	g_6135
ptg000021l	5647934	5650836	2902	g_6135	g_34803
ptg000021l	5661414	5676476	15062	g_34803	g_7042
ptg000021l	5679572	5688373	8801	g_7042	g_13610
ptg000021l	5695301	5702361	7060	g_13610	g_11723
ptg000021l	5709637	5710034	397	g_11723	g_37681
ptg000021l	5717998	5720336	2338	g_37681	g_5489
ptg000021l	5727911	5735073	7162	g_5489	g_35701
ptg000021l	5738086	5763890	25804	g_35701	g_8392
ptg000021l	5779755	5799743	19988	g_8392	g_32683
ptg000021l	5801301	5809275	7974	g_32683	g_30688
ptg000021l	5812945	5870533	57588	g_30688	g_14348
ptg000021l	5884481	5893925	9444	g_14348	g_31000
ptg000021l	5902854	6005804	102950	g_31000	g_18367
ptg000021l	6011574	6110755	99181	g_18367	g_6212
ptg000021l	6111186	6206210	95024	g_6212	g_38151
ptg000021l	6207751	6283927	76176	g_38151	g_11651
ptg000021l	6292142	6412450	120308	g_11651	g_11579
ptg000021l	6434308	6443749	9441	g_11579	g_6198
ptg000021l	6461592	6462616	1024	g_6198	g_27092
ptg000021l	6464406	6474927	10521	g_27092	g_6545
ptg000021l	6476240	6528863	52623	g_6545	g_6735
ptg000021l	6535046	6538199	3153	g_6735	g_22947
ptg000021l	6544953	6549813	4860	g_22947	g_9079
ptg000021l	6556411	6559361	2950	g_9079	g_14772
ptg000021l	6565898	6569975	4077	g_14772	g_20730
ptg000021l	6573114	6594032	20918	g_20730	g_37374
ptg000021l	6594283	6598590	4307	g_37374	g_34423
ptg000021l	6598847	6613166	14319	g_34423	g_21629
ptg000021l	6614281	6637112	22831	g_21629	g_149
ptg000021l	6659865	6710056	50191	g_149	g_9213
ptg000021l	6712558	6725155	12597	g_9213	g_8403
ptg000021l	6730566	6756310	25744	g_8403	g_31801
ptg000021l	6762514	6782733	20219	g_31801	g_10316
ptg000021l	6788901	6794210	5309	g_10316	g_30837
ptg000021l	6798599	6800575	1976	g_30837	g_3014
ptg000021l	6820700	6832923	12223	g_3014	g_18714
ptg000021l	6833396	6835972	2576	g_18714	g_11759
ptg000021l	6841277	6843637	2360	g_11759	g_8556
ptg000021l	6843855	6844693	838	g_8556	g_547
ptg000021l	6864851	6867392	2541	g_547	g_3228
ptg000021l	6879960	6887034	7074	g_3228	g_31250
ptg000021l	6887273	6887830	557	g_31250	g_8567
ptg000021l	6909265	6916990	7725	g_8567	g_11604
ptg000021l	6926313	6930064	3751	g_11604	g_2795
ptg000021l	6935778	6944409	8631	g_2795	g_39796
ptg000021l	6945314	6958075	12761	g_39796	g_24292
ptg000021l	6961578	6968240	6662	g_24292	g_19756
ptg000021l	6974605	6995726	21121	g_19756	g_20470
ptg000021l	6996175	7008411	12236	g_20470	g_23260
ptg000021l	7012019	7013895	1876	g_23260	g_18555
ptg000021l	7015482	7020147	4665	g_18555	g_25399
ptg000021l	7023566	7031542	7976	g_25399	g_29566
ptg000021l	7034520	7061037	26517	g_29566	g_31879
ptg000021l	7062065	7065436	3371	g_31879	g_7862
ptg000021l	7066359	7078267	11908	g_7862	g_20392
ptg000021l	7079697	7083917	4220	g_20392	g_28485
ptg000021l	7085392	7091131	5739	g_28485	g_39682
ptg000021l	7091478	7102013	10535	g_39682	g_30839
ptg000021l	7102270	7102884	614	g_30839	g_12099
ptg000021l	7111060	7113790	2730	g_12099	g_19345
ptg000021l	7123783	7128996	5213	g_19345	g_3728
ptg000021l	7132545	7144834	12289	g_3728	g_33555
ptg000021l	7147210	7148923	1713	g_33555	g_23668
ptg000021l	7150585	7161602	11017	g_23668	g_29043
ptg000021l	7182350	7183149	799	g_29043	g_3725
ptg000021l	7196016	7201212	5196	g_3725	g_18248
ptg000021l	7222637	7277270	54633	g_18248	g_4489
ptg000021l	7300074	7348625	48551	g_4489	g_28224
ptg000021l	7370325	7373890	3565	g_28224	g_25351
ptg000021l	7375828	7381290	5462	g_25351	g_28518
ptg000021l	7381739	7473484	91745	g_28518	g_33932
ptg000021l	7488348	7526202	37854	g_33932	g_12350
ptg000021l	7533017	7534810	1793	g_12350	g_27529
ptg000021l	7537353	7539024	1671	g_27529	g_4228
ptg000021l	7539560	7539642	82	g_4228	g_3316
ptg000021l	7539929	7555919	15990	g_3316	g_16114
ptg000021l	7562035	7579195	17160	g_16114	g_19150
ptg000021l	7579542	7755586	176044	g_19150	g_21162
ptg000021l	7760356	7762397	2041	g_21162	g_34578
ptg000021l	7771460	7791936	20476	g_34578	g_28622
ptg000021l	7810944	7820684	9740	g_28622	g_28687
ptg000021l	7830238	7877721	47483	g_28687	g_923
ptg000021l	7884856	7885258	402	g_923	g_39916
ptg000021l	7901635	7917738	16103	g_39916	g_28831
ptg000021l	7919027	7942993	23966	g_28831	g_15747
ptg000021l	7957461	8026368	68907	g_15747	g_9671
ptg000021l	8043684	8169632	125948	g_9671	g_8572
ptg000021l	8169844	8310746	140902	g_8572	g_18890
ptg000021l	8321851	8362010	40159	g_18890	g_22835
ptg000021l	8377946	8378955	1009	g_22835	g_40088
ptg000021l	8387988	8389386	1398	g_40088	g_10651
ptg000021l	8390795	8394216	3421	g_10651	g_26723
ptg000021l	8395329	8397152	1823	g_26723	g_11912
ptg000021l	8403373	8474176	70803	g_11912	g_27402
ptg000021l	8478035	8534512	56477	g_27402	g_4003
ptg000021l	8547616	8553265	5649	g_4003	g_24166
ptg000021l	8560511	8565589	5078	g_24166	g_17528
ptg000021l	8566071	8581746	15675	g_17528	g_17469
ptg000021l	8589671	8745834	156163	g_17469	g_10156
ptg000021l	8746657	8748672	2015	g_10156	g_27691
ptg000021l	8752541	8756839	4298	g_27691	g_3926
ptg000021l	8772893	8807347	34454	g_3926	g_19296
ptg000021l	8807592	8812289	4697	g_19296	g_3682
ptg000021l	8812495	8953501	141006	g_3682	g_2829
ptg000021l	8953704	8971717	18013	g_2829	g_4939
ptg000021l	8984596	9003671	19075	g_4939	g_4101
ptg000021l	9007050	9011863	4813	g_4101	g_21969
ptg000021l	9025029	9079398	54369	g_21969	g_21010
ptg000021l	9079715	9136972	57257	g_21010	g_23472
ptg000021l	9138991	9161360	22369	g_23472	g_17418
ptg000021l	9161917	9209946	48029	g_17418	g_28192
ptg000021l	9242654	9272951	30297	g_28192	g_21976
ptg000021l	9273817	9276820	3003	g_21976	g_18278
ptg000021l	9278094	9281859	3765	g_18278	g_34372
ptg000021l	9287311	9290771	3460	g_34372	g_19662
ptg000021l	9294941	9300142	5201	g_19662	g_12125
ptg000021l	9323555	9332941	9386	g_12125	g_24910
ptg000021l	9333735	9341090	7355	g_24910	g_16512
ptg000021l	9341413	9470528	129115	g_16512	g_31377
ptg000021l	9472835	9490839	18004	g_31377	g_16990
ptg000021l	9491051	9536835	45784	g_16990	g_1674
ptg000021l	9539786	9554513	14727	g_1674	g_5631
ptg000021l	9555232	9564021	8789	g_5631	g_15098
ptg000021l	9565368	9569830	4462	g_15098	g_5204
ptg000021l	9570492	9572480	1988	g_5204	g_7018
ptg000021l	9587682	9621826	34144	g_7018	g_21392
ptg000021l	9644070	9722663	78593	g_21392	g_12172
ptg000021l	9730305	9955514	225209	g_12172	g_1992
ptg000021l	9957400	10417887	460487	g_1992	g_6829
ptg000021l	10435272	10438383	3111	g_6829	g_3146
ptg000021l	10446505	10452790	6285	g_3146	g_3706
ptg000021l	10474032	10483284	9252	g_3706	g_2304
ptg000021l	10503195	10521709	18514	g_2304	g_15238
ptg000021l	10534584	10552577	17993	g_15238	g_4138
ptg000021l	10554612	10560029	5417	g_4138	g_25847
ptg000021l	10578459	10582646	4187	g_25847	g_24393
ptg000021l	10595842	10601761	5919	g_24393	g_18629
ptg000021l	10603898	10612085	8187	g_18629	g_2952
ptg000021l	10634811	10653981	19170	g_2952	g_16051
ptg000021l	10662443	10671438	8995	g_16051	g_12015
ptg000021l	10678736	10683848	5112	g_12015	g_27608
ptg000021l	10688802	10691395	2593	g_27608	g_29488
ptg000021l	10695557	10717664	22107	g_29488	g_27257
ptg000021l	10724715	10730903	6188	g_27257	g_18223
ptg000021l	10739298	10816135	76837	g_18223	g_2587
ptg000021l	10890316	10895146	4830	g_2587	g_19449
ptg000021l	10899100	10924693	25593	g_19449	g_2770
ptg000021l	10926302	10947299	20997	g_2770	g_3683
ptg000021l	10950160	10952584	2424	g_3683	g_32263
ptg000021l	10954315	10958080	3765	g_32263	g_35698
ptg000021l	10969324	10970416	1092	g_35698	g_22675
ptg000021l	10989586	10998311	8725	g_22675	g_3701
ptg000021l	11006242	11032050	25808	g_3701	g_38534
ptg000021l	11032271	11075451	43180	g_38534	g_28417
ptg000021l	11119936	11184147	64211	g_28417	g_35214
ptg000021l	11212025	11219653	7628	g_35214	g_15251
ptg000021l	11230467	11234210	3743	g_15251	g_31654
ptg000021l	11238730	11246716	7986	g_31654	g_40245
ptg000021l	11249320	11251103	1783	g_40245	g_23859
ptg000021l	11259641	11331621	71980	g_23859	g_11652
ptg000021l	11341142	11344810	3668	g_11652	g_38111
ptg000021l	11353947	11370320	16373	g_38111	g_37377
ptg000021l	11370700	11412378	41678	g_37377	g_37079
ptg000021l	11429780	11437328	7548	g_37079	g_16693
ptg000021l	11445344	11446770	1426	g_16693	g_40200
ptg000021l	11457319	11460940	3621	g_40200	g_19618
ptg000021l	11462437	11468812	6375	g_19618	g_38581
ptg000021l	11469447	11477895	8448	g_38581	g_36902
ptg000021l	11484736	11487846	3110	g_36902	g_30712
ptg000021l	11495243	11512062	16819	g_30712	g_4447
ptg000021l	11518052	11519471	1419	g_4447	g_7050
ptg000021l	11526996	11535666	8670	g_7050	g_35381
ptg000021l	11536832	11593962	57130	g_35381	g_10227
ptg000021l	11597073	11598116	1043	g_10227	g_7008
ptg000021l	11603154	11690399	87245	g_7008	g_1553
ptg000021l	11690650	11763291	72641	g_1553	g_14369
ptg000021l	11768165	11787222	19057	g_14369	g_13131
ptg000021l	11789962	12068026	278064	g_13131	g_27588
ptg000021l	12077006	12091568	14562	g_27588	g_37279
ptg000021l	12099209	12112921	13712	g_37279	g_7158
ptg000021l	12123747	12135219	11472	g_7158	g_28835
ptg000021l	12141648	12145771	4123	g_28835	g_13293
ptg000021l	12149229	12151739	2510	g_13293	g_17492
ptg000021l	12152828	12154642	1814	g_17492	g_28894
ptg000021l	12157971	12164848	6877	g_28894	g_1961
ptg000021l	12184216	12186319	2103	g_1961	g_5553
ptg000021l	12196533	12217249	20716	g_5553	g_17179
ptg000021l	12237087	12251285	14198	g_17179	g_2091
ptg000021l	12253304	12273322	20018	g_2091	g_19668
ptg000021l	12284244	12288694	4450	g_19668	g_3716
ptg000021l	12293481	12367500	74019	g_3716	g_37654
ptg000021l	12370343	12401636	31293	g_37654	g_14021
ptg000021l	12412608	12413519	911	g_14021	g_22867
ptg000021l	12426497	12607788	181291	g_22867	g_14510
ptg000021l	12614717	12671596	56879	g_14510	g_36389
ptg000021l	12695158	12760814	65656	g_36389	g_10243
ptg000021l	12767364	12829079	61715	g_10243	g_38699
ptg000021l	12830224	12878709	48485	g_38699	g_20996
ptg000021l	12881268	13030971	149703	g_20996	g_35311
ptg000021l	13031879	13106927	75048	g_35311	g_15501
ptg000021l	13107202	13133682	26480	g_15501	g_2640
ptg000021l	13152784	13172458	19674	g_2640	g_17420
ptg000021l	13181040	13254644	73604	g_17420	g_26472
ptg000021l	13295335	13365551	70216	g_26472	g_22557
ptg000021l	13366651	13595034	228383	g_22557	g_1373
ptg000021l	13597990	13629329	31339	g_1373	g_731
ptg000021l	13629589	13682549	52960	g_731	g_1208
ptg000021l	13682779	13684728	1949	g_1208	g_33211
ptg000021l	13695955	13696793	838	g_33211	g_226
ptg000021l	13705085	13708190	3105	g_226	g_16630
ptg000021l	13715505	13735113	19608	g_16630	g_18133
ptg000021l	13736927	13792089	55162	g_18133	g_2852
ptg000021l	13796242	13806927	10685	g_2852	g_17223
ptg000021l	13817988	13825687	7699	g_17223	g_24526
ptg000021l	13835918	13966027	130109	g_24526	g_32902
ptg000021l	13993638	14063669	70031	g_32902	g_8962
ptg000021l	14067994	14081751	13757	g_8962	g_6750
ptg000021l	14089698	14173104	83406	g_6750	g_16809
ptg000021l	14173502	14175388	1886	g_16809	g_38302
ptg000021l	14201058	14372715	171657	g_38302	g_14631
ptg000021l	14381460	14561378	179918	g_14631	g_22333
ptg000021l	14572813	14625634	52821	g_22333	g_23405
ptg000021l	14631441	14801463	170022	g_23405	g_9799
ptg000021l	14804210	14807902	3692	g_9799	g_32667
ptg000021l	14813620	14814272	652	g_32667	g_18368
ptg000021l	14815345	14826610	11265	g_18368	g_12959
ptg000021l	14838673	14876504	37831	g_12959	g_2626
ptg000021l	14897584	14953866	56282	g_2626	g_21889
ptg000021l	14975000	15035125	60125	g_21889	g_22176
ptg000021l	15039988	15060757	20769	g_22176	g_29331
ptg000021l	15061005	15132392	71387	g_29331	g_14394
ptg000021l	15132879	15201787	68908	g_14394	g_26928
ptg000021l	15202020	15243933	41913	g_26928	g_19855
ptg000021l	15252459	15255595	3136	g_19855	g_18599
ptg000021l	15261470	15264068	2598	g_18599	g_32905
ptg000021l	15265486	15267030	1544	g_32905	g_30813
ptg000021l	15267257	15273595	6338	g_30813	g_32651
ptg000021l	15274137	15277742	3605	g_32651	g_9678
ptg000021l	15286763	15290670	3907	g_9678	g_22569
ptg000021l	15292570	15292600	30	g_22569	g_40225
ptg000021l	15296715	15300973	4258	g_40225	g_8087
ptg000021l	15301419	15305351	3932	g_8087	g_11911
ptg000021l	15314491	15323094	8603	g_11911	g_9974
ptg000021l	15328494	15334875	6381	g_9974	g_6976
ptg000021l	15335474	15411899	76425	g_6976	g_6131
ptg000021l	15435716	15455699	19983	g_6131	g_22940
ptg000021l	15458697	15485488	26791	g_22940	g_4403
ptg000021l	15490558	15576394	85836	g_4403	g_6596
ptg000021l	15576723	15615010	38287	g_6596	g_5388
ptg000021l	15623611	15642571	18960	g_5388	g_27077
ptg000021l	15645131	15651421	6290	g_27077	g_20764
ptg000021l	15657000	15664880	7880	g_20764	g_11352
ptg000021l	15669887	15690097	20210	g_11352	g_29136
ptg000021l	15691158	15702893	11735	g_29136	g_30356
ptg000021l	15705294	15720113	14819	g_30356	g_11680
ptg000021l	15740484	15754512	14028	g_11680	g_21498
ptg000021l	15767425	15823950	56525	g_21498	g_3423
ptg000021l	15825926	15831802	5876	g_3423	g_38277
ptg000021l	15833658	15839526	5868	g_38277	g_28491
ptg000021l	15841322	15991570	150248	g_28491	g_23628
ptg000021l	16032389	16089868	57479	g_23628	g_17966
ptg000021l	16096300	16105177	8877	g_17966	g_22199
ptg000021l	16170751	16170849	98	g_22199	g_33875
ptg000021l	16171076	16223063	51987	g_33875	g_33851
ptg000021l	16243171	16308230	65059	g_33851	g_4035
ptg000021l	16326208	16343598	17390	g_4035	g_31470
ptg000021l	16350236	16367477	17241	g_31470	g_8521
ptg000021l	16368652	16419569	50917	g_8521	g_6274
ptg000021l	16442167	16521431	79264	g_6274	g_37226
ptg000022l	269205	379493	110288	g_14934	g_38491
ptg000022l	379927	402805	22878	g_38491	g_24047
ptg000022l	403491	419504	16013	g_24047	g_5607
ptg000022l	420790	533212	112422	g_5607	g_18865
ptg000022l	535600	547995	12395	g_18865	g_28484
ptg000022l	548225	548471	246	g_28484	g_4172
ptg000022l	549469	644850	95381	g_4172	g_5150
ptg000022l	645071	896761	251690	g_5150	g_19383
ptg000022l	897408	937618	40210	g_19383	g_29928
ptg000022l	938250	954996	16746	g_29928	g_2458
ptg000022l	968592	976134	7542	g_2458	g_16455
ptg000022l	976385	976470	85	g_16455	g_31175
ptg000022l	977036	1120833	143797	g_31175	g_1482
ptg000022l	1121078	1201134	80056	g_1482	g_2930
ptg000022l	1203214	1250375	47161	g_2930	g_22318
ptg000022l	1250623	1482335	231712	g_22318	g_14483
ptg000022l	1484009	1504303	20294	g_14483	g_30387
ptg000022l	1505076	1660071	154995	g_30387	g_34950
ptg000022l	1678797	1709309	30512	g_34950	g_2002
ptg000022l	1710392	1718743	8351	g_2002	g_39938
ptg000022l	1725437	1763414	37977	g_39938	g_5612
ptg000022l	1764493	1832101	67608	g_5612	g_26073
ptg000022l	1851002	1856736	5734	g_26073	g_3434
ptg000022l	1857092	1858679	1587	g_3434	g_6067
ptg000022l	1859257	1864887	5630	g_6067	g_15402
ptg000022l	1865498	1983715	118217	g_15402	g_31685
ptg000022l	1984662	1997996	13334	g_31685	g_22495
ptg000022l	1998676	2017456	18780	g_22495	g_7156
ptg000022l	2017776	2043181	25405	g_7156	g_22773
ptg000022l	2064863	2073151	8288	g_22773	g_14165
ptg000022l	2093009	2099426	6417	g_14165	g_4654
ptg000022l	2108907	2112327	3420	g_4654	g_10377
ptg000022l	2114709	2116184	1475	g_10377	g_18970
ptg000022l	2135944	2137379	1435	g_18970	g_13393
ptg000022l	2149758	2190893	41135	g_13393	g_13908
ptg000022l	2191270	2206258	14988	g_13908	g_24424
ptg000022l	2206926	2243767	36841	g_24424	g_34213
ptg000022l	2262261	2262354	93	g_34213	g_25795
ptg000022l	2263127	2289943	26816	g_25795	g_32799
ptg000022l	2299201	2377333	78132	g_32799	g_30716
ptg000022l	2377728	2386789	9061	g_30716	g_31670
ptg000022l	2412646	2429063	16417	g_31670	g_12812
ptg000022l	2437288	2438144	856	g_12812	g_18333
ptg000022l	2445242	2450150	4908	g_18333	g_6878
ptg000022l	2450689	2496739	46050	g_6878	g_4950
ptg000022l	2497446	2527774	30328	g_4950	g_34653
ptg000022l	2530513	2538498	7985	g_34653	g_29339
ptg000022l	2558638	2604730	46092	g_29339	g_12602
ptg000022l	2605290	2658967	53677	g_12602	g_23473
ptg000022l	2659933	2666746	6813	g_23473	g_27054
ptg000022l	2667120	2670098	2978	g_27054	g_6937
ptg000022l	2676632	2694807	18175	g_6937	g_15992
ptg000022l	2702766	2741651	38885	g_15992	g_17370
ptg000022l	2748667	2763886	15219	g_17370	g_35779
ptg000022l	2764086	2772248	8162	g_35779	g_37391
ptg000022l	2772754	2845097	72343	g_37391	g_22778
ptg000022l	2851064	2876075	25011	g_22778	g_8624
ptg000022l	2876827	2884371	7544	g_8624	g_23104
ptg000022l	2884871	2927925	43054	g_23104	g_1820
ptg000022l	2928728	2992026	63298	g_1820	g_17883
ptg000022l	2992478	3056290	63812	g_17883	g_32571
ptg000022l	3123875	3132618	8743	g_32571	g_19745
ptg000022l	3140584	3141764	1180	g_19745	g_4488
ptg000022l	3142210	3175131	32921	g_4488	g_21675
ptg000022l	3176168	3195692	19524	g_21675	g_31202
ptg000022l	3205221	3206229	1008	g_31202	g_16656
ptg000022l	3217464	3258636	41172	g_16656	g_18965
ptg000022l	3266693	3282031	15338	g_18965	g_7871
ptg000022l	3299571	3316130	16559	g_7871	g_1247
ptg000022l	3316615	3320976	4361	g_1247	g_20108
ptg000022l	3325792	3340937	15145	g_20108	g_36415
ptg000022l	3343518	3436040	92522	g_36415	g_38274
ptg000022l	3447934	3484073	36139	g_38274	g_28250
ptg000022l	3484417	3520325	35908	g_28250	g_23750
ptg000022l	3535303	3549422	14119	g_23750	g_21834
ptg000022l	3549655	3577389	27734	g_21834	g_35125
ptg000022l	3630615	3630947	332	g_35125	g_34497
ptg000022l	3633224	3636692	3468	g_34497	g_15243
ptg000022l	3646013	3680550	34537	g_15243	g_26248
ptg000022l	3687359	3711276	23917	g_26248	g_3378
ptg000022l	3711524	3797183	85659	g_3378	g_23401
ptg000022l	3797551	3892956	95405	g_23401	g_36690
ptg000022l	3894772	4033055	138283	g_36690	g_6982
ptg000022l	4047226	4086347	39121	g_32376	g_32254
ptg000022l	4087372	4125518	38146	g_32254	g_30685
ptg000022l	4132588	4141781	9193	g_30685	g_35229
ptg000022l	4148492	4159607	11115	g_35229	g_15013
ptg000022l	4162981	4167429	4448	g_15013	g_33846
ptg000022l	4176537	4242292	65755	g_33846	g_29269
ptg000022l	4243146	4351996	108850	g_29269	g_28029
ptg000022l	4363146	4369189	6043	g_28029	g_11607
ptg000022l	4370457	4467308	96851	g_11607	g_27888
ptg000022l	4482695	4498409	15714	g_27888	g_32191
ptg000022l	4505076	4517463	12387	g_32191	g_15942
ptg000022l	4523488	4570213	46725	g_15942	g_2884
ptg000022l	4571268	4571927	659	g_2884	g_37337
ptg000022l	4572328	4682306	109978	g_37337	g_605
ptg000022l	4683448	4705111	21663	g_605	g_29550
ptg000022l	4707031	4755717	48686	g_29550	g_12948
ptg000022l	4755929	4781817	25888	g_12948	g_26579
ptg000022l	4790607	4807362	16755	g_26579	g_23563
ptg000022l	4807907	4843480	35573	g_23563	g_7053
ptg000022l	4846369	4851866	5497	g_7053	g_28486
ptg000022l	4854145	4873303	19158	g_28486	g_2413
ptg000022l	4875574	4912288	36714	g_2413	g_18509
ptg000022l	4919134	4928226	9092	g_18509	g_7642
ptg000022l	4930858	4960404	29546	g_7642	g_9585
ptg000022l	4963193	5168486	205293	g_9585	g_22855
ptg000022l	5176610	5184142	7532	g_22855	g_13618
ptg000022l	5199817	5206287	6470	g_13618	g_36822
ptg000022l	5212725	5215187	2462	g_36822	g_11397
ptg000022l	5234532	5312686	78154	g_11397	g_14127
ptg000022l	5313036	5335470	22434	g_14127	g_19740
ptg000022l	5359613	5392690	33077	g_19740	g_17850
ptg000022l	5394042	5420259	26217	g_17850	g_20905
ptg000022l	5440830	5481636	40806	g_20905	g_34420
ptg000022l	5484020	5511668	27648	g_34420	g_34478
ptg000022l	5522041	5537283	15242	g_34478	g_716
ptg000022l	5538800	5549746	10946	g_716	g_33995
ptg000022l	5575687	5587912	12225	g_33995	g_19838
ptg000022l	5591911	5626919	35008	g_19838	g_23639
ptg000022l	5629446	5634995	5549	g_23639	g_35528
ptg000022l	5651809	5655164	3355	g_35528	g_19521
ptg000022l	5661944	5690181	28237	g_19521	g_34366
ptg000022l	5701612	5710610	8998	g_34366	g_25303
ptg000022l	5715615	5791636	76021	g_25303	g_4775
ptg000022l	5793579	5804645	11066	g_4775	g_33833
ptg000022l	5807165	5807597	432	g_33833	g_13147
ptg000022l	5807953	5808235	282	g_13147	g_3062
ptg000022l	5808621	5811320	2699	g_3062	g_39151
ptg000022l	5814702	5815525	823	g_39151	g_19312
ptg000022l	5817855	5889872	72017	g_19312	g_35011
ptg000022l	5890840	5891239	399	g_35011	g_17201
ptg000022l	5891745	5905562	13817	g_17201	g_9499
ptg000022l	5906647	5907071	424	g_9499	g_5802
ptg000022l	5907397	5969076	61679	g_5802	g_7189
ptg000022l	5969489	5969661	172	g_7189	g_38985
ptg000022l	5969894	6063153	93259	g_38985	g_931
ptg000022l	6075538	6149013	73475	g_931	g_24791
ptg000022l	6152800	6156549	3749	g_24791	g_1837
ptg000022l	6170655	6178081	7426	g_1837	g_519
ptg000022l	6187891	6193807	5916	g_519	g_35663
ptg000022l	6195987	6200293	4306	g_35663	g_15391
ptg000022l	6202531	6218656	16125	g_15391	g_24084
ptg000022l	6233858	6238049	4191	g_24084	g_26198
ptg000022l	6238927	6298553	59626	g_26198	g_27237
ptg000022l	6310934	6317323	6389	g_27237	g_1990
ptg000022l	6323012	6345847	22835	g_26622	g_32830
ptg000022l	6347526	6430005	82479	g_32830	g_37161
ptg000022l	6430403	6467842	37439	g_37161	g_34242
ptg000022l	6478781	6496261	17480	g_34242	g_20120
ptg000022l	6502319	6619644	117325	g_20120	g_22109
ptg000022l	6623257	6639302	16045	g_22109	g_27221
ptg000022l	6639601	6670901	31300	g_27221	g_17931
ptg000022l	6671288	6681726	10438	g_17931	g_23543
ptg000022l	6682490	6699522	17032	g_23543	g_2487
ptg000022l	6704315	6707508	3193	g_2487	g_10487
ptg000022l	6710463	6714483	4020	g_10487	g_11901
ptg000022l	6716841	6778081	61240	g_11901	g_19323
ptg000022l	6784307	6807617	23310	g_19323	g_3535
ptg000022l	6808516	6821072	12556	g_3535	g_4337
ptg000022l	6839417	6848232	8815	g_4337	g_26968
ptg000022l	6854903	6865792	10889	g_26968	g_34159
ptg000022l	6888932	6898053	9121	g_34159	g_11990
ptg000022l	6899362	6914811	15449	g_11990	g_14708
ptg000022l	6923513	6940325	16812	g_14708	g_27244
ptg000022l	6940645	6954502	13857	g_27244	g_34903
ptg000022l	6969255	7063673	94418	g_34903	g_6304
ptg000022l	7069675	7106112	36437	g_6304	g_31011
ptg000022l	7120995	7199092	78097	g_31011	g_13350
ptg000022l	7209441	7259734	50293	g_13350	g_34015
ptg000022l	7265761	7295858	30097	g_34015	g_30691
ptg000022l	7296622	7330759	34137	g_30691	g_24220
ptg000022l	7331084	7336849	5765	g_24220	g_12321
ptg000022l	7341539	7374603	33064	g_12321	g_22131
ptg000022l	7390914	7424444	33530	g_22131	g_27544
ptg000022l	7448377	7454402	6025	g_27544	g_39661
ptg000022l	7465118	7468430	3312	g_4416	g_34429
ptg000022l	7477152	7488098	10946	g_34429	g_561
ptg000022l	7498206	7507714	9508	g_561	g_27078
ptg000022l	7517998	7522597	4599	g_27078	g_11960
ptg000022l	7531494	7536815	5321	g_11960	g_26199
ptg000022l	7556459	7564245	7786	g_26199	g_1590
ptg000022l	7566164	7576467	10303	g_1590	g_28154
ptg000022l	7576850	7583862	7012	g_28154	g_28094
ptg000022l	7591089	7595610	4521	g_28094	g_20421
ptg000022l	7606096	7617889	11793	g_20421	g_19038
ptg000022l	7632403	7644113	11710	g_19038	g_14521
ptg000022l	7651435	7669949	18514	g_14521	g_29263
ptg000022l	7672734	7680616	7882	g_29263	g_7482
ptg000022l	7691932	7724109	32177	g_7482	g_35801
ptg000022l	7733220	7739171	5951	g_35801	g_15563
ptg000022l	7740691	7745646	4955	g_15563	g_36518
ptg000022l	7747022	7756781	9759	g_36518	g_16054
ptg000022l	7772819	7781665	8846	g_16054	g_14128
ptg000022l	7804482	7812150	7668	g_14128	g_23431
ptg000022l	7820136	7823451	3315	g_23431	g_36626
ptg000022l	7835695	7840827	5132	g_36626	g_26960
ptg000022l	7850042	7853269	3227	g_26960	g_3736
ptg000022l	7867299	7922729	55430	g_3736	g_757
ptg000022l	7925205	7932165	6960	g_757	g_33089
ptg000022l	7944334	7948073	3739	g_33089	g_997
ptg000022l	7959971	7990552	30581	g_997	g_14469
ptg000022l	7995211	8019568	24357	g_14469	g_15804
ptg000022l	8019948	8021099	1151	g_15804	g_26335
ptg000022l	8022281	8031985	9704	g_26335	g_27928
ptg000022l	8038846	8062540	23694	g_27928	g_24917
ptg000022l	8062806	8091748	28942	g_24917	g_27161
ptg000022l	8092047	8098800	6753	g_27161	g_8995
ptg000022l	8099555	8145409	45854	g_8995	g_12014
ptg000022l	8146461	8233537	87076	g_12014	g_25867
ptg000022l	8234172	8271214	37042	g_25867	g_35316
ptg000022l	8271522	8471912	200390	g_35316	g_26456
ptg000022l	8472154	8535088	62934	g_26456	g_1387
ptg000022l	8535309	8615980	80671	g_1387	g_23677
ptg000022l	8616315	8656610	40295	g_23677	g_439
ptg000022l	8657083	8720143	63060	g_439	g_4926
ptg000022l	8720343	8798737	78394	g_4926	g_31649
ptg000022l	8802047	8805632	3585	g_31649	g_20110
ptg000022l	8809972	8832457	22485	g_20110	g_2919
ptg000022l	8833098	8873817	40719	g_2919	g_34353
ptg000022l	8880179	8884313	4134	g_34353	g_22171
ptg000022l	8884714	8913539	28825	g_22171	g_10882
ptg000022l	8913841	8927133	13292	g_10882	g_13182
ptg000022l	8931553	8962315	30762	g_13182	g_7880
ptg000022l	8964324	8974198	9874	g_7880	g_19769
ptg000022l	8974650	9036713	62063	g_19769	g_23076
ptg000022l	9056653	9061617	4964	g_23076	g_14948
ptg000022l	9061850	9063968	2118	g_14948	g_4310
ptg000022l	9064468	9066947	2479	g_4310	g_23548
ptg000022l	9067357	9393656	326299	g_23548	g_36056
ptg000022l	9414191	9431261	17070	g_36056	g_119
ptg000022l	9443358	9444817	1459	g_119	g_3157
ptg000022l	9465230	9466921	1691	g_3157	g_40186
ptg000022l	9468832	9469688	856	g_40186	g_18281
ptg000022l	9473507	9480983	7476	g_18281	g_4888
ptg000022l	9499809	9505391	5582	g_4888	g_39984
ptg000022l	9528710	9531683	2973	g_39984	g_28071
ptg000022l	9537559	9539716	2157	g_28071	g_13074
ptg000022l	9553285	9599157	45872	g_13074	g_11966
ptg000022l	9620657	9625909	5252	g_11966	g_1719
ptg000022l	9627145	9636179	9034	g_1719	g_29230
ptg000022l	9641504	9648867	7363	g_29230	g_30919
ptg000022l	9653191	9656040	2849	g_30919	g_28390
ptg000022l	9667575	9719135	51560	g_28390	g_16047
ptg000022l	9724453	9735258	10805	g_16047	g_5453
ptg000022l	9735470	9761486	26016	g_5453	g_11555
ptg000022l	9762457	9768034	5577	g_11555	g_3075
ptg000022l	9782280	9818874	36594	g_3075	g_1202
ptg000022l	9819338	9858839	39501	g_1202	g_19327
ptg000022l	9881205	9912224	31019	g_19327	g_1065
ptg000022l	9913531	9946341	32810	g_1065	g_11308
ptg000022l	9951832	9956481	4649	g_11308	g_9634
ptg000022l	9977428	9998346	20918	g_9634	g_15658
ptg000022l	10005404	10005675	271	g_15658	g_11443
ptg000022l	10011436	10014408	2972	g_11443	g_25451
ptg000022l	10029989	10034709	4720	g_25451	g_30792
ptg000022l	10052649	10077997	25348	g_30792	g_28127
ptg000022l	10078479	10085244	6765	g_28127	g_18675
ptg000022l	10085831	10090483	4652	g_18675	g_35935
ptg000022l	10090965	10134260	43295	g_35935	g_38707
ptg000022l	10134538	10152507	17969	g_38707	g_27678
ptg000022l	10152860	10171062	18202	g_27678	g_4211
ptg000022l	10171544	10180050	8506	g_4211	g_28315
ptg000022l	10180475	10186057	5582	g_28315	g_32506
ptg000022l	10208590	10216277	7687	g_32506	g_28497
ptg000022l	10222735	10225057	2322	g_28497	g_18222
ptg000022l	10229878	10245199	15321	g_18222	g_10071
ptg000022l	10255327	10259464	4137	g_10071	g_22744
ptg000022l	10272503	10277816	5313	g_22744	g_8222
ptg000022l	10281621	10363323	81702	g_8222	g_13512
ptg000022l	10369526	10383905	14379	g_13512	g_38152
ptg000022l	10386293	10390448	4155	g_38152	g_20052
ptg000022l	10391715	10397278	5563	g_20052	g_17540
ptg000022l	10414329	10445887	31558	g_17540	g_3771
ptg000022l	10467568	10494918	27350	g_3771	g_27874
ptg000022l	10496651	10517658	21007	g_27874	g_30010
ptg000022l	10528221	10532600	4379	g_30010	g_16816
ptg000022l	10533652	10544958	11306	g_16816	g_22105
ptg000022l	10546229	10555272	9043	g_22105	g_26639
ptg000022l	10556273	10662953	106680	g_26639	g_19905
ptg000022l	10674620	10734449	59829	g_19905	g_2600
ptg000022l	10735060	10752638	17578	g_2600	g_10395
ptg000022l	10753150	10860575	107425	g_10395	g_1204
ptg000022l	10861174	10964712	103538	g_1204	g_14829
ptg000022l	10965359	11113153	147794	g_14829	g_1855
ptg000022l	11119113	11122947	3834	g_1855	g_30332
ptg000022l	11132995	11137426	4431	g_30332	g_31986
ptg000022l	11140518	11141434	916	g_31986	g_13389
ptg000022l	11142690	11144652	1962	g_13389	g_29460
ptg000022l	11158482	11195065	36583	g_29460	g_19716
ptg000022l	11215004	11231098	16094	g_19716	g_37864
ptg000022l	11237237	11271403	34166	g_37864	g_10181
ptg000022l	11274142	11285546	11404	g_10181	g_15491
ptg000022l	11288281	11385984	97703	g_15491	g_23768
ptg000022l	11387792	11395704	7912	g_23768	g_2671
ptg000022l	11418499	11432639	14140	g_2671	g_2623
ptg000022l	11433199	11438915	5716	g_2623	g_6109
ptg000022l	11457711	11459529	1818	g_6109	g_40009
ptg000022l	11461023	11570159	109136	g_40009	g_3893
ptg000022l	11570461	11593109	22648	g_3893	g_27514
ptg000022l	11595457	11675326	79869	g_27514	g_31848
ptg000022l	11676666	11677520	854	g_31848	g_2417
ptg000022l	11681184	11682688	1504	g_2417	g_22901
ptg000022l	11691286	11693329	2043	g_22901	g_31851
ptg000022l	11719045	11730593	11548	g_31851	g_318
ptg000022l	11736578	11775103	38525	g_318	g_16792
ptg000022l	11777247	11778003	756	g_16792	g_13736
ptg000022l	11782570	11785549	2979	g_13736	g_25139
ptg000022l	11796297	11805476	9179	g_25139	g_24274
ptg000022l	11830428	11832894	2466	g_24274	g_32524
ptg000022l	11836524	11849250	12726	g_32524	g_14569
ptg000022l	11853863	11859775	5912	g_14569	g_188
ptg000022l	11860641	11892563	31922	g_188	g_16597
ptg000022l	11892934	11991078	98144	g_16597	g_25255
ptg000022l	12003713	12012316	8603	g_25255	g_6438
ptg000022l	12016910	12019889	2979	g_6438	g_40015
ptg000022l	12026325	12028026	1701	g_40015	g_33023
ptg000022l	12035988	12039874	3886	g_33023	g_31341
ptg000022l	12068965	12081398	12433	g_31341	g_32643
ptg000022l	12096325	12100870	4545	g_32643	g_32051
ptg000022l	12111585	12117414	5829	g_32051	g_23886
ptg000022l	12120789	12132710	11921	g_23886	g_34731
ptg000022l	12133374	12135020	1646	g_34731	g_1659
ptg000022l	12136485	12181971	45486	g_1659	g_34488
ptg000022l	12194522	12279079	84557	g_34488	g_25716
ptg000022l	12281627	12283188	1561	g_25716	g_4291
ptg000022l	12285280	12305489	20209	g_4291	g_36484
ptg000022l	12307126	12334062	26936	g_36484	g_8383
ptg000022l	12336791	12344515	7724	g_8383	g_37677
ptg000022l	12346920	12378773	31853	g_37677	g_25024
ptg000022l	12388378	12399872	11494	g_25024	g_15210
ptg000022l	12414372	12418248	3876	g_15210	g_31099
ptg000022l	12434177	12439900	5723	g_31099	g_4852
ptg000022l	12455173	12504967	49794	g_4852	g_26694
ptg000022l	12527607	12571232	43625	g_26694	g_26984
ptg000022l	12595175	12602425	7250	g_26984	g_11201
ptg000022l	12608724	12631286	22562	g_11201	g_34438
ptg000022l	12635795	12638416	2621	g_34438	g_36086
ptg000022l	12646650	12650116	3466	g_36086	g_17007
ptg000022l	12654740	12776211	121471	g_17007	g_10689
ptg000022l	12799709	12807324	7615	g_10689	g_19870
ptg000022l	12808802	12809339	537	g_19870	g_34050
ptg000022l	12815563	12823445	7882	g_34050	g_2482
ptg000022l	12826191	12831503	5312	g_2482	g_6447
ptg000022l	12848435	12850905	2470	g_6447	g_5102
ptg000022l	12853464	12859013	5549	g_5102	g_951
ptg000022l	12861468	12862982	1514	g_951	g_12721
ptg000022l	12868712	12871080	2368	g_12721	g_15052
ptg000022l	12875781	12879702	3921	g_15052	g_6392
ptg000022l	12898038	12898414	376	g_6392	g_26205
ptg000022l	12898638	12901894	3256	g_26205	g_15024
ptg000022l	12904448	12951294	46846	g_15024	g_4922
ptg000022l	12962554	12969105	6551	g_4922	g_28048
ptg000022l	12983722	13011839	28117	g_28048	g_24354
ptg000022l	13012933	13025574	12641	g_24354	g_30779
ptg000022l	13042385	13047663	5278	g_30779	g_21058
ptg000022l	13054641	13057243	2602	g_21058	g_37568
ptg000022l	13059538	13063116	3578	g_37568	g_6204
ptg000022l	13063885	13083822	19937	g_6204	g_21016
ptg000022l	13084157	13090791	6634	g_21016	g_28090
ptg000022l	13100591	13102979	2388	g_28090	g_32432
ptg000022l	13106513	13108966	2453	g_32432	g_24609
ptg000022l	13117492	13126951	9459	g_24609	g_17181
ptg000022l	13151283	13192195	40912	g_17181	g_1058
ptg000022l	13216226	13233014	16788	g_1058	g_39178
ptg000022l	13233301	13249544	16243	g_39178	g_22461
ptg000022l	13249903	13254747	4844	g_22461	g_34024
ptg000022l	13256169	13262247	6078	g_34024	g_22225
ptg000022l	13266289	13273098	6809	g_22225	g_8059
ptg000022l	13281026	13286636	5610	g_8059	g_36662
ptg000022l	13287499	13292435	4936	g_36662	g_23485
ptg000022l	13306366	13353814	47448	g_23485	g_12214
ptg000022l	13355265	13360325	5060	g_12214	g_13372
ptg000022l	13361132	13441930	80798	g_13372	g_27166
ptg000022l	13442418	13450505	8087	g_27166	g_8330
ptg000022l	13453767	13493386	39619	g_8330	g_16909
ptg000022l	13499138	13543216	44078	g_16909	g_34064
ptg000022l	13543845	13547892	4047	g_34064	g_9404
ptg000022l	13551253	13636516	85263	g_9404	g_7233
ptg000022l	13642590	13672218	29628	g_7233	g_8144
ptg000022l	13672676	13678777	6101	g_8144	g_3625
ptg000022l	13704899	13708388	3489	g_3625	g_2372
ptg000022l	13709479	13736319	26840	g_2372	g_13594
ptg000022l	13742281	13744749	2468	g_13594	g_30873
ptg000022l	13750751	13752016	1265	g_30873	g_18783
ptg000022l	13756685	13785835	29150	g_18783	g_37416
ptg000022l	13789206	13871469	82263	g_37416	g_37569
ptg000022l	13884750	13891141	6391	g_37569	g_30915
ptg000022l	13897141	13943265	46124	g_30915	g_8162
ptg000022l	13956391	13962664	6273	g_8162	g_24041
ptg000022l	13962915	13970145	7230	g_24041	g_12678
ptg000022l	13984796	14076474	91678	g_12678	g_6457
ptg000022l	14076731	14190377	113646	g_6457	g_29058
ptg000022l	14190787	14284014	93227	g_29058	g_38230
ptg000022l	14284655	14304074	19419	g_38230	g_20633
ptg000022l	14307446	14311567	4121	g_20633	g_31236
ptg000022l	14313036	14315933	2897	g_31236	g_15837
ptg000022l	14320738	14325490	4752	g_15837	g_20652
ptg000022l	14332125	14332663	538	g_20652	g_3469
ptg000022l	14332869	14336603	3734	g_3469	g_28772
ptg000022l	14344898	14364697	19799	g_28772	g_39095
ptg000022l	14365152	14379202	14050	g_39095	g_10645
ptg000022l	14379420	14398857	19437	g_10645	g_8708
ptg000022l	14406299	14475650	69351	g_8708	g_13002
ptg000022l	14476066	14595756	119690	g_13002	g_19911
ptg000022l	14600371	14684387	84016	g_19911	g_30048
ptg000022l	14684692	14687236	2544	g_30048	g_3323
ptg000022l	14687490	14697731	10241	g_3323	g_39146
ptg000022l	14699351	14701824	2473	g_39146	g_11646
ptg000022l	14708170	14720897	12727	g_11646	g_9539
ptg000022l	14725891	14727198	1307	g_9539	g_454
ptg000022l	14727446	14733867	6421	g_454	g_4693
ptg000022l	14736887	14737791	904	g_4693	g_4206
ptg000022l	14742514	14746752	4238	g_4206	g_24970
ptg000022l	14753118	14755047	1929	g_24970	g_37579
ptg000022l	14765004	14774818	9814	g_37579	g_34979
ptg000022l	14783836	14791072	7236	g_34979	g_23713
ptg000022l	14795519	14803366	7847	g_23713	g_33645
ptg000022l	14806504	14830025	23521	g_33645	g_1057
ptg000022l	14832786	14836646	3860	g_1057	g_35886
ptg000022l	14841262	14844679	3417	g_35886	g_10711
ptg000022l	14862935	14867757	4822	g_10711	g_2958
ptg000022l	14874531	14877967	3436	g_2958	g_23602
ptg000022l	14886870	14890766	3896	g_23602	g_24586
ptg000022l	14894103	14899703	5600	g_24586	g_20005
ptg000022l	14901068	14903772	2704	g_20005	g_15848
ptg000022l	14906772	14913729	6957	g_15848	g_9719
ptg000022l	14916550	14924603	8053	g_9719	g_22000
ptg000022l	14924845	14928787	3942	g_22000	g_19272
ptg000022l	14932030	14937744	5714	g_19272	g_24196
ptg000022l	14940496	14942709	2213	g_24196	g_19459
ptg000022l	14944795	14946317	1522	g_19459	g_39866
ptg000022l	14947823	14948721	898	g_23541	g_19000
ptg000022l	14954996	14957311	2315	g_19000	g_20215
ptg000022l	14958445	14981185	22740	g_20215	g_32318
ptg000022l	14983452	14986140	2688	g_32318	g_36165
ptg000022l	14988345	14993741	5396	g_36165	g_11477
ptg000022l	14997998	15004766	6768	g_11477	g_8782
ptg000022l	15010925	15012004	1079	g_8782	g_17387
ptg000022l	15013181	15016790	3609	g_17387	g_33893
ptg000022l	15023295	15029894	6599	g_33893	g_37594
ptg000022l	15040236	15064546	24310	g_37594	g_37123
ptg000022l	15065121	15123233	58112	g_37123	g_1332
ptg000022l	15131987	15154750	22763	g_1332	g_12083
ptg000022l	15176012	15186355	10343	g_12083	g_27473
ptg000022l	15200637	15228458	27821	g_27473	g_23977
ptg000022l	15233436	15262245	28809	g_23977	g_6219
ptg000022l	15271631	15308222	36591	g_6219	g_30514
ptg000022l	15312996	15327926	14930	g_30514	g_32715
ptg000022l	15332681	15336009	3328	g_32715	g_11126
ptg000022l	15342797	15347413	4616	g_11126	g_24975
ptg000022l	15350253	15352194	1941	g_24975	g_6647
ptg000022l	15355759	15361588	5829	g_6647	g_24826
ptg000022l	15386205	15390099	3894	g_24826	g_7261
ptg000022l	15391460	15412793	21333	g_7261	g_36001
ptg000022l	15423659	15435452	11793	g_36001	g_35897
ptg000022l	15439857	15443333	3476	g_35897	g_31847
ptg000022l	15452574	15455646	3072	g_31847	g_34206
ptg000022l	15462362	15465765	3403	g_34206	g_35934
ptg000022l	15468960	15471911	2951	g_35934	g_9080
ptg000022l	15476185	15477536	1351	g_9080	g_29940
ptg000022l	15489226	15490942	1716	g_29940	g_14035
ptg000022l	15499904	15502537	2633	g_14035	g_15425
ptg000022l	15506768	15510352	3584	g_15425	g_21691
ptg000022l	15510570	15602588	92018	g_21691	g_6515
ptg000022l	15604863	15666567	61704	g_6515	g_17220
ptg000022l	15667229	15673748	6519	g_17220	g_7559
ptg000022l	15682425	15689257	6832	g_7559	g_18790
ptg000022l	15690282	15691437	1155	g_18790	g_780
ptg000022l	15700208	15728784	28576	g_780	g_2525
ptg000022l	15730613	15731273	660	g_2525	g_1797
ptg000022l	15742364	15744400	2036	g_1797	g_1059
ptg000022l	15745037	15747315	2278	g_1059	g_23982
ptg000022l	15748052	15755928	7876	g_23982	g_13231
ptg000022l	15756585	15757754	1169	g_13231	g_21252
ptg000022l	15758541	15759263	722	g_21252	g_26603
ptg000022l	15759923	15761100	1177	g_26603	g_19918
ptg000022l	15761887	15762609	722	g_19918	g_13774
ptg000022l	15763262	15771177	7915	g_13774	g_23400
ptg000022l	15777194	15789774	12580	g_23400	g_19017
ptg000022l	15806526	15808525	1999	g_19017	g_3824
ptg000022l	15816930	15819239	2309	g_3824	g_13842
ptg000022l	15819775	15832993	13218	g_13842	g_23841
ptg000022l	15837926	15844797	6871	g_23841	g_28249
ptg000022l	15851016	15851423	407	g_28249	g_1976
ptg000022l	15864931	15903088	38157	g_1976	g_2538
ptg000022l	15911126	15914039	2913	g_2538	g_30197
ptg000022l	15921791	15924150	2359	g_30197	g_7753
ptg000022l	15929592	15943264	13672	g_7753	g_22970
ptg000022l	15953757	15990900	37143	g_22970	g_16027
ptg000022l	15992015	15998032	6017	g_16027	g_22936
ptg000022l	16009008	16011127	2119	g_22936	g_25568
ptg000022l	16014255	16014901	646	g_25568	g_28352
ptg000022l	16015830	16023010	7180	g_28352	g_16018
ptg000022l	16026450	16034517	8067	g_16018	g_39224
ptg000022l	16039160	16040319	1159	g_39224	g_566
ptg000022l	16054053	16095418	41365	g_566	g_1539
ptg000022l	16118075	16137158	19083	g_1539	g_23614
ptg000022l	16137466	16176230	38764	g_23614	g_10742
ptg000022l	16180053	16209330	29277	g_10742	g_28897
ptg000022l	16214548	16255004	40456	g_28897	g_16409
ptg000022l	16272860	16275829	2969	g_16409	g_34597
ptg000022l	16277284	16286251	8967	g_34597	g_29593
ptg000022l	16290269	16292923	2654	g_29593	g_34281
ptg000022l	16313435	16316658	3223	g_34281	g_37212
ptg000022l	16323107	16331161	8054	g_37212	g_19367
ptg000022l	16349636	16358015	8379	g_19367	g_34788
ptg000022l	16369102	16370966	1864	g_34788	g_16813
ptg000022l	16372418	16385514	13096	g_16813	g_28711
ptg000022l	16400191	16406110	5919	g_28711	g_9731
ptg000022l	16409059	16413405	4346	g_9731	g_9827
ptg000022l	16437486	16440890	3404	g_9827	g_9470
ptg000022l	16445634	16449805	4171	g_9470	g_30808
ptg000022l	16457773	16461819	4046	g_30808	g_28369
ptg000022l	16476892	16478224	1332	g_28369	g_30346
ptg000022l	16486062	16492534	6472	g_30346	g_27035
ptg000022l	16498256	16499225	969	g_27035	g_10498
ptg000022l	16501909	16502910	1001	g_10498	g_11913
ptg000022l	16503164	16521264	18100	g_11913	g_25050
ptg000022l	16523630	16528044	4414	g_25050	g_20986
ptg000022l	16530308	16531381	1073	g_20986	g_21717
ptg000022l	16535913	16537984	2071	g_21717	g_4149
ptg000022l	16538220	16541761	3541	g_4149	g_34473
ptg000022l	16548477	16554226	5749	g_34473	g_40288
ptg000022l	16554639	16664366	109727	g_40288	g_34345
ptg000022l	16664629	16722561	57932	g_34345	g_32168
ptg000022l	16736890	16751322	14432	g_32168	g_31652
ptg000022l	16754541	16758829	4288	g_31652	g_16457
ptg000022l	16784110	16784634	524	g_16457	g_29257
ptg000022l	16787808	16789964	2156	g_29257	g_23464
ptg000022l	16823108	16826612	3504	g_23464	g_20477
ptg000022l	16831992	16832160	168	g_20477	g_35296
ptg000022l	16835289	16837639	2350	g_35296	g_34673
ptg000022l	16839930	16845012	5082	g_34673	g_9724
ptg000022l	16846869	16850445	3576	g_9724	g_27193
ptg000022l	16855513	16864031	8518	g_27193	g_2188
ptg000022l	16864402	16868714	4312	g_2188	g_27749
ptg000022l	16885292	16887246	1954	g_27749	g_35676
ptg000022l	16891283	16896962	5679	g_35676	g_34577
ptg000022l	16897858	16897994	136	g_34577	g_40289
ptg000022l	16899428	16907688	8260	g_40289	g_34615
ptg000022l	16908647	16949187	40540	g_34615	g_30884
ptg000022l	16961423	16998930	37507	g_30884	g_13444
ptg000022l	16999652	17001831	2179	g_13444	g_19804
ptg000022l	17005858	17007069	1211	g_19804	g_13034
ptg000022l	17008454	17009892	1438	g_13034	g_10995
ptg000022l	17018652	17020992	2340	g_10995	g_10335
ptg000022l	17021639	17022712	1073	g_10335	g_15047
ptg000022l	17023137	17030705	7568	g_15047	g_20707
ptg000022l	17037050	17039292	2242	g_20707	g_12971
ptg000022l	17040445	17047720	7275	g_12971	g_7491
ptg000022l	17055552	17056877	1325	g_7491	g_7278
ptg000022l	17057310	17058499	1189	g_7278	g_15660
ptg000022l	17060476	17062083	1607	g_15660	g_30331
ptg000022l	17063477	17071168	7691	g_30331	g_3462
ptg000022l	17075370	17079629	4259	g_3462	g_6572
ptg000022l	17095537	17096817	1280	g_6572	g_29838
ptg000022l	17097029	17101008	3979	g_29838	g_33359
ptg000022l	17101313	17125276	23963	g_33359	g_36027
ptg000022l	17132082	17142513	10431	g_36027	g_25271
ptg000022l	17147461	17150126	2665	g_25271	g_19721
ptg000022l	17155108	17159101	3993	g_19721	g_13897
ptg000022l	17159727	17166481	6754	g_13897	g_14446
ptg000022l	17180268	17204995	24727	g_14446	g_14734
ptg000022l	17215031	17239530	24499	g_39259	g_12260
ptg000022l	17240394	17257473	17079	g_12260	g_21783
ptg000022l	17258513	17356688	98175	g_21783	g_15885
ptg000022l	17357548	17395730	38182	g_15885	g_4381
ptg000022l	17418807	17421521	2714	g_4381	g_16042
ptg000022l	17426356	17442507	16151	g_16042	g_22030
ptg000022l	17467483	17479692	12209	g_22030	g_28311
ptg000022l	17497380	17528436	31056	g_28311	g_36572
ptg000022l	17529756	17545538	15782	g_36572	g_36443
ptg000022l	17546533	17555238	8705	g_36443	g_7939
ptg000022l	17564053	17585237	21184	g_7939	g_18313
ptg000022l	17586559	17590027	3468	g_18313	g_10268
ptg000022l	17591169	17601496	10327	g_10268	g_13894
ptg000022l	17603480	17624697	21217	g_13894	g_26323
ptg000022l	17630173	17631933	1760	g_26323	g_18486
ptg000022l	17634921	17635366	445	g_18486	g_2015
ptg000022l	17636802	17639527	2725	g_2015	g_10828
ptg000022l	17641518	17642918	1400	g_10828	g_12585
ptg000022l	17651251	17714094	62843	g_12585	g_19353
ptg000022l	17714522	17714699	177	g_19353	g_7755
ptg000022l	17734602	17751640	17038	g_7755	g_36064
ptg000022l	17756366	17770321	13955	g_36064	g_9544
ptg000022l	17778146	17813364	35218	g_9544	g_16314
ptg000022l	17813981	17828932	14951	g_16314	g_34726
ptg000022l	17840524	17881025	40501	g_34726	g_16319
ptg000022l	17892743	17897827	5084	g_16319	g_21543
ptg000022l	17903200	17910350	7150	g_21543	g_7646
ptg000022l	17911309	17938712	27403	g_7646	g_3758
ptg000022l	17945369	17951432	6063	g_3758	g_14540
ptg000022l	17954271	17955447	1176	g_14540	g_37402
ptg000022l	17957363	17965652	8289	g_37402	g_33468
ptg000022l	17968222	17970119	1897	g_33468	g_37996
ptg000022l	17977296	17980513	3217	g_37996	g_37407
ptg000022l	17982085	18021206	39121	g_37407	g_11978
ptg000022l	18026873	18031336	4463	g_11978	g_24065
ptg000022l	18032247	18034151	1904	g_24065	g_14078
ptg000022l	18036878	18047701	10823	g_14078	g_8993
ptg000022l	18048266	18054535	6269	g_8993	g_9400
ptg000022l	18062282	18065255	2973	g_9400	g_37622
ptg000022l	18072641	18073408	767	g_37622	g_31935
ptg000022l	18074808	18079256	4448	g_31935	g_11393
ptg000022l	18079822	18085921	6099	g_11393	g_7584
ptg000022l	18114659	18226720	112061	g_7584	g_30914
ptg000022l	18228840	18264016	35176	g_30914	g_20057
ptg000022l	18264246	18395268	131022	g_20057	g_2200
ptg000022l	18396380	18402011	5631	g_2200	g_12111
ptg000022l	18410820	18428435	17615	g_12111	g_15717
ptg000022l	18429552	18430721	1169	g_15717	g_13531
ptg000022l	18431636	18478525	46889	g_13531	g_25131
ptg000022l	18480461	18573104	92643	g_25131	g_15876
ptg000022l	18577031	18579583	2552	g_15876	g_31702
ptg000022l	18594428	18595735	1307	g_31702	g_27720
ptg000022l	18598851	18602573	3722	g_27720	g_3160
ptg000022l	18607786	18613446	5660	g_3160	g_3850
ptg000022l	18618124	18654271	36147	g_3850	g_19546
ptg000022l	18664990	18686870	21880	g_19546	g_10397
ptg000022l	18689711	18693576	3865	g_10397	g_15415
ptg000022l	18698943	18750078	51135	g_15415	g_36073
ptg000022l	18752135	18791093	38958	g_36073	g_4613
ptg000022l	18797426	18808885	11459	g_4613	g_21086
ptg000022l	18812798	18834652	21854	g_21086	g_31782
ptg000022l	18840244	18849199	8955	g_31782	g_1311
ptg000022l	18857699	18932705	75006	g_1311	g_9759
ptg000022l	18943799	18944804	1005	g_9759	g_33450
ptg000022l	18952420	18954706	2286	g_33450	g_5068
ptg000022l	18959493	18984926	25433	g_5068	g_11232
ptg000022l	19001653	19362242	360589	g_11232	g_17263
ptg000022l	19381582	19422150	40568	g_17263	g_3668
ptg000022l	19426414	19434342	7928	g_3668	g_5673
ptg000022l	19448463	19468976	20513	g_5673	g_30533
ptg000022l	19473997	19480367	6370	g_30533	g_18084
ptg000022l	19484542	19485407	865	g_18084	g_36375
ptg000022l	19493129	19497136	4007	g_36375	g_30984
ptg000022l	19505597	19526530	20933	g_30984	g_33755
ptg000022l	19540661	19542757	2096	g_33755	g_2034
ptg000022l	19549817	19558687	8870	g_2034	g_39234
ptg000022l	19559022	19563610	4588	g_39234	g_2836
ptg000022l	19570480	19572330	1850	g_2836	g_14251
ptg000022l	19574674	19577685	3011	g_14251	g_17663
ptg000022l	19582022	19588734	6712	g_17663	g_34831
ptg000022l	19590736	19593173	2437	g_34831	g_28455
ptg000022l	19596942	19627184	30242	g_28455	g_7058
ptg000022l	19638650	19642424	3774	g_7058	g_8977
ptg000022l	19645726	19649729	4003	g_8977	g_16378
ptg000022l	19650946	19751815	100869	g_16378	g_38825
ptg000022l	19758789	19868837	110048	g_38825	g_18933
ptg000022l	19881647	19927177	45530	g_18933	g_3223
ptg000022l	19939502	19944901	5399	g_3223	g_22539
ptg000022l	19964511	20004050	39539	g_22539	g_36440
ptg000022l	20004817	20007452	2635	g_36440	g_2786
ptg000022l	20016180	20022670	6490	g_2786	g_26884
ptg000022l	20041093	20073865	32772	g_26884	g_18518
ptg000022l	20079786	20087100	7314	g_18518	g_25631
ptg000022l	20089496	20093718	4222	g_25631	g_37675
ptg000022l	20097018	20099136	2118	g_37675	g_20890
ptg000022l	20099483	20100129	646	g_20890	g_30440
ptg000022l	20102671	20105289	2618	g_30440	g_3468
ptg000022l	20125537	20127149	1612	g_3468	g_40104
ptg000022l	20132978	20136396	3418	g_40104	g_40105
ptg000022l	20141487	20141594	107	g_40105	g_11992
ptg000022l	20149600	20170082	20482	g_11992	g_26695
ptg000022l	20173472	20175015	1543	g_26695	g_7187
ptg000022l	20177040	20177974	934	g_7187	g_5166
ptg000022l	20178636	20187756	9120	g_5166	g_25636
ptg000022l	20188367	20200787	12420	g_25636	g_28863
ptg000022l	20201347	20214445	13098	g_28863	g_30921
ptg000022l	20215727	20240143	24416	g_30921	g_18519
ptg000022l	20244344	20245362	1018	g_18519	g_25473
ptg000022l	20247405	20248238	833	g_25473	g_3532
ptg000022l	20249987	20269227	19240	g_3532	g_18788
ptg000022l	20274486	20278558	4072	g_18788	g_3629
ptg000022l	20281112	20286099	4987	g_3629	g_20915
ptg000022l	20302843	20307571	4728	g_20915	g_32471
ptg000022l	20319767	20384123	64356	g_32471	g_29036
ptg000022l	20392838	20412916	20078	g_29036	g_32718
ptg000022l	20418850	20630623	211773	g_32718	g_17125
ptg000022l	20634761	20646175	11414	g_17125	g_10150
ptg000022l	20650060	20654497	4437	g_10150	g_23326
ptg000022l	20672580	20681938	9358	g_23326	g_10506
ptg000022l	20683921	20687049	3128	g_10506	g_14638
ptg000022l	20688225	20690639	2414	g_14638	g_40135
ptg000022l	20691794	20696111	4317	g_40135	g_40123
ptg000022l	20697954	20706002	8048	g_40123	g_13422
ptg000022l	20709045	20712045	3000	g_13422	g_4457
ptg000022l	20714245	20719325	5080	g_4457	g_28443
ptg000022l	20732038	20736683	4645	g_28443	g_8903
ptg000022l	20745808	20803758	57950	g_8903	g_39665
ptg000022l	20804066	20806232	2166	g_39665	g_25524
ptg000022l	20809396	20811632	2236	g_25524	g_12928
ptg000022l	20813745	20815732	1987	g_12928	g_12421
ptg000022l	20823142	20823399	257	g_12421	g_10062
ptg000022l	20829859	20831639	1780	g_10062	g_9176
ptg000022l	20839764	20840573	809	g_9176	g_34675
ptg000022l	20844359	20845882	1523	g_34675	g_35993
ptg000022l	20854002	20980097	126095	g_35993	g_2618
ptg000022l	20990848	21050846	59998	g_2618	g_18566
ptg000022l	21062976	21074153	11177	g_18566	g_8930
ptg000022l	21076660	21085682	9022	g_8930	g_9302
ptg000022l	21088474	21097493	9019	g_9302	g_17168
ptg000022l	21100295	21107697	7402	g_17168	g_29733
ptg000022l	21110481	21118560	8079	g_29733	g_11624
ptg000022l	21121365	21129087	7722	g_11624	g_24974
ptg000022l	21131864	21143137	11273	g_24974	g_7905
ptg000022l	21145654	21153389	7735	g_7905	g_37976
ptg000022l	21156173	21167095	10922	g_37976	g_21686
ptg000022l	21169898	21177302	7404	g_21686	g_18532
ptg000022l	21180085	21188052	7967	g_18532	g_28257
ptg000022l	21189488	21191020	1532	g_28257	g_10029
ptg000022l	21193852	21201686	7834	g_10029	g_28194
ptg000022l	21204272	21218678	14406	g_28194	g_1598
ptg000022l	21219430	21222006	2576	g_1598	g_10457
ptg000022l	21224802	21232200	7398	g_10457	g_10442
ptg000022l	21234977	21240003	5026	g_10442	g_9593
ptg000022l	21242816	21250329	7513	g_9593	g_30992
ptg000022l	21253121	21262808	9687	g_30992	g_13602
ptg000022l	21265631	21273366	7735	g_13602	g_10400
ptg000022l	21275921	21280406	4485	g_10400	g_35644
ptg000022l	21283166	21305237	22071	g_35644	g_471
ptg000022l	21312518	21322338	9820	g_471	g_9822
ptg000022l	21324898	21339231	14333	g_9822	g_29887
ptg000022l	21341531	21362819	21288	g_29887	g_35789
ptg000022l	21368717	21369880	1163	g_35789	g_16547
ptg000022l	21375794	21379496	3702	g_16547	g_29301
ptg000022l	21379771	21382578	2807	g_29301	g_6224
ptg000022l	21400206	21403426	3220	g_6224	g_25017
ptg000022l	21406985	21420605	13620	g_25017	g_18108
ptg000022l	21422513	21434676	12163	g_18108	g_29751
ptg000022l	21441665	21445971	4306	g_29751	g_20743
ptg000022l	21457701	21461440	3739	g_20743	g_25142
ptg000022l	21462514	21478483	15969	g_25142	g_1701
ptg000022l	21491056	21510250	19194	g_1701	g_23027
ptg000022l	21512053	21521557	9504	g_23027	g_40182
ptg000022l	21524393	21526010	1617	g_40182	g_18132
ptg000022l	21532940	21534776	1836	g_18132	g_14587
ptg000022l	21535720	21540731	5011	g_14587	g_4385
ptg000022l	21545391	21575548	30157	g_4385	g_13216
ptg000022l	21577066	21612778	35712	g_13216	g_2939
ptg000022l	21614796	21620192	5396	g_2939	g_39954
ptg000022l	21621919	21637869	15950	g_39954	g_2215
ptg000022l	21638720	21643886	5166	g_2215	g_28428
ptg000022l	21645619	21653211	7592	g_28428	g_25124
ptg000022l	21655621	21663590	7969	g_25124	g_13586
ptg000022l	21665837	21681603	15766	g_13586	g_5920
ptg000022l	21681803	21701563	19760	g_5920	g_10654
ptg000022l	21702581	21735667	33086	g_10654	g_30207
ptg000022l	21736419	21745243	8824	g_30207	g_22375
ptg000022l	21746979	21752040	5061	g_22375	g_4867
ptg000022l	21756624	21788438	31814	g_4867	g_16734
ptg000022l	21789691	21793179	3488	g_16734	g_40163
ptg000022l	21795252	21801931	6679	g_40163	g_12705
ptg000022l	21804087	21809213	5126	g_12705	g_16836
ptg000022l	21811349	21814857	3508	g_16836	g_34325
ptg000022l	21816657	21825840	9183	g_34325	g_24069
ptg000022l	21827970	21831481	3511	g_24069	g_113
ptg000022l	21833281	21839819	6538	g_113	g_36163
ptg000022l	21841945	21852487	10542	g_36163	g_15017
ptg000022l	21855094	21862183	7089	g_15017	g_35836
ptg000022l	21863766	21873159	9393	g_35836	g_25386
ptg000022l	21874853	21888298	13445	g_25386	g_32389
ptg000022l	21890429	21895587	5158	g_32389	g_7982
ptg000022l	21919041	21968527	49486	g_7982	g_18148
ptg000022l	21969570	22018810	49240	g_18148	g_4166
ptg000022l	22021585	22028763	7178	g_4166	g_12077
ptg000022l	22032614	22048052	15438	g_12077	g_16808
ptg000022l	22052186	22149888	97702	g_16808	g_4995
ptg000022l	22150400	22192617	42217	g_4995	g_27433
ptg000022l	22192901	22248168	55267	g_27433	g_23659
ptg000022l	22249785	22255528	5743	g_23659	g_20688
ptg000022l	22261480	22263740	2260	g_20688	g_24492
ptg000022l	22270677	22333463	62786	g_24492	g_25769
ptg000022l	22336856	22404614	67758	g_25769	g_3969
ptg000022l	22413650	22423576	9926	g_3969	g_19031
ptg000022l	22429341	22430046	705	g_19031	g_28502
ptg000022l	22442736	22443853	1117	g_28502	g_15707
ptg000022l	22445460	22453275	7815	g_15707	g_621
ptg000022l	22453628	22537847	84219	g_621	g_14663
ptg000022l	22538383	22548136	9753	g_14663	g_7787
ptg000022l	22554227	22571857	17630	g_7787	g_29794
ptg000022l	22572075	22581275	9200	g_29794	g_19375
ptg000022l	22586217	22625621	39404	g_19375	g_21943
ptg000022l	22626085	22626198	113	g_21943	g_18592
ptg000022l	22626845	22720027	93182	g_18592	g_30138
ptg000022l	22720557	22969336	248779	g_30138	g_22422
ptg000022l	22969875	23191658	221783	g_22422	g_16993
ptg000022l	23192191	23203301	11110	g_16993	g_28546
ptg000022l	23203831	23425267	221436	g_28546	g_16872
ptg000022l	23425806	23607960	182154	g_16872	g_5765
ptg000022l	23610976	23613681	2705	g_5765	g_38042
ptg000022l	23616422	23618998	2576	g_38042	g_11396
ptg000022l	23640051	23644034	3983	g_11396	g_1533
ptg000022l	23646714	23655763	9049	g_1533	g_32547
ptg000022l	23677305	23678983	1678	g_32547	g_7675
ptg000022l	23681780	23702501	20721	g_7675	g_726
ptg000022l	23712594	23714922	2328	g_726	g_30075
ptg000022l	23733640	23737878	4238	g_30075	g_21925
ptg000022l	23741680	23744226	2546	g_21925	g_33998
ptg000022l	23753853	23759383	5530	g_33998	g_38341
ptg000022l	23765719	23766919	1200	g_38341	g_15173
ptg000022l	23769414	23770684	1270	g_15173	g_12013
ptg000022l	23772406	23773281	875	g_12013	g_23486
ptg000022l	23776512	23777395	883	g_23486	g_7444
ptg000022l	23782354	23790464	8110	g_7444	g_11167
ptg000022l	23791747	23815552	23805	g_11167	g_32691
ptg000022l	23818521	23820509	1988	g_32691	g_14227
ptg000022l	23823393	23826871	3478	g_14227	g_40130
ptg000022l	23828866	23832279	3413	g_34664	g_22595
ptg000022l	23834889	23838440	3551	g_22595	g_4287
ptg000022l	23855352	23857739	2387	g_4287	g_7524
ptg000022l	23860864	23900654	39790	g_7524	g_26600
ptg000022l	23903865	23905157	1292	g_26600	g_36996
ptg000022l	23906325	23910428	4103	g_36996	g_29855
ptg000022l	23913823	23916657	2834	g_29855	g_26752
ptg000022l	23921734	23926280	4546	g_26752	g_14173
ptg000022l	23929728	23934188	4460	g_14173	g_20127
ptg000022l	23940119	23948197	8078	g_20127	g_25683
ptg000022l	23956990	23958095	1105	g_25683	g_28166
ptg000022l	23962021	23964722	2701	g_28166	g_25265
ptg000022l	23971779	23980852	9073	g_25265	g_39037
ptg000022l	23981502	23983660	2158	g_39037	g_10517
ptg000022l	24004142	24026102	21960	g_10517	g_5829
ptg000022l	24035510	24059640	24130	g_5829	g_6103
ptg000022l	24073209	24075900	2691	g_6103	g_6040
ptg000022l	24092553	24106252	13699	g_6040	g_17744
ptg000022l	24109436	24142485	33049	g_17744	g_14385
ptg000022l	24152363	24155214	2851	g_14385	g_27485
ptg000022l	24161228	24169898	8670	g_27485	g_3594
ptg000022l	24172456	24173880	1424	g_3594	g_39024
ptg000022l	24176125	24179356	3231	g_39024	g_31287
ptg000022l	24180728	24312240	131512	g_31287	g_23800
ptg000022l	24314893	24355821	40928	g_23800	g_23435
ptg000022l	24367292	24457890	90598	g_23435	g_2058
ptg000022l	24459569	24488608	29039	g_2058	g_34738
ptg000022l	24489234	24494235	5001	g_34738	g_31224
ptg000022l	24502302	24540038	37736	g_31224	g_7125
ptg000022l	24546357	24566007	19650	g_7125	g_21333
ptg000022l	24581412	24588396	6984	g_21333	g_37052
ptg000022l	24618863	24675628	56765	g_37052	g_17157
ptg000022l	24690448	24694832	4384	g_17157	g_5881
ptg000022l	24697280	24758066	60786	g_5881	g_34555
ptg000022l	24758578	24812533	53955	g_34555	g_14317
ptg000022l	24878114	24884695	6581	g_14317	g_8364
ptg000022l	24885048	25030356	145308	g_8364	g_16786
ptg000022l	25042693	25261540	218847	g_16786	g_34968
ptg000022l	25261878	25299435	37557	g_34968	g_12492
ptg000022l	25301616	25345030	43414	g_12492	g_35171
ptg000022l	25354471	25570900	216429	g_35171	g_27103
ptg000022l	25571118	25589137	18019	g_27103	g_10139
ptg000022l	25595736	25680533	84797	g_10139	g_20689
ptg000022l	25704031	25711351	7320	g_20689	g_19672
ptg000022l	25713779	25714761	982	g_19672	g_11005
ptg000022l	25717162	25722538	5376	g_11005	g_33619
ptg000022l	25727948	25731143	3195	g_33619	g_1614
ptg000022l	25753440	25758027	4587	g_1614	g_16919
ptg000022l	25760772	25772524	11752	g_16919	g_37621
ptg000022l	25778301	25786989	8688	g_37621	g_28728
ptg000022l	25806893	25814017	7124	g_28728	g_27886
ptg000022l	25835953	25838421	2468	g_27886	g_28635
ptg000022l	25838651	25842240	3589	g_28635	g_15069
ptg000022l	25844002	25845261	1259	g_15069	g_10935
ptg000022l	25849351	25877711	28360	g_10935	g_16450
ptg000022l	25884631	25887633	3002	g_16450	g_6703
ptg000022l	25889007	25889547	540	g_6703	g_35358
ptg000022l	25893934	25970663	76729	g_35358	g_31125
ptg000022l	25971511	25972845	1334	g_31125	g_15194
ptg000022l	25990907	25999583	8676	g_15194	g_16360
ptg000022l	26016737	26018036	1299	g_16360	g_4690
ptg000022l	26022061	26061318	39257	g_4690	g_38464
ptg000022l	26061950	26174706	112756	g_38464	g_32739
ptg000022l	26175296	26263734	88438	g_32739	g_37048
ptg000022l	26270402	26305883	35481	g_37048	g_32707
ptg000022l	26314862	26336303	21441	g_32707	g_34710
ptg000022l	26347444	26354042	6598	g_34710	g_16451
ptg000022l	26371735	26375424	3689	g_16451	g_23080
ptg000022l	26378651	26413239	34588	g_23080	g_3605
ptg000022l	26413442	26456924	43482	g_3605	g_9933
ptg000022l	26469775	26496603	26828	g_9933	g_5472
ptg000022l	26502459	26503522	1063	g_5472	g_7502
ptg000022l	26514381	26515760	1379	g_7502	g_5342
ptg000022l	26521621	26531360	9739	g_5342	g_4551
ptg000022l	26532950	26549543	16593	g_4551	g_19648
ptg000022l	26553929	26556933	3004	g_19648	g_23193
ptg000022l	26559377	26564285	4908	g_23193	g_5058
ptg000022l	26569516	26572974	3458	g_5058	g_25794
ptg000022l	26574828	26576356	1528	g_25794	g_12314
ptg000022l	26578307	26580767	2460	g_12314	g_13847
ptg000022l	26584113	26631184	47071	g_13847	g_30709
ptg000022l	26637035	26648979	11944	g_30709	g_17825
ptg000022l	26649179	26653418	4239	g_17825	g_24718
ptg000022l	26673489	26708918	35429	g_24718	g_18773
ptg000022l	26721314	26726906	5592	g_18773	g_8019
ptg000022l	26736213	26750143	13930	g_8019	g_35714
ptg000022l	26767077	26771911	4834	g_35714	g_32044
ptg000022l	26794902	26804034	9132	g_32044	g_35483
ptg000022l	26812245	26824348	12103	g_35483	g_11392
ptg000022l	26825217	26858525	33308	g_11392	g_34178
ptg000022l	26860592	26872323	11731	g_34178	g_6612
ptg000022l	26876971	26882605	5634	g_6612	g_23960
ptg000022l	26884307	26892315	8008	g_23960	g_26257
ptg000022l	26894900	26965307	70407	g_26257	g_36355
ptg000022l	26966155	26990666	24511	g_36355	g_16336
ptg000022l	27007149	27025647	18498	g_16336	g_7011
ptg000022l	27027776	27028996	1220	g_7011	g_6826
ptg000022l	27034571	27037614	3043	g_6826	g_37121
ptg000022l	27043324	27046116	2792	g_37121	g_26997
ptg000022l	27050776	27051415	639	g_26997	g_11240
ptg000022l	27054133	27058568	4435	g_11240	g_16312
ptg000022l	27064146	27066281	2135	g_16312	g_15384
ptg000022l	27086654	27093232	6578	g_15384	g_24405
ptg000022l	27098479	27153833	55354	g_24405	g_28893
ptg000022l	27164175	27165434	1259	g_28893	g_27833
ptg000022l	27174211	27176646	2435	g_27833	g_10321
ptg000022l	27178763	27179761	998	g_10321	g_26772
ptg000022l	27189665	27192242	2577	g_26772	g_22846
ptg000022l	27200591	27203517	2926	g_22846	g_16392
ptg000022l	27223876	27250624	26748	g_16392	g_34943
ptg000022l	27264004	27268837	4833	g_34943	g_3577
ptg000022l	27273522	27279293	5771	g_3577	g_15116
ptg000022l	27282324	27287345	5021	g_15116	g_27734
ptg000022l	27296560	27305033	8473	g_27734	g_29358
ptg000022l	27322703	27332370	9667	g_29358	g_5619
ptg000022l	27339271	27342199	2928	g_5619	g_20487
ptg000022l	27348150	27408834	60684	g_20487	g_12553
ptg000022l	27427090	27434118	7028	g_12553	g_21205
ptg000022l	27441607	27448268	6661	g_21205	g_36454
ptg000022l	27459411	27462618	3207	g_36454	g_21363
ptg000022l	27470767	27474144	3377	g_21363	g_7764
ptg000022l	27478517	27483738	5221	g_7764	g_1861
ptg000022l	27495124	27505715	10591	g_1861	g_5579
ptg000022l	27509329	27520810	11481	g_5579	g_7611
ptg000022l	27524066	27547072	23006	g_7611	g_6113
ptg000022l	27548448	27553971	5523	g_6113	g_19634
ptg000022l	27557216	27712975	155759	g_19634	g_507
ptg000022l	27721694	27723872	2178	g_507	g_12175
ptg000022l	27725734	27804606	78872	g_12175	g_17965
ptg000022l	27806487	27811856	5369	g_17965	g_22555
ptg000022l	27822463	27824391	1928	g_22555	g_18800
ptg000022l	27830055	27833073	3018	g_18800	g_18309
ptg000022l	27835856	27846519	10663	g_18309	g_10355
ptg000022l	27852496	27869810	17314	g_10355	g_37967
ptg000022l	27871856	27941123	69267	g_37967	g_30594
ptg000022l	27941629	27971578	29949	g_30594	g_21661
ptg000022l	27971823	27984651	12828	g_21661	g_5019
ptg000022l	27999772	28120600	120828	g_5019	g_4104
ptg000022l	28132675	28135452	2777	g_4104	g_15092
ptg000022l	28140104	28180022	39918	g_15092	g_22472
ptg000022l	28186389	28232785	46396	g_22472	g_9028
ptg000022l	28233276	28242135	8859	g_9028	g_19848
ptg000022l	28242878	28349259	106381	g_19848	g_37043
ptg000022l	28350550	28404274	53724	g_37043	g_9540
ptg000022l	28405924	28413068	7144	g_9540	g_28271
ptg000022l	28422898	28450072	27174	g_28271	g_19010
ptg000022l	28455572	28460665	5093	g_19010	g_24427
ptg000022l	28472636	28490939	18303	g_24427	g_16956
ptg000022l	28493250	28498309	5059	g_16956	g_1369
ptg000022l	28499688	28508838	9150	g_1369	g_17929
ptg000022l	28519124	28541127	22003	g_17929	g_15631
ptg000022l	28562766	28651475	88709	g_15631	g_9737
ptg000022l	28663543	28777027	113484	g_9737	g_15668
ptg000022l	28778280	28805317	27037	g_15668	g_7670
ptg000022l	28806420	28825618	19198	g_7670	g_37809
ptg000022l	28827315	28845318	18003	g_37809	g_35098
ptg000022l	28845524	28875831	30307	g_35098	g_23416
ptg000022l	28892815	28904141	11326	g_23416	g_84
ptg000022l	28924810	28937596	12786	g_84	g_3779
ptg000022l	28944708	28947840	3132	g_3779	g_654
ptg000022l	28949424	28953130	3706	g_654	g_31998
ptg000022l	28965015	28971179	6164	g_31998	g_5572
ptg000022l	28984868	28990649	5781	g_5572	g_33903
ptg000022l	28992528	29099168	106640	g_33903	g_2940
ptg000022l	29100448	29102483	2035	g_2940	g_13184
ptg000022l	29113342	29144280	30938	g_13184	g_15126
ptg000022l	29166812	29198406	31594	g_15126	g_9043
ptg000022l	29228600	29299642	71042	g_9043	g_14897
ptg000022l	29309492	29311268	1776	g_14897	g_12302
ptg000022l	29322350	29325485	3135	g_12302	g_14355
ptg000022l	29341027	29363396	22369	g_14355	g_6561
ptg000022l	29367952	29397680	29728	g_6561	g_19386
ptg000022l	29440035	29444815	4780	g_19386	g_29394
ptg000022l	29453299	29459980	6681	g_29394	g_24248
ptg000022l	29462449	29465184	2735	g_24248	g_30551
ptg000022l	29481616	29619949	138333	g_30551	g_19612
ptg000022l	29620908	29642353	21445	g_19612	g_7022
ptg000022l	29654992	29703608	48616	g_7022	g_31629
ptg000022l	29705335	29778205	72870	g_31629	g_1475
ptg000022l	29786118	29842897	56779	g_1475	g_22046
ptg000022l	29863670	29873439	9769	g_22046	g_31327
ptg000022l	29891989	29893853	1864	g_31327	g_15859
ptg000022l	29902474	29911975	9501	g_15859	g_755
ptg000022l	29913177	29980973	67796	g_755	g_25123
ptg000022l	29981839	30034980	53141	g_25123	g_3113
ptg000022l	30049898	30054546	4648	g_3113	g_24634
ptg000022l	30063836	30161275	97439	g_24634	g_17795
ptg000022l	30168543	30171165	2622	g_17795	g_3945
ptg000022l	30175050	30175691	641	g_3945	g_21760
ptg000022l	30191567	30193340	1773	g_21760	g_5336
ptg000022l	30202922	30228988	26066	g_5336	g_6244
ptg000022l	30239430	30296379	56949	g_6244	g_9895
ptg000022l	30297062	30445105	148043	g_9895	g_16576
ptg000022l	30447048	30486845	39797	g_16576	g_18465
ptg000022l	30487927	30501562	13635	g_18465	g_16635
ptg000022l	30501933	30701774	199841	g_16635	g_4904
ptg000022l	30703522	30709647	6125	g_4904	g_2244
ptg000022l	30709952	30785536	75584	g_2244	g_23200
ptg000022l	30785736	30785994	258	g_23200	g_7056
ptg000022l	30786614	30813628	27014	g_7056	g_4344
ptg000022l	30822218	30881856	59638	g_4344	g_13196
ptg000022l	30890917	30970705	79788	g_13196	g_39239
ptg000022l	30971406	30984435	13029	g_39239	g_12218
ptg000022l	30992402	31003724	11322	g_12218	g_22802
ptg000022l	31024780	31033129	8349	g_22802	g_36854
ptg000022l	31035962	31043809	7847	g_36854	g_18949
ptg000022l	31092476	31139052	46576	g_18949	g_29300
ptg000022l	31150195	31179044	28849	g_29300	g_33423
ptg000022l	31180804	31242528	61724	g_33423	g_1026
ptg000022l	31259747	31268325	8578	g_1026	g_32843
ptg000022l	31268555	31287534	18979	g_32843	g_12786
ptg000022l	31288877	31307528	18651	g_12786	g_35889
ptg000022l	31326667	31352494	25827	g_35889	g_17096
ptg000022l	31353372	31364473	11101	g_17096	g_2674
ptg000022l	31364742	31368771	4029	g_2674	g_13252
ptg000022l	31369013	31411999	42986	g_13252	g_12365
ptg000022l	31412436	31445260	32824	g_12365	g_3836
ptg000022l	31445463	31582029	136566	g_3836	g_14846
ptg000022l	31593477	31611475	17998	g_14846	g_412
ptg000022l	31612815	31633135	20320	g_412	g_13403
ptg000022l	31638077	31665886	27809	g_13403	g_15552
ptg000022l	31686085	31837664	151579	g_15552	g_1407
ptg000022l	31846455	31852796	6341	g_1407	g_4321
ptg000022l	31870894	31889608	18714	g_4321	g_33678
ptg000022l	31894631	31910919	16288	g_33678	g_23530
ptg000022l	31911437	31928841	17404	g_23530	g_37795
ptg000022l	31929371	31951452	22081	g_37795	g_19381
ptg000022l	31954029	31973965	19936	g_19381	g_32433
ptg000022l	31974285	31974324	39	g_32433	g_3271
ptg000022l	31974875	31975040	165	g_3271	g_34477
ptg000022l	31975246	31975371	125	g_34477	g_6588
ptg000022l	31975670	31979069	3399	g_6588	g_9729
ptg000022l	31987792	31993139	5347	g_9729	g_9368
ptg000022l	31997255	32004308	7053	g_9368	g_33883
ptg000022l	32012742	32017264	4522	g_33883	g_18373
ptg000022l	32021629	32031212	9583	g_18373	g_19761
ptg000022l	32040159	32049251	9092	g_19761	g_40203
ptg000022l	32050401	32057878	7477	g_40203	g_27876
ptg000022l	32065839	32135001	69162	g_27876	g_12154
ptg000022l	32141195	32147125	5930	g_12154	g_2955
ptg000022l	32153390	32182622	29232	g_2955	g_22863
ptg000022l	32203998	32212720	8722	g_22863	g_12530
ptg000022l	32214624	32226260	11636	g_12530	g_36824
ptg000022l	32245766	32252087	6321	g_36824	g_17126
ptg000022l	32254614	32301303	46689	g_17126	g_33275
ptg000022l	32318450	32324431	5981	g_33275	g_304
ptg000022l	32332345	32359397	27052	g_304	g_20768
ptg000022l	32367400	32376593	9193	g_20768	g_10399
ptg000022l	32377345	32411439	34094	g_10399	g_29534
ptg000022l	32411642	32414162	2520	g_29534	g_6206
ptg000023l	4946	71653	66707	g_37650	g_14923
ptg000023l	74807	76513	1706	g_14923	g_14515
ptg000023l	85021	88898	3877	g_14515	g_12362
ptg000023l	104717	113739	9022	g_12362	g_26562
ptg000023l	126961	144744	17783	g_26562	g_10971
ptg000023l	150795	156582	5787	g_10971	g_20851
ptg000023l	158339	169036	10697	g_20851	g_14789
ptg000023l	177595	183272	5677	g_14789	g_708
ptg000023l	192033	212316	20283	g_708	g_17363
ptg000023l	218074	238916	20842	g_17363	g_18130
ptg000023l	249203	249746	543	g_18130	g_30920
ptg000023l	268198	274469	6271	g_30920	g_19330
ptg000023l	275647	285320	9673	g_19330	g_20106
ptg000023l	307968	341924	33956	g_20106	g_28867
ptg000023l	353331	356377	3046	g_28867	g_25598
ptg000023l	357885	358807	922	g_25598	g_32202
ptg000023l	379761	387848	8087	g_32202	g_15910
ptg000023l	454605	472410	17805	g_15910	g_17190
ptg000023l	490978	575632	84654	g_17190	g_13493
ptg000023l	575919	579615	3696	g_13493	g_22914
ptg000023l	580478	800036	219558	g_22914	g_33595
ptg000023l	802031	806340	4309	g_33595	g_37352
ptg000023l	815098	820339	5241	g_37352	g_8947
ptg000023l	835199	837250	2051	g_8947	g_34686
ptg000023l	846883	850020	3137	g_34686	g_25741
ptg000023l	864350	886434	22084	g_25741	g_34263
ptg000023l	886922	908282	21360	g_34263	g_17680
ptg000023l	948409	1119009	170600	g_17680	g_36848
ptg000023l	1121436	1246236	124800	g_36848	g_36179
ptg000023l	1252265	1266860	14595	g_36179	g_23895
ptg000023l	1302714	1342954	40240	g_23895	g_23903
ptg000023l	1355983	1361586	5603	g_23903	g_39968
ptg000023l	1365605	1378486	12881	g_39968	g_3637
ptg000023l	1382234	1385547	3313	g_3637	g_14103
ptg000023l	1385870	1449951	64081	g_14103	g_22299
ptg000023l	1454238	1456100	1862	g_22299	g_29285
ptg000023l	1464353	1466234	1881	g_29285	g_10087
ptg000023l	1468879	1477376	8497	g_10087	g_14908
ptg000023l	1485856	1548782	62926	g_14908	g_27379
ptg000023l	1558144	1577161	19017	g_27379	g_17411
ptg000023l	1578428	1588460	10032	g_17411	g_752
ptg000023l	1589883	1594348	4465	g_752	g_8050
ptg000023l	1603644	1636387	32743	g_8050	g_4866
ptg000023l	1637546	1638883	1337	g_4866	g_9952
ptg000023l	1640800	1645264	4464	g_9952	g_3447
ptg000023l	1654559	1717810	63251	g_3447	g_5569
ptg000023l	1719054	1722089	3035	g_5569	g_12473
ptg000023l	1727809	1758373	30564	g_12473	g_6437
ptg000023l	1759943	1762514	2571	g_6437	g_32585
ptg000023l	1772457	1775988	3531	g_32585	g_22233
ptg000023l	1783943	1794445	10502	g_22233	g_18713
ptg000023l	1803941	1806150	2209	g_18713	g_26743
ptg000023l	1808292	1818422	10130	g_26743	g_19185
ptg000023l	1822600	1832062	9462	g_19185	g_26270
ptg000023l	1846377	1862386	16009	g_26270	g_3794
ptg000023l	1866129	1883763	17634	g_3794	g_33022
ptg000023l	1883984	1884924	940	g_33022	g_9488
ptg000023l	1888008	1889441	1433	g_9488	g_27521
ptg000023l	1891696	1904691	12995	g_27521	g_27623
ptg000023l	1910657	1937317	26660	g_27623	g_26978
ptg000023l	1939885	1940634	749	g_26978	g_35281
ptg000023l	1948273	1949142	869	g_35281	g_22287
ptg000023l	1954853	1962441	7588	g_22287	g_16443
ptg000023l	1972818	1974500	1682	g_16443	g_7944
ptg000023l	1979793	1987190	7397	g_7944	g_33236
ptg000023l	1991797	1993922	2125	g_33236	g_4982
ptg000023l	2005496	2005695	199	g_4982	g_36618
ptg000023l	2005937	2006667	730	g_36618	g_24790
ptg000023l	2012768	2035565	22797	g_24790	g_4829
ptg000023l	2051074	2065364	14290	g_4829	g_2032
ptg000023l	2072117	2073434	1317	g_2032	g_28269
ptg000023l	2075007	2077884	2877	g_28269	g_19982
ptg000023l	2081392	2087042	5650	g_19982	g_28305
ptg000023l	2091345	2095631	4286	g_28305	g_30657
ptg000023l	2116176	2122657	6481	g_30657	g_1694
ptg000023l	2123881	2130371	6490	g_1694	g_37921
ptg000023l	2133789	2137242	3453	g_37921	g_27047
ptg000023l	2140999	2142733	1734	g_27047	g_23337
ptg000023l	2146934	2148355	1421	g_23337	g_22788
ptg000023l	2157598	2174011	16413	g_22788	g_6330
ptg000023l	2183468	2187910	4442	g_6330	g_20459
ptg000023l	2191329	2192901	1572	g_20459	g_22998
ptg000023l	2195332	2196707	1375	g_22998	g_3992
ptg000023l	2212150	2222209	10059	g_3992	g_13366
ptg000023l	2223252	2225657	2405	g_13366	g_18184
ptg000023l	2230303	2231075	772	g_18184	g_32692
ptg000023l	2234657	2240505	5848	g_32692	g_11889
ptg000023l	2245763	2250465	4702	g_11889	g_40102
ptg000023l	2259267	2261905	2638	g_40102	g_21243
ptg000023l	2265050	2312662	47612	g_21243	g_9572
ptg000023l	2317001	2317242	241	g_9572	g_40071
ptg000023l	2331920	2338317	6397	g_40071	g_4783
ptg000023l	2344905	2353762	8857	g_4783	g_32995
ptg000023l	2368453	2375676	7223	g_32995	g_9000
ptg000023l	2387938	2398638	10700	g_9000	g_18761
ptg000023l	2408023	2418141	10118	g_18761	g_4201
ptg000023l	2424085	2436472	12387	g_4201	g_502
ptg000023l	2439016	2439329	313	g_502	g_4302
ptg000023l	2442491	2443823	1332	g_4302	g_26115
ptg000023l	2447128	2449897	2769	g_26115	g_21165
ptg000023l	2452151	2461322	9171	g_21165	g_12121
ptg000023l	2465833	2466308	475	g_12121	g_16016
ptg000023l	2468329	2471180	2851	g_16016	g_16846
ptg000023l	2472361	2473183	822	g_16846	g_13308
ptg000023l	2475737	2535224	59487	g_13308	g_36878
ptg000023l	2535952	2538093	2141	g_36878	g_40293
ptg000023l	2538950	2545846	6896	g_40293	g_16094
ptg000023l	2560644	2566709	6065	g_16094	g_7484
ptg000023l	2567638	2571486	3848	g_7484	g_2270
ptg000023l	2576230	2617643	41413	g_2270	g_4828
ptg000023l	2629408	2652019	22611	g_4828	g_13455
ptg000023l	2654375	2671935	17560	g_13455	g_24935
ptg000023l	2672432	2674936	2504	g_24935	g_32529
ptg000023l	2675586	2687832	12246	g_32529	g_17432
ptg000023l	2699549	2702004	2455	g_17432	g_31413
ptg000023l	2710168	2711844	1676	g_31413	g_7470
ptg000023l	2712737	2713669	932	g_7470	g_1350
ptg000023l	2716190	2718644	2454	g_1350	g_39923
ptg000023l	2725781	2757844	32063	g_39923	g_25416
ptg000023l	2758074	2842497	84423	g_25416	g_459
ptg000023l	2842784	2847258	4474	g_459	g_33415
ptg000023l	2847542	2895736	48194	g_33415	g_8101
ptg000023l	2906360	2935921	29561	g_8101	g_8569
ptg000023l	2936553	3045706	109153	g_8569	g_33796
ptg000023l	3050601	3055139	4538	g_33796	g_37984
ptg000023l	3061933	3063603	1670	g_37984	g_356
ptg000023l	3065711	3069046	3335	g_356	g_22019
ptg000023l	3072011	3078491	6480	g_22019	g_4638
ptg000023l	3082445	3123234	40789	g_4638	g_15595
ptg000023l	3148034	3156060	8026	g_15595	g_19999
ptg000023l	3158382	3185731	27349	g_19999	g_7081
ptg000023l	3189459	3208430	18971	g_7081	g_28774
ptg000023l	3212422	3241080	28658	g_28774	g_6424
ptg000023l	3241919	3243688	1769	g_6424	g_3614
ptg000023l	3249293	3253234	3941	g_3614	g_40048
ptg000023l	3260357	3262235	1878	g_40048	g_8499
ptg000023l	3270377	3305780	35403	g_8499	g_1785
ptg000023l	3308612	3312106	3494	g_1785	g_27995
ptg000023l	3314091	3446455	132364	g_27995	g_13835
ptg000023l	3461309	3464373	3064	g_13835	g_14795
ptg000023l	3464960	3524999	60039	g_14795	g_37186
ptg000023l	3526959	3528763	1804	g_37186	g_30853
ptg000023l	3532609	3537896	5287	g_30853	g_25614
ptg000023l	3542435	3556729	14294	g_25614	g_37355
ptg000023l	3557338	3558282	944	g_37355	g_6194
ptg000023l	3558581	3561229	2648	g_6194	g_38664
ptg000023l	3562164	3563512	1348	g_38664	g_24371
ptg000023l	3564516	3566946	2430	g_24371	g_4261
ptg000023l	3567965	3574971	7006	g_4261	g_38604
ptg000023l	3575378	3579451	4073	g_38604	g_8142
ptg000023l	3585185	3588310	3125	g_8142	g_18023
ptg000023l	3602444	3620422	17978	g_18023	g_32672
ptg000023l	3625180	3628899	3719	g_32672	g_21223
ptg000023l	3631043	3632294	1251	g_21223	g_3918
ptg000023l	3645667	3657801	12134	g_3918	g_21610
ptg000023l	3663102	3666179	3077	g_21610	g_11019
ptg000023l	3668143	3680961	12818	g_11019	g_32122
ptg000023l	3685897	3754159	68262	g_32122	g_25109
ptg000023l	3770728	3788907	18179	g_25109	g_11843
ptg000023l	3797501	3802038	4537	g_11843	g_36539
ptg000023l	3811884	3813348	1464	g_36539	g_37540
ptg000023l	3819665	3821468	1803	g_37540	g_29870
ptg000023l	3826047	3829172	3125	g_29870	g_13286
ptg000023l	3831285	3833561	2276	g_13286	g_29873
ptg000023l	3839819	3851170	11351	g_29873	g_28459
ptg000023l	3853817	3857857	4040	g_28459	g_26962
ptg000023l	3859067	3899531	40464	g_26962	g_28621
ptg000023l	3900832	3911195	10363	g_28621	g_36295
ptg000023l	3924958	3937228	12270	g_36295	g_17400
ptg000023l	3938022	3950566	12544	g_17400	g_12843
ptg000023l	3974203	3980434	6231	g_12843	g_10675
ptg000023l	3981249	4146001	164752	g_10675	g_33200
ptg000023l	4160768	4179866	19098	g_33200	g_15834
ptg000023l	4185616	4222270	36654	g_15834	g_5595
ptg000023l	4237804	4243663	5859	g_5595	g_35135
ptg000023l	4244017	4245842	1825	g_35135	g_35181
ptg000023l	4246354	4272883	26529	g_35181	g_9762
ptg000023l	4292382	4294414	2032	g_9762	g_20280
ptg000023l	4309510	4322133	12623	g_20280	g_11573
ptg000023l	4322603	4339953	17350	g_11573	g_2663
ptg000023l	4341976	4348925	6949	g_2663	g_35991
ptg000023l	4352696	4423267	70571	g_35991	g_2223
ptg000023l	4428231	4433783	5552	g_2223	g_110
ptg000023l	4437183	4438148	965	g_110	g_10179
ptg000023l	4466766	4490310	23544	g_10179	g_90
ptg000023l	4503828	4509229	5401	g_90	g_15829
ptg000023l	4514870	4518279	3409	g_15829	g_26465
ptg000023l	4526123	4537882	11759	g_26465	g_12303
ptg000023l	4538799	4555568	16769	g_12303	g_22844
ptg000023l	4559485	4570357	10872	g_22844	g_29497
ptg000023l	4571357	4573942	2585	g_29497	g_2331
ptg000023l	4578603	4587524	8921	g_2331	g_31424
ptg000023l	4602602	4608425	5823	g_31424	g_8546
ptg000023l	4608673	4733067	124394	g_8546	g_22478
ptg000023l	4733504	4742205	8701	g_22478	g_7578
ptg000023l	4755331	4766115	10784	g_7578	g_4875
ptg000023l	4768994	4785413	16419	g_4875	g_21742
ptg000023l	4793467	4794655	1188	g_21742	g_27037
ptg000023l	4801606	4817622	16016	g_27037	g_30155
ptg000023l	4823461	4847307	23846	g_30155	g_26710
ptg000023l	4865959	4869988	4029	g_26710	g_8821
ptg000023l	4884710	4902012	17302	g_8821	g_34300
ptg000023l	4908033	4925224	17191	g_34300	g_10092
ptg000023l	4936780	4940518	3738	g_10092	g_40080
ptg000023l	4943029	4947615	4586	g_40080	g_10091
ptg000023l	4949184	4954327	5143	g_10091	g_27644
ptg000023l	4955804	4981511	25707	g_27644	g_4108
ptg000023l	4982053	4984198	2145	g_4108	g_17693
ptg000023l	4994393	4994473	80	g_17693	g_33965
ptg000023l	4996068	4996264	196	g_33965	g_17297
ptg000023l	5002789	5007889	5100	g_17297	g_11087
ptg000023l	5033293	5050279	16986	g_11087	g_4330
ptg000023l	5057472	5117359	59887	g_4330	g_29458
ptg000023l	5117838	5241004	123166	g_29458	g_3847
ptg000023l	5245832	5282098	36266	g_3847	g_29830
ptg000023l	5297512	5302050	4538	g_29830	g_23656
ptg000023l	5304825	5314474	9649	g_23656	g_14623
ptg000023l	5328668	5329677	1009	g_14623	g_37909
ptg000023l	5332084	5333268	1184	g_37909	g_25431
ptg000023l	5336554	5402822	66268	g_25431	g_13020
ptg000023l	5404280	5425880	21600	g_13020	g_4921
ptg000023l	5426344	5445626	19282	g_4921	g_27429
ptg000023l	5446237	5468827	22590	g_27429	g_18003
ptg000023l	5478912	5483190	4278	g_18003	g_22578
ptg000023l	5486194	5487172	978	g_22578	g_22025
ptg000023l	5492464	5493532	1068	g_22025	g_32092
ptg000023l	5495201	5496304	1103	g_32092	g_8011
ptg000023l	5499221	5503456	4235	g_8011	g_9928
ptg000023l	5505764	5587595	81831	g_9928	g_20892
ptg000023l	5587840	5597080	9240	g_20892	g_1189
ptg000023l	5605087	5617774	12687	g_1189	g_6636
ptg000023l	5620367	5621211	844	g_6636	g_37413
ptg000023l	5622365	5628105	5740	g_37413	g_24863
ptg000023l	5628726	5631174	2448	g_24863	g_8843
ptg000023l	5631790	5637076	5286	g_8843	g_9694
ptg000023l	5639846	5724442	84596	g_9694	g_26141
ptg000023l	5725532	5791932	66400	g_26141	g_33611
ptg000023l	5798178	5850505	52327	g_33611	g_28436
ptg000023l	5850723	5851483	760	g_28436	g_12193
ptg000023l	5851806	5853681	1875	g_12193	g_7078
ptg000023l	5854179	5901653	47474	g_7078	g_21770
ptg000023l	5902690	5902919	229	g_21770	g_35378
ptg000023l	5903185	5972655	69470	g_35378	g_9832
ptg000023l	5991880	6035546	43666	g_9832	g_22404
ptg000023l	6038550	6067884	29334	g_22404	g_28006
ptg000023l	6068186	6097854	29668	g_28006	g_12084
ptg000023l	6117605	6131804	14199	g_12084	g_39690
ptg000023l	6140573	6209759	69186	g_34037	g_29442
ptg000023l	6211909	6230592	18683	g_29442	g_1762
ptg000023l	6230909	6312545	81636	g_1762	g_23899
ptg000023l	6312778	6413537	100759	g_23899	g_35407
ptg000023l	6434316	6521930	87614	g_35407	g_27084
ptg000023l	6522364	6534822	12458	g_27084	g_24725
ptg000023l	6535088	6537331	2243	g_24725	g_3144
ptg000023l	6543980	6545308	1328	g_3144	g_575
ptg000023l	6554562	6558283	3721	g_575	g_11241
ptg000023l	6568772	6570549	1777	g_11241	g_10193
ptg000023l	6572892	6581845	8953	g_10193	g_17691
ptg000023l	6584132	6590048	5916	g_17691	g_40120
ptg000023l	6605365	6612899	7534	g_40120	g_13183
ptg000023l	6629449	6636595	7146	g_13183	g_16137
ptg000023l	6657622	6659404	1782	g_16137	g_38655
ptg000023l	6660717	6706193	45476	g_38655	g_23477
ptg000023l	6711610	6714158	2548	g_23477	g_9300
ptg000023l	6737258	6746130	8872	g_9300	g_5665
ptg000023l	6748328	6749609	1281	g_5665	g_40000
ptg000023l	6751173	6753117	1944	g_40000	g_37658
ptg000023l	6762647	6797412	34765	g_37658	g_38112
ptg000023l	6820525	6823969	3444	g_38112	g_802
ptg000023l	6824475	6891416	66941	g_802	g_16084
ptg000023l	6905703	6906236	533	g_16084	g_34899
ptg000023l	6908415	6912928	4513	g_34899	g_7698
ptg000023l	6917338	6923760	6422	g_7698	g_36530
ptg000023l	6924536	6940244	15708	g_36530	g_36063
ptg000023l	6960520	6964705	4185	g_36063	g_29684
ptg000023l	6975204	6982838	7634	g_29684	g_17258
ptg000023l	6996419	7027116	30697	g_17258	g_7057
ptg000023l	7047890	7067519	19629	g_7057	g_13328
ptg000023l	7092210	7100414	8204	g_13328	g_13274
ptg000023l	7107805	7110342	2537	g_13274	g_10983
ptg000023l	7118532	7130821	12289	g_10983	g_36630
ptg000023l	7143535	7144781	1246	g_36630	g_2835
ptg000023l	7148160	7192125	43965	g_2835	g_8900
ptg000023l	7192784	7284848	92064	g_8900	g_25267
ptg000023l	7294537	7297095	2558	g_25267	g_26196
ptg000023l	7318546	7322811	4265	g_26196	g_38229
ptg000023l	7330785	7334254	3469	g_38229	g_36870
ptg000023l	7358892	7387355	28463	g_36870	g_23113
ptg000023l	7388128	7469822	81694	g_23113	g_10500
ptg000023l	7473431	7474800	1369	g_10500	g_19780
ptg000023l	7477583	7486603	9020	g_19780	g_28536
ptg000023l	7490339	7593545	103206	g_28536	g_2361
ptg000023l	7606423	7625870	19447	g_2361	g_27603
ptg000023l	7632722	7651992	19270	g_27603	g_32419
ptg000023l	7665814	7676476	10662	g_32419	g_23328
ptg000023l	7678215	7692319	14104	g_23328	g_26861
ptg000023l	7706012	7736349	30337	g_26861	g_26416
ptg000023l	7736987	7890625	153638	g_26416	g_28834
ptg000023l	7890843	8051052	160209	g_28834	g_34436
ptg000023l	8053074	8224973	171899	g_34436	g_38250
ptg000023l	8225416	8279010	53594	g_38250	g_11532
ptg000023l	8280659	8283038	2379	g_11532	g_1777
ptg000023l	8286409	8347069	60660	g_1777	g_17633
ptg000023l	8350131	8351356	1225	g_17633	g_18214
ptg000023l	8368942	8447003	78061	g_18214	g_2515
ptg000023l	8461747	8493440	31693	g_2515	g_33478
ptg000023l	8493790	8553657	59867	g_33478	g_3107
ptg000023l	8564379	8573041	8662	g_3107	g_7353
ptg000023l	8574267	8627668	53401	g_7353	g_10772
ptg000023l	8637863	8639221	1358	g_10772	g_29413
ptg000023l	8659122	8690195	31073	g_29413	g_27283
ptg000023l	8692847	8724931	32084	g_27283	g_1637
ptg000023l	8725935	8736386	10451	g_1637	g_7694
ptg000023l	8737411	8862988	125577	g_7694	g_2791
ptg000023l	8868894	8881529	12635	g_2791	g_26344
ptg000023l	8884794	8886491	1697	g_26344	g_33563
ptg000023l	8887651	8985854	98203	g_33563	g_20543
ptg000023l	9016595	9067667	51072	g_20543	g_17086
ptg000023l	9067948	9195786	127838	g_17086	g_21583
ptg000023l	9196058	9231063	35005	g_21583	g_36399
ptg000023l	9241921	9256741	14820	g_36399	g_14432
ptg000023l	9265377	9417062	151685	g_14432	g_25344
ptg000023l	9420951	9656627	235676	g_25344	g_34853
ptg000023l	9663343	9666163	2820	g_34853	g_37935
ptg000023l	9669636	9675793	6157	g_37935	g_37682
ptg000023l	9684456	9707790	23334	g_37682	g_11587
ptg000023l	9729261	9730149	888	g_11587	g_31634
ptg000023l	9732737	9735378	2641	g_31634	g_16567
ptg000023l	9737464	9756796	19332	g_16567	g_23819
ptg000023l	9757308	9768404	11096	g_23819	g_33616
ptg000023l	9770301	9773480	3179	g_33616	g_15765
ptg000023l	9776080	9784313	8233	g_15765	g_18153
ptg000023l	9784795	9835112	50317	g_18153	g_11267
ptg000023l	9835534	9848166	12632	g_11267	g_1970
ptg000023l	9850456	9859275	8819	g_1970	g_12738
ptg000023l	9859727	9864092	4365	g_12738	g_2956
ptg000023l	9864385	9877479	13094	g_2956	g_31128
ptg000023l	9880132	9888256	8124	g_31128	g_39519
ptg000023l	9889465	9906370	16905	g_18029	g_555
ptg000023l	9915036	9920641	5605	g_555	g_6646
ptg000023l	9928838	9929946	1108	g_6646	g_1008
ptg000023l	9930425	9932546	2121	g_1008	g_14580
ptg000023l	9948724	9985565	36841	g_14580	g_38296
ptg000023l	10003602	10005630	2028	g_38296	g_33393
ptg000023l	10008200	10009204	1004	g_33393	g_6893
ptg000023l	10021711	10026523	4812	g_6893	g_29159
ptg000023l	10029493	10066321	36828	g_29159	g_29656
ptg000023l	10077252	10123916	46664	g_29656	g_1329
ptg000023l	10124488	10136926	12438	g_1329	g_20348
ptg000023l	10159037	10169295	10258	g_20348	g_25611
ptg000023l	10171790	10175431	3641	g_25611	g_16520
ptg000023l	10185035	10196680	11645	g_16520	g_24567
ptg000023l	10227728	10233833	6105	g_24567	g_7044
ptg000023l	10234360	10301056	66696	g_7044	g_24453
ptg000023l	10301928	10315243	13315	g_24453	g_15628
ptg000023l	10316115	10322148	6033	g_15628	g_12300
ptg000023l	10323527	10357732	34205	g_12300	g_13650
ptg000023l	10358970	10370354	11384	g_13650	g_39759
ptg000023l	10372958	10387795	14837	g_15931	g_8578
ptg000023l	10391421	10397603	6182	g_8578	g_7816
ptg000023l	10398130	10426073	27943	g_7816	g_10980
ptg000023l	10428351	10434965	6614	g_39727	g_38546
ptg000023l	10441203	10470435	29232	g_4444	g_3153
ptg000023l	10471694	10533640	61946	g_3153	g_25356
ptg000023l	10533888	10539570	5682	g_25356	g_34498
ptg000023l	10540391	10793960	253569	g_34498	g_22060
ptg000023l	10794241	10847921	53680	g_22060	g_8616
ptg000023l	10851189	10994150	142961	g_8616	g_4111
ptg000023l	11018845	11030851	12006	g_4111	g_13934
ptg000023l	11031282	11099985	68703	g_13934	g_16149
ptg000023l	11102908	11135028	32120	g_16149	g_17342
ptg000023l	11136398	11146239	9841	g_17342	g_8945
ptg000023l	11147609	11211278	63669	g_8945	g_35430
ptg000023l	11212483	11239314	26831	g_35430	g_7553
ptg000023l	11239655	11240449	794	g_7553	g_31631
ptg000023l	11241879	11304091	62212	g_31631	g_1833
ptg000023l	11304417	11313230	8813	g_1833	g_15510
ptg000023l	11313667	11392086	78419	g_15510	g_19151
ptg000023l	11392460	11426746	34286	g_19151	g_3208
ptg000023l	11427042	11430608	3566	g_3208	g_30044
ptg000023l	11431138	11432572	1434	g_30044	g_31942
ptg000023l	11447141	11487407	40266	g_31942	g_10743
ptg000023l	11502227	11512275	10048	g_10743	g_33346
ptg000023l	11512880	11519380	6500	g_33346	g_27726
ptg000023l	11528571	11535282	6711	g_27726	g_17536
ptg000023l	11539333	11542790	3457	g_17536	g_13694
ptg000023l	11553338	11557301	3963	g_13694	g_27687
ptg000023l	11557786	11627244	69458	g_27687	g_1631
ptg000023l	11632062	11632711	649	g_1631	g_37421
ptg000023l	11633025	11635164	2139	g_37421	g_26900
ptg000023l	11653060	11659057	5997	g_26900	g_25264
ptg000023l	11659377	11660758	1381	g_25264	g_34652
ptg000023l	11661645	11706093	44448	g_34652	g_16150
ptg000023l	11715675	11718761	3086	g_16150	g_31843
ptg000023l	11726056	11757030	30974	g_31843	g_37943
ptg000023l	11759935	11804758	44823	g_37943	g_795
ptg000023l	11806278	11823387	17109	g_795	g_24376
ptg000023l	11827331	11916236	88905	g_24376	g_30122
ptg000023l	11926311	11948343	22032	g_30122	g_5670
ptg000023l	11948708	11967174	18466	g_5670	g_7176
ptg000023l	11971026	11975357	4331	g_7176	g_7049
ptg000023l	11975830	12026451	50621	g_7049	g_18240
ptg000023l	12038527	12048976	10449	g_18240	g_14937
ptg000023l	12050124	12050229	105	g_14937	g_25693
ptg000023l	12050877	12054972	4095	g_25693	g_12808
ptg000023l	12060243	12062191	1948	g_12808	g_6266
ptg000023l	12062736	12067112	4376	g_6266	g_14325
ptg000023l	12072858	12074245	1387	g_14325	g_25807
ptg000023l	12087169	12107571	20402	g_25807	g_23355
ptg000023l	12108820	12115248	6428	g_23355	g_5439
ptg000023l	12116374	12143261	26887	g_5439	g_2257
ptg000023l	12143473	12144038	565	g_2257	g_14212
ptg000023l	12145054	12147257	2203	g_14212	g_31263
ptg000023l	12148171	12183539	35368	g_31263	g_10256
ptg000023l	12184273	12207839	23566	g_10256	g_31259
ptg000023l	12208264	12208455	191	g_31259	g_14150
ptg000023l	12225446	12225798	352	g_14150	g_28957
ptg000023l	12230055	12232577	2522	g_28957	g_28253
ptg000024l	19575	68258	48683	g_17660	g_15361
ptg000024l	88097	114414	26317	g_15361	g_3615
ptg000024l	122978	162820	39842	g_3615	g_35635
ptg000024l	163077	200113	37036	g_35635	g_36684
ptg000024l	215302	224977	9675	g_36684	g_26871
ptg000024l	235300	368794	133494	g_26871	g_39604
ptg000024l	369165	463092	93927	g_39604	g_15772
ptg000024l	463658	473206	9548	g_15772	g_7980
ptg000024l	473907	492745	18838	g_7980	g_21939
ptg000024l	494082	708673	214591	g_21939	g_19122
ptg000024l	714074	774993	60919	g_19122	g_34798
ptg000024l	783190	787281	4091	g_34798	g_24720
ptg000024l	788276	803030	14754	g_24720	g_8796
ptg000024l	803950	836221	32271	g_8796	g_23227
ptg000024l	848491	1297138	448647	g_23227	g_12590
ptg000024l	1297473	1297612	139	g_12590	g_25058
ptg000024l	1297923	1404119	106196	g_25058	g_300
ptg000024l	1407682	1437707	30025	g_300	g_30050
ptg000024l	1438942	1537137	98195	g_30050	g_4361
ptg000024l	1537379	1573455	36076	g_4361	g_1198
ptg000024l	1574537	1582801	8264	g_1198	g_7403
ptg000024l	1583091	1694373	111282	g_7403	g_2546
ptg000024l	1702717	1703859	1142	g_2546	g_27958
ptg000024l	1717123	1729515	12392	g_27958	g_29077
ptg000024l	1729727	1732709	2982	g_29077	g_24170
ptg000024l	1734634	1736502	1868	g_24170	g_38192
ptg000024l	1742073	1778460	36387	g_38192	g_1411
ptg000024l	1791116	1846950	55834	g_1411	g_22999
ptg000024l	1847288	1852964	5676	g_22999	g_17774
ptg000024l	1853935	1874391	20456	g_17774	g_11193
ptg000024l	1887565	1938364	50799	g_11193	g_16493
ptg000024l	1948344	1992417	44073	g_16493	g_35278
ptg000024l	1999514	2006192	6678	g_35278	g_5819
ptg000024l	2007765	2071398	63633	g_5819	g_29968
ptg000024l	2071652	2082237	10585	g_29968	g_18288
ptg000024l	2082494	2131904	49410	g_18288	g_1364
ptg000024l	2132614	2138366	5752	g_1364	g_26574
ptg000024l	2141077	2145643	4566	g_26574	g_10601
ptg000024l	2148078	2150711	2633	g_10601	g_10621
ptg000024l	2153111	2347858	194747	g_10621	g_22077
ptg000024l	2357748	2362343	4595	g_22077	g_10978
ptg000024l	2364239	2401651	37412	g_10978	g_21255
ptg000024l	2401902	2402866	964	g_21255	g_1152
ptg000024l	2403102	2411474	8372	g_1152	g_22396
ptg000024l	2417185	2419041	1856	g_22396	g_23197
ptg000024l	2427444	2429367	1923	g_23197	g_19384
ptg000024l	2432140	2434218	2078	g_19384	g_8713
ptg000024l	2434451	2447400	12949	g_8713	g_26693
ptg000024l	2470696	2478650	7954	g_26693	g_29053
ptg000024l	2479276	2482311	3035	g_29053	g_33573
ptg000024l	2482952	2495001	12049	g_33573	g_29010
ptg000024l	2518970	2536135	17165	g_29010	g_12911
ptg000024l	2541874	2683587	141713	g_12911	g_14776
ptg000024l	2683796	2719609	35813	g_14776	g_10371
ptg000024l	2719920	2769065	49145	g_10371	g_13692
ptg000024l	2780023	3074576	294553	g_13692	g_23794
ptg000024l	3159868	3173624	13756	g_23794	g_14034
ptg000024l	3174034	3418246	244212	g_14034	g_10663
ptg000024l	3426490	3429414	2924	g_10663	g_24071
ptg000024l	3452325	3589643	137318	g_24071	g_32310
ptg000024l	3595909	3598709	2800	g_32310	g_9047
ptg000024l	3603789	3667692	63903	g_9047	g_22431
ptg000024l	3691286	3723502	32216	g_22431	g_18430
ptg000024l	3738884	3778185	39301	g_18430	g_19247
ptg000024l	3778415	3787672	9257	g_19247	g_23505
ptg000024l	3801765	3835823	34058	g_23505	g_17228
ptg000024l	3848403	3848797	394	g_17228	g_10781
ptg000024l	3859908	3933094	73186	g_10781	g_34658
ptg000024l	3935779	3993926	58147	g_34658	g_17881
ptg000024l	4048089	4049148	1059	g_17881	g_40178
ptg000024l	4067592	4069108	1516	g_40178	g_32275
ptg000024l	4075772	4077083	1311	g_32275	g_31235
ptg000024l	4082507	4107758	25251	g_31235	g_32171
ptg000024l	4113265	4116753	3488	g_32171	g_11324
ptg000024l	4122200	4157241	35041	g_11324	g_22092
ptg000024l	4169568	4191443	21875	g_22092	g_10390
ptg000024l	4193676	4288518	94842	g_10390	g_38179
ptg000024l	4288781	4325939	37158	g_38179	g_15000
ptg000024l	4326145	4368857	42712	g_15000	g_31093
ptg000024l	4371608	4383408	11800	g_31093	g_10818
ptg000024l	4387009	4629308	242299	g_10818	g_30099
ptg000024l	4630603	4632607	2004	g_30099	g_13320
ptg000024l	4634064	4853122	219058	g_13320	g_29776
ptg000024l	4854963	4981101	126138	g_29776	g_27515
ptg000024l	4981343	5011963	30620	g_27515	g_33861
ptg000024l	5012298	5031315	19017	g_33861	g_12561
ptg000024l	5038154	5094249	56095	g_12561	g_13048
ptg000024l	5113017	5120794	7777	g_13048	g_28994
ptg000024l	5134550	5139262	4712	g_28994	g_37922
ptg000024l	5140200	5147052	6852	g_37922	g_36955
ptg000024l	5147990	5151135	3145	g_36955	g_26636
ptg000024l	5167759	5174881	7122	g_26636	g_12917
ptg000024l	5195454	5231764	36310	g_12917	g_26145
ptg000024l	5237189	5240674	3485	g_26145	g_14909
ptg000024l	5242506	5406006	163500	g_14909	g_7462
ptg000024l	5430855	5564577	133722	g_7462	g_31313
ptg000024l	5581095	6187619	606524	g_38877	g_30490
ptg000024l	6198122	6238023	39901	g_30490	g_6205
ptg000024l	6247208	6253794	6586	g_6205	g_11700
ptg000024l	6258662	6264183	5521	g_11700	g_6616
ptg000024l	6266381	6483912	217531	g_6616	g_38098
ptg000024l	6484829	6529650	44821	g_38098	g_34035
ptg000024l	6529877	6535256	5379	g_34035	g_36183
ptg000024l	6542564	6544795	2231	g_36183	g_23210
ptg000024l	6555160	6559473	4313	g_23210	g_5652
ptg000024l	6563278	6582704	19426	g_5652	g_12293
ptg000024l	6679653	6683948	4295	g_12293	g_27113
ptg000024l	6686604	6688787	2183	g_27113	g_26384
ptg000024l	6696887	6715391	18504	g_26384	g_2418
ptg000024l	6723548	6725522	1974	g_2418	g_3371
ptg000024l	6732076	6781089	49013	g_3371	g_3314
ptg000024l	6783157	6917306	134149	g_3314	g_34884
ptg000024l	6917605	7041016	123411	g_34884	g_4758
ptg000024l	7042731	7287176	244445	g_4758	g_3089
ptg000024l	7310987	7317085	6098	g_3089	g_39958
ptg000024l	7349169	7354834	5665	g_39958	g_4913
ptg000024l	7357131	7358388	1257	g_4913	g_24404
ptg000024l	7359815	7360535	720	g_24404	g_34494
ptg000024l	7368732	7372915	4183	g_34494	g_12693
ptg000024l	7375541	7377387	1846	g_12693	g_16329
ptg000024l	7382630	7536001	153371	g_16329	g_29511
ptg000024l	7556310	7657844	101534	g_29511	g_29789
ptg000024l	7658143	7864340	206197	g_29789	g_23896
ptg000024l	7864555	7870730	6175	g_23896	g_22953
ptg000024l	7870981	7891534	20553	g_22953	g_26083
ptg000024l	7891935	7924162	32227	g_26083	g_1994
ptg000024l	7924872	8090224	165352	g_1994	g_19506
ptg000024l	8095237	8136097	40860	g_19506	g_30896
ptg000024l	8136318	8146521	10203	g_30896	g_30033
ptg000024l	8146781	8294615	147834	g_30033	g_12135
ptg000024l	8304073	8340002	35929	g_12135	g_38989
ptg000024l	8342263	8351429	9166	g_38989	g_15742
ptg000024l	8361935	8365700	3765	g_15742	g_24736
ptg000024l	8366677	8386820	20143	g_24736	g_18258
ptg000024l	8387188	8387223	35	g_18258	g_40185
ptg000024l	8388251	8393780	5529	g_40185	g_38069
ptg000024l	8396842	8397671	829	g_38069	g_37723
ptg000024l	8398994	8400373	1379	g_37723	g_36363
ptg000024l	8403692	8408576	4884	g_36363	g_4223
ptg000024l	8410534	8413925	3391	g_4223	g_10376
ptg000024l	8427368	8431134	3766	g_10376	g_34847
ptg000024l	8435936	8443813	7877	g_34847	g_20579
ptg000024l	8451231	8453152	1921	g_20579	g_29558
ptg000024l	8461450	8468029	6579	g_29558	g_22769
ptg000024l	8468985	8478555	9570	g_22769	g_15440
ptg000024l	8480472	8481230	758	g_15440	g_15989
ptg000024l	8486625	8490260	3635	g_15989	g_6289
ptg000024l	8496495	8499587	3092	g_6289	g_1212
ptg000024l	8516320	8610319	93999	g_1212	g_14855
ptg000024l	8611377	8638260	26883	g_14855	g_19986
ptg000024l	8650212	8653724	3512	g_19986	g_3953
ptg000024l	8664026	8680458	16432	g_3953	g_9919
ptg000024l	8697016	8724323	27307	g_9919	g_1874
ptg000024l	8732621	8734588	1967	g_1874	g_26707
ptg000024l	8740848	8744710	3862	g_26707	g_19714
ptg000024l	8745204	8790296	45092	g_19714	g_8949
ptg000024l	8801045	8802281	1236	g_8949	g_28244
ptg000024l	8811047	8819164	8117	g_28244	g_38016
ptg000024l	8827593	8832160	4567	g_38016	g_144
ptg000024l	8835745	8836855	1110	g_144	g_39895
ptg000024l	8838214	8850275	12061	g_39895	g_15788
ptg000024l	8851369	8852601	1232	g_15788	g_14715
ptg000024l	8870768	8925430	54662	g_14715	g_1915
ptg000024l	8926014	8960024	34010	g_1915	g_9846
ptg000024l	9003974	9037181	33207	g_9846	g_5862
ptg000024l	9047477	9050118	2641	g_5862	g_31673
ptg000024l	9058593	9059866	1273	g_31673	g_27692
ptg000024l	9071885	9086019	14134	g_27692	g_17389
ptg000024l	9089148	9092623	3475	g_17389	g_4096
ptg000024l	9110432	9139069	28637	g_4096	g_26099
ptg000024l	9140460	9147789	7329	g_26099	g_23415
ptg000024l	9152234	9160213	7979	g_23415	g_8165
ptg000024l	9182048	9184539	2491	g_8165	g_31665
ptg000024l	9188787	9191471	2684	g_31665	g_36507
ptg000024l	9201826	9205033	3207	g_36507	g_20959
ptg000024l	9206376	9252549	46173	g_20959	g_11136
ptg000024l	9252791	9273764	20973	g_11136	g_1863
ptg000024l	9276465	9284301	7836	g_1863	g_36386
ptg000024l	9287623	9313526	25903	g_36386	g_25045
ptg000024l	9313759	9324631	10872	g_25045	g_34959
ptg000024l	9324864	9398809	73945	g_34959	g_10737
ptg000024l	9419947	9503258	83311	g_10737	g_22629
ptg000024l	9506491	9508856	2365	g_22629	g_30225
ptg000024l	9530901	9536619	5718	g_30225	g_14427
ptg000024l	9560827	9624467	63640	g_14427	g_24575
ptg000024l	9625363	9645755	20392	g_24575	g_1796
ptg000024l	9646825	9654002	7177	g_1796	g_7223
ptg000024l	9671662	9686368	14706	g_7223	g_14869
ptg000024l	9690650	9692826	2176	g_14869	g_12007
ptg000024l	9698852	9702280	3428	g_12007	g_9379
ptg000024l	9705065	9707698	2633	g_9379	g_6649
ptg000024l	9710193	9720744	10551	g_6649	g_16296
ptg000024l	9728079	9812027	83948	g_16296	g_27122
ptg000024l	9820729	9824121	3392	g_27122	g_21084
ptg000024l	9840285	9900958	60673	g_21084	g_12274
ptg000024l	9904235	9905767	1532	g_12274	g_37852
ptg000024l	9909713	9913682	3969	g_37852	g_36028
ptg000024l	9923815	9944338	20523	g_36028	g_11128
ptg000024l	9949236	9950718	1482	g_11128	g_13387
ptg000024l	9952613	9995684	43071	g_13387	g_12267
ptg000024l	9996745	9999624	2879	g_12267	g_19505
ptg000024l	10000202	10006283	6081	g_19505	g_32248
ptg000024l	10011796	10019053	7257	g_32248	g_31818
ptg000024l	10023119	10039679	16560	g_31818	g_12425
ptg000024l	10048897	10053537	4640	g_12425	g_8398
ptg000024l	10057618	10061847	4229	g_8398	g_11311
ptg000024l	10062449	10065314	2865	g_11311	g_10569
ptg000024l	10068642	10072897	4255	g_10569	g_24033
ptg000024l	10076712	10087480	10768	g_24033	g_24777
ptg000024l	10095651	10100542	4891	g_24777	g_40251
ptg000024l	10105489	10108718	3229	g_40251	g_14608
ptg000024l	10109845	10135196	25351	g_14608	g_8020
ptg000024l	10135474	10136277	803	g_8020	g_20155
ptg000024l	10142253	10148827	6574	g_20155	g_28307
ptg000024l	10151271	10157467	6196	g_28307	g_19737
ptg000024l	10168184	10178596	10412	g_19737	g_13055
ptg000024l	10184522	10189486	4964	g_13055	g_23116
ptg000024l	10191330	10191515	185	g_23116	g_9567
ptg000024l	10191742	10198755	7013	g_9567	g_683
ptg000024l	10214460	10226101	11641	g_683	g_35992
ptg000024l	10228125	10230601	2476	g_35992	g_14054
ptg000024l	10232907	10236329	3422	g_14054	g_33667
ptg000024l	10243334	10243684	350	g_33667	g_20437
ptg000024l	10246648	10250124	3476	g_20437	g_16124
ptg000024l	10254042	10276570	22528	g_16124	g_29248
ptg000024l	10282111	10284381	2270	g_29248	g_21206
ptg000024l	10285513	10321003	35490	g_21206	g_27337
ptg000024l	10326721	10347615	20894	g_27337	g_11296
ptg000024l	10352009	10354333	2324	g_11296	g_21007
ptg000024l	10379889	10382507	2618	g_21007	g_3300
ptg000024l	10394736	10396946	2210	g_3300	g_14151
ptg000024l	10406114	10409427	3313	g_14151	g_29823
ptg000024l	10410914	10413079	2165	g_29823	g_1019
ptg000024l	10415343	10416657	1314	g_1019	g_19583
ptg000024l	10420156	10421232	1076	g_19583	g_1548
ptg000024l	10426421	10519779	93358	g_1548	g_34020
ptg000024l	10521980	10569036	47056	g_34020	g_32487
ptg000024l	10602269	10659415	57146	g_32487	g_24927
ptg000024l	10663621	10679956	16335	g_24927	g_12871
ptg000024l	10680228	10686371	6143	g_12871	g_35535
ptg000024l	10702121	10705441	3320	g_35535	g_26887
ptg000024l	10708371	10733503	25132	g_26887	g_14898
ptg000024l	10742455	10744747	2292	g_14898	g_3490
ptg000024l	10752812	10754752	1940	g_3490	g_21030
ptg000024l	10758596	10764621	6025	g_21030	g_30803
ptg000024l	10778230	10782326	4096	g_30803	g_25577
ptg000024l	10783149	10785992	2843	g_25577	g_7855
ptg000024l	10786423	10798121	11698	g_7855	g_5847
ptg000024l	10799599	10817942	18343	g_5847	g_9949
ptg000024l	10823591	10827294	3703	g_9949	g_37388
ptg000024l	10839318	10846854	7536	g_37388	g_16224
ptg000024l	10848610	10853820	5210	g_16224	g_25190
ptg000024l	10863028	10877738	14710	g_25190	g_35747
ptg000024l	10878529	10882392	3863	g_35747	g_17290
ptg000024l	10883060	10888642	5582	g_17290	g_29327
ptg000024l	10889097	10905232	16135	g_29327	g_1956
ptg000024l	10913089	10923745	10656	g_1956	g_23307
ptg000024l	10930264	10983464	53200	g_23307	g_6056
ptg000024l	10990732	11080041	89309	g_6056	g_17784
ptg000024l	11080244	11093693	13449	g_17784	g_4365
ptg000024l	11094574	11168668	74094	g_4365	g_33877
ptg000024l	11168976	11224123	55147	g_33877	g_27820
ptg000024l	11224326	11229373	5047	g_27820	g_37547
ptg000024l	11230917	11579044	348127	g_37547	g_4122
ptg000024l	11588155	11614160	26005	g_4122	g_7055
ptg000024l	11614369	11778146	163777	g_7055	g_22223
ptg000024l	11802288	11864047	61759	g_22223	g_13837
ptg000024l	11866819	11875451	8632	g_13837	g_28433
ptg000024l	11877265	11886980	9715	g_28433	g_21504
ptg000024l	11912280	11927267	14987	g_21504	g_37187
ptg000024l	11933043	11970273	37230	g_37187	g_27146
ptg000024l	11983421	12044493	61072	g_27146	g_8494
ptg000024l	12052199	12055235	3036	g_8494	g_39981
ptg000024l	12066935	12072890	5955	g_39981	g_4756
ptg000024l	12086337	12089803	3466	g_4756	g_25627
ptg000024l	12091689	12094689	3000	g_25627	g_27506
ptg000024l	12097505	12100171	2666	g_27506	g_306
ptg000024l	12107213	12107690	477	g_306	g_10120
ptg000024l	12113598	12123356	9758	g_10120	g_29066
ptg000024l	12128859	12133857	4998	g_29066	g_3810
ptg000024l	12145355	12157987	12632	g_3810	g_14440
ptg000024l	12160197	12195439	35242	g_14440	g_30542
ptg000024l	12209345	12214683	5338	g_30542	g_16652
ptg000024l	12217711	12218042	331	g_16652	g_11813
ptg000024l	12221421	12221604	183	g_11813	g_37047
ptg000024l	12225813	12228212	2399	g_37047	g_29774
ptg000024l	12236301	12240927	4626	g_29774	g_12107
ptg000024l	12242850	12255263	12413	g_12107	g_2912
ptg000024l	12259043	12272442	13399	g_38584	g_16934
ptg000024l	12278334	12299623	21289	g_16934	g_10573
ptg000024l	12300426	12314422	13996	g_10573	g_31421
ptg000024l	12315045	12317560	2515	g_31421	g_21870
ptg000024l	12318189	12334564	16375	g_21870	g_35493
ptg000024l	12335253	12359881	24628	g_35493	g_20844
ptg000024l	12370819	12374631	3812	g_20844	g_35952
ptg000024l	12375038	12385370	10332	g_35952	g_28702
ptg000024l	12386840	12388867	2027	g_28702	g_3723
ptg000024l	12389875	12392623	2748	g_3723	g_7892
ptg000024l	12396004	12412117	16113	g_7892	g_17094
ptg000024l	12420164	12423530	3366	g_17094	g_18572
ptg000024l	12425279	12432742	7463	g_18572	g_17950
ptg000024l	12434309	12440054	5745	g_17950	g_23607
ptg000024l	12440782	12464382	23600	g_23607	g_18002
ptg000024l	12464654	12467790	3136	g_18002	g_5467
ptg000024l	12478885	12484634	5749	g_5467	g_28117
ptg000024l	12484924	12489169	4245	g_28117	g_7864
ptg000024l	12495088	12507812	12724	g_7864	g_26655
ptg000024l	12523128	12573940	50812	g_26655	g_25373
ptg000024l	12579516	12582293	2777	g_25373	g_8445
ptg000024l	12583356	12600541	17185	g_8445	g_20461
ptg000024l	12601557	12611662	10105	g_20461	g_10562
ptg000024l	12627970	12656600	28630	g_10562	g_12726
ptg000024l	12666553	12683932	17379	g_12726	g_6817
ptg000024l	12701136	12751490	50354	g_6817	g_24730
ptg000024l	12751975	12756695	4720	g_24730	g_29127
ptg000024l	12777757	12807298	29541	g_29127	g_32884
ptg000024l	12807893	12830374	22481	g_32884	g_35069
ptg000024l	12830685	12831410	725	g_35069	g_27731
ptg000024l	12831745	12856705	24960	g_27731	g_16259
ptg000024l	12878366	12936041	57675	g_16259	g_34988
ptg000024l	12936911	12953623	16712	g_34988	g_35923
ptg000024l	12970299	12971154	855	g_35923	g_3711
ptg000024l	12971879	12975004	3125	g_3711	g_9027
ptg000024l	12975732	12979508	3776	g_9027	g_17961
ptg000024l	12980251	12983391	3140	g_17961	g_27167
ptg000024l	12984143	12988153	4010	g_27167	g_542
ptg000024l	12988881	12991520	2639	g_542	g_6687
ptg000024l	12992248	12994952	2704	g_6687	g_16163
ptg000024l	12995680	13072141	76461	g_16163	g_28010
ptg000024l	13074993	13343529	268536	g_28010	g_27070
ptg000024l	13345499	13409969	64470	g_27070	g_23141
ptg000024l	13410493	13580024	169531	g_23141	g_38556
ptg000024l	13580923	13582911	1988	g_38556	g_40018
ptg000024l	13584299	13585803	1504	g_40018	g_40017
ptg000024l	13586708	13588700	1992	g_40017	g_6548
ptg000024l	13590379	13597785	7406	g_6548	g_3097
ptg000024l	13604118	13639179	35061	g_3097	g_7379
ptg000024l	13645319	13652224	6905	g_7379	g_3735
ptg000024l	13665678	13667994	2316	g_3735	g_35191
ptg000024l	13674908	13917466	242558	g_35191	g_5974
ptg000024l	13952352	13957337	4985	g_5974	g_9890
ptg000024l	13969470	13983554	14084	g_9890	g_32264
ptg000024l	14012039	14035639	23600	g_32264	g_18631
ptg000024l	14036013	14040374	4361	g_18631	g_16099
ptg000024l	14044871	14047983	3112	g_16099	g_1290
ptg000024l	14051972	14054176	2204	g_1290	g_12326
ptg000024l	14059855	14062969	3114	g_12326	g_5494
ptg000024l	14065374	14065993	619	g_5494	g_2666
ptg000024l	14072322	14075679	3357	g_2666	g_13456
ptg000024l	14076617	14081296	4679	g_13456	g_36129
ptg000024l	14095748	14103797	8049	g_36129	g_24277
ptg000024l	14104006	14108611	4605	g_24277	g_24688
ptg000024l	14110548	14111328	780	g_24688	g_22857
ptg000024l	14114752	14120572	5820	g_22857	g_14612
ptg000024l	14129831	14134481	4650	g_14612	g_9330
ptg000024l	14141817	14145495	3678	g_9330	g_40068
ptg000024l	14149941	14177552	27611	g_40068	g_17764
ptg000024l	14180199	14181702	1503	g_17764	g_4517
ptg000024l	14190693	14199765	9072	g_4517	g_10620
ptg000024l	14201865	14224364	22499	g_10620	g_10735
ptg000024l	14230028	14232610	2582	g_10735	g_8740
ptg000024l	14233719	14249719	16000	g_8740	g_29502
ptg000024l	14251874	14253594	1720	g_29502	g_27664
ptg000024l	14253929	14333381	79452	g_27664	g_9955
ptg000024l	14336113	14338410	2297	g_9955	g_11498
ptg000024l	14346672	14362359	15687	g_11498	g_11591
ptg000024l	14363644	14364191	547	g_11591	g_969
ptg000024l	14365168	14372956	7788	g_969	g_28157
ptg000024l	14376588	14379318	2730	g_28157	g_26595
ptg000024l	14393531	14424542	31011	g_26595	g_32058
ptg000024l	14428936	14429983	1047	g_32058	g_28597
ptg000024l	14430372	14430977	605	g_28597	g_17886
ptg000024l	14432290	14446758	14468	g_17886	g_17303
ptg000024l	14449939	14450887	948	g_17303	g_24075
ptg000024l	14454472	14465653	11181	g_24075	g_40268
ptg000024l	14465970	14468971	3001	g_40268	g_27705
ptg000024l	14472606	14480111	7505	g_27705	g_2202
ptg000024l	14488484	14558666	70182	g_2202	g_37942
ptg000024l	14559937	14576787	16850	g_37942	g_36155
ptg000024l	14583142	14585053	1911	g_36155	g_5526
ptg000024l	14592141	14651895	59754	g_5526	g_34288
ptg000024l	14652296	14661863	9567	g_34288	g_36420
ptg000024l	14663954	14686853	22899	g_36420	g_22878
ptg000024l	14687062	14737328	50266	g_22878	g_32702
ptg000024l	14768093	14772646	4553	g_32702	g_38862
ptg000024l	14773365	14779749	6384	g_38862	g_23820
ptg000024l	14780501	14791620	11119	g_23820	g_3055
ptg000024l	14792519	14800412	7893	g_3055	g_26364
ptg000024l	14806845	14820917	14072	g_26364	g_24607
ptg000024l	14840559	14846697	6138	g_24607	g_17657
ptg000024l	14855131	14857233	2102	g_17657	g_6488
ptg000024l	14859296	14918900	59604	g_6488	g_27855
ptg000024l	14926269	14928793	2524	g_27855	g_17559
ptg000024l	14929410	14931335	1925	g_17559	g_25170
ptg000024l	14936566	15040183	103617	g_25170	g_14888
ptg000024l	15052013	15056769	4756	g_14888	g_4033
ptg000024l	15060588	15061591	1003	g_4033	g_33825
ptg000024l	15063694	15065825	2131	g_33825	g_17268
ptg000024l	15067789	15070165	2376	g_17268	g_15381
ptg000024l	15072326	15082725	10399	g_15381	g_29900
ptg000024l	15091766	15104997	13231	g_29900	g_24377
ptg000024l	15111782	15116916	5134	g_24377	g_7677
ptg000024l	15133857	15136924	3067	g_7677	g_12171
ptg000024l	15137124	15137178	54	g_12171	g_36777
ptg000024l	15145851	15188373	42522	g_36777	g_28959
ptg000024l	15188603	15239411	50808	g_28959	g_18289
ptg000024l	15241782	15330183	88401	g_18289	g_28539
ptg000024l	15338154	15349813	11659	g_28539	g_15517
ptg000024l	15350082	15356447	6365	g_15517	g_11256
ptg000024l	15357199	15364617	7418	g_11256	g_4633
ptg000024l	15378770	15381270	2500	g_4633	g_36117
ptg000024l	15382795	15384480	1685	g_36117	g_21802
ptg000024l	15389117	15392804	3687	g_21802	g_38593
ptg000024l	15406423	15409178	2755	g_35791	g_31891
ptg000024l	15409846	15410828	982	g_31891	g_31688
ptg000024l	15413411	15414486	1075	g_31688	g_17707
ptg000024l	15416773	15419948	3175	g_17707	g_15590
ptg000024l	15424425	15428580	4155	g_15590	g_33122
ptg000024l	15445817	15453769	7952	g_33122	g_832
ptg000024l	15469671	15474362	4691	g_832	g_5243
ptg000024l	15482914	15514107	31193	g_5243	g_15877
ptg000024l	15515770	15517025	1255	g_15877	g_38290
ptg000024l	15518873	15523775	4902	g_38290	g_34793
ptg000024l	15529196	15530820	1624	g_34793	g_34668
ptg000024l	15532169	15535866	3697	g_34668	g_26927
ptg000024l	15538012	15540222	2210	g_26927	g_31956
ptg000024l	15541173	15543990	2817	g_31956	g_16678
ptg000024l	15552761	15554509	1748	g_16678	g_2551
ptg000024l	15556108	15557804	1696	g_2551	g_24049
ptg000024l	15564018	15567676	3658	g_24049	g_22362
ptg000024l	15569047	15574345	5298	g_22362	g_10143
ptg000024l	15595643	15601504	5861	g_10143	g_15762
ptg000024l	15610750	15629214	18464	g_39800	g_21248
ptg000024l	15644564	15646447	1883	g_21248	g_29110
ptg000024l	15660943	15672152	11209	g_29110	g_25855
ptg000024l	15711628	15715758	4130	g_25855	g_922
ptg000024l	15720268	15756533	36265	g_922	g_28132
ptg000024l	15760141	15762493	2352	g_28132	g_38099
ptg000024l	15767327	15767706	379	g_38099	g_13628
ptg000024l	15790289	15804335	14046	g_13628	g_9514
ptg000024l	15804550	15876600	72050	g_9514	g_33339
ptg000024l	15880436	15884768	4332	g_33339	g_7586
ptg000024l	15885293	15890575	5282	g_7586	g_28400
ptg000024l	15893851	15895033	1182	g_28400	g_7159
ptg000024l	15898740	15908751	10011	g_7159	g_30717
ptg000024l	15913260	15914394	1134	g_30717	g_1993
ptg000024l	15915438	15916596	1158	g_1993	g_2856
ptg000024l	15919231	15922475	3244	g_2856	g_39952
ptg000024l	15923002	15924967	1965	g_39952	g_31485
ptg000024l	15930050	16002114	72064	g_31485	g_34471
ptg000024l	16002650	16032043	29393	g_34471	g_31920
ptg000024l	16032711	16067483	34772	g_31920	g_39974
ptg000024l	16069339	16071893	2554	g_39974	g_4266
ptg000024l	16087461	16109373	21912	g_4266	g_6554
ptg000024l	16112034	16112769	735	g_6554	g_11630
ptg000024l	16115561	16117858	2297	g_11630	g_33827
ptg000024l	16118730	16129470	10740	g_33827	g_8280
ptg000024l	16140193	16143042	2849	g_8280	g_12973
ptg000024l	16147096	16155270	8174	g_12973	g_13810
ptg000024l	16156121	16208200	52079	g_13810	g_28532
ptg000024l	16208775	16211830	3055	g_28532	g_38041
ptg000024l	16219070	16242233	23163	g_38041	g_15414
ptg000024l	16256471	16258634	2163	g_15414	g_27724
ptg000024l	16262168	16266681	4513	g_27724	g_37517
ptg000024l	16267193	16270601	3408	g_37517	g_17133
ptg000024l	16271880	16273414	1534	g_17133	g_9594
ptg000024l	16278449	16297022	18573	g_9594	g_20590
ptg000024l	16299748	16302671	2923	g_20590	g_30543
ptg000024l	16303282	16308075	4793	g_30543	g_13004
ptg000024l	16314013	16325173	11160	g_13004	g_11344
ptg000024l	16328099	16709200	381101	g_11344	g_25898
ptg000024l	16710027	16711929	1902	g_25898	g_35734
ptg000024l	16712306	16713073	767	g_35734	g_1781
ptg000024l	16714149	16730484	16335	g_1781	g_4778
ptg000024l	16731838	16741203	9365	g_4778	g_13046
ptg000024l	16748910	16753184	4274	g_13046	g_10331
ptg000024l	16762190	16793565	31375	g_10331	g_18366
ptg000024l	16796004	16803784	7780	g_18366	g_27045
ptg000024l	16816764	16881488	64724	g_27045	g_23061
ptg000024l	16882603	16885269	2666	g_23061	g_3777
ptg000024l	16887613	16890003	2390	g_3777	g_5066
ptg000024l	16892228	16893382	1154	g_5066	g_10802
ptg000024l	16903726	16906336	2610	g_10802	g_22145
ptg000024l	16912585	16919098	6513	g_22145	g_9522
ptg000024l	16919736	17204141	284405	g_9522	g_25995
ptg000024l	17225626	17227162	1536	g_25995	g_33462
ptg000024l	17230898	17232672	1774	g_33462	g_19977
ptg000024l	17234019	17262483	28464	g_19977	g_17423
ptg000024l	17262779	17266218	3439	g_17423	g_2649
ptg000024l	17270248	17271585	1337	g_2649	g_4533
ptg000024l	17277636	17280306	2670	g_4533	g_23969
ptg000024l	17282043	17330197	48154	g_23969	g_4071
ptg000024l	17331429	17343119	11690	g_4071	g_3841
ptg000024l	17346338	17378027	31689	g_3841	g_22455
ptg000024l	17384638	17394831	10193	g_22455	g_6993
ptg000024l	17399111	17410195	11084	g_6993	g_10182
ptg000024l	17418446	17420423	1977	g_10182	g_22676
ptg000024l	17422939	17423533	594	g_22676	g_18387
ptg000024l	17432984	17446153	13169	g_18387	g_26033
ptg000024l	17446353	17479639	33286	g_26033	g_1486
ptg000024l	17479911	17480113	202	g_1486	g_23562
ptg000024l	17480349	17480564	215	g_23562	g_26114
ptg000024l	17480992	17490869	9877	g_26114	g_19209
ptg000024l	17502413	17527655	25242	g_19209	g_3418
ptg000024l	17531242	17570739	39497	g_3418	g_26863
ptg000024l	17582922	17604018	21096	g_26863	g_39695
ptg000024l	17605595	17700217	94622	g_39695	g_31767
ptg000024l	17700612	17703113	2501	g_31767	g_13568
ptg000024l	17703880	17740043	36163	g_13568	g_16515
ptg000024l	17740591	17908184	167593	g_16515	g_17762
ptg000024l	17917837	17921918	4081	g_17762	g_28584
ptg000024l	17924320	17926154	1834	g_28584	g_33264
ptg000024l	17937213	17952488	15275	g_33264	g_14943
ptg000024l	17957620	17964000	6380	g_14943	g_21102
ptg000024l	17969545	17970965	1420	g_21102	g_474
ptg000024l	17972533	17995259	22726	g_474	g_36356
ptg000024l	17996371	18048033	51662	g_36356	g_18314
ptg000024l	18054896	18064549	9653	g_18314	g_12711
ptg000024l	18068220	18122428	54208	g_12711	g_35815
ptg000024l	18125496	18126424	928	g_35815	g_14620
ptg000024l	18128272	18132422	4150	g_14620	g_39918
ptg000024l	18134760	18136260	1500	g_39918	g_1047
ptg000024l	18136724	18160582	23858	g_1047	g_16503
ptg000024l	18178069	18180618	2549	g_16503	g_15141
ptg000024l	18181937	18187354	5417	g_15141	g_6789
ptg000024l	18218471	18221650	3179	g_6789	g_24584
ptg000024l	18226788	18228138	1350	g_24584	g_19314
ptg000024l	18230441	18234391	3950	g_19314	g_2027
ptg000024l	18246090	18274144	28054	g_2027	g_6781
ptg000024l	18299651	18302942	3291	g_6781	g_8252
ptg000024l	18303256	18316648	13392	g_8252	g_24679
ptg000024l	18322594	18340125	17531	g_24679	g_2151
ptg000024l	18341978	18386779	44801	g_2151	g_33091
ptg000024l	18388515	18410381	21866	g_33091	g_26851
ptg000024l	18411619	18423503	11884	g_26851	g_28901
ptg000024l	18437993	18465737	27744	g_28901	g_4194
ptg000024l	18488227	18490998	2771	g_4194	g_20992
ptg000024l	18492851	18518875	26024	g_20992	g_19429
ptg000024l	18527107	18528568	1461	g_19429	g_4736
ptg000024l	18534996	18559536	24540	g_4736	g_8471
ptg000024l	18560835	18572387	11552	g_8471	g_29437
ptg000024l	18576997	18723769	146772	g_29437	g_36629
ptg000024l	18747286	18762066	14780	g_36629	g_10000
ptg000024l	18775068	18820767	45699	g_10000	g_10149
ptg000024l	18829466	18831688	2222	g_10149	g_3225
ptg000024l	18832452	18835885	3433	g_3225	g_1988
ptg000024l	18842162	18850538	8376	g_1988	g_33540
ptg000024l	18865800	18952490	86690	g_33540	g_30274
ptg000024l	18952729	19104682	151953	g_30274	g_3920
ptg000024l	19104915	19336003	231088	g_3920	g_26919
ptg000024l	19336278	19439828	103550	g_26919	g_2113
ptg000024l	19440049	19469285	29236	g_2113	g_2139
ptg000024l	19505077	19510091	5014	g_2139	g_13136
ptg000024l	19513018	19526974	13956	g_13136	g_13264
ptg000024l	19531376	19535527	4151	g_13264	g_35044
ptg000024l	19545432	19546681	1249	g_35044	g_22150
ptg000024l	19547216	19550332	3116	g_22150	g_16996
ptg000024l	19553684	19557576	3892	g_16996	g_6485
ptg000024l	19567542	19570986	3444	g_6485	g_36681
ptg000024l	19595000	19618703	23703	g_36681	g_6610
ptg000024l	19618918	19716358	97440	g_6610	g_6599
ptg000024l	19726686	19728841	2155	g_6599	g_34547
ptg000024l	19736772	19746014	9242	g_34547	g_15125
ptg000024l	19748817	19753579	4762	g_15125	g_26315
ptg000024l	19770708	20113447	342739	g_26315	g_30454
ptg000024l	20151806	20154088	2282	g_30454	g_20482
ptg000024l	20157664	20162062	4398	g_20482	g_3654
ptg000024l	20163330	20169830	6500	g_3654	g_10175
ptg000024l	20177672	20244669	66997	g_10175	g_157
ptg000024l	20244881	20260643	15762	g_157	g_15800
ptg000024l	20268759	20273081	4322	g_15800	g_23072
ptg000024l	20286418	20298070	11652	g_23072	g_30096
ptg000024l	20299155	20370295	71140	g_30096	g_10600
ptg000024l	20379210	20380443	1233	g_10600	g_20807
ptg000024l	20382743	20394416	11673	g_20807	g_26580
ptg000024l	20398517	20402223	3706	g_26580	g_4843
ptg000024l	20407953	20439000	31047	g_4843	g_7738
ptg000024l	20447088	20449415	2327	g_7738	g_15231
ptg000024l	20451177	20456446	5269	g_15231	g_18427
ptg000024l	20458898	20465891	6993	g_18427	g_37272
ptg000024l	20467489	20496522	29033	g_37272	g_2555
ptg000024l	20497942	20512566	14624	g_39712	g_37665
ptg000024l	20513600	20567827	54227	g_37665	g_17689
ptg000024l	20573021	20580422	7401	g_17689	g_535
ptg000024l	20586059	20587234	1175	g_535	g_17992
ptg000024l	20591391	20614293	22902	g_17992	g_9644
ptg000024l	20627865	20633576	5711	g_9644	g_32805
ptg000024l	20637625	20644140	6515	g_32805	g_21797
ptg000024l	20654242	20660896	6654	g_21797	g_37824
ptg000024l	20672310	20681298	8988	g_37824	g_24828
ptg000024l	20687605	20691035	3430	g_24828	g_17417
ptg000024l	20707739	20715760	8021	g_17417	g_26778
ptg000024l	20731294	20731600	306	g_26778	g_7600
ptg000024l	20732670	20761569	28899	g_7600	g_28517
ptg000024l	20762369	20767102	4733	g_28517	g_12065
ptg000024l	20769770	20771167	1397	g_12065	g_23546
ptg000024l	20772543	20775430	2887	g_23546	g_10673
ptg000024l	20794386	20797428	3042	g_10673	g_16936
ptg000024l	20799931	20802141	2210	g_16936	g_28639
ptg000024l	20807787	20810549	2762	g_28639	g_15689
ptg000024l	20818132	20820635	2503	g_15689	g_829
ptg000024l	20829078	20834039	4961	g_829	g_513
ptg000024l	20837634	20944854	107220	g_513	g_7202
ptg000024l	20945120	20965093	19973	g_7202	g_21973
ptg000024l	20965341	21017561	52220	g_21973	g_4
ptg000024l	21031652	21033797	2145	g_4	g_11572
ptg000024l	21035031	21044709	9678	g_11572	g_28026
ptg000024l	21045986	21049147	3161	g_28026	g_9491
ptg000024l	21056756	21067868	11112	g_9491	g_3805
ptg000024l	21093714	21117607	23893	g_3805	g_34391
ptg000024l	21124604	21127061	2457	g_34391	g_1870
ptg000024l	21129291	21133247	3956	g_1870	g_15994
ptg000024l	21134131	21201200	67069	g_15994	g_22795
ptg000024l	21212500	21233820	21320	g_22795	g_32205
ptg000024l	21234665	21238841	4176	g_32205	g_2445
ptg000024l	21239308	21311431	72123	g_2445	g_12788
ptg000024l	21311685	21314386	2701	g_12788	g_24544
ptg000024l	21315726	21319267	3541	g_24544	g_26449
ptg000024l	21321175	21323280	2105	g_26449	g_35596
ptg000024l	21330683	21331893	1210	g_35596	g_15437
ptg000024l	21338582	21339788	1206	g_15437	g_7225
ptg000024l	21344616	21346943	2327	g_7225	g_30824
ptg000024l	21347419	21353979	6560	g_30824	g_15403
ptg000024l	21354764	21448642	93878	g_15403	g_17560
ptg000024l	21449445	21452222	2777	g_17560	g_27572
ptg000024l	21463272	21524382	61110	g_27572	g_32338
ptg000024l	21524882	21576519	51637	g_32338	g_7352
ptg000024l	21585408	21597285	11877	g_7352	g_33808
ptg000024l	21604907	21608755	3848	g_33808	g_32468
ptg000024l	21615435	21619033	3598	g_32468	g_21092
ptg000024l	21623736	21637313	13577	g_21092	g_21961
ptg000024l	21638569	21643500	4931	g_21961	g_19403
ptg000024l	21643844	21647904	4060	g_19403	g_38313
ptg000024l	21653312	21654780	1468	g_38313	g_30243
ptg000024l	21661104	21695379	34275	g_30243	g_18329
ptg000024l	21724187	21743861	19674	g_18329	g_295
ptg000024l	21746577	21756191	9614	g_295	g_33496
ptg000024l	21767131	21849676	82545	g_33496	g_34336
ptg000024l	21864192	21989479	125287	g_34336	g_28181
ptg000024l	22001441	22006707	5266	g_28181	g_40270
ptg000024l	22014402	22077001	62599	g_40270	g_37985
ptg000024l	22085935	22189279	103344	g_37985	g_7948
ptg000024l	22221228	22259230	38002	g_7948	g_16676
ptg000024l	22263697	22435226	171529	g_16676	g_264
ptg000024l	22436270	22974549	538279	g_38601	g_19372
ptg000024l	22975433	22984558	9125	g_19372	g_21070
ptg000024l	22985046	23050393	65347	g_21070	g_18636
ptg000024l	23051082	23059361	8279	g_18636	g_36133
ptg000024l	23059849	23227707	167858	g_36133	g_8540
ptg000024l	23229308	23229333	25	g_8540	g_33840
ptg000024l	23230466	23232259	1793	g_33840	g_20668
ptg000024l	23233092	23257684	24592	g_20668	g_15436
ptg000024l	23265946	23269717	3771	g_15436	g_12656
ptg000024l	23286972	23294321	7349	g_12656	g_36136
ptg000024l	23306049	23353272	47223	g_36136	g_33551
ptg000024l	23353679	23377825	24146	g_33551	g_14647
ptg000024l	23396680	23524460	127780	g_14647	g_30294
ptg000024l	23525119	23629208	104089	g_30294	g_33646
ptg000024l	23629828	23659504	29676	g_33646	g_61
ptg000024l	23661894	23679688	17794	g_61	g_236
ptg000024l	23680083	23768613	88530	g_236	g_11279
ptg000024l	23769407	23771581	2174	g_11279	g_14900
ptg000024l	23772093	23871204	99111	g_14900	g_22541
ptg000024l	23871815	23904196	32381	g_22541	g_3776
ptg000024l	23904414	23953738	49324	g_3776	g_16916
ptg000024l	23954298	24007672	53374	g_16916	g_27089
ptg000024l	24008154	24120070	111916	g_27089	g_12980
ptg000024l	24120825	24132531	11706	g_12980	g_32197
ptg000024l	24133115	24135885	2770	g_32197	g_24842
ptg000024l	24136517	24140527	4010	g_24842	g_31383
ptg000024l	24141468	24141490	22	g_31383	g_24796
ptg000024l	24142116	24148377	6261	g_24796	g_14770
ptg000024l	24148604	24154990	6386	g_14770	g_16917
ptg000024l	24155244	24162982	7738	g_16917	g_10748
ptg000024l	24163599	24209379	45780	g_10748	g_27577
ptg000024l	24209888	24293911	84023	g_27577	g_21613
ptg000024l	24294348	24384680	90332	g_21613	g_12940
ptg000024l	24387268	24743045	355777	g_12940	g_13063
ptg000024l	24743587	24943861	200274	g_13063	g_6
ptg000024l	24944529	24944593	64	g_6	g_32240
ptg000024l	24945339	24945928	589	g_32240	g_28320
ptg000024l	24946932	24969151	22219	g_28320	g_25216
ptg000024l	24969966	25009087	39121	g_25216	g_10547
ptg000024l	25009521	25118833	109312	g_10547	g_39846
ptg000024l	25119291	25194621	75330	g_39846	g_31743
ptg000024l	25195505	25217209	21704	g_31743	g_10494
ptg000024l	25217694	25248057	30363	g_10494	g_8140
ptg000024l	25248503	25273174	24671	g_8140	g_17717
ptg000024l	25273758	25289070	15312	g_17717	g_9317
ptg000024l	25292928	25297864	4936	g_9317	g_12569
ptg000024l	25298247	25329493	31246	g_12569	g_21533
ptg000024l	25329732	25340877	11145	g_21533	g_4068
ptg000024l	25341617	25415773	74156	g_4068	g_8021
ptg000024l	25416957	25431301	14344	g_8021	g_32558
ptg000024l	25431567	25570228	138661	g_32558	g_37813
ptg000024l	25570737	25743229	172492	g_37813	g_16754
ptg000024l	25743558	26001055	257497	g_16754	g_7664
ptg000024l	26001450	26043995	42545	g_7664	g_14258
ptg000024l	26044390	26044489	99	g_14258	g_9667
ptg000024l	26045118	26149639	104521	g_9667	g_21853
ptg000024l	26150010	26214222	64212	g_21853	g_9953
ptg000024l	26215841	26248926	33085	g_9953	g_2256
ptg000024l	26249594	26295518	45924	g_2256	g_32107
ptg000024l	26297638	26464789	167151	g_32107	g_34805
ptg000024l	26465256	26509294	44038	g_34805	g_13768
ptg000024l	26511090	26573064	61974	g_13768	g_17893
ptg000024l	26574326	26596327	22001	g_17893	g_1886
ptg000024l	26596863	26601939	5076	g_1886	g_39936
ptg000024l	26602196	26669605	67409	g_39936	g_29023
ptg000024l	26670321	26674815	4494	g_29023	g_33150
ptg000024l	26676083	26913726	237643	g_33150	g_27666
ptg000024l	26914616	26939352	24736	g_27666	g_28242
ptg000024l	26939900	27114550	174650	g_28242	g_2667
ptg000024l	27114825	27131183	16358	g_2667	g_24216
ptg000024l	27131458	27202046	70588	g_24216	g_40190
ptg000024l	27205812	27214280	8468	g_40190	g_18630
ptg000024l	27218046	27232757	14711	g_18630	g_3747
ptg000024l	27234067	27260943	26876	g_3747	g_362
ptg000024l	27261389	27346071	84682	g_362	g_24505
ptg000024l	27346394	27346500	106	g_24505	g_14148
ptg000024l	27346952	27361703	14751	g_14148	g_7476
ptg000024l	27362032	27362104	72	g_7476	g_40032
ptg000024l	27362550	27643540	280990	g_40032	g_33240
ptg000024l	27643806	27720195	76389	g_33240	g_26663
ptg000024l	27720656	27880100	159444	g_26663	g_26512
ptg000024l	27880486	27884563	4077	g_26512	g_8078
ptg000024l	27885639	27944353	58714	g_8078	g_11246
ptg000024l	27944577	27970411	25834	g_11246	g_6600
ptg000024l	27973068	28072072	99004	g_6600	g_9773
ptg000024l	28073118	28087063	13945	g_9773	g_36276
ptg000024l	28088031	28154307	66276	g_36276	g_9819
ptg000024l	28154774	28185692	30918	g_9819	g_27621
ptg000024l	28185913	28206953	21040	g_27621	g_19068
ptg000024l	28207585	28556674	349089	g_19068	g_24361
ptg000024l	28558174	28704614	146440	g_24361	g_24497
ptg000024l	28726018	28729629	3611	g_24497	g_12992
ptg000024l	28732905	28735843	2938	g_12992	g_30800
ptg000024l	28740393	28744322	3929	g_30800	g_16651
ptg000024l	28748157	28751891	3734	g_16651	g_13966
ptg000024l	28752268	28820409	68141	g_13966	g_195
ptg000024l	28820780	28894339	73559	g_195	g_22533
ptg000024l	28898157	28913773	15616	g_22533	g_18460
ptg000024l	28932095	28976660	44565	g_18460	g_23095
ptg000024l	28982227	28988189	5962	g_23095	g_29342
ptg000024l	28995476	29042590	47114	g_29342	g_13997
ptg000024l	29043309	29091524	48215	g_13997	g_25480
ptg000024l	29091922	29107406	15484	g_25480	g_16375
ptg000024l	29107816	29125405	17589	g_16375	g_4251
ptg000024l	29125803	29161153	35350	g_4251	g_24422
ptg000024l	29161992	29268232	106240	g_24422	g_9769
ptg000024l	29277631	29300284	22653	g_9769	g_17957
ptg000024l	29300625	29436787	136162	g_17957	g_30007
ptg000024l	29437011	29500702	63691	g_30007	g_35165
ptg000024l	29502570	29622399	119829	g_35165	g_28627
ptg000024l	29635567	29644714	9147	g_28627	g_11657
ptg000024l	29658662	29683513	24851	g_11657	g_37906
ptg000024l	29683782	29725900	42118	g_37906	g_15370
ptg000024l	29742239	29744518	2279	g_15370	g_15473
ptg000024l	29746084	29746212	128	g_15473	g_29576
ptg000024l	29756596	29772670	16074	g_29576	g_3352
ptg000024l	29788572	29808764	20192	g_3352	g_34283
ptg000024l	29823807	29824758	951	g_34283	g_11953
ptg000024l	29826288	29826416	128	g_11953	g_30787
ptg000024l	29835477	29849967	14490	g_30787	g_33900
ptg000024l	29862722	29868082	5360	g_33900	g_15531
ptg000024l	29882919	29885377	2458	g_15531	g_4983
ptg000024l	29886943	29887071	128	g_4983	g_9188
ptg000024l	29897479	29918173	20694	g_9188	g_9856
ptg000024l	29918442	29921546	3104	g_9856	g_26186
ptg000024l	29923738	30006390	82652	g_26186	g_25054
ptg000024l	30022584	30032439	9855	g_25054	g_24064
ptg000024l	30034358	30068103	33745	g_24064	g_821
ptg000024l	30068564	30097187	28623	g_821	g_37966
ptg000024l	30099014	30101314	2300	g_37966	g_7434
ptg000024l	30108777	30136591	27814	g_7434	g_16559
ptg000024l	30152326	30155284	2958	g_16559	g_8466
ptg000024l	30166781	30167971	1190	g_8466	g_40046
ptg000024l	30172636	30213952	41316	g_40046	g_19912
ptg000024l	30243114	30260373	17259	g_19912	g_11285
ptg000024l	30270710	30331964	61254	g_11285	g_13631
ptg000024l	30332335	30340280	7945	g_13631	g_11415
ptg000024l	30340642	30345229	4587	g_11415	g_29334
ptg000024l	30364252	30403062	38810	g_29334	g_9654
ptg000024l	30411212	30411909	697	g_9654	g_23202
ptg000024l	30420412	30429075	8663	g_23202	g_36059
ptg000024l	30430898	30431070	172	g_36059	g_34655
ptg000024l	30431471	30457919	26448	g_34655	g_16968
ptg000024l	30462324	30464684	2360	g_16968	g_20411
ptg000024l	30467061	30494482	27421	g_20411	g_32021
ptg000024l	30508178	30510768	2590	g_32021	g_10382
ptg000024l	30520708	30546853	26145	g_10382	g_29556
ptg000024l	30558439	30573431	14992	g_29556	g_14609
ptg000024l	30573655	30577313	3658	g_14609	g_29637
ptg000024l	30594063	30653162	59099	g_29637	g_8739
ptg000024l	30653560	30653646	86	g_8739	g_30208
ptg000024l	30654290	30664522	10232	g_30208	g_15738
ptg000024l	30664845	30665213	368	g_15738	g_21831
ptg000024l	30665749	30690333	24584	g_21831	g_16133
ptg000024l	30691250	30767080	75830	g_16133	g_14884
ptg000024l	30767547	30838185	70638	g_14884	g_37282
ptg000024l	30838985	31016528	177543	g_37282	g_38201
ptg000024l	31016752	31087364	70612	g_38201	g_14287
ptg000024l	31087579	31087682	103	g_14287	g_21490
ptg000024l	31089340	31156489	67149	g_21490	g_25643
ptg000024l	31157169	31157280	111	g_25643	g_25383
ptg000024l	31157903	31179906	22003	g_25383	g_19094
ptg000024l	31181186	31230959	49773	g_19094	g_5548
ptg000024l	31231851	31267536	35685	g_5548	g_11520
ptg000024l	31271181	31278823	7642	g_11520	g_26708
ptg000024l	31279764	31342403	62639	g_26708	g_21534
ptg000024l	31342762	31386471	43709	g_21534	g_33
ptg000024l	31387046	31399140	12094	g_33	g_16901
ptg000024l	31399442	31401134	1692	g_16901	g_12665
ptg000024l	31402484	31415010	12526	g_12665	g_8741
ptg000025l	26912	109616	82704	g_14742	g_7852
ptg000025l	110110	131902	21792	g_7852	g_11300
ptg000025l	132144	149867	17723	g_11300	g_32284
ptg000025l	150322	161082	10760	g_32284	g_40280
ptg000025l	161555	165090	3535	g_40280	g_32402
ptg000025l	166736	186977	20241	g_32402	g_24866
ptg000025l	192462	194291	1829	g_24866	g_32887
ptg000025l	207557	207768	211	g_32887	g_13250
ptg000025l	208076	208714	638	g_13250	g_23414
ptg000025l	209427	212470	3043	g_23414	g_13795
ptg000025l	213534	334576	121042	g_13795	g_3769
ptg000025l	335997	370158	34161	g_3769	g_24039
ptg000025l	376998	414838	37840	g_24039	g_4157
ptg000025l	439811	534119	94308	g_4157	g_9452
ptg000025l	542671	569606	26935	g_9452	g_28161
ptg000025l	605219	642019	36800	g_28161	g_22928
ptg000025l	642273	665759	23486	g_22928	g_2360
ptg000025l	666457	685091	18634	g_2360	g_2406
ptg000025l	686353	802907	116554	g_2406	g_15160
ptg000025l	805284	821361	16077	g_15160	g_29314
ptg000025l	821963	968106	146143	g_29314	g_32666
ptg000025l	968480	969291	811	g_32666	g_4701
ptg000025l	969497	995461	25964	g_4701	g_27649
ptg000025l	996141	1032962	36821	g_27649	g_17482
ptg000025l	1034634	1083042	48408	g_17482	g_30021
ptg000025l	1095299	1274257	178958	g_30021	g_14363
ptg000025l	1274538	1285460	10922	g_14363	g_3194
ptg000025l	1285840	1302177	16337	g_3194	g_9153
ptg000025l	1302935	1306433	3498	g_9153	g_31526
ptg000025l	1306666	1357795	51129	g_31526	g_19093
ptg000025l	1358145	1378079	19934	g_19093	g_5474
ptg000025l	1378606	1412319	33713	g_5474	g_34406
ptg000025l	1412915	1431751	18836	g_34406	g_12139
ptg000025l	1437685	1526499	88814	g_12139	g_15684
ptg000025l	1534483	1678344	143861	g_15684	g_15903
ptg000025l	1686452	1688261	1809	g_15903	g_11323
ptg000025l	1695702	1699191	3489	g_11323	g_36554
ptg000025l	1704047	1758168	54121	g_36554	g_3483
ptg000025l	1778840	1872717	93877	g_3483	g_3277
ptg000025l	1877960	1901861	23901	g_3277	g_7644
ptg000025l	1903307	1917458	14151	g_7644	g_34938
ptg000025l	1941418	1948030	6612	g_34938	g_23753
ptg000025l	1968020	2054873	86853	g_23753	g_7667
ptg000025l	2072978	2111470	38492	g_7667	g_18801
ptg000025l	2113011	2113161	150	g_18801	g_4695
ptg000025l	2113628	2175175	61547	g_4695	g_30224
ptg000025l	2178159	2208090	29931	g_30224	g_39450
ptg000025l	2208938	2267764	58826	g_39450	g_37368
ptg000025l	2268489	2269263	774	g_37368	g_37829
ptg000025l	2270267	2294167	23900	g_37829	g_35946
ptg000025l	2294775	2300045	5270	g_35946	g_30276
ptg000025l	2300587	2359730	59143	g_30276	g_7173
ptg000025l	2360914	2385450	24536	g_7173	g_3123
ptg000025l	2386034	2412865	26831	g_3123	g_9975
ptg000025l	2413800	2430239	16439	g_9975	g_36834
ptg000025l	2430859	2540501	109642	g_36834	g_24564
ptg000025l	2542564	2662409	119845	g_24564	g_11592
ptg000025l	2662726	2746131	83405	g_11592	g_26332
ptg000025l	2774433	2778047	3614	g_26332	g_13374
ptg000025l	2778502	2828857	50355	g_13374	g_6378
ptg000025l	2829405	2892383	62978	g_6378	g_9194
ptg000025l	2895766	2898873	3107	g_9194	g_16992
ptg000025l	2920701	2922530	1829	g_16992	g_377
ptg000025l	2930003	2934555	4552	g_377	g_8196
ptg000025l	2940657	2945383	4726	g_8196	g_28585
ptg000025l	2961060	2966392	5332	g_28585	g_19221
ptg000025l	2967211	2975340	8129	g_19221	g_3143
ptg000025l	2975765	2976119	354	g_3143	g_21548
ptg000025l	2976604	3069009	92405	g_21548	g_3731
ptg000025l	3075046	3136961	61915	g_3731	g_9371
ptg000025l	3137998	3140446	2448	g_9371	g_22290
ptg000025l	3140940	3169199	28259	g_22290	g_32000
ptg000025l	3169705	3175036	5331	g_32000	g_22391
ptg000025l	3190472	3195501	5029	g_22391	g_9335
ptg000025l	3208865	3213017	4152	g_9335	g_8894
ptg000025l	3218351	3232516	14165	g_8894	g_27901
ptg000025l	3232974	3364348	131374	g_27901	g_22173
ptg000025l	3373594	3387325	13731	g_22173	g_28966
ptg000025l	3389031	3409593	20562	g_28966	g_591
ptg000025l	3411244	3421275	10031	g_591	g_9893
ptg000025l	3421940	3600532	178592	g_9893	g_15616
ptg000025l	3619050	3738727	119677	g_15616	g_37626
ptg000025l	3740173	3853117	112944	g_37626	g_18823
ptg000025l	3853326	3911986	58660	g_18823	g_24330
ptg000025l	3924898	3926899	2001	g_24330	g_3870
ptg000025l	3928707	3933940	5233	g_3870	g_19578
ptg000025l	3935088	3963794	28706	g_19578	g_11530
ptg000025l	3975471	4126040	150569	g_11530	g_25136
ptg000025l	4131392	4144920	13528	g_25136	g_24436
ptg000025l	4145600	4278558	132958	g_24436	g_10327
ptg000025l	4279160	4308230	29070	g_10327	g_16160
ptg000025l	4308736	4323000	14264	g_16160	g_8825
ptg000025l	4332552	4357056	24504	g_8825	g_25381
ptg000025l	4363090	4379390	16300	g_25381	g_8425
ptg000025l	4402800	4422202	19402	g_8425	g_21879
ptg000025l	4435520	4436060	540	g_21879	g_26798
ptg000025l	4439563	4463306	23743	g_26798	g_28085
ptg000025l	4463713	4487203	23490	g_28085	g_35543
ptg000025l	4487913	4489163	1250	g_35543	g_32502
ptg000025l	4489663	4504907	15244	g_32502	g_30242
ptg000025l	4507609	4515064	7455	g_30242	g_28278
ptg000025l	4515441	4521085	5644	g_28278	g_2614
ptg000025l	4546363	4605404	59041	g_2614	g_30986
ptg000025l	4605814	4645719	39905	g_30986	g_9743
ptg000025l	4650872	4724142	73270	g_9743	g_17505
ptg000025l	4738568	4850352	111784	g_17505	g_31831
ptg000025l	4851008	4873476	22468	g_31831	g_30040
ptg000025l	4882276	4904632	22356	g_30040	g_25011
ptg000025l	4904979	4915120	10141	g_25011	g_6604
ptg000025l	4934392	4937017	2625	g_6604	g_26324
ptg000025l	4938006	4938222	216	g_26324	g_14730
ptg000025l	4946980	4990001	43021	g_14730	g_29421
ptg000025l	5026053	5047816	21763	g_29421	g_12170
ptg000025l	5048295	5059479	11184	g_12170	g_23394
ptg000025l	5096003	5145047	49044	g_23394	g_25013
ptg000025l	5156650	5166413	9763	g_25013	g_16499
ptg000025l	5166856	5169733	2877	g_16499	g_5023
ptg000025l	5186503	5244045	57542	g_5023	g_18299
ptg000025l	5249983	5257138	7155	g_18299	g_12938
ptg000025l	5260591	5261048	457	g_12938	g_39721
ptg000025l	5261251	5284329	23078	g_39721	g_15294
ptg000025l	5296651	5297870	1219	g_15294	g_28569
ptg000025l	5298532	5304892	6360	g_28569	g_7026
ptg000025l	5322246	5350199	27953	g_7026	g_15320
ptg000025l	5351860	5352618	758	g_15320	g_22509
ptg000025l	5353136	5353184	48	g_22509	g_10770
ptg000025l	5353816	5358623	4807	g_10770	g_3766
ptg000025l	5358835	5363365	4530	g_3766	g_556
ptg000025l	5363985	5382399	18414	g_556	g_16964
ptg000025l	5382974	5420449	37475	g_16964	g_37696
ptg000025l	5420805	5536554	115749	g_37696	g_8084
ptg000025l	5536928	5681355	144427	g_8084	g_35710
ptg000025l	5682359	5697339	14980	g_35710	g_13559
ptg000025l	5698481	5717915	19434	g_13559	g_28782
ptg000025l	5718943	5759743	40800	g_28782	g_9695
ptg000025l	5761763	5761849	86	g_9695	g_24827
ptg000025l	5762061	5800615	38554	g_24827	g_8536
ptg000025l	5813699	5813733	34	g_8536	g_32699
ptg000026l	485374	487772	2398	g_32948	g_17671
ptg000026l	494154	496358	2204	g_17671	g_22188
ptg000026l	497744	508019	10275	g_22188	g_1666
ptg000026l	511623	534771	23148	g_1666	g_17700
ptg000026l	535617	604470	68853	g_17700	g_29355
ptg000026l	605972	639737	33765	g_29355	g_36641
ptg000026l	651915	696642	44727	g_36641	g_8198
ptg000026l	702951	724792	21841	g_8198	g_2566
ptg000026l	750404	778547	28143	g_2566	g_36876
ptg000026l	784282	787234	2952	g_36876	g_39687
ptg000026l	797846	798941	1095	g_8998	g_18813
ptg000026l	801058	802199	1141	g_18813	g_1253
ptg000026l	804685	809948	5263	g_1253	g_21218
ptg000026l	815929	832705	16776	g_21218	g_20926
ptg000026l	837482	857822	20340	g_20926	g_5773
ptg000026l	871946	877229	5283	g_5773	g_3451
ptg000026l	877672	885196	7524	g_3451	g_11501
ptg000026l	885435	918553	33118	g_11501	g_4384
ptg000026l	929836	933005	3169	g_4384	g_549
ptg000026l	937192	941834	4642	g_549	g_19110
ptg000026l	953155	1059988	106833	g_19110	g_6790
ptg000026l	1060818	1140104	79286	g_6790	g_38231
ptg000026l	1146100	1148124	2024	g_38231	g_12162
ptg000026l	1157320	1165419	8099	g_12162	g_28903
ptg000026l	1184835	1186384	1549	g_28903	g_28173
ptg000026l	1188997	1190014	1017	g_28173	g_19784
ptg000026l	1195232	1200781	5549	g_19784	g_32750
ptg000026l	1219525	1225962	6437	g_32750	g_7822
ptg000026l	1230742	1233018	2276	g_7822	g_37830
ptg000026l	1240019	1258985	18966	g_37830	g_25177
ptg000026l	1262761	1275237	12476	g_25177	g_25338
ptg000026l	1285614	1289479	3865	g_25338	g_29827
ptg000026l	1297392	1297979	587	g_29827	g_12138
ptg000026l	1301030	1307555	6525	g_12138	g_27016
ptg000026l	1318449	1323601	5152	g_27016	g_10717
ptg000026l	1329326	1348523	19197	g_10717	g_36156
ptg000026l	1354971	1357413	2442	g_36156	g_22460
ptg000026l	1373125	1374453	1328	g_22460	g_27826
ptg000026l	1378158	1380215	2057	g_27826	g_11395
ptg000026l	1401207	1416858	15651	g_11395	g_16214
ptg000026l	1431468	1439089	7621	g_16214	g_14823
ptg000026l	1452934	1592380	139446	g_14823	g_16040
ptg000026l	1592598	1592911	313	g_16040	g_10579
ptg000026l	1608211	1612363	4152	g_10579	g_20704
ptg000026l	1613505	1697728	84223	g_20704	g_207
ptg000026l	1708352	1713723	5371	g_207	g_28036
ptg000026l	1716068	1723491	7423	g_28036	g_25810
ptg000026l	1732464	1734767	2303	g_25810	g_7916
ptg000026l	1735945	1755250	19305	g_7916	g_9390
ptg000026l	1758862	1798044	39182	g_9390	g_12067
ptg000026l	1806941	1901158	94217	g_12067	g_4863
ptg000026l	1901379	1901524	145	g_4863	g_21777
ptg000026l	1904585	1961393	56808	g_21777	g_34575
ptg000026l	1963323	1983684	20361	g_34575	g_24579
ptg000026l	1996716	2016099	19383	g_24579	g_1987
ptg000026l	2016302	2040476	24174	g_1987	g_13093
ptg000026l	2045384	2051099	5715	g_13093	g_19663
ptg000026l	2063299	2065438	2139	g_19663	g_9841
ptg000026l	2068666	2070295	1629	g_9841	g_40285
ptg000026l	2072185	2077942	5757	g_40285	g_33599
ptg000026l	2085788	2086611	823	g_33599	g_6894
ptg000026l	2087265	2088566	1301	g_6894	g_33959
ptg000026l	2093959	2094838	879	g_33959	g_29021
ptg000026l	2097613	2106645	9032	g_29021	g_34888
ptg000026l	2114217	2118079	3862	g_34888	g_12093
ptg000026l	2141359	2169467	28108	g_12093	g_32542
ptg000026l	2169733	2185974	16241	g_32542	g_11748
ptg000026l	2186897	2192130	5233	g_11748	g_676
ptg000026l	2192678	2214099	21421	g_676	g_5070
ptg000026l	2238748	2241589	2841	g_5070	g_14591
ptg000026l	2257644	2259287	1643	g_29845	g_33465
ptg000026l	2270424	2309342	38918	g_33465	g_21826
ptg000026l	2309581	2361045	51464	g_21826	g_13646
ptg000026l	2361386	2363543	2157	g_13646	g_12173
ptg000026l	2366770	2377493	10723	g_12173	g_4917
ptg000026l	2387984	2454818	66834	g_4917	g_25545
ptg000026l	2457626	2459864	2238	g_25545	g_40007
ptg000026l	2465677	2467459	1782	g_40007	g_6054
ptg000026l	2484891	2498064	13173	g_6054	g_678
ptg000026l	2504431	2505252	821	g_678	g_26837
ptg000026l	2508285	2509961	1676	g_26837	g_33010
ptg000026l	2530168	2531893	1725	g_33010	g_19878
ptg000026l	2542174	2542934	760	g_19878	g_35964
ptg000026l	2543795	2544256	461	g_35964	g_21133
ptg000026l	2549096	2550068	972	g_21133	g_9932
ptg000026l	2556464	2768981	212517	g_9932	g_20687
ptg000026l	2805153	2845591	40438	g_20687	g_35903
ptg000026l	2857676	2859922	2246	g_35903	g_27766
ptg000026l	2866674	2870192	3518	g_27766	g_40093
ptg000026l	2871301	2875835	4534	g_40093	g_11198
ptg000026l	2884028	2887942	3914	g_11198	g_36119
ptg000026l	2899559	2902418	2859	g_36119	g_8551
ptg000026l	2917299	2923029	5730	g_8551	g_4782
ptg000026l	2932506	2938909	6403	g_4782	g_7609
ptg000026l	2939154	2973991	34837	g_7609	g_18697
ptg000026l	2978849	2987508	8659	g_18697	g_37146
ptg000026l	2999369	3015021	15652	g_37146	g_433
ptg000026l	3037827	3143687	105860	g_433	g_15112
ptg000026l	3145984	3146490	506	g_15112	g_20691
ptg000026l	3147629	3148381	752	g_20691	g_14134
ptg000026l	3150217	3150822	605	g_14134	g_9688
ptg000026l	3154484	3157597	3113	g_9688	g_21767
ptg000026l	3161181	3188610	27429	g_21767	g_6806
ptg000026l	3240296	3272124	31828	g_6806	g_36669
ptg000026l	3288960	3362749	73789	g_36669	g_36502
ptg000026l	3371245	3482274	111029	g_36502	g_25570
ptg000026l	3482519	3599709	117190	g_25570	g_9918
ptg000026l	3599927	3602096	2169	g_9918	g_29622
ptg000026l	3602317	3897848	295531	g_29622	g_9879
ptg000026l	3908973	3914540	5567	g_9879	g_17756
ptg000026l	3918301	3919447	1146	g_17756	g_22615
ptg000026l	3923689	3925169	1480	g_22615	g_29765
ptg000026l	3927929	3954113	26184	g_29765	g_36143
ptg000026l	3954406	3961779	7373	g_36143	g_24080
ptg000026l	3964380	4104442	140062	g_24080	g_24042
ptg000026l	4118940	4119407	467	g_24042	g_13067
ptg000026l	4119634	4130136	10502	g_13067	g_37708
ptg000026l	4138941	4141859	2918	g_37708	g_1564
ptg000026l	4150020	4152538	2518	g_1564	g_21141
ptg000026l	4164853	4168182	3329	g_21141	g_16825
ptg000026l	4182338	4182434	96	g_16825	g_40165
ptg000026l	4185937	4202865	16928	g_40165	g_30416
ptg000026l	4211996	4214899	2903	g_30416	g_18171
ptg000026l	4223438	4226876	3438	g_18171	g_33030
ptg000026l	4233673	4287411	53738	g_33030	g_20993
ptg000026l	4295681	4378703	83022	g_20993	g_37596
ptg000026l	4390625	4394850	4225	g_37596	g_5477
ptg000026l	4395568	4422636	27068	g_5477	g_12062
ptg000026l	4423109	4425162	2053	g_12062	g_3004
ptg000026l	4429765	4431491	1726	g_3004	g_8982
ptg000026l	4438251	4439827	1576	g_8982	g_25166
ptg000026l	4440186	4515300	75114	g_25166	g_6727
ptg000026l	4515879	4528001	12122	g_6727	g_11995
ptg000026l	4537626	4538512	886	g_11995	g_233
ptg000026l	4551153	4551232	79	g_233	g_39901
ptg000026l	4577281	4712741	135460	g_39901	g_8504
ptg000026l	4714864	4784228	69364	g_8504	g_1751
ptg000026l	4784539	4811830	27291	g_1751	g_13764
ptg000026l	4812135	4984751	172616	g_13764	g_19416
ptg000026l	4989383	5029474	40091	g_19416	g_7975
ptg000026l	5041703	5097303	55600	g_7975	g_36527
ptg000026l	5098436	5186709	88273	g_36527	g_27206
ptg000026l	5186993	5372980	185987	g_27206	g_36385
ptg000026l	5373225	5447174	73949	g_36385	g_22682
ptg000026l	5455195	5504197	49002	g_22682	g_4290
ptg000026l	5510200	5513002	2802	g_4290	g_29170
ptg000026l	5517153	5529284	12131	g_29170	g_25056
ptg000026l	5531265	5538216	6951	g_25056	g_30807
ptg000026l	5539256	5542091	2835	g_30807	g_30742
ptg000026l	5542603	5543488	885	g_30742	g_8287
ptg000026l	5551137	5593225	42088	g_8287	g_12756
ptg000026l	5611304	5616162	4858	g_12756	g_21293
ptg000026l	5616368	5619663	3295	g_21293	g_28695
ptg000026l	5630017	5740031	110014	g_28695	g_36244
ptg000026l	5746298	5765266	18968	g_36244	g_9232
ptg000026l	5769716	5774495	4779	g_9232	g_11508
ptg000026l	5794467	5796129	1662	g_11508	g_28916
ptg000026l	5804087	5892548	88461	g_28916	g_31875
ptg000026l	5898964	5917653	18689	g_31875	g_18081
ptg000026l	5920251	5922487	2236	g_18081	g_5718
ptg000026l	5937348	5972373	35025	g_5718	g_9252
ptg000026l	5980989	6033187	52198	g_9252	g_17539
ptg000026l	6047245	6068827	21582	g_17539	g_19024
ptg000026l	6093036	6097902	4866	g_19024	g_10050
ptg000026l	6106991	6430511	323520	g_10050	g_19530
ptg000026l	6440261	6457792	17531	g_19530	g_4827
ptg000027l	506899	511591	4692	g_9511	g_37567
ptg000027l	512334	529985	17651	g_37567	g_5876
ptg000027l	530476	667569	137093	g_5876	g_3988
ptg000027l	668234	683321	15087	g_3988	g_23531
ptg000027l	683893	753051	69158	g_23531	g_5606
ptg000027l	754970	786848	31878	g_5606	g_22522
ptg000027l	790057	818703	28646	g_22522	g_11116
ptg000027l	819128	873874	54746	g_11116	g_3573
ptg000027l	874734	890175	15441	g_3573	g_17135
ptg000027l	891071	1003543	112472	g_17135	g_1592
ptg000027l	1006800	1062363	55563	g_1592	g_8179
ptg000027l	1074221	1079095	4874	g_8179	g_17871
ptg000027l	1084684	1106324	21640	g_17871	g_11299
ptg000027l	1106875	1141450	34575	g_11299	g_5369
ptg000027l	1141761	1295864	154103	g_5369	g_3830
ptg000027l	1297598	1317812	20214	g_3830	g_11563
ptg000027l	1318210	1330084	11874	g_11563	g_8240
ptg000027l	1330626	1419100	88474	g_8240	g_777
ptg000027l	1419300	1421063	1763	g_777	g_25442
ptg000027l	1424083	1442430	18347	g_25442	g_31655
ptg000027l	1443560	1455435	11875	g_31655	g_25531
ptg000027l	1456193	1522538	66345	g_25531	g_29575
ptg000027l	1523386	1574475	51089	g_29575	g_31838
ptg000027l	1577625	1594175	16550	g_31838	g_33369
ptg000027l	1613940	1669383	55443	g_33369	g_26440
ptg000027l	1670612	1748045	77433	g_26440	g_14779
ptg000027l	1748263	1843220	94957	g_14779	g_33748
ptg000027l	1843630	1861166	17536	g_33748	g_11248
ptg000027l	1861759	1910222	48463	g_11248	g_31468
ptg000027l	1917858	1929029	11171	g_31468	g_19075
ptg000027l	1930669	2001346	70677	g_19075	g_23730
ptg000027l	2001807	2001995	188	g_23730	g_16075
ptg000027l	2002372	2002407	35	g_16075	g_12534
ptg000027l	2002868	2003086	218	g_12534	g_30819
ptg000027l	2003403	2150552	147149	g_30819	g_24056
ptg000027l	2163056	2287349	124293	g_24056	g_18017
ptg000027l	2287690	2290721	3031	g_18017	g_4238
ptg000027l	2294370	3066120	771750	g_4238	g_27006
ptg000027l	3066488	3066706	218	g_27006	g_31756
ptg000027l	3068867	3119666	50799	g_31756	g_23807
ptg000027l	3120577	3139615	19038	g_23807	g_9217
ptg000027l	3140130	3145294	5164	g_9217	g_12012
ptg000027l	3145767	3164170	18403	g_12012	g_26295
ptg000027l	3164940	3173325	8385	g_26295	g_27671
ptg000027l	3173654	3234811	61157	g_27671	g_20201
ptg000027l	3253928	3297903	43975	g_20201	g_3621
ptg000027l	3298127	3307496	9369	g_3621	g_13082
ptg000027l	3307759	3321209	13450	g_13082	g_36774
ptg000027l	3321802	3353561	31759	g_36774	g_36005
ptg000027l	3354049	3357324	3275	g_36005	g_37931
ptg000027l	3357764	3358138	374	g_37931	g_33254
ptg000027l	3358563	3501536	142973	g_33254	g_16228
ptg000027l	3503206	3518310	15104	g_16228	g_3279
ptg000027l	3518891	3616658	97767	g_3279	g_4239
ptg000027l	3617794	3689815	72021	g_4239	g_10566
ptg000027l	3690678	3714657	23979	g_10566	g_34519
ptg000027l	3715556	3736056	20500	g_34519	g_23630
ptg000027l	3736739	3809823	73084	g_23630	g_12270
ptg000027l	3810401	3810501	100	g_12270	g_1889
ptg000027l	3811205	3892703	81498	g_1889	g_11658
ptg000027l	3892945	3943065	50120	g_11658	g_15736
ptg000027l	3943661	3943802	141	g_15736	g_25845
ptg000027l	3944032	3960122	16090	g_25845	g_35883
ptg000027l	3960646	3968329	7683	g_35883	g_10870
ptg000027l	3968586	4006521	37935	g_10870	g_709
ptg000027l	4007225	4036866	29641	g_709	g_30760
ptg000027l	4037087	4056250	19163	g_30760	g_28598
ptg000027l	4057248	4062689	5441	g_28598	g_21313
ptg000027l	4063495	4076854	13359	g_21313	g_32934
ptg000027l	4079222	4101053	21831	g_32934	g_16855
ptg000027l	4102927	4129668	26741	g_16855	g_29325
ptg000027l	4130156	4146194	16038	g_29325	g_14146
ptg000027l	4149204	4288153	138949	g_14146	g_27642
ptg000027l	4288419	4298559	10140	g_27642	g_10879
ptg000027l	4299263	4352597	53334	g_10879	g_21805
ptg000027l	4353493	4419975	66482	g_21805	g_13177
ptg000027l	4420625	4450325	29700	g_13177	g_10001
ptg000027l	4451224	4457079	5855	g_10001	g_10383
ptg000027l	4458113	4571511	113398	g_10383	g_33723
ptg000027l	4571744	4690637	118893	g_33723	g_15599
ptg000027l	4691416	4882514	191098	g_15599	g_38021
ptg000027l	4882792	4898723	15931	g_38021	g_37479
ptg000027l	4901290	4950699	49409	g_37479	g_29798
ptg000027l	4951121	4961260	10139	g_29798	g_35805
ptg000027l	4961934	4978262	16328	g_35805	g_27907
ptg000027l	4981338	4990483	9145	g_27907	g_15493
ptg000027l	5000665	5003497	2832	g_15493	g_22731
ptg000027l	5016000	5020669	4669	g_22731	g_8691
ptg000027l	5049991	5134515	84524	g_8691	g_16538
ptg000027l	5149002	5166402	17400	g_16538	g_16564
ptg000027l	5178214	5201175	22961	g_16564	g_10241
ptg000027l	5201708	5211511	9803	g_10241	g_19183
ptg000027l	5212305	5231794	19489	g_19183	g_5870
ptg000027l	5304678	5324329	19651	g_5870	g_14249
ptg000027l	5326555	5329889	3334	g_14249	g_2065
ptg000027l	5330437	5337825	7388	g_2065	g_3358
ptg000028l	21728	124480	102752	g_4264	g_23580
ptg000028l	125328	126784	1456	g_23580	g_28764
ptg000028l	143834	157421	13587	g_28764	g_19162
ptg000028l	160221	201803	41582	g_19162	g_5611
ptg000028l	210353	247516	37163	g_5611	g_36784
ptg000028l	250321	269894	19573	g_36784	g_22137
ptg000028l	273849	298832	24983	g_22137	g_34742
ptg000028l	302471	305666	3195	g_34742	g_5818
ptg000028l	313249	317239	3990	g_5818	g_22274
ptg000028l	330714	333179	2465	g_22274	g_29973
ptg000028l	356818	537791	180973	g_29973	g_22462
ptg000028l	554899	557906	3007	g_22462	g_972
ptg000028l	558286	559070	784	g_972	g_27296
ptg000028l	559783	559938	155	g_27296	g_8984
ptg000028l	560666	561049	383	g_8984	g_20621
ptg000028l	561744	642161	80417	g_20621	g_20594
ptg000028l	655649	671340	15691	g_20594	g_6292
ptg000028l	672023	672097	74	g_6292	g_40012
ptg000028l	673152	697202	24050	g_40012	g_36248
ptg000028l	697633	739643	42010	g_36248	g_23897
ptg000028l	741987	744459	2472	g_23897	g_32659
ptg000028l	759447	804292	44845	g_32659	g_6895
ptg000028l	806564	973965	167401	g_6895	g_20081
ptg000028l	976831	1081264	104433	g_20081	g_28067
ptg000028l	1081968	1094257	12289	g_28067	g_6730
ptg000028l	1094928	1095253	325	g_6730	g_30793
ptg000028l	1096281	1128016	31735	g_30793	g_36526
ptg000028l	1128300	1416511	288211	g_36526	g_38190
ptg000028l	1416750	1446278	29528	g_38190	g_38076
ptg000028l	1468785	1472815	4030	g_38076	g_22865
ptg000028l	1473300	1531888	58588	g_22865	g_36544
ptg000028l	1537230	1557404	20174	g_36544	g_32007
ptg000028l	1558765	1566195	7430	g_32007	g_12712
ptg000028l	1566617	1723344	156727	g_12712	g_21219
ptg000028l	1724250	1775341	51091	g_21219	g_22711
ptg000028l	1787958	1794570	6612	g_22711	g_36619
ptg000028l	1794884	1832220	37336	g_36619	g_21427
ptg000028l	1851536	1859904	8368	g_21427	g_14583
ptg000028l	1867494	1875999	8505	g_14583	g_25919
ptg000028l	1885457	1886376	919	g_25919	g_5799
ptg000028l	1888673	1896452	7779	g_5799	g_38528
ptg000028l	1898071	1912995	14924	g_38528	g_14428
ptg000028l	1913387	1919352	5965	g_14428	g_8458
ptg000028l	1919594	1923005	3411	g_8458	g_31336
ptg000028l	1930708	2069987	139279	g_31336	g_33830
ptg000028l	2092768	2096246	3478	g_33830	g_13748
ptg000028l	2117124	2123810	6686	g_13748	g_12683
ptg000028l	2133671	2141526	7855	g_12683	g_15853
ptg000028l	2151307	2154725	3418	g_15853	g_25283
ptg000028l	2155474	2184216	28742	g_25283	g_19687
ptg000028l	2184536	2197879	13343	g_19687	g_33730
ptg000028l	2202522	2219370	16848	g_33730	g_21731
ptg000028l	2222429	2225957	3528	g_21731	g_23579
ptg000028l	2226702	2227832	1130	g_23579	g_36836
ptg000028l	2247929	2275411	27482	g_36836	g_19919
ptg000028l	2285291	2321998	36707	g_19919	g_6123
ptg000028l	2328641	2334610	5969	g_6123	g_9806
ptg000028l	2334810	2364286	29476	g_9806	g_17018
ptg000028l	2364861	2445053	80192	g_17018	g_33690
ptg000028l	2445466	2462201	16735	g_33690	g_13421
ptg000028l	2474108	2478704	4596	g_13421	g_22420
ptg000028l	2479129	2480663	1534	g_22420	g_20485
ptg000028l	2483111	2538115	55004	g_20485	g_4369
ptg000028l	2539032	2596717	57685	g_4369	g_5362
ptg000028l	2600318	2618603	18285	g_5362	g_4706
ptg000028l	2625181	2639497	14316	g_4706	g_26223
ptg000028l	2641233	2735292	94059	g_26223	g_20097
ptg000028l	2735537	2770654	35117	g_20097	g_6987
ptg000028l	2770863	2793454	22591	g_6987	g_18591
ptg000028l	2809843	2817492	7649	g_18591	g_37198
ptg000028l	2819186	2915476	96290	g_37198	g_31018
ptg000028l	2921292	2971960	50668	g_31018	g_13267
ptg000028l	2972250	3023407	51157	g_13267	g_36561
ptg000028l	3032619	3037240	4621	g_36561	g_10015
ptg000028l	3043286	3181406	138120	g_10015	g_17088
ptg000028l	3181678	3184998	3320	g_17088	g_40147
ptg000028l	3186257	3186641	384	g_40147	g_15543
ptg000028l	3187162	3254069	66907	g_15543	g_17945
ptg000028l	3254512	3282483	27971	g_17945	g_9473
ptg000028l	3282998	3297864	14866	g_9473	g_12130
ptg000028l	3299150	3345375	46225	g_12130	g_9241
ptg000028l	3346217	3377132	30915	g_9241	g_25751
ptg000028l	3377644	3377872	228	g_25751	g_26994
ptg000028l	3378114	3459704	81590	g_26994	g_35086
ptg000028l	3459988	3530886	70898	g_35086	g_1684
ptg000028l	3531833	3647206	115373	g_1684	g_6239
ptg000028l	3658896	3757254	98358	g_6239	g_18644
ptg000028l	3758021	3796402	38381	g_18644	g_15941
ptg000028l	3797889	3880791	82902	g_15941	g_32828
ptg000028l	3881120	4210849	329729	g_32828	g_898
ptg000028l	4212807	4224500	11693	g_898	g_7220
ptg000028l	4224829	4266506	41677	g_7220	g_10013
ptg000028l	4266721	4333145	66424	g_10013	g_26326
ptg000028l	4333519	4365899	32380	g_26326	g_13876
ptg000028l	4366411	4414187	47776	g_13876	g_8664
ptg000028l	4416422	4418879	2457	g_8664	g_40055
ptg000028l	4420583	4424585	4002	g_40055	g_8292
ptg000028l	4425916	4443798	17882	g_8292	g_6010
ptg000028l	4446824	4498297	51473	g_6010	g_14485
ptg000028l	4499275	4518421	19146	g_14485	g_219
ptg000028l	4518747	4522994	4247	g_219	g_22985
ptg000028l	4537395	4540163	2768	g_22985	g_1207
ptg000028l	4546239	4552877	6638	g_1207	g_19115
ptg000028l	4553740	4639864	86124	g_19115	g_22494
ptg000028l	4640103	4646936	6833	g_22494	g_26450
ptg000028l	4647535	4659095	11560	g_26450	g_18218
ptg000028l	4659541	4776157	116616	g_18218	g_6107
ptg000028l	4776483	4835356	58873	g_6107	g_17608
ptg000028l	4835634	5042100	206466	g_17608	g_8371
ptg000028l	5044250	5044265	15	g_8371	g_8500
ptg000028l	5045155	5105246	60091	g_27709	g_14671
ptg000028l	5112065	5138403	26338	g_14671	g_37833
ptg000028l	5138786	5191218	52432	g_37833	g_35331
ptg000028l	5203446	5209852	6406	g_35331	g_6761
ptg000028l	5230989	5251323	20334	g_6761	g_33004
ptg000028l	5252377	5444743	192366	g_33004	g_17407
ptg000028l	5445252	5447845	2593	g_17407	g_5211
ptg000028l	5448204	5483312	35108	g_5211	g_3800
ptg000028l	5499565	5546285	46720	g_3800	g_39555
ptg000028l	5546977	5634886	87909	g_39555	g_26955
ptg000028l	5635194	5799546	164352	g_26955	g_38823
ptg000028l	5800028	5815782	15754	g_38823	g_31142
ptg000028l	5818075	5915204	97129	g_31142	g_13292
ptg000028l	5916490	5992660	76170	g_13292	g_3234
ptg000029l	288821	326688	37867	g_24666	g_3354
ptg000029l	327440	520648	193208	g_3354	g_2074
ptg000029l	523615	573786	50171	g_2074	g_37399
ptg000029l	574049	583968	9919	g_37399	g_6048
ptg000029l	584720	594544	9824	g_6048	g_21980
ptg000029l	594978	654362	59384	g_21980	g_23944
ptg000029l	654880	685318	30438	g_23944	g_28337
ptg000029l	686250	706442	20192	g_28337	g_8845
ptg000029l	707773	756856	49083	g_8845	g_29121
ptg000029l	757311	793937	36626	g_29121	g_37029
ptg000029l	795376	837652	42276	g_37029	g_5458
ptg000029l	838185	865659	27474	g_5458	g_21651
ptg000029l	866690	872592	5902	g_21651	g_27053
ptg000029l	873566	902633	29067	g_27053	g_26638
ptg000029l	903679	930940	27261	g_26638	g_31557
ptg000029l	932477	967587	35110	g_31557	g_25830
ptg000029l	968315	968371	56	g_25830	g_11095
ptg000029l	969414	1115017	145603	g_11095	g_38086
ptg000029l	1115787	1355171	239384	g_38086	g_1297
ptg000029l	1366351	1402170	35819	g_1297	g_19301
ptg000029l	1418642	1421852	3210	g_19301	g_7689
ptg000029l	1442286	1489039	46753	g_7689	g_2261
ptg000029l	1489524	1496142	6618	g_2261	g_21766
ptg000029l	1496694	1496834	140	g_21766	g_26731
ptg000029l	1497150	1511395	14245	g_26731	g_28405
ptg000029l	1511706	1512726	1020	g_28405	g_20856
ptg000029l	1525281	1583024	57743	g_20856	g_11804
ptg000029l	1584187	1585184	997	g_11804	g_31022
ptg000029l	1586092	1586716	624	g_31022	g_40153
ptg000029l	1587402	1587849	447	g_40153	g_15807
ptg000029l	1588067	1796890	208823	g_15807	g_34166
ptg000029l	1797912	1872448	74536	g_34166	g_2078
ptg000029l	1872975	2009908	136933	g_2078	g_20020
ptg000029l	2010420	2022032	11612	g_20020	g_31256
ptg000029l	2023402	2056878	33476	g_31256	g_31318
ptg000029l	2077973	2080408	2435	g_31318	g_20132
ptg000029l	2086551	2087386	835	g_20132	g_9265
ptg000029l	2099239	2234395	135156	g_9265	g_5883
ptg000029l	2234928	2310223	75295	g_5883	g_33017
ptg000029l	2310903	2404460	93557	g_33017	g_2405
ptg000029l	2405371	2593805	188434	g_2405	g_6126
ptg000029l	2595030	2713764	118734	g_6126	g_1629
ptg000029l	2732556	2736532	3976	g_39364	g_12505
ptg000029l	2738640	2792266	53626	g_12505	g_25645
ptg000029l	2811910	2819312	7402	g_25645	g_7541
ptg000029l	2820988	2918066	97078	g_7541	g_14166
ptg000029l	2935035	3092923	157888	g_14166	g_28237
ptg000029l	3093465	3140145	46680	g_28237	g_7548
ptg000029l	3140699	3173239	32540	g_7548	g_20783
ptg000029l	3173895	3191428	17533	g_20783	g_18245
ptg000029l	3191937	3192023	86	g_18245	g_36011
ptg000029l	3193489	3323762	130273	g_36011	g_9772
ptg000029l	3323986	3377454	53468	g_9772	g_35969
ptg000029l	3377966	3671478	293512	g_35969	g_12775
ptg000029l	3703361	3715625	12264	g_12775	g_15148
ptg000029l	3741966	3874518	132552	g_15148	g_39126
ptg000029l	3875144	4075287	200143	g_39126	g_5836
ptg000029l	4075772	4122683	46911	g_5836	g_33377
ptg000029l	4123801	4165100	41299	g_33377	g_11177
ptg000029l	4165354	4310684	145330	g_11177	g_21364
ptg000029l	4311310	4507150	195840	g_21364	g_34033
ptg000029l	4508128	4510031	1903	g_34033	g_30349
ptg000029l	4510297	4581535	71238	g_30349	g_2055
ptg000029l	4582350	4603559	21209	g_2055	g_19174
ptg000029l	4604035	4631184	27149	g_19174	g_32182
ptg000029l	4631624	4651884	20260	g_32182	g_14061
ptg000029l	4652657	4701862	49205	g_14061	g_12316
ptg000029l	4720565	4928935	208370	g_12316	g_34613
ptg000029l	4930602	5061111	130509	g_34613	g_14408
ptg000029l	5061410	5061629	219	g_14408	g_2920
ptg000029l	5062069	5074791	12722	g_2920	g_9535
ptg000029l	5075444	5075676	232	g_9535	g_16355
ptg000029l	5076374	5114067	37693	g_16355	g_24412
ptg000029l	5116390	5129930	13540	g_24412	g_31041
ptg000029l	5138011	5190530	52519	g_31041	g_18044
ptg000029l	5203955	5204665	710	g_18044	g_36548
ptg000029l	5205153	5207947	2794	g_36548	g_33891
ptg000029l	5222735	5224437	1702	g_33891	g_18361
ptg000029l	5225513	5232198	6685	g_18361	g_24981
ptg000029l	5242257	5311593	69336	g_24981	g_31244
ptg000029l	5311847	5359547	47700	g_31244	g_13509
ptg000029l	5379276	5383313	4037	g_13509	g_4434
ptg000029l	5384300	5384588	288	g_4434	g_6422
ptg000029l	5386324	5389867	3543	g_6422	g_10308
ptg000029l	5402784	5479953	77169	g_10308	g_12345
ptg000029l	5480804	5481696	892	g_12345	g_4546
ptg000029l	5499892	5505849	5957	g_4546	g_35377
ptg000029l	5566462	5574843	8381	g_35377	g_18332
ptg000029l	5597184	5630510	33326	g_18332	g_31297
ptg000029l	5630761	5688164	57403	g_31297	g_36312
ptg000029l	5689900	5743367	53467	g_36312	g_6537
ptg000029l	5743804	5759136	15332	g_6537	g_36714
ptg000029l	5759345	5796525	37180	g_36714	g_27788
ptg000029l	5796860	5939507	142647	g_27788	g_34245
ptg000029l	5939809	5982396	42587	g_34245	g_4836
ptg000029l	6007179	6082546	75367	g_4836	g_31053
ptg000029l	6083250	6097512	14262	g_31053	g_9531
ptg000029l	6097856	6226941	129085	g_9531	g_25884
ptg000029l	6227441	6343684	116243	g_25884	g_7455
ptg000029l	6346588	6407902	61314	g_7455	g_24848
ptg000029l	6408387	6531017	122630	g_24848	g_37841
ptg000029l	6531985	6542882	10897	g_37841	g_30199
ptg000029l	6543163	6557054	13891	g_30199	g_4356
ptg000029l	6557539	6557581	42	g_4356	g_17332
ptg000029l	6558075	6786103	228028	g_17332	g_15358
ptg000029l	6811295	6814995	3700	g_15358	g_18251
ptg000029l	6829320	6834306	4986	g_18251	g_5929
ptg000029l	6839245	6853682	14437	g_5929	g_5324
ptg000029l	6860180	6963380	103200	g_5324	g_29178
ptg000029l	6963646	7092106	128460	g_29178	g_32059
ptg000029l	7093143	7133151	40008	g_32059	g_29603
ptg000029l	7144494	7199308	54814	g_29603	g_6383
ptg000029l	7199589	7288929	89340	g_6383	g_12725
ptg000029l	7290377	7344921	54544	g_12725	g_23035
ptg000029l	7356090	7362398	6308	g_23035	g_35954
ptg000029l	7363870	7400018	36148	g_35954	g_30870
ptg000029l	7400359	7425909	25550	g_30870	g_21164
ptg000029l	7438166	7491756	53590	g_21164	g_22580
ptg000029l	7493402	7505308	11906	g_22580	g_39548
ptg000029l	7505988	7532023	26035	g_39548	g_9922
ptg000029l	7536763	7599278	62515	g_9922	g_15495
ptg000029l	7601209	7601435	226	g_15495	g_12759
ptg000029l	7601875	7612999	11124	g_12759	g_38255
ptg000029l	7626407	7629673	3266	g_38255	g_11718
ptg000029l	7629879	7665680	35801	g_11718	g_32925
ptg000029l	7670411	7711217	40806	g_32925	g_8881
ptg000029l	7734346	7739216	4870	g_8881	g_16886
ptg000029l	7756326	7776368	20042	g_38738	g_1112
ptg000029l	7786842	7805352	18510	g_1112	g_2392
ptg000029l	7813955	7818260	4305	g_2392	g_11716
ptg000029l	7825809	7832463	6654	g_25494	g_37150
ptg000029l	7856738	7921553	64815	g_37150	g_2859
ptg000029l	7922178	7936693	14515	g_2859	g_12000
ptg000029l	7952408	7960697	8289	g_12000	g_37345
ptg000029l	7960918	7960985	67	g_37345	g_37715
ptg000029l	7966718	7966913	195	g_37715	g_7837
ptg000029l	7975034	7977820	2786	g_7837	g_36313
ptg000029l	7980663	7984966	4303	g_36313	g_13901
ptg000029l	8026176	8055663	29487	g_13901	g_29816
ptg000029l	8057069	8105742	48673	g_29816	g_19791
ptg000029l	8106206	8112945	6739	g_19791	g_32439
ptg000029l	8121161	8137889	16728	g_32439	g_32459
ptg000029l	8139691	8146775	7084	g_32459	g_33601
ptg000029l	8163739	8163795	56	g_33601	g_27306
ptg000029l	8164037	8176019	11982	g_27306	g_3115
ptg000029l	8196547	8221092	24545	g_3115	g_14439
ptg000029l	8221331	8245298	23967	g_14439	g_17112
ptg000029l	8251318	8261424	10106	g_17112	g_24884
ptg000029l	8262329	8268470	6141	g_24884	g_11475
ptg000029l	8277463	8286669	9206	g_11475	g_31666
ptg000029l	8287367	8297703	10336	g_31666	g_7424
ptg000029l	8303266	8304614	1348	g_7424	g_28174
ptg000029l	8310804	8313158	2354	g_28174	g_29277
ptg000029l	8316042	8319339	3297	g_29277	g_12547
ptg000029l	8321008	8328895	7887	g_12547	g_14350
ptg000029l	8340737	8341984	1247	g_14350	g_9677
ptg000029l	8347422	8351192	3770	g_9677	g_25030
ptg000029l	8356937	8380977	24040	g_25030	g_37879
ptg000029l	8400658	8407279	6621	g_37879	g_17082
ptg000029l	8415777	8416521	744	g_17082	g_22506
ptg000029l	8423502	8440514	17012	g_22506	g_29660
ptg000029l	8464024	8467068	3044	g_29660	g_13089
ptg000029l	8477197	8480910	3713	g_13089	g_34737
ptg000029l	8487698	8489384	1686	g_34737	g_38261
ptg000029l	8521272	8533965	12693	g_38261	g_14123
ptg000029l	8543039	8554973	11934	g_14123	g_32087
ptg000029l	8563045	8647454	84409	g_32087	g_32114
ptg000029l	8657563	8681305	23742	g_32114	g_31218
ptg000029l	8688649	8838027	149378	g_31218	g_27185
ptg000029l	8838290	8928823	90533	g_27185	g_30548
ptg000029l	8933437	9035217	101780	g_30548	g_10221
ptg000029l	9036059	9077453	41394	g_10221	g_23007
ptg000029l	9077674	9133378	55704	g_23007	g_9278
ptg000029l	9152617	9186826	34209	g_9278	g_31690
ptg000029l	9191091	9346485	155394	g_31690	g_11849
ptg000029l	9357141	9357838	697	g_11849	g_896
ptg000029l	9363510	9364446	936	g_896	g_20163
ptg000029l	9369658	9371631	1973	g_20163	g_3077
ptg000029l	9380841	9433190	52349	g_3077	g_38234
ptg000029l	9456448	9636950	180502	g_38234	g_2889
ptg000029l	9637237	9657909	20672	g_2889	g_39572
ptg000029l	9659382	9675145	15763	g_9812	g_9998
ptg000029l	9688500	9721962	33462	g_9998	g_10519
ptg000029l	9730395	9733509	3114	g_10519	g_10373
ptg000029l	9743396	9744574	1178	g_10373	g_4680
ptg000029l	9751392	9755453	4061	g_4680	g_28988
ptg000029l	9755686	9758402	2716	g_28988	g_37938
ptg000029l	9778676	9798230	19554	g_37938	g_33746
ptg000029l	9801494	9804351	2857	g_33746	g_35247
ptg000029l	9806100	9810023	3923	g_35247	g_23238
ptg000029l	9813763	9819809	6046	g_23238	g_10773
ptg000029l	9825286	10003204	177918	g_10773	g_36697
ptg000029l	10004478	10067038	62560	g_36697	g_28826
ptg000029l	10112386	10117266	4880	g_28826	g_26879
ptg000029l	10117781	10128704	10923	g_26879	g_99
ptg000029l	10129387	10187846	58459	g_99	g_33610
ptg000029l	10188985	10193993	5008	g_33610	g_30724
ptg000029l	10219629	10235935	16306	g_30724	g_7536
ptg000029l	10237548	10307205	69657	g_7536	g_2830
ptg000029l	10308761	10475054	166293	g_2830	g_3677
ptg000029l	10493246	10506884	13638	g_3677	g_34733
ptg000029l	10512496	10518512	6016	g_34733	g_31460
ptg000029l	10528269	10553008	24739	g_31460	g_8552
ptg000029l	10558306	10611786	53480	g_8552	g_36043
ptg000029l	10612025	10680130	68105	g_36043	g_6571
ptg000029l	10680369	10698670	18301	g_6571	g_28234
ptg000030l	31649	109154	77505	g_34086	g_32869
ptg000030l	116898	124111	7213	g_32869	g_24618
ptg000030l	151299	169458	18159	g_24618	g_33904
ptg000030l	188500	222235	33735	g_33904	g_1914
ptg000030l	223101	230008	6907	g_1914	g_33743
ptg000030l	230925	234747	3822	g_33743	g_30650
ptg000030l	237800	246937	9137	g_30650	g_34440
ptg000030l	270632	274934	4302	g_34440	g_28945
ptg000030l	308420	310375	1955	g_28945	g_23916
ptg000030l	312735	324374	11639	g_23916	g_19142
ptg000030l	348084	428937	80853	g_19142	g_6151
ptg000030l	429380	441823	12443	g_6151	g_29822
ptg000030l	442206	442689	483	g_29822	g_31129
ptg000030l	446369	457298	10929	g_31129	g_29790
ptg000030l	458017	465933	7916	g_29790	g_28873
ptg000031l	27949	32760	4811	g_39853	g_29625
ptg000031l	38252	169440	131188	g_29625	g_37071
ptg000031l	169712	174219	4507	g_37071	g_28145
ptg000031l	192773	195373	2600	g_28145	g_31877
ptg000031l	202244	232281	30037	g_31877	g_26877
ptg000031l	239393	243479	4086	g_26877	g_34059
ptg000031l	269178	403533	134355	g_34059	g_488
ptg000031l	404627	446578	41951	g_38718	g_6678
ptg000031l	448356	459935	11579	g_6678	g_33057
ptg000031l	479061	481567	2506	g_33057	g_32084
ptg000031l	503699	512651	8952	g_32084	g_11497
ptg000031l	517212	521009	3797	g_11497	g_30941
ptg000031l	525440	527447	2007	g_30941	g_38320
ptg000031l	548205	551971	3766	g_38320	g_1736
ptg000031l	554078	556653	2575	g_1736	g_36551
ptg000031l	557306	561257	3951	g_36551	g_36288
ptg000032l	201858	213375	11517	g_22972	g_2721
ptg000032l	226606	344508	117902	g_2721	g_16759
ptg000032l	348143	350559	2416	g_16759	g_37065
ptg000032l	351917	352366	449	g_37065	g_12879
ptg000032l	353430	356360	2930	g_12879	g_9209
ptg000032l	356659	356867	208	g_9209	g_33139
ptg000032l	357460	439915	82455	g_33139	g_17217
ptg000032l	440403	440440	37	g_17217	g_34171
ptg000032l	440754	442611	1857	g_34171	g_5227
ptg000032l	444080	522480	78400	g_5227	g_25489
ptg000032l	523373	556528	33155	g_25489	g_27388
ptg000032l	556947	558711	1764	g_27388	g_4819
ptg000032l	558932	558989	57	g_4819	g_280
ptg000032l	559198	639443	80245	g_280	g_1097
ptg000032l	639832	639971	139	g_1097	g_27893
ptg000032l	640390	640456	66	g_27893	g_7390
ptg000032l	640962	765649	124687	g_7390	g_4959
ptg000032l	766074	1099457	333383	g_4959	g_32299
ptg000032l	1099807	1109622	9815	g_32299	g_18316
ptg000032l	1109969	1141536	31567	g_18316	g_1056
ptg000032l	1142489	1263167	120678	g_1056	g_32682
ptg000032l	1264648	1286092	21444	g_32682	g_1949
ptg000032l	1308402	1321298	12896	g_20815	g_9021
ptg000032l	1321867	1322386	519	g_9021	g_7336
ptg000032l	1339898	1349172	9274	g_7336	g_7357
ptg000032l	1372593	1409676	37083	g_7357	g_10736
ptg000032l	1411729	1416915	5186	g_10736	g_35580
ptg000032l	1417193	1417492	299	g_35580	g_37245
ptg000032l	1422432	1427145	4713	g_37245	g_15929
ptg000032l	1463335	1475594	12259	g_15929	g_14985
ptg000032l	1475960	1511075	35115	g_14985	g_19039
ptg000032l	1520126	1521238	1112	g_19039	g_32260
ptg000032l	1524269	1527365	3096	g_32260	g_14312
ptg000032l	1540180	1543771	3591	g_39983	g_4814
ptg000032l	1557780	1570046	12266	g_4814	g_32068
ptg000032l	1575504	1609200	33696	g_32068	g_26868
ptg000032l	1625541	1631945	6404	g_26868	g_19932
ptg000032l	1633467	1643324	9857	g_19932	g_3549
ptg000032l	1643599	1643775	176	g_3549	g_34018
ptg000032l	1648733	1648929	196	g_34018	g_37
ptg000032l	1651588	1653584	1996	g_37	g_14055
ptg000032l	1656533	1658465	1932	g_14055	g_24871
ptg000032l	1663886	1699403	35517	g_24871	g_9711
ptg000034l	39208	390332	351124	g_22519	g_3971
ptg000034l	390781	402805	12024	g_3971	g_28203
ptg000034l	403308	403425	117	g_28203	g_35990
ptg000034l	404024	418006	13982	g_35990	g_16243
ptg000034l	423758	438192	14434	g_16243	g_33464
ptg000034l	441039	442962	1923	g_33464	g_19795
ptg000034l	444554	473039	28485	g_19795	g_22319
ptg000034l	473338	588239	114901	g_22319	g_7772
ptg000034l	588451	640608	52157	g_7772	g_1010
ptg000034l	640826	651267	10441	g_1010	g_37435
ptg000034l	654823	668721	13898	g_37435	g_26187
ptg000034l	684861	687245	2384	g_26187	g_21361
ptg000034l	705141	754905	49764	g_21361	g_369
ptg000034l	758522	825467	66945	g_369	g_13874
ptg000034l	827452	841328	13876	g_13874	g_2159
ptg000034l	859611	863011	3400	g_2159	g_18834
ptg000034l	878684	966243	87559	g_18834	g_6041
ptg000034l	966575	1006273	39698	g_6041	g_1621
ptg000034l	1015556	1116497	100941	g_1621	g_21938
ptg000034l	1116733	1118718	1985	g_21938	g_4267
ptg000034l	1119029	1145184	26155	g_4267	g_5904
ptg000034l	1146014	1159398	13384	g_5904	g_29653
ptg000034l	1160315	1160789	474	g_29653	g_34513
ptg000034l	1161307	1243956	82649	g_34513	g_22812
ptg000034l	1244399	1244618	219	g_22812	g_25223
ptg000034l	1244935	1257403	12468	g_25223	g_4131
ptg000034l	1257846	1326049	68203	g_4131	g_13775
ptg000034l	1331611	1401871	70260	g_13775	g_7920
ptg000034l	1402089	1534976	132887	g_7920	g_13005
ptg000034l	1535317	1544245	8928	g_13005	g_33606
ptg000034l	1544448	1665918	121470	g_33606	g_29644
ptg000034l	1677346	1734960	57614	g_29644	g_29515
ptg000034l	1736036	1745686	9650	g_29515	g_11172
ptg000034l	1745985	1760855	14870	g_11172	g_25540
ptg000034l	1761304	1820090	58786	g_25540	g_32393
ptg000034l	1820512	1834107	13595	g_32393	g_3101
ptg000034l	1839275	1870920	31645	g_3101	g_24569
ptg000034l	1890347	1924136	33789	g_24569	g_16476
ptg000034l	1925761	1933448	7687	g_16476	g_185
ptg000034l	1936439	1987881	51442	g_185	g_1458
ptg000034l	1994507	1999216	4709	g_1458	g_20989
ptg000034l	2006825	2008795	1970	g_20989	g_2324
ptg000034l	2019098	2040056	20958	g_2324	g_16740
ptg000034l	2041387	2047773	6386	g_16740	g_26206
ptg000034l	2054576	2124093	69517	g_26206	g_16747
ptg000034l	2124419	2194302	69883	g_16747	g_3298
ptg000034l	2194613	2228633	34020	g_3298	g_32742
ptg000034l	2252096	2275548	23452	g_32742	g_7116
ptg000034l	2277650	2302916	25266	g_7116	g_5530
ptg000034l	2321160	2327316	6156	g_5530	g_14393
ptg000034l	2327573	2331365	3792	g_14393	g_36402
ptg000034l	2332654	2346189	13535	g_36402	g_27681
ptg000034l	2362289	2366760	4471	g_27681	g_4568
ptg000034l	2395621	2397312	1691	g_4568	g_17498
ptg000034l	2397695	2424942	27247	g_17498	g_20287
ptg000034l	2425617	2434287	8670	g_20287	g_40207
ptg000034l	2444257	2447070	2813	g_40207	g_5378
ptg000034l	2455622	2461352	5730	g_5378	g_21054
ptg000034l	2461657	2471610	9953	g_21054	g_3420
ptg000034l	2472587	2475052	2465	g_3420	g_4078
ptg000034l	2475603	2486441	10838	g_4078	g_4314
ptg000034l	2496130	2519961	23831	g_4314	g_10134
ptg000034l	2521142	2524840	3698	g_10134	g_23056
ptg000034l	2525079	2526186	1107	g_23056	g_25029
ptg000034l	2526407	2554253	27846	g_25029	g_20583
ptg000034l	2554870	2598171	43301	g_20583	g_24820
ptg000034l	2608513	2650964	42451	g_24820	g_28554
ptg000034l	2657909	2669666	11757	g_28554	g_1937
ptg000034l	2670370	2748834	78464	g_1937	g_4907
ptg000034l	2750719	2826952	76233	g_4907	g_9378
ptg000034l	2850587	2852225	1638	g_9378	g_4070
ptg000034l	2912061	3070469	158408	g_4070	g_12280
ptg000034l	3070870	3193678	122808	g_12280	g_29357
ptg000034l	3215779	3218072	2293	g_29357	g_31512
ptg000034l	3229304	3287927	58623	g_31512	g_28500
ptg000034l	3288643	3332515	43872	g_28500	g_6179
ptg000034l	3332859	3343399	10540	g_6179	g_28437
ptg000034l	3343749	3405675	61926	g_28437	g_34600
ptg000034l	3406373	3488246	81873	g_34600	g_20739
ptg000034l	3489320	3497470	8150	g_20739	g_32926
ptg000034l	3498018	3543104	45086	g_32926	g_26103
ptg000034l	3547898	3606132	58234	g_26103	g_14161
ptg000034l	3608238	3682446	74208	g_14161	g_26137
ptg000034l	3685975	3717218	31243	g_26137	g_14664
ptg000034l	3724764	3726656	1892	g_14664	g_12021
ptg000034l	3747500	3763806	16306	g_12021	g_16989
ptg000034l	3767709	3769017	1308	g_16989	g_31574
ptg000034l	3769977	3770626	649	g_31574	g_6783
ptg000034l	3783121	3809500	26379	g_6783	g_34556
ptg000034l	3809766	3812819	3053	g_34556	g_480
ptg000034l	3845623	3863207	17584	g_480	g_35175
ptg000034l	3863698	3876188	12490	g_35175	g_36549
ptg000034l	3876973	3879669	2696	g_36549	g_6970
ptg000034l	3881801	3896105	14304	g_6970	g_33676
ptg000034l	3896608	3930950	34342	g_33676	g_20192
ptg000034l	3941851	3943723	1872	g_20192	g_13394
ptg000034l	3949065	3954699	5634	g_13394	g_30230
ptg000034l	3989170	4007999	18829	g_30230	g_19990
ptg000034l	4009886	4052977	43091	g_19990	g_10708
ptg000034l	4056550	4066539	9989	g_10708	g_22952
ptg000034l	4075349	4105472	30123	g_22952	g_4379
ptg000034l	4106981	4326976	219995	g_4379	g_9484
ptg000034l	4337169	4369809	32640	g_9484	g_34101
ptg000034l	4370063	4428319	58256	g_34101	g_26858
ptg000034l	4429155	4559834	130679	g_26858	g_14222
ptg000034l	4570432	4800516	230084	g_14222	g_34446
ptg000034l	4808922	4809298	376	g_34446	g_13699
ptg000034l	4811076	4940190	129114	g_13699	g_15292
ptg000034l	4941164	5020491	79327	g_15292	g_7835
ptg000034l	5032638	5045416	12778	g_7835	g_9019
ptg000034l	5053343	5064163	10820	g_9019	g_15005
ptg000034l	5064966	5131130	66164	g_15005	g_5969
ptg000034l	5131645	5211004	79359	g_5969	g_17653
ptg000034l	5233022	5237509	4487	g_17653	g_35741
ptg000034l	5248491	5251993	3502	g_35741	g_18521
ptg000034l	5254930	5266363	11433	g_18521	g_7780
ptg000034l	5273851	5279443	5592	g_7780	g_2995
ptg000034l	5284267	5286019	1752	g_2995	g_3136
ptg000034l	5307868	5341163	33295	g_3136	g_19237
ptg000034l	5346510	5351197	4687	g_19237	g_13516
ptg000034l	5355293	5360904	5611	g_13516	g_10972
ptg000034l	5366941	5402437	35496	g_10972	g_37240
ptg000034l	5403453	5443175	39722	g_37240	g_18421
ptg000034l	5447485	5519969	72484	g_18421	g_7121
ptg000034l	5520736	5539582	18846	g_7121	g_24614
ptg000034l	5540106	5659210	119104	g_24614	g_26390
ptg000034l	5659425	5671197	11772	g_26390	g_3432
ptg000034l	5671481	5749433	77952	g_3432	g_19494
ptg000034l	5749744	5851294	101550	g_19494	g_13672
ptg000034l	5851823	5909064	57241	g_13672	g_30004
ptg000034l	5924841	5933782	8941	g_30004	g_14993
ptg000034l	5939211	5948853	9642	g_14993	g_31535
ptg000034l	5961622	5963855	2233	g_31535	g_3533
ptg000034l	5966817	5977805	10988	g_3533	g_22125
ptg000034l	5978605	5998537	19932	g_22125	g_29979
ptg000034l	5999875	6059882	60007	g_29979	g_18871
ptg000034l	6061273	6116418	55145	g_18871	g_18
ptg000034l	6120325	6126722	6397	g_18	g_22713
ptg000034l	6151005	6231566	80561	g_22713	g_15584
ptg000034l	6236319	6243786	7467	g_15584	g_18180
ptg000034l	6246762	6293359	46597	g_18180	g_13821
ptg000034l	6301297	6303015	1718	g_13821	g_37011
ptg000034l	6303389	6305114	1725	g_37011	g_26992
ptg000034l	6307893	6309749	1856	g_26992	g_33447
ptg000034l	6320501	6367569	47068	g_33447	g_17035
ptg000034l	6386245	6523309	137064	g_17035	g_31934
ptg000034l	6523923	6555155	31232	g_31934	g_27733
ptg000034l	6572635	6577617	4982	g_27733	g_8295
ptg000034l	6586908	6690721	103813	g_8295	g_3874
ptg000034l	6691167	6807921	116754	g_3874	g_11408
ptg000034l	6815784	6935170	119386	g_11408	g_2728
ptg000034l	6939937	7173794	233857	g_2728	g_29305
ptg000034l	7175933	7219443	43510	g_29305	g_10695
ptg000034l	7220003	7294275	74272	g_10695	g_14010
ptg000034l	7294604	7358874	64270	g_14010	g_16943
ptg000034l	7359646	7368017	8371	g_16943	g_6358
ptg000034l	7368853	7372198	3345	g_6358	g_9637
ptg000034l	7373190	7389044	15854	g_9637	g_14866
ptg000034l	7396545	7468571	72026	g_14866	g_31131
ptg000034l	7471684	7596093	124409	g_31131	g_4262
ptg000034l	7596509	7634791	38282	g_4262	g_39331
ptg000034l	7635009	7639506	4497	g_39331	g_2424
ptg000034l	7640867	7663000	22133	g_2424	g_13265
ptg000034l	7666333	7666682	349	g_13265	g_32911
ptg000034l	7672762	7689417	16655	g_32911	g_17557
ptg000034l	7707296	7767912	60616	g_17557	g_12559
ptg000034l	7782033	7811150	29117	g_12559	g_3649
ptg000034l	7815535	7853194	37659	g_3649	g_26610
ptg000034l	7857981	7913595	55614	g_26610	g_7179
ptg000034l	7920212	7922486	2274	g_7179	g_17481
ptg000034l	7925403	7997659	72256	g_17481	g_8254
ptg000034l	8021227	8029991	8764	g_8254	g_33047
ptg000034l	8037524	8044234	6710	g_33047	g_5373
ptg000034l	8056700	8091324	34624	g_5373	g_1435
ptg000034l	8092938	8098253	5315	g_1435	g_19121
ptg000034l	8122058	8138068	16010	g_19121	g_37172
ptg000034l	8141407	8143228	1821	g_37172	g_12132
ptg000034l	8154840	8159375	4535	g_12132	g_23288
ptg000034l	8182301	8230586	48285	g_23288	g_4190
ptg000034l	8235424	8453383	217959	g_4190	g_6365
ptg000034l	8454126	8584080	129954	g_6365	g_20922
ptg000034l	8676802	8741527	64725	g_20922	g_21101
ptg000034l	8741775	8826257	84482	g_21101	g_15345
ptg000034l	8826544	8829315	2771	g_15345	g_28372
ptg000034l	8830502	9058644	228142	g_28372	g_8434
ptg000034l	9060095	9068073	7978	g_8434	g_28937
ptg000034l	9068699	9298877	230178	g_28937	g_3173
ptg000034l	9302149	9302244	95	g_3173	g_39959
ptg000034l	9303239	9326701	23462	g_39959	g_13831
ptg000034l	9327168	9358007	30839	g_13831	g_4662
ptg000034l	9358300	9364569	6269	g_4662	g_17443
ptg000034l	9387821	9407911	20090	g_17443	g_32908
ptg000034l	9416472	9456842	40370	g_39337	g_25158
ptg000034l	9457210	9460882	3672	g_25158	g_18010
ptg000034l	9474386	9478739	4353	g_18010	g_13501
ptg000034l	9480649	9497334	16685	g_13501	g_14550
ptg000034l	9497561	9684075	186514	g_14550	g_3784
ptg000034l	9696943	9708327	11384	g_3784	g_26475
ptg000034l	9716992	9775345	58353	g_26475	g_2262
ptg000034l	9780877	9784051	3174	g_2262	g_29105
ptg000034l	9784881	9797593	12712	g_29105	g_25266
ptg000034l	9821956	9824073	2117	g_25266	g_10883
ptg000034l	9827708	9838810	11102	g_10883	g_17758
ptg000034l	9849327	9917846	68519	g_17758	g_10126
ptg000034l	9985000	10030978	45978	g_10126	g_17684
ptg000034l	10043097	10046830	3733	g_17684	g_23925
ptg000034l	10063928	10079293	15365	g_23925	g_4480
ptg000034l	10090089	10090842	753	g_4480	g_23710
ptg000034l	10096074	10101174	5100	g_23710	g_3658
ptg000034l	10103180	10108935	5755	g_3658	g_9454
ptg000034l	10122875	10125153	2278	g_9454	g_19079
ptg000034l	10126678	10142151	15473	g_19079	g_13223
ptg000034l	10154169	10161428	7259	g_13223	g_25761
ptg000034l	10181609	10192293	10684	g_25761	g_19021
ptg000034l	10192775	10208727	15952	g_19021	g_9876
ptg000034l	10209419	10217023	7604	g_9876	g_9790
ptg000034l	10241250	10371605	130355	g_9790	g_12247
ptg000034l	10371817	10431057	59240	g_12247	g_27374
ptg000034l	10431260	10434968	3708	g_27374	g_34285
ptg000034l	10435171	10509608	74437	g_34285	g_25752
ptg000034l	10511641	10610847	99206	g_25752	g_32236
ptg000034l	10613564	10836133	222569	g_32236	g_14471
ptg000034l	10846280	10849106	2826	g_14471	g_20370
ptg000034l	10858457	10860570	2113	g_20370	g_5026
ptg000034l	10867556	10871037	3481	g_30929	g_25626
ptg000034l	10871846	10891251	19405	g_25626	g_32040
ptg000034l	10894612	10957224	62612	g_32040	g_32642
ptg000034l	10960307	10963069	2762	g_32642	g_11304
ptg000034l	10968417	10973442	5025	g_11304	g_16340
ptg000034l	10987052	10994100	7048	g_16340	g_13849
ptg000034l	10997093	10998932	1839	g_13849	g_6429
ptg000034l	11002678	11014311	11633	g_6429	g_25270
ptg000034l	11027513	11028819	1306	g_25270	g_35192
ptg000034l	11029139	11033253	4114	g_35192	g_26431
ptg000034l	11035602	11039173	3571	g_26431	g_26628
ptg000034l	11040118	11050307	10189	g_26628	g_21234
ptg000034l	11051256	11061047	9791	g_21234	g_13105
ptg000034l	11075695	11078043	2348	g_13105	g_2545
ptg000034l	11086030	11089921	3891	g_2545	g_27821
ptg000034l	11092220	11178005	85785	g_27821	g_28432
ptg000034l	11185848	11198559	12711	g_28432	g_32578
ptg000034l	11211231	11232851	21620	g_32578	g_16682
ptg000034l	11254860	11268742	13882	g_16682	g_11004
ptg000034l	11283002	11284930	1928	g_11004	g_12773
ptg000034l	11289161	11290520	1359	g_12773	g_36040
ptg000034l	11300903	11304413	3510	g_36040	g_4647
ptg000034l	11307876	11317539	9663	g_4647	g_4036
ptg000034l	11318636	11385752	67116	g_4036	g_3642
ptg000034l	11406550	11429769	23219	g_3642	g_26901
ptg000034l	11432157	11438546	6389	g_26901	g_24914
ptg000034l	11453106	11463990	10884	g_24914	g_13258
ptg000034l	11468082	11471115	3033	g_13258	g_6253
ptg000034l	11476242	11505208	28966	g_6253	g_33774
ptg000034l	11517739	11520887	3148	g_33774	g_7829
ptg000034l	11541156	11546737	5581	g_7829	g_9602
ptg000034l	11558193	11659351	101158	g_9602	g_23327
ptg000034l	11679919	11727942	48023	g_23327	g_30200
ptg000034l	11728544	11842772	114228	g_30200	g_11665
ptg000034l	11862287	11970666	108379	g_11665	g_33050
ptg000034l	11971565	12043237	71672	g_33050	g_2186
ptg000034l	12043506	12044689	1183	g_2186	g_7114
ptg000034l	12045048	12050550	5502	g_7114	g_20359
ptg000034l	12051353	12319372	268019	g_20359	g_4481
ptg000034l	12337015	12464924	127909	g_4481	g_34028
ptg000034l	12465937	12525654	59717	g_34028	g_2982
ptg000034l	12529620	12530658	1038	g_2982	g_29984
ptg000034l	12532467	12539697	7230	g_29984	g_12839
ptg000034l	12540932	12582456	41524	g_12839	g_597
ptg000034l	12586712	12615077	28365	g_597	g_19025
ptg000034l	12615592	12619153	3561	g_19025	g_16931
ptg000034l	12620178	12620310	132	g_16931	g_18849
ptg000034l	12621425	12626309	4884	g_18849	g_16670
ptg000034l	12626873	12670431	43558	g_16670	g_10291
ptg000034l	12671225	12671357	132	g_10291	g_18648
ptg000034l	12672472	12677459	4987	g_18648	g_12502
ptg000034l	12681706	12717906	36200	g_12502	g_34324
ptg000034l	12721779	12722784	1005	g_34324	g_31750
ptg000034l	12728305	12953004	224699	g_31750	g_7797
ptg000034l	12963919	12991763	27844	g_7797	g_5555
ptg000034l	13003000	13053848	50848	g_5555	g_37582
ptg000034l	13055560	13095987	40427	g_37582	g_21455
ptg000034l	13096595	13224588	127993	g_21455	g_40059
ptg000034l	13244051	13249547	5496	g_40059	g_8801
ptg000034l	13254530	13268923	14393	g_8801	g_27184
ptg000034l	13272949	13277457	4508	g_27184	g_18119
ptg000034l	13277699	13363484	85785	g_18119	g_34224
ptg000034l	13369205	13458200	88995	g_34224	g_14292
ptg000034l	13459763	13465760	5997	g_14292	g_8323
ptg000034l	13474595	13478670	4075	g_8323	g_33920
ptg000034l	13488748	13498979	10231	g_33920	g_20258
ptg000034l	13508626	13546187	37561	g_20258	g_35290
ptg000034l	13549510	13570024	20514	g_35290	g_38205
ptg000034l	13574585	13656327	81742	g_38205	g_27674
ptg000034l	13661691	13669814	8123	g_27674	g_9299
ptg000034l	13682508	13708520	26012	g_9299	g_6544
ptg000034l	13708807	13722501	13694	g_6544	g_34770
ptg000034l	13746756	13795394	48638	g_34770	g_16692
ptg000034l	13799945	13810700	10755	g_16692	g_13805
ptg000034l	13813878	13814612	734	g_13805	g_18389
ptg000034l	13816335	13818864	2529	g_18389	g_16851
ptg000034l	13825346	13833483	8137	g_16851	g_35275
ptg000034l	13837377	13839835	2458	g_35275	g_29041
ptg000034l	13851944	13929572	77628	g_29041	g_23303
ptg000034l	13931146	13966237	35091	g_23303	g_22864
ptg000034l	13989306	14010863	21557	g_22864	g_22442
ptg000034l	14037117	14041909	4792	g_22442	g_10930
ptg000034l	14042922	14121076	78154	g_10930	g_38917
ptg000034l	14124029	14168493	44464	g_14279	g_36060
ptg000034l	14170302	14171439	1137	g_36060	g_30285
ptg000034l	14176307	14186546	10239	g_30285	g_31455
ptg000034l	14201136	14296017	94881	g_31455	g_30486
ptg000034l	14304735	14309903	5168	g_30486	g_13026
ptg000034l	14323820	14331114	7294	g_13026	g_37524
ptg000034l	14332442	14334533	2091	g_37524	g_13634
ptg000034l	14337610	14339476	1866	g_13634	g_8173
ptg000034l	14347335	14400851	53516	g_8173	g_16156
ptg000034l	14404314	14407135	2821	g_16156	g_14760
ptg000034l	14411399	14414182	2783	g_14760	g_29057
ptg000034l	14419091	14429417	10326	g_29057	g_37520
ptg000034l	14437257	14441830	4573	g_37520	g_9294
ptg000034l	14462866	14510534	47668	g_9294	g_36030
ptg000034l	14514525	14526572	12047	g_36030	g_11544
ptg000034l	14528881	14542142	13261	g_11544	g_9508
ptg000034l	14546825	14551962	5137	g_9508	g_18680
ptg000034l	14557798	14561665	3867	g_18680	g_19713
ptg000034l	14569404	14572980	3576	g_19713	g_863
ptg000034l	14573303	14581303	8000	g_863	g_28089
ptg000034l	14585795	14604855	19060	g_28089	g_1523
ptg000034l	14605175	14605631	456	g_1523	g_22
ptg000034l	14621310	14676632	55322	g_22	g_27086
ptg000034l	14680507	14682950	2443	g_27086	g_10444
ptg000034l	14687877	14689864	1987	g_10444	g_15560
ptg000034l	14694394	14697133	2739	g_15560	g_36208
ptg000034l	14697682	14699388	1706	g_36208	g_30935
ptg000034l	14699958	14704477	4519	g_30935	g_40275
ptg000034l	14705064	14756533	51469	g_40275	g_36481
ptg000034l	14767119	14794299	27180	g_36481	g_29064
ptg000034l	14800817	14802690	1873	g_29064	g_12104
ptg000034l	14805806	14806653	847	g_12104	g_37752
ptg000034l	14819809	14822282	2473	g_37752	g_4156
ptg000034l	14826147	14827668	1521	g_4156	g_7884
ptg000034l	14841199	14882418	41219	g_7884	g_17537
ptg000034l	14887589	14900793	13204	g_17537	g_3928
ptg000034l	14901613	14947568	45955	g_3928	g_26741
ptg000034l	14966533	14984232	17699	g_26741	g_3936
ptg000034l	14999955	15014533	14578	g_3936	g_27979
ptg000034l	15018581	15038550	19969	g_27979	g_7897
ptg000034l	15042370	15045559	3189	g_7897	g_3019
ptg000034l	15049616	15051249	1633	g_3019	g_22646
ptg000034l	15057062	15083104	26042	g_22646	g_25992
ptg000034l	15103053	15107001	3948	g_25992	g_4260
ptg000034l	15126311	15128324	2013	g_4260	g_9259
ptg000034l	15131660	15166930	35270	g_9259	g_20848
ptg000034l	15187630	15406182	218552	g_20848	g_27530
ptg000034l	15409154	15410682	1528	g_27530	g_27628
ptg000034l	15413843	15432539	18696	g_27628	g_32894
ptg000034l	15432817	15433328	511	g_32894	g_39801
ptg000034l	15433570	15438765	5195	g_39801	g_18434
ptg000034l	15444107	15449616	5509	g_18434	g_3210
ptg000034l	15455735	15568220	112485	g_3210	g_17391
ptg000034l	15568420	15633007	64587	g_17391	g_35911
ptg000034l	15633354	15641432	8078	g_35911	g_406
ptg000034l	15643252	15722255	79003	g_406	g_24735
ptg000034l	15722485	15727606	5121	g_24735	g_16806
ptg000034l	15742457	15755072	12615	g_38949	g_18579
ptg000034l	15756715	15781627	24912	g_18579	g_7709
ptg000034l	15787275	15801875	14600	g_7709	g_22048
ptg000034l	15806890	15807564	674	g_22048	g_35043
ptg000034l	15815623	15820505	4882	g_35043	g_23075
ptg000034l	15840113	15848900	8787	g_23075	g_18209
ptg000034l	15862630	15871106	8476	g_18209	g_11870
ptg000034l	15876619	15972593	95974	g_11870	g_30103
ptg000034l	15973482	15975676	2194	g_30103	g_35018
ptg000034l	15981572	16037943	56371	g_35018	g_20945
ptg000034l	16038866	16043867	5001	g_20945	g_37075
ptg000034l	16047212	16076274	29062	g_37075	g_37209
ptg000034l	16076555	16130763	54208	g_37209	g_13973
ptg000034l	16210613	16354241	143628	g_13973	g_7139
ptg000034l	16354561	16359466	4905	g_7139	g_26911
ptg000034l	16384834	16389912	5078	g_26911	g_670
ptg000034l	16402157	16403832	1675	g_670	g_8503
ptg000034l	16407287	16427635	20348	g_8503	g_27017
ptg000034l	16431564	16435182	3618	g_27017	g_31271
ptg000034l	16438575	16463400	24825	g_31271	g_25497
ptg000034l	16483542	16699165	215623	g_25497	g_31195
ptg000034l	16706274	16711548	5274	g_31195	g_20500
ptg000034l	16714211	16716963	2752	g_20500	g_36135
ptg000034l	16722966	16727262	4296	g_36135	g_3932
ptg000034l	16746451	16750576	4125	g_3932	g_4708
ptg000034l	16770499	16799719	29220	g_4708	g_21388
ptg000034l	16803953	16805596	1643	g_21388	g_5671
ptg000034l	16807038	16809588	2550	g_5671	g_24323
ptg000034l	16813911	16815495	1584	g_24323	g_8468
ptg000034l	16816811	16822417	5606	g_8468	g_33330
ptg000034l	16846209	16878707	32498	g_33330	g_5404
ptg000034l	16888959	16901565	12606	g_5404	g_37962
ptg000034l	16905036	16912831	7795	g_37962	g_9432
ptg000034l	16915786	16935469	19683	g_10024	g_10066
ptg000034l	16935771	16940147	4376	g_10066	g_38321
ptg000034l	16950976	16953949	2973	g_38321	g_34660
ptg000034l	16954734	16991728	36994	g_34660	g_26321
ptg000034l	16992935	17054183	61248	g_26321	g_34516
ptg000034l	17066590	17074617	8027	g_34516	g_39488
ptg000034l	17083685	17086770	3085	g_8693	g_36571
ptg000034l	17101719	17198735	97016	g_36571	g_28662
ptg000034l	17215588	17219687	4099	g_28662	g_1362
ptg000034l	17227839	17319945	92106	g_1362	g_25325
ptg000034l	17326955	17334848	7893	g_25325	g_37294
ptg000034l	17339342	17340313	971	g_37294	g_34743
ptg000034l	17348515	17353164	4649	g_34743	g_35486
ptg000034l	17360090	17388487	28397	g_35486	g_7241
ptg000034l	17391961	17396625	4664	g_7241	g_30019
ptg000034l	17403697	17411958	8261	g_30019	g_6093
ptg000034l	17415630	17417437	1807	g_6093	g_23760
ptg000034l	17419540	17423946	4406	g_23760	g_18198
ptg000034l	17425616	17434961	9345	g_18198	g_14703
ptg000034l	17439041	17440578	1537	g_14703	g_21229
ptg000034l	17448355	17449085	730	g_21229	g_36954
ptg000034l	17452868	17455460	2592	g_36954	g_10674
ptg000034l	17465820	17502625	36805	g_10674	g_16310
ptg000034l	17508471	17514710	6239	g_16310	g_7487
ptg000034l	17527667	17532968	5301	g_7487	g_3756
ptg000034l	17534386	17549073	14687	g_3756	g_18803
ptg000034l	17549408	17562425	13017	g_18803	g_18471
ptg000034l	17563873	17569373	5500	g_18471	g_35179
ptg000034l	17569975	17576945	6970	g_35179	g_1456
ptg000034l	17579568	17584028	4460	g_1456	g_23813
ptg000034l	17598187	17604310	6123	g_23813	g_6387
ptg000034l	17611246	17613867	2621	g_6387	g_4622
ptg000034l	17628670	17631077	2407	g_4622	g_12401
ptg000034l	17632996	17645832	12836	g_12401	g_3409
ptg000034l	17664900	17689802	24902	g_3409	g_16048
ptg000034l	17700807	17702263	1456	g_16048	g_776
ptg000034l	17702523	17727636	25113	g_776	g_9718
ptg000034l	17732379	17735713	3334	g_9718	g_4087
ptg000034l	17738265	17746275	8010	g_4087	g_18674
ptg000034l	17758221	17767364	9143	g_18674	g_12266
ptg000034l	17769513	17772178	2665	g_12266	g_12103
ptg000034l	17773827	17793498	19671	g_12103	g_33506
ptg000034l	17794147	17797118	2971	g_33506	g_2951
ptg000034l	17801214	17816610	15396	g_2951	g_263
ptg000034l	17819296	17861492	42196	g_263	g_22809
ptg000034l	17863988	17880215	16227	g_22809	g_2023
ptg000034l	17906379	17925658	19279	g_2023	g_29145
ptg000034l	17943355	17965495	22140	g_29145	g_29892
ptg000034l	17968167	17970117	1950	g_29892	g_9346
ptg000034l	17981835	17984120	2285	g_9346	g_2932
ptg000034l	17994082	17996779	2697	g_2932	g_31380
ptg000034l	18007835	18008671	836	g_31380	g_36802
ptg000034l	18009688	18010406	718	g_36802	g_32222
ptg000034l	18033270	18036891	3621	g_32222	g_35388
ptg000034l	18041913	18048932	7019	g_35388	g_9760
ptg000034l	18054355	18063151	8796	g_9760	g_40198
ptg000034l	18065499	18066631	1132	g_40198	g_19446
ptg000034l	18070899	18072112	1213	g_19446	g_6393
ptg000034l	18073970	18077615	3645	g_6393	g_26370
ptg000034l	18083059	18087079	4020	g_26370	g_2203
ptg000034l	18095254	18112013	16759	g_2203	g_33453
ptg000034l	18121645	18124632	2987	g_33453	g_2839
ptg000034l	18135764	18140539	4775	g_2839	g_18403
ptg000034l	18142033	18151445	9412	g_18403	g_23275
ptg000034l	18160739	18186167	25428	g_23275	g_4015
ptg000034l	18208266	18220296	12030	g_4015	g_3757
ptg000034l	18220598	18253670	33072	g_3757	g_39971
ptg000034l	18256425	18278770	22345	g_39971	g_33564
ptg000034l	18279045	18314292	35247	g_33564	g_36717
ptg000034l	18316307	18334892	18585	g_36717	g_26896
ptg000034l	18341088	18344953	3865	g_26896	g_25748
ptg000034l	18346238	18349706	3468	g_25748	g_10852
ptg000034l	18355011	18359368	4357	g_10852	g_24977
ptg000034l	18361662	18364729	3067	g_24977	g_26367
ptg000034l	18366455	18381091	14636	g_26367	g_2648
ptg000034l	18388967	18395579	6612	g_2648	g_8587
ptg000034l	18405772	18421046	15274	g_8587	g_21512
ptg000034l	18422002	18438161	16159	g_21512	g_37807
ptg000034l	18451053	18456631	5578	g_37807	g_26045
ptg000034l	18463192	18464393	1201	g_26045	g_9921
ptg000034l	18468117	18469648	1531	g_9921	g_32687
ptg000034l	18477023	18478938	1915	g_32687	g_27589
ptg000034l	18481047	18484286	3239	g_27589	g_12297
ptg000034l	18491377	18499585	8208	g_12297	g_856
ptg000034l	18502317	18515807	13490	g_856	g_13338
ptg000034l	18520155	18551680	31525	g_13338	g_24177
ptg000034l	18556445	18575573	19128	g_24177	g_33923
ptg000034l	18589440	18590860	1420	g_33923	g_6906
ptg000034l	18591186	18597486	6300	g_6906	g_14406
ptg000034l	18602592	18703747	101155	g_14406	g_23363
ptg000034l	18716507	18722211	5704	g_23363	g_22626
ptg000034l	18725295	18726346	1051	g_22626	g_16774
ptg000034l	18735516	18737891	2375	g_16774	g_11671
ptg000034l	18757574	18760296	2722	g_11671	g_13202
ptg000034l	18762252	18782475	20223	g_13202	g_8450
ptg000034l	18790418	18794674	4256	g_8450	g_11556
ptg000034l	18799754	18814276	14522	g_11556	g_22726
ptg000034l	18815343	18822392	7049	g_22726	g_6371
ptg000034l	18826044	18905506	79462	g_6371	g_1282
ptg000034l	18907057	18908529	1472	g_1282	g_32485
ptg000034l	18911930	18917796	5866	g_32485	g_30991
ptg000034l	18922227	18925640	3413	g_30991	g_28292
ptg000034l	18931319	18951179	19860	g_28292	g_23836
ptg000034l	18952666	18956226	3560	g_23836	g_23476
ptg000034l	18987511	19005032	17521	g_23476	g_21395
ptg000034l	19007049	19015919	8870	g_21395	g_40050
ptg000034l	19016218	19016433	215	g_40050	g_8519
ptg000034l	19022234	19031409	9175	g_8519	g_40180
ptg000034l	19031705	19034688	2983	g_40180	g_18024
ptg000034l	19038563	19044402	5839	g_18024	g_14919
ptg000034l	19070104	19089619	19515	g_14919	g_30101
ptg000034l	19101453	19105042	3589	g_30101	g_6709
ptg000034l	19106320	19108697	2377	g_6709	g_2222
ptg000034l	19112226	19125409	13183	g_2222	g_38094
ptg000034l	19128404	19131690	3286	g_38094	g_23770
ptg000034l	19133859	19139166	5307	g_23770	g_25680
ptg000034l	19140218	19142825	2607	g_25680	g_12147
ptg000034l	19143076	19146685	3609	g_12147	g_12045
ptg000034l	19157514	19159372	1858	g_38897	g_16807
ptg000034l	19166862	19169437	2575	g_16807	g_28841
ptg000034l	19169757	19173593	3836	g_28841	g_13273
ptg000034l	19186802	19204882	18080	g_13273	g_25535
ptg000034l	19218733	19223691	4958	g_25535	g_7120
ptg000034l	19247009	19248768	1759	g_7120	g_17078
ptg000034l	19249760	19250479	719	g_17078	g_30980
ptg000034l	19300597	19312560	11963	g_30980	g_32426
ptg000034l	19327729	19331651	3922	g_32426	g_17561
ptg000034l	19338085	19340305	2220	g_17561	g_13138
ptg000034l	19343973	19345362	1389	g_13138	g_33945
ptg000034l	19346828	19349758	2930	g_33945	g_9681
ptg000034l	19354657	19356519	1862	g_9681	g_7204
ptg000034l	19356773	19374305	17532	g_7204	g_19632
ptg000034l	19374733	19390782	16049	g_19632	g_12322
ptg000034l	19407984	19415367	7383	g_12322	g_10264
ptg000034l	19425035	19471906	46871	g_10264	g_363
ptg000034l	19475072	19482891	7819	g_363	g_30845
ptg000034l	19484801	19495889	11088	g_30845	g_37171
ptg000034l	19498162	19506413	8251	g_37171	g_20741
ptg000034l	19509138	19517126	7988	g_20741	g_14977
ptg000034l	19518961	19523294	4333	g_14977	g_26320
ptg000034l	19525367	19535913	10546	g_26320	g_31072
ptg000034l	19537076	19538823	1747	g_31072	g_5756
ptg000034l	19540685	19550107	9422	g_5756	g_24573
ptg000034l	19551407	19617087	65680	g_24573	g_7820
ptg000034l	19620883	19622213	1330	g_7820	g_13773
ptg000034l	19624609	19626226	1617	g_13773	g_1339
ptg000034l	19628481	19635598	7117	g_1339	g_7858
ptg000034l	19639342	19650960	11618	g_7858	g_20617
ptg000034l	19653124	19656597	3473	g_20617	g_31418
ptg000034l	19659886	19790102	130216	g_31418	g_1997
ptg000034l	19790674	19904408	113734	g_1997	g_2085
ptg000034l	19908399	19910389	1990	g_2085	g_8080
ptg000034l	19919319	19944776	25457	g_8080	g_14915
ptg000034l	19953480	19973495	20015	g_14915	g_27989
ptg000034l	19975536	19977928	2392	g_27989	g_18035
ptg000034l	19978881	19983902	5021	g_18035	g_16571
ptg000034l	19986352	19994241	7889	g_16571	g_824
ptg000034l	19996750	20013548	16798	g_824	g_21683
ptg000034l	20028139	20030968	2829	g_21683	g_7355
ptg000034l	20051236	20077951	26715	g_7355	g_14827
ptg000034l	20092167	20121233	29066	g_14827	g_18546
ptg000034l	20125398	20132645	7247	g_18546	g_38114
ptg000034l	20133076	20142912	9836	g_38114	g_22890
ptg000034l	20144631	20150730	6099	g_22890	g_25527
ptg000034l	20157202	20169703	12501	g_25527	g_24965
ptg000034l	20186152	20192018	5866	g_24965	g_2503
ptg000034l	20203347	20222938	19591	g_2503	g_18706
ptg000034l	20224159	20243121	18962	g_18706	g_7208
ptg000034l	20243345	20257251	13906	g_7208	g_222
ptg000034l	20279189	20280535	1346	g_222	g_7521
ptg000034l	20283399	20284177	778	g_7521	g_26570
ptg000034l	20285149	20292192	7043	g_26570	g_26373
ptg000034l	20295106	20312641	17535	g_26373	g_35731
ptg000034l	20314383	20344765	30382	g_35731	g_15002
ptg000034l	20346267	20359357	13090	g_15002	g_29680
ptg000034l	20360952	20424412	63460	g_29680	g_30903
ptg000034l	20425287	20436127	10840	g_30903	g_34790
ptg000034l	20440384	20444710	4326	g_34790	g_1567
ptg000034l	20448940	20509295	60355	g_1567	g_36742
ptg000034l	20517579	20522603	5024	g_36742	g_23186
ptg000034l	20532325	20535067	2742	g_23186	g_35835
ptg000034l	20539940	20541158	1218	g_35835	g_39904
ptg000034l	20547278	20549828	2550	g_39904	g_380
ptg000034l	20551237	20571150	19913	g_380	g_4928
ptg000034l	20578094	20603387	25293	g_4928	g_7711
ptg000034l	20609922	20611841	1919	g_7711	g_27952
ptg000034l	20612636	20613061	425	g_27952	g_7510
ptg000034l	20623990	20700600	76610	g_7510	g_13682
ptg000034l	20721242	20732537	11295	g_13682	g_19558
ptg000034l	20740282	20752737	12455	g_19558	g_8683
ptg000034l	20764217	20765314	1097	g_8683	g_40056
ptg000034l	20765611	20793006	27395	g_40056	g_1528
ptg000034l	20799516	20838381	38865	g_1528	g_1425
ptg000034l	20847521	20926739	79218	g_1425	g_8070
ptg000034l	20944166	20951703	7537	g_8070	g_29639
ptg000034l	20957553	20961672	4119	g_29639	g_11856
ptg000034l	20963215	20966155	2940	g_11856	g_40101
ptg000034l	20968610	20971180	2570	g_40101	g_2989
ptg000034l	20976543	20977477	934	g_2989	g_31291
ptg000034l	20980584	20983061	2477	g_31291	g_13470
ptg000034l	20994326	21000501	6175	g_13470	g_40124
ptg000034l	21006004	21097581	91577	g_40124	g_30135
ptg000034l	21097919	21155772	57853	g_30135	g_26155
ptg000034l	21156878	21237777	80899	g_26155	g_37393
ptg000034l	21238055	21261505	23450	g_37393	g_1895
ptg000034l	21267229	21269218	1989	g_1895	g_212
ptg000034l	21271399	21275022	3623	g_212	g_444
ptg000034l	21303035	21309118	6083	g_444	g_32344
ptg000034l	21310407	21310818	411	g_32344	g_29471
ptg000034l	21312304	21315129	2825	g_29471	g_2129
ptg000034l	21319047	21321860	2813	g_2129	g_24487
ptg000034l	21334257	21336034	1777	g_24487	g_7307
ptg000034l	21346103	21349967	3864	g_7307	g_16412
ptg000034l	21353431	21354380	949	g_16412	g_6089
ptg000034l	21364930	21377542	12612	g_6089	g_18525
ptg000034l	21384209	21415364	31155	g_18525	g_15945
ptg000034l	21423360	21430874	7514	g_15945	g_8933
ptg000034l	21437640	21440237	2597	g_8933	g_17030
ptg000034l	21440690	21462214	21524	g_17030	g_28909
ptg000034l	21462549	21482076	19527	g_28909	g_24901
ptg000034l	21487993	21502346	14353	g_24901	g_2162
ptg000034l	21508408	21532746	24338	g_2162	g_11295
ptg000034l	21542600	21558487	15887	g_11295	g_18544
ptg000034l	21559506	21576983	17477	g_18544	g_13278
ptg000034l	21578812	21584269	5457	g_13278	g_21339
ptg000034l	21590694	21605685	14991	g_21339	g_3956
ptg000034l	21618414	21622513	4099	g_3956	g_30410
ptg000034l	21648382	21652734	4352	g_30410	g_2864
ptg000034l	21658337	21668625	10288	g_2864	g_26890
ptg000034l	21670810	21673262	2452	g_26890	g_36905
ptg000034l	21681000	21773346	92346	g_36905	g_8358
ptg000034l	21773678	21874235	100557	g_8358	g_30384
ptg000034l	21875287	21915194	39907	g_30384	g_5812
ptg000034l	21918110	21921574	3464	g_5812	g_720
ptg000034l	21923694	21985982	62288	g_720	g_1530
ptg000034l	21997182	22138487	141305	g_1530	g_35286
ptg000034l	22162616	22191888	29272	g_35286	g_16235
ptg000034l	22198927	22276964	78037	g_16235	g_21575
ptg000034l	22278699	22283190	4491	g_21575	g_23675
ptg000034l	22295234	22364281	69047	g_23675	g_33795
ptg000034l	22375867	22381248	5381	g_33795	g_25499
ptg000034l	22397512	22410475	12963	g_25499	g_16765
ptg000034l	22410717	22437799	27082	g_16765	g_19002
ptg000034l	22439168	22611671	172503	g_19002	g_36273
ptg000034l	22615843	22669517	53674	g_36273	g_97
ptg000034l	22670203	22699536	29333	g_97	g_10540
ptg000034l	22706264	22708326	2062	g_10540	g_2669
ptg000034l	22709535	22711046	1511	g_2669	g_381
ptg000034l	22736234	22738470	2236	g_381	g_20367
ptg000034l	22740767	22743805	3038	g_20367	g_37610
ptg000034l	22744071	22759020	14949	g_37610	g_6339
ptg000034l	22771461	22778905	7444	g_6339	g_806
ptg000034l	22780242	22805960	25718	g_806	g_27982
ptg000034l	22806475	22837762	31287	g_27982	g_30120
ptg000034l	22863641	22880741	17100	g_30120	g_21859
ptg000034l	22884491	22908941	24450	g_21859	g_1254
ptg000034l	22909180	22915039	5859	g_1254	g_3886
ptg000034l	22933793	22948343	14550	g_3886	g_6668
ptg000034l	22976984	23002762	25778	g_6668	g_20932
ptg000034l	23006935	23008365	1430	g_20932	g_1639
ptg000034l	23010307	23047229	36922	g_1639	g_1210
ptg000034l	23059061	23072183	13122	g_1210	g_23775
ptg000034l	23078939	23082487	3548	g_23775	g_7067
ptg000034l	23087063	23092363	5300	g_7067	g_15258
ptg000034l	23095727	23096658	931	g_15258	g_22485
ptg000034l	23102013	23105539	3526	g_22485	g_37735
ptg000034l	23114385	23119064	4679	g_37735	g_12071
ptg000034l	23122026	23123256	1230	g_12071	g_31820
ptg000034l	23124467	23126387	1920	g_31820	g_2448
ptg000034l	23127810	23128436	626	g_2448	g_26254
ptg000034l	23129212	23132505	3293	g_26254	g_19295
ptg000034l	23133793	23136785	2992	g_19295	g_830
ptg000034l	23144891	23147250	2359	g_830	g_26776
ptg000034l	23152320	23158631	6311	g_26776	g_3304
ptg000034l	23160055	23164162	4107	g_3304	g_13873
ptg000034l	23170035	23216469	46434	g_13873	g_24418
ptg000034l	23224685	23233198	8513	g_24418	g_4360
ptg000034l	23240139	23243376	3237	g_4360	g_39976
ptg000034l	23245563	23259456	13893	g_39976	g_13806
ptg000034l	23262462	23359281	96819	g_13806	g_34083
ptg000034l	23360186	23364393	4207	g_34083	g_23262
ptg000034l	23365451	23393039	27588	g_23262	g_9092
ptg000034l	23393431	23418345	24914	g_9092	g_33885
ptg000034l	23427527	23441571	14044	g_33885	g_21094
ptg000034l	23444624	23446537	1913	g_21094	g_8454
ptg000034l	23453081	23455153	2072	g_8454	g_25969
ptg000034l	23460865	23467246	6381	g_25969	g_21630
ptg000034l	23470178	23487880	17702	g_21630	g_39735
ptg000034l	23488206	23491345	3139	g_39735	g_1033
ptg000034l	23493951	23504622	10671	g_1033	g_29737
ptg000034l	23506402	23509149	2747	g_29737	g_11235
ptg000034l	23510932	23513679	2747	g_11235	g_18305
ptg000034l	23515483	23517772	2289	g_18305	g_1569
ptg000034l	23525718	23529613	3895	g_1569	g_5318
ptg000034l	23530725	23534935	4210	g_5318	g_26718
ptg000034l	23545416	23548995	3579	g_26718	g_25921
ptg000034l	23550898	23553409	2511	g_25921	g_23221
ptg000034l	23557263	23564216	6953	g_23221	g_21197
ptg000034l	23565450	23607258	41808	g_21197	g_37565
ptg000034l	23607956	23629422	21466	g_37565	g_14467
ptg000034l	23636109	23701772	65663	g_14467	g_2178
ptg000034l	23705047	23730004	24957	g_2178	g_32633
ptg000034l	23732733	23736484	3751	g_32633	g_36393
ptg000034l	23739738	23760996	21258	g_36393	g_29184
ptg000034l	23772934	23812469	39535	g_29184	g_19116
ptg000034l	23813032	23850663	37631	g_19116	g_28108
ptg000034l	23868420	23908942	40522	g_28108	g_29416
ptg000034l	23929386	23950451	21065	g_29416	g_29668
ptg000034l	23953836	23954387	551	g_29668	g_4997
ptg000034l	23958351	23959397	1046	g_4997	g_27050
ptg000034l	23965744	23994715	28971	g_27050	g_13318
ptg000034l	24014580	24020836	6256	g_13318	g_5359
ptg000034l	24051449	24057361	5912	g_5359	g_15183
ptg000034l	24057624	24126587	68963	g_15183	g_12453
ptg000034l	24145430	24149624	4194	g_12453	g_756
ptg000034l	24150361	24152692	2331	g_756	g_17422
ptg000034l	24155582	24155644	62	g_17422	g_6350
ptg000034l	24155892	24157269	1377	g_6350	g_27259
ptg000034l	24158406	24165416	7010	g_27259	g_2208
ptg000034l	24173913	24176559	2646	g_2208	g_9445
ptg000034l	24176759	24181090	4331	g_9445	g_7695
ptg000034l	24189727	24215947	26220	g_7695	g_29493
ptg000034l	24221841	24242853	21012	g_29493	g_19762
ptg000034l	24246116	24257161	11045	g_19762	g_4549
ptg000034l	24259993	24265731	5738	g_4549	g_20442
ptg000034l	24269185	24271594	2409	g_20442	g_21366
ptg000034l	24277290	24296150	18860	g_21366	g_34849
ptg000034l	24302503	24305091	2588	g_34849	g_14622
ptg000034l	24309214	24310884	1670	g_14622	g_31573
ptg000034l	24313204	24340598	27394	g_31573	g_15650
ptg000034l	24348671	24353551	4880	g_15650	g_19904
ptg000034l	24361272	24370590	9318	g_19904	g_34180
ptg000034l	24373364	24568160	194796	g_38543	g_26109
ptg000034l	24568369	24722611	154242	g_26109	g_15042
ptg000034l	24722844	24852439	129595	g_15042	g_30737
ptg000034l	24853935	24859642	5707	g_30737	g_4764
ptg000034l	24864353	24867116	2763	g_4764	g_39982
ptg000034l	24883224	24893358	10134	g_39982	g_11810
ptg000034l	24893603	24895056	1453	g_11810	g_36985
ptg000034l	24895316	24923202	27886	g_36985	g_34114
ptg000034l	24937188	24940658	3470	g_34114	g_14310
ptg000034l	24945462	24998655	53193	g_14310	g_28799
ptg000034l	25014736	25020158	5422	g_28799	g_17953
ptg000034l	25023434	25032471	9037	g_17953	g_6762
ptg000034l	25032836	25036784	3948	g_6762	g_25028
ptg000034l	25038175	25042553	4378	g_25028	g_79
ptg000034l	25044869	25058495	13626	g_79	g_10412
ptg000034l	25072391	25072442	51	g_10412	g_30299
ptg000034l	25072687	25098960	26273	g_30299	g_24273
ptg000034l	25101699	25107224	5525	g_24273	g_5941
ptg000034l	25113938	25126109	12171	g_5941	g_18190
ptg000034l	25137059	25141248	4189	g_18190	g_15340
ptg000034l	25141676	25144851	3175	g_15340	g_40144
ptg000034l	25159265	25168584	9319	g_40144	g_38982
ptg000034l	25170314	25191033	20719	g_1565	g_16743
ptg000034l	25202707	25206516	3809	g_16743	g_7454
ptg000034l	25207854	25213052	5198	g_7454	g_21942
ptg000034l	25224236	25227696	3460	g_21942	g_24111
ptg000034l	25233001	25280167	47166	g_24111	g_33038
ptg000034l	25282126	25284749	2623	g_33038	g_1479
ptg000034l	25296947	25306089	9142	g_1479	g_797
ptg000034l	25317917	25329987	12070	g_38582	g_35569
ptg000034l	25335899	25339496	3597	g_35569	g_20767
ptg000034l	25347086	25350916	3830	g_20767	g_6853
ptg000034l	25355171	25365076	9905	g_6853	g_38429
ptg000034l	25365309	25419342	54033	g_38429	g_20285
ptg000034l	25419617	25419664	47	g_20285	g_24832
ptg000034l	25438802	25444979	6177	g_24832	g_3509
ptg000034l	25464098	25466892	2794	g_3509	g_9347
ptg000034l	25473009	25544578	71569	g_9347	g_12131
ptg000034l	25547669	25617239	69570	g_12131	g_13807
ptg000034l	25618257	25621458	3201	g_13807	g_3425
ptg000034l	25642821	25644695	1874	g_3425	g_35517
ptg000034l	25649227	25658076	8849	g_35517	g_34404
ptg000034l	25661575	25665726	4151	g_34404	g_15827
ptg000034l	25674821	26031318	356497	g_15827	g_23736
ptg000034l	26040645	26085509	44864	g_23736	g_32324
ptg000034l	26086903	26091956	5053	g_32324	g_5534
ptg000034l	26095867	26096962	1095	g_5534	g_37455
ptg000034l	26099425	26127446	28021	g_37455	g_6053
ptg000034l	26144758	26169798	25040	g_6053	g_2460
ptg000034l	26182789	26184577	1788	g_2460	g_30948
ptg000034l	26186877	26188672	1795	g_30948	g_25746
ptg000034l	26191976	26192848	872	g_25746	g_8826
ptg000034l	26198356	26200638	2282	g_8826	g_11773
ptg000034l	26202547	26263283	60736	g_11773	g_4575
ptg000034l	26266089	26275496	9407	g_4575	g_28642
ptg000034l	26275910	26288277	12367	g_28642	g_13885
ptg000034l	26298350	26301672	3322	g_13885	g_33750
ptg000034l	26306858	26310784	3926	g_33750	g_39194
ptg000034l	26311429	26317448	6019	g_39194	g_7889
ptg000034l	26320307	26331748	11441	g_7889	g_37054
ptg000034l	26334792	26359511	24719	g_37054	g_9060
ptg000034l	26360731	26364532	3801	g_9060	g_17113
ptg000034l	26365095	26366402	1307	g_17113	g_13185
ptg000034l	26372949	26392213	19264	g_13185	g_1516
ptg000034l	26394957	26406200	11243	g_1516	g_5108
ptg000034l	26409415	26412218	2803	g_5108	g_40252
ptg000034l	26415931	26417451	1520	g_40252	g_25051
ptg000034l	26419104	26422013	2909	g_25051	g_21285
ptg000034l	26432372	26713411	281039	g_21285	g_12818
ptg000034l	26721786	26727275	5489	g_12818	g_37573
ptg000034l	26728426	26732100	3674	g_37573	g_18378
ptg000034l	26753641	26764254	10613	g_18378	g_40172
ptg000034l	26773385	26776765	3380	g_40172	g_17590
ptg000034l	26789186	26858470	69284	g_17590	g_2699
ptg000034l	26872893	26881140	8247	g_2699	g_14115
ptg000034l	26884042	26886688	2646	g_14115	g_28771
ptg000034l	26892107	26895145	3038	g_28771	g_39152
ptg000034l	26895848	26916759	20911	g_39152	g_39602
ptg000034l	26917462	26942360	24898	g_39602	g_4016
ptg000034l	26964725	26973636	8911	g_4016	g_9141
ptg000034l	26979332	27005035	25703	g_9141	g_5926
ptg000034l	27025758	27034466	8708	g_5926	g_25063
ptg000034l	27042288	27067314	25026	g_25063	g_20763
ptg000034l	27067877	27215119	147242	g_20763	g_28946
ptg000034l	27235272	27240047	4775	g_28946	g_36
ptg000034l	27254162	27279186	25024	g_36	g_1506
ptg000034l	27283104	27293423	10319	g_1506	g_4606
ptg000034l	27313352	27342334	28982	g_4606	g_36559
ptg000034l	27346744	27365177	18433	g_36559	g_26497
ptg000034l	27373234	27477552	104318	g_26497	g_16625
ptg000034l	27482780	27547858	65078	g_16625	g_3375
ptg000034l	27557294	27585007	27713	g_3375	g_15578
ptg000034l	27588085	27653111	65026	g_15578	g_30575
ptg000034l	27653827	27763322	109495	g_30575	g_10578
ptg000034l	27764338	27779011	14673	g_10578	g_38084
ptg000034l	27779472	27900328	120856	g_38084	g_27975
ptg000034l	27903463	27995474	92011	g_27975	g_4458
ptg000034l	28015138	28020866	5728	g_4458	g_30607
ptg000034l	28021489	28055435	33946	g_30607	g_20997
ptg000034l	28058569	28078138	19569	g_20997	g_38291
ptg000034l	28081620	28109483	27863	g_38291	g_8874
ptg000034l	28110939	28142210	31271	g_8874	g_31892
ptg000034l	28143802	28167996	24194	g_31892	g_27097
ptg000034l	28168595	28230169	61574	g_27097	g_7604
ptg000034l	28242128	28244920	2792	g_22409	g_34148
ptg000034l	28245507	28263032	17525	g_34148	g_820
ptg000034l	28277017	28351783	74766	g_820	g_20965
ptg000034l	28352704	28406647	53943	g_20965	g_39496
ptg000034l	28406925	28415011	8086	g_39496	g_27576
ptg000034l	28415445	28417048	1603	g_27576	g_269
ptg000034l	28422195	28433712	11517	g_269	g_20637
ptg000034l	28452636	28463051	10415	g_20637	g_24750
ptg000034l	28465543	28472263	6720	g_24750	g_22583
ptg000034l	28478238	28484169	5931	g_22583	g_35996
ptg000034l	28492779	28525595	32816	g_10	g_7453
ptg000034l	28552598	28614530	61932	g_7453	g_1881
ptg000034l	28616996	28624491	7495	g_1881	g_4032
ptg000034l	28632090	28638764	6674	g_4032	g_19421
ptg000034l	28639852	28644391	4539	g_19421	g_158
ptg000034l	28648752	28657439	8687	g_158	g_28442
ptg000034l	28658509	28665020	6511	g_28442	g_27513
ptg000034l	28666090	28672572	6482	g_27513	g_10204
ptg000034l	28673660	28692056	18396	g_10204	g_37251
ptg000034l	28693144	28697965	4821	g_37251	g_4119
ptg000034l	28703567	28706935	3368	g_4119	g_4046
ptg000034l	28727856	28735279	7423	g_4046	g_28238
ptg000034l	28741506	28751617	10111	g_28238	g_2184
ptg000034l	28768866	28794129	25263	g_2184	g_17045
ptg000034l	28801494	28805952	4458	g_17045	g_26557
ptg000034l	28811038	28814654	3616	g_26557	g_1754
ptg000034l	28826800	28862055	35255	g_1754	g_33839
ptg000034l	28870481	28874144	3663	g_33839	g_36331
ptg000034l	28879545	28882960	3415	g_36331	g_31188
ptg000034l	28887495	28909618	22123	g_31188	g_13555
ptg000034l	28922221	28923006	785	g_13555	g_9414
ptg000034l	28925691	28927509	1818	g_9414	g_26617
ptg000034l	28927736	28930801	3065	g_26617	g_23187
ptg000034l	28933470	28936063	2593	g_23187	g_27927
ptg000034l	28938786	28943144	4358	g_27927	g_40045
ptg000034l	28946193	28947504	1311	g_40045	g_8456
ptg000034l	28950273	28952280	2007	g_8456	g_30773
ptg000034l	28955662	28959533	3871	g_30773	g_3158
ptg000034l	28979132	28981089	1957	g_3158	g_16138
ptg000034l	28995417	28999660	4243	g_16138	g_8481
ptg000034l	29002784	29010565	7781	g_8481	g_22230
ptg000034l	29016984	29032028	15044	g_22230	g_24504
ptg000034l	29036963	29039872	2909	g_24504	g_5603
ptg000034l	29045002	29072209	27207	g_5603	g_37509
ptg000034l	29073943	29076621	2678	g_37509	g_4721
ptg000034l	29090227	29116753	26526	g_4721	g_34160
ptg000034l	29117724	29118687	963	g_34160	g_35601
ptg000034l	29119667	29172038	52371	g_35601	g_11717
ptg000034l	29173648	29181614	7966	g_11717	g_9982
ptg000034l	29191918	29210981	19063	g_9982	g_6273
ptg000034l	29217493	29219852	2359	g_6273	g_6788
ptg000034l	29221129	29224761	3632	g_6788	g_40022
ptg000034l	29227079	29227410	331	g_40022	g_31039
ptg000034l	29232956	29233933	977	g_31039	g_8423
ptg000034l	29234551	29238243	3692	g_8423	g_9850
ptg000034l	29252012	29253943	1931	g_9850	g_16295
ptg000034l	29254422	29263682	9260	g_16295	g_14147
ptg000034l	29284030	29290729	6699	g_14147	g_2717
ptg000034l	29299623	29323089	23466	g_2717	g_31787
ptg000034l	29329179	29440081	110902	g_31787	g_33733
ptg000034l	29445782	29524661	78879	g_33733	g_18137
ptg000034l	29524882	29571250	46368	g_18137	g_25618
ptg000034l	29571498	29574033	2535	g_25618	g_11484
ptg000034l	29574389	29621504	47115	g_11484	g_10287
ptg000034l	29621710	29654588	32878	g_10287	g_22722
ptg000034l	29657563	29662533	4970	g_22722	g_17549
ptg000034l	29667278	29722797	55519	g_17549	g_38425
ptg000034l	29723501	29760499	36998	g_38425	g_16147
ptg000034l	29764070	29823562	59492	g_16147	g_16426
ptg000034l	29824810	29866989	42179	g_16426	g_11076
ptg000034l	29900253	29925611	25358	g_11076	g_36221
ptg000034l	29925844	29947100	21256	g_36221	g_24746
ptg000034l	29953712	29963822	10110	g_24746	g_11278
ptg000034l	29970185	30056373	86188	g_11278	g_10166
ptg000034l	30077153	30120638	43485	g_10166	g_23972
ptg000034l	30130763	30150597	19834	g_23972	g_7442
ptg000034l	30154295	30162281	7986	g_7442	g_23382
ptg000034l	30177212	30278088	100876	g_23382	g_19552
ptg000034l	30286191	30288611	2420	g_19552	g_33118
ptg000034l	30298074	30304035	5961	g_33118	g_37659
ptg000034l	30307896	30310813	2917	g_37659	g_10389
ptg000034l	30328466	30332830	4364	g_10389	g_11387
ptg000034l	30341514	30343002	1488	g_11387	g_31487
ptg000034l	30350508	30352951	2443	g_31487	g_14992
ptg000034l	30370527	30454666	84139	g_14992	g_747
ptg000034l	30472645	30585585	112940	g_747	g_13862
ptg000034l	30586355	30738992	152637	g_13862	g_26790
ptg000034l	30745269	30748010	2741	g_26790	g_37638
ptg000034l	30768310	30769434	1124	g_37638	g_1801
ptg000034l	30773071	30775897	2826	g_1801	g_7161
ptg000034l	30786763	30862186	75423	g_39085	g_25955
ptg000034l	30864076	30882950	18874	g_25955	g_36425
ptg000034l	30894440	30948449	54009	g_36425	g_8492
ptg000034l	30948661	30996909	48248	g_8492	g_11430
ptg000034l	31005474	31012038	6564	g_11430	g_36348
ptg000034l	31026422	31036207	9785	g_36348	g_24478
ptg000034l	31042529	31045936	3407	g_24478	g_321
ptg000034l	31053435	31063308	9873	g_321	g_32646
ptg000034l	31065895	31078422	12527	g_32646	g_12392
ptg000034l	31084295	31098032	13737	g_12392	g_3749
ptg000034l	31127094	31144704	17610	g_3749	g_14747
ptg000034l	31174564	31196720	22156	g_14747	g_23387
ptg000034l	31215469	31276347	60878	g_23387	g_5701
ptg000034l	31298138	31362385	64247	g_5701	g_15068
ptg000034l	31362618	31394639	32021	g_15068	g_3457
ptg000034l	31394923	31411484	16561	g_3457	g_1067
ptg000034l	31418315	31423730	5415	g_1067	g_21216
ptg000034l	31424503	31425556	1053	g_21216	g_23521
ptg000034l	31436399	31785137	348738	g_23521	g_37036
ptg000034l	31793281	31809768	16487	g_37036	g_8033
ptg000034l	31824291	31848246	23955	g_8033	g_17203
ptg000034l	31872265	31894224	21959	g_17203	g_6082
ptg000034l	31894484	31898932	4448	g_6082	g_15783
ptg000034l	31899558	31975673	76115	g_15783	g_18379
ptg000034l	31975912	31990465	14553	g_18379	g_25874
ptg000034l	31990677	32057217	66540	g_25874	g_2558
ptg000034l	32059341	32061465	2124	g_2558	g_4763
ptg000034l	32065576	32067938	2362	g_4763	g_40224
ptg000034l	32072692	32084783	12091	g_40224	g_22476
ptg000034l	32085514	32087308	1794	g_22476	g_14059
ptg000034l	32097135	32106199	9064	g_14059	g_33837
ptg000034l	32108096	32165228	57132	g_33837	g_36892
ptg000034l	32185866	32192438	6572	g_36892	g_2302
ptg000034l	32198067	32226809	28742	g_2302	g_36111
ptg000034l	32264010	32268819	4809	g_36111	g_2070
ptg000034l	32275874	32276649	775	g_2070	g_10554
ptg000034l	32281723	32282105	382	g_10554	g_37734
ptg000034l	32300508	32435001	134493	g_37734	g_10421
ptg000034l	32456665	32466878	10213	g_10421	g_2563
ptg000034l	32501986	32552425	50439	g_2563	g_31481
ptg000034l	32553432	32558464	5032	g_31481	g_29615
ptg000034l	32574137	32580436	6299	g_29615	g_2213
ptg000034l	32580645	32585736	5091	g_2213	g_29172
ptg000034l	32609112	32614385	5273	g_29172	g_30371
ptg000034l	32615584	32623303	7719	g_30371	g_32608
ptg000034l	32623836	32638514	14678	g_32608	g_37874
ptg000034l	32639365	32664441	25076	g_37874	g_19053
ptg000034l	32664713	32667136	2423	g_19053	g_13051
ptg000034l	32667348	32685707	18359	g_13051	g_392
ptg000034l	32701387	32714981	13594	g_392	g_22249
ptg000034l	32716597	32719223	2626	g_22249	g_38954
ptg000034l	32720098	33085278	365180	g_38954	g_29266
ptg000034l	33085739	33085982	243	g_29266	g_22751
ptg000034l	33086467	33116322	29855	g_22751	g_16247
ptg000034l	33117212	33124135	6923	g_16247	g_24462
ptg000034l	33132265	33266445	134180	g_24462	g_15369
ptg000034l	33283391	33406647	123256	g_15369	g_20480
ptg000034l	33467299	33500140	32841	g_20480	g_19320
ptg000034l	33521396	33580871	59475	g_19320	g_22153
ptg000034l	33581215	33582357	1142	g_22153	g_2983
ptg000034l	33582620	33598890	16270	g_2983	g_15344
ptg000034l	33609627	33615356	5729	g_15344	g_24962
ptg000034l	33621968	33625479	3511	g_24962	g_565
ptg000034l	33650225	33687425	37200	g_565	g_22712
ptg000034l	33698236	33730187	31951	g_22712	g_38284
ptg000034l	33756090	33774933	18843	g_38284	g_25103
ptg000034l	33777406	33782601	5195	g_25103	g_28480
ptg000034l	33800143	33822993	22850	g_28480	g_10975
ptg000034l	33843082	33852053	8971	g_10975	g_21648
ptg000034l	33855336	34000680	145344	g_21648	g_3227
ptg000034l	34022576	34050137	27561	g_3227	g_14153
ptg000034l	34052289	34160255	107966	g_14153	g_13563
ptg000034l	34160704	34473354	312650	g_13563	g_29201
ptg000034l	34555441	34565853	10412	g_29201	g_25447
ptg000034l	34567777	34569046	1269	g_25447	g_40255
ptg000034l	34573275	34580580	7305	g_40255	g_17381
ptg000034l	34582505	34703054	120549	g_17381	g_659
ptg000034l	34712273	34720097	7824	g_659	g_15308
ptg000035l	18578	26993	8415	g_5157	g_27789
ptg000035l	29888	44228	14340	g_27789	g_26949
ptg000035l	44734	62075	17341	g_26949	g_36182
ptg000035l	62293	67059	4766	g_36182	g_2278
ptg000035l	86470	102327	15857	g_2278	g_25098
ptg000035l	102635	105523	2888	g_25098	g_32534
ptg000035l	120335	123765	3430	g_32534	g_4545
ptg000035l	129079	130687	1608	g_4545	g_7076
ptg000035l	139486	144539	5053	g_7076	g_14673
ptg000035l	151011	151619	608	g_14673	g_26956
ptg000035l	152692	155719	3027	g_26956	g_20893
ptg000035l	172528	178957	6429	g_20893	g_14105
ptg000035l	183616	202424	18808	g_14105	g_19547
ptg000035l	218434	229009	10575	g_19547	g_11859
ptg000035l	240980	243490	2510	g_11859	g_1788
ptg000035l	255359	258722	3363	g_1788	g_13499
ptg000035l	268233	272436	4203	g_13499	g_30167
ptg000035l	273542	279638	6096	g_30167	g_23535
ptg000035l	281385	285501	4116	g_23535	g_13255
ptg000035l	287343	289735	2392	g_13255	g_31850
ptg000035l	290925	297362	6437	g_31850	g_23976
ptg000035l	298842	302244	3402	g_23976	g_5663
ptg000035l	310527	320219	9692	g_5663	g_17265
ptg000035l	322327	323942	1615	g_17265	g_31301
ptg000035l	325736	343349	17613	g_31301	g_24124
ptg000035l	346225	351775	5550	g_24124	g_24479
ptg000035l	362494	369673	7179	g_24479	g_33849
ptg000035l	370440	391796	21356	g_33849	g_4999
ptg000035l	411408	425335	13927	g_4999	g_1353
ptg000035l	428339	430564	2225	g_1353	g_28747
ptg000035l	435760	445360	9600	g_28747	g_12974
ptg000035l	446596	447413	817	g_12974	g_26140
ptg000035l	449957	455342	5385	g_26140	g_1770
ptg000035l	458119	462841	4722	g_1770	g_24794
ptg000035l	466671	469816	3145	g_24794	g_12993
ptg000035l	491454	504375	12921	g_12993	g_20977
ptg000035l	505622	507890	2268	g_20977	g_13010
ptg000035l	514121	519030	4909	g_13010	g_21592
ptg000035l	520653	523747	3094	g_21592	g_33370
ptg000035l	525475	593923	68448	g_33370	g_15272
ptg000035l	597672	599457	1785	g_15272	g_12954
ptg000035l	604759	638000	33241	g_12954	g_9791
ptg000035l	647403	649066	1663	g_9791	g_36895
ptg000035l	656470	658522	2052	g_36895	g_29247
ptg000035l	692377	697352	4975	g_29247	g_24693
ptg000035l	705400	709828	4428	g_24693	g_6134
ptg000035l	714508	746566	32058	g_6134	g_1117
ptg000035l	747441	750634	3193	g_1117	g_28808
ptg000035l	752066	763262	11196	g_28808	g_23992
ptg000035l	764047	765973	1926	g_23992	g_16354
ptg000035l	768035	776543	8508	g_16354	g_37366
ptg000035l	776743	782145	5402	g_37366	g_34216
ptg000035l	785477	832322	46845	g_34216	g_30495
ptg000035l	850894	884635	33741	g_30495	g_38624
ptg000035l	887196	920823	33627	g_38624	g_30988
ptg000035l	921239	936391	15152	g_30988	g_10597
ptg000035l	944538	985748	41210	g_10597	g_4579
ptg000035l	986410	997906	11496	g_4579	g_20217
ptg000035l	998970	1014198	15228	g_20217	g_3967
ptg000035l	1019094	1035382	16288	g_3967	g_6755
ptg000035l	1039573	1056079	16506	g_6755	g_15255
ptg000035l	1060302	1064266	3964	g_15255	g_28349
ptg000035l	1072903	1074030	1127	g_28349	g_6318
ptg000035l	1085373	1091069	5696	g_6318	g_31043
ptg000035l	1098107	1101567	3460	g_31043	g_18445
ptg000035l	1111892	1122430	10538	g_18445	g_17952
ptg000035l	1135084	1242606	107522	g_17952	g_21000
ptg000035l	1249098	1262908	13810	g_21000	g_36699
ptg000035l	1263117	1302606	39489	g_36699	g_6267
ptg000035l	1304654	1346081	41427	g_6267	g_17589
ptg000035l	1364152	1376769	12617	g_17589	g_34883
ptg000035l	1387360	1388927	1567	g_34883	g_33591
ptg000035l	1391520	1403614	12094	g_33591	g_14691
ptg000035l	1403838	1405519	1681	g_14691	g_26697
ptg000035l	1408801	1410060	1259	g_26697	g_27446
ptg000035l	1413064	1478493	65429	g_27446	g_33682
ptg000035l	1490428	1496126	5698	g_33682	g_3722
ptg000035l	1504760	1507392	2632	g_3722	g_3689
ptg000035l	1516815	1524032	7217	g_3689	g_31617
ptg000035l	1542618	1543530	912	g_31617	g_4020
ptg000035l	1552394	1555127	2733	g_4020	g_11277
ptg000035l	1581043	1584253	3210	g_11277	g_21637
ptg000035l	1587944	1596329	8385	g_21637	g_12889
ptg000035l	1606387	1611616	5229	g_12889	g_23847
ptg000035l	1613020	1629088	16068	g_23847	g_30174
ptg000035l	1631021	1640633	9612	g_30174	g_27579
ptg000035l	1643953	1644841	888	g_27579	g_20548
ptg000035l	1662038	1662445	407	g_20548	g_12981
ptg000035l	1671108	1679792	8684	g_12981	g_3385
ptg000035l	1690946	1693716	2770	g_3385	g_30636
ptg000035l	1707002	1722542	15540	g_30636	g_11078
ptg000035l	1723333	1731076	7743	g_11078	g_10860
ptg000035l	1740671	1745237	4566	g_10860	g_26275
ptg000035l	1746013	1751570	5557	g_26275	g_22577
ptg000035l	1762666	1783036	20370	g_22577	g_3888
ptg000035l	1783745	1786665	2920	g_3888	g_35737
ptg000035l	1805905	1809506	3601	g_35737	g_5480
ptg000035l	1814401	1817676	3275	g_5480	g_5180
ptg000035l	1818518	1825683	7165	g_5180	g_25622
ptg000035l	1826277	1829359	3082	g_25622	g_23461
ptg000035l	1833793	1835833	2040	g_23461	g_10279
ptg000035l	1850535	1855892	5357	g_10279	g_35393
ptg000035l	1867599	1869405	1806	g_35393	g_24502
ptg000035l	1872845	1881295	8450	g_24502	g_30596
ptg000035l	1903418	1914843	11425	g_30596	g_4342
ptg000035l	1916040	1918322	2282	g_4342	g_25835
ptg000035l	1935536	1939080	3544	g_25835	g_8768
ptg000035l	1943141	1947452	4311	g_8768	g_13362
ptg000035l	1949718	1994597	44879	g_13362	g_23773
ptg000035l	2011481	2016160	4679	g_23773	g_5954
ptg000035l	2020976	2022181	1205	g_5954	g_7768
ptg000035l	2032587	2041759	9172	g_7768	g_17142
ptg000035l	2042406	2058167	15761	g_38879	g_23320
ptg000035l	2058697	2060156	1459	g_23320	g_33762
ptg000035l	2063792	2065430	1638	g_33762	g_7620
ptg000035l	2071097	2099449	28352	g_7620	g_32259
ptg000035l	2118456	2123416	4960	g_32259	g_16121
ptg000035l	2127058	2128744	1686	g_16121	g_18287
ptg000035l	2133105	2136832	3727	g_18287	g_33608
ptg000035l	2140051	2141994	1943	g_33608	g_26277
ptg000035l	2151358	2158852	7494	g_26277	g_15483
ptg000035l	2169413	2176336	6923	g_15483	g_32635
ptg000035l	2182619	2196110	13491	g_32635	g_24950
ptg000035l	2205799	2208922	3123	g_24950	g_19541
ptg000035l	2209335	2211906	2571	g_19541	g_35352
ptg000035l	2212296	2227309	15013	g_35352	g_35799
ptg000035l	2234697	2237827	3130	g_35799	g_26406
ptg000035l	2238051	2241359	3308	g_26406	g_7265
ptg000035l	2248596	2263533	14937	g_7265	g_33983
ptg000035l	2268418	2283838	15420	g_33983	g_22206
ptg000035l	2287893	2306821	18928	g_22206	g_22244
ptg000035l	2307036	2374150	67114	g_22244	g_8860
ptg000035l	2382497	2418066	35569	g_8860	g_12774
ptg000035l	2427925	2431387	3462	g_12774	g_14104
ptg000035l	2434938	2443334	8396	g_14104	g_18671
ptg000035l	2450866	2455004	4138	g_18671	g_2507
ptg000035l	2455901	2458734	2833	g_2507	g_37022
ptg000035l	2459149	2463934	4785	g_37022	g_18808
ptg000035l	2464393	2479401	15008	g_18808	g_39097
ptg000035l	2479777	2483881	4104	g_39097	g_32521
ptg000035l	2484257	2499218	14961	g_32521	g_23624
ptg000035l	2506921	2513807	6886	g_23624	g_3818
ptg000035l	2520957	2526447	5490	g_3818	g_26148
ptg000035l	2538918	2610055	71137	g_26148	g_34786
ptg000035l	2613442	2615721	2279	g_34786	g_727
ptg000035l	2619385	2623458	4073	g_727	g_18963
ptg000035l	2629474	2632136	2662	g_18963	g_5410
ptg000035l	2635157	2670648	35491	g_5410	g_33054
ptg000035l	2681593	2683156	1563	g_33054	g_34124
ptg000035l	2689135	2690709	1574	g_34124	g_31373
ptg000035l	2696055	2696602	547	g_31373	g_17137
ptg000035l	2699322	2745046	45724	g_17137	g_28634
ptg000035l	2751641	2763678	12037	g_28634	g_36513
ptg000035l	2764262	2791514	27252	g_36513	g_7306
ptg000035l	2793766	2802304	8538	g_7306	g_18814
ptg000035l	2807838	2809176	1338	g_18814	g_35683
ptg000035l	2822902	2827418	4516	g_35683	g_20385
ptg000035l	2839199	2853541	14342	g_20385	g_2928
ptg000035l	2854170	2912941	58771	g_29094	g_13190
ptg000035l	2918281	2931125	12844	g_13190	g_21039
ptg000035l	2939101	2943945	4844	g_21039	g_12932
ptg000035l	2956338	2959647	3309	g_12932	g_34055
ptg000035l	2981159	2990470	9311	g_34055	g_11924
ptg000035l	2994359	2999189	4830	g_11924	g_26421
ptg000035l	2999948	3000923	975	g_26421	g_34422
ptg000035l	3006032	3009242	3210	g_34422	g_5291
ptg000035l	3023242	3026517	3275	g_5291	g_37363
ptg000035l	3045322	3069935	24613	g_37363	g_21277
ptg000035l	3074883	3075789	906	g_21277	g_18496
ptg000035l	3084458	3091826	7368	g_18496	g_20953
ptg000035l	3092962	3109370	16408	g_20953	g_12770
ptg000035l	3112558	3159623	47065	g_12770	g_8987
ptg000035l	3161095	3161990	895	g_8987	g_4145
ptg000035l	3165860	3169540	3680	g_4145	g_1731
ptg000035l	3175260	3178701	3441	g_1731	g_10538
ptg000035l	3186473	3192112	5639	g_10538	g_5414
ptg000035l	3196362	3204723	8361	g_5414	g_14635
ptg000035l	3210812	3216701	5889	g_14635	g_40278
ptg000035l	3219237	3220911	1674	g_40278	g_32234
ptg000035l	3229045	3231014	1969	g_32234	g_31513
ptg000035l	3235431	3238100	2669	g_31513	g_4072
ptg000035l	3259528	3261390	1862	g_4072	g_18660
ptg000035l	3263801	3264867	1066	g_18660	g_5820
ptg000035l	3271596	3274213	2617	g_5820	g_18032
ptg000035l	3278786	3280505	1719	g_18032	g_4936
ptg000035l	3281912	3283984	2072	g_4936	g_38002
ptg000035l	3293352	3293712	360	g_38002	g_37845
ptg000035l	3294938	3300282	5344	g_37845	g_1128
ptg000035l	3300533	3301275	742	g_1128	g_5615
ptg000035l	3304444	3312653	8209	g_38743	g_22456
ptg000035l	3313552	3315013	1461	g_22456	g_34906
ptg000035l	3320218	3326886	6668	g_34906	g_24131
ptg000035l	3332718	3346412	13694	g_24131	g_11560
ptg000035l	3366323	3368596	2273	g_11560	g_35127
ptg000035l	3371132	3373580	2448	g_35127	g_10617
ptg000035l	3375992	3382632	6640	g_10617	g_8199
ptg000035l	3386645	3396428	9783	g_8199	g_34958
ptg000035l	3396649	3399841	3192	g_34958	g_15216
ptg000035l	3400272	3405571	5299	g_15216	g_12629
ptg000035l	3411750	3414796	3046	g_12629	g_26311
ptg000035l	3422718	3428238	5520	g_26311	g_3526
ptg000035l	3428594	3513577	84983	g_3526	g_36250
ptg000035l	3542316	3542380	64	g_36250	g_17593
ptg000035l	3542715	3556750	14035	g_17593	g_19409
ptg000035l	3571724	3579904	8180	g_16696	g_3296
ptg000035l	3585807	3599706	13899	g_3296	g_34583
ptg000035l	3605882	3611973	6091	g_34583	g_19011
ptg000035l	3617041	3625506	8465	g_19011	g_31230
ptg000035l	3631537	3637259	5722	g_31230	g_1601
ptg000035l	3637588	3638924	1336	g_1601	g_16954
ptg000035l	3649253	3652331	3078	g_16954	g_28209
ptg000035l	3652753	3657799	5046	g_28209	g_30487
ptg000035l	3660901	3662352	1451	g_30487	g_13689
ptg000035l	3666323	3669128	2805	g_13689	g_20804
ptg000035l	3671397	3671464	67	g_20804	g_33989
ptg000035l	3673684	3674585	901	g_33989	g_3513
ptg000035l	3678534	3680431	1897	g_3513	g_30182
ptg000035l	3687188	3712169	24981	g_30182	g_10195
ptg000035l	3715610	3718994	3384	g_10195	g_707
ptg000035l	3719287	3721510	2223	g_707	g_1722
ptg000035l	3722558	3733113	10555	g_1722	g_12570
ptg000035l	3741008	3750782	9774	g_12570	g_2949
ptg000035l	3757399	3758029	630	g_2949	g_39955
ptg000035l	3759848	3763094	3246	g_39955	g_13471
ptg000035l	3765458	3772186	6728	g_13471	g_18117
ptg000035l	3780373	3796937	16564	g_18117	g_26397
ptg000035l	3819357	3825325	5968	g_26397	g_24999
ptg000035l	3832128	3832644	516	g_24999	g_22643
ptg000035l	3838264	3838998	734	g_22643	g_21237
ptg000035l	3841015	3843861	2846	g_21237	g_2790
ptg000035l	3852912	3858919	6007	g_2790	g_8308
ptg000035l	3862023	3865522	3499	g_8308	g_647
ptg000035l	3869876	3871365	1489	g_647	g_40023
ptg000035l	3874446	3876799	2353	g_40023	g_6794
ptg000035l	3878731	3879880	1149	g_6794	g_3857
ptg000035l	3881700	3887117	5417	g_3857	g_21209
ptg000035l	3893114	3895097	1983	g_21209	g_28205
ptg000035l	3901221	3984809	83588	g_28205	g_33384
ptg000035l	3992995	4125934	132939	g_33384	g_21111
ptg000035l	4134971	4192891	57920	g_21111	g_4081
ptg000035l	4193493	4204596	11103	g_4081	g_23858
ptg000035l	4224543	4225734	1191	g_23858	g_22201
ptg000035l	4228190	4232798	4608	g_22201	g_16184
ptg000035l	4236433	4303169	66736	g_16184	g_34781
ptg000035l	4303990	4437750	133760	g_34781	g_14051
ptg000035l	4455639	4458434	2795	g_14051	g_7973
ptg000035l	4471515	4471729	214	g_7973	g_6591
ptg000035l	4473642	4477920	4278	g_6591	g_21724
ptg000035l	4493400	4494889	1489	g_21724	g_15020
ptg000035l	4501827	4505145	3318	g_15020	g_14157
ptg000035l	4521107	4541655	20548	g_14157	g_28618
ptg000035l	4555290	4574276	18986	g_28618	g_19645
ptg000035l	4576366	4584340	7974	g_39212	g_16308
ptg000035l	4595817	4600991	5174	g_16308	g_1344
ptg000035l	4622296	4718673	96377	g_1344	g_18930
ptg000035l	4718876	4724160	5284	g_18930	g_28492
ptg000035l	4724864	4726506	1642	g_28492	g_7266
ptg000035l	4727195	4755683	28488	g_7266	g_25198
ptg000035l	4765384	4768599	3215	g_25198	g_9792
ptg000035l	4768871	4781287	12416	g_9792	g_17863
ptg000035l	4785195	4795972	10777	g_17863	g_30619
ptg000035l	4799686	4847570	47884	g_30619	g_31644
ptg000035l	4855084	4909997	54913	g_31644	g_25518
ptg000035l	4910284	5057546	147262	g_25518	g_25358
ptg000035l	5069338	5119145	49807	g_25358	g_3179
ptg000035l	5119372	5149261	29889	g_3179	g_17480
ptg000035l	5168132	5184055	15923	g_17480	g_3887
ptg000035l	5185620	5194588	8968	g_3887	g_8462
ptg000035l	5213235	5215576	2341	g_8462	g_36279
ptg000035l	5221071	5240137	19066	g_36279	g_15246
ptg000035l	5241017	5246461	5444	g_15246	g_5726
ptg000035l	5247621	5251963	4342	g_5726	g_17355
ptg000035l	5258406	5259693	1287	g_17355	g_8584
ptg000035l	5261337	5264651	3314	g_8584	g_28583
ptg000035l	5271772	5274730	2958	g_28583	g_7421
ptg000035l	5288980	5303847	14867	g_7421	g_34637
ptg000035l	5310640	5361857	51217	g_34637	g_30684
ptg000035l	5362075	5399476	37401	g_30684	g_9015
ptg000035l	5399697	5415614	15917	g_9015	g_32418
ptg000035l	5436121	5458145	22024	g_32418	g_17550
ptg000035l	5474861	5486421	11560	g_17550	g_11072
ptg000035l	5495528	5563502	67974	g_11072	g_12622
ptg000035l	5568094	5591294	23200	g_12622	g_32396
ptg000035l	5604839	5617923	13084	g_32396	g_12961
ptg000035l	5641354	5668445	27091	g_12961	g_29304
ptg000035l	5691499	5696405	4906	g_29304	g_13112
ptg000035l	5696857	5699525	2668	g_13112	g_19071
ptg000035l	5699857	5733023	33166	g_19071	g_6297
ptg000035l	5751983	5818255	66272	g_6297	g_40034
ptg000035l	5818938	5824302	5364	g_40034	g_7778
ptg000035l	5825622	5839104	13482	g_7778	g_20648
ptg000035l	5840285	5845270	4985	g_20648	g_24358
ptg000035l	5846445	5852922	6477	g_24358	g_11999
ptg000035l	5853245	5853642	397	g_11999	g_1445
ptg000035l	5856021	5859567	3546	g_1445	g_18795
ptg000035l	5861967	5914796	52829	g_18795	g_10296
ptg000035l	5919432	5921081	1649	g_10296	g_16067
ptg000035l	5923061	5925042	1981	g_16067	g_40060
ptg000035l	5925248	5925451	203	g_40060	g_8904
ptg000035l	5935158	5938133	2975	g_8904	g_30408
ptg000035l	5946195	5955464	9269	g_30408	g_26089
ptg000035l	5960085	5973192	13107	g_26089	g_13424
ptg000035l	5998394	6054727	56333	g_13424	g_11926
ptg000035l	6057806	6068139	10333	g_11926	g_26862
ptg000035l	6070242	6072446	2204	g_26862	g_16380
ptg000035l	6076977	6078624	1647	g_16380	g_32531
ptg000035l	6081722	6089080	7358	g_32531	g_23317
ptg000035l	6089280	6102897	13617	g_23317	g_7203
ptg000035l	6113333	6115093	1760	g_7203	g_32409
ptg000035l	6116070	6134279	18209	g_32409	g_12975
ptg000035l	6136003	6203916	67913	g_12975	g_5520
ptg000035l	6210075	6215128	5053	g_5520	g_23237
ptg000035l	6220426	6222065	1639	g_23237	g_26749
ptg000035l	6223610	6228675	5065	g_26749	g_32514
ptg000035l	6229640	6247666	18026	g_32514	g_14491
ptg000035l	6249022	6252219	3197	g_14491	g_9626
ptg000035l	6257555	6273006	15451	g_9626	g_37882
ptg000035l	6277591	6281640	4049	g_37882	g_11404
ptg000035l	6287072	6288190	1118	g_11404	g_19417
ptg000035l	6302117	6306289	4172	g_19417	g_13109
ptg000035l	6310649	6312328	1679	g_13109	g_36319
ptg000035l	6312645	6315412	2767	g_36319	g_23033
ptg000035l	6315675	6322848	7173	g_23033	g_8532
ptg000035l	6327737	6330263	2526	g_8532	g_6587
ptg000035l	6333126	6427646	94520	g_6587	g_1746
ptg000035l	6427903	6434523	6620	g_1746	g_778
ptg000035l	6434951	6437733	2782	g_778	g_4960
ptg000035l	6443108	6448910	5802	g_4960	g_19044
ptg000035l	6477345	6482662	5317	g_19044	g_18428
ptg000035l	6486200	6506321	20121	g_18428	g_10424
ptg000035l	6512572	6526130	13558	g_10424	g_32358
ptg000035l	6530561	6580622	50061	g_32358	g_19845
ptg000035l	6588062	6662914	74852	g_19845	g_2804
ptg000035l	6664053	6668896	4843	g_2804	g_38676
ptg000035l	6672691	6685424	12733	g_38676	g_12642
ptg000035l	6686179	6722237	36058	g_12642	g_28197
ptg000035l	6722554	6743076	20522	g_28197	g_33472
ptg000035l	6743831	6756144	12313	g_33472	g_3286
ptg000035l	6756899	6764011	7112	g_3286	g_26905
ptg000035l	6772665	6806893	34228	g_26905	g_22389
ptg000035l	6807210	6840820	33610	g_22389	g_785
ptg000035l	6841575	6873538	31963	g_785	g_28615
ptg000035l	6877994	6901104	23110	g_28615	g_5529
ptg000035l	6910856	6926029	15173	g_5529	g_1936
ptg000035l	6950001	6975176	25175	g_1936	g_15676
ptg000035l	6976063	6976404	341	g_15676	g_4155
ptg000035l	6978268	6992987	14719	g_4155	g_8748
ptg000035l	6997149	7013687	16538	g_8748	g_7190
ptg000035l	7018925	7027162	8237	g_7190	g_6146
ptg000035l	7027705	7142674	114969	g_6146	g_33241
ptg000035l	7158010	7173821	15811	g_33241	g_508
ptg000035l	7174834	7203201	28367	g_508	g_35277
ptg000035l	7203599	7235308	31709	g_35277	g_12901
ptg000035l	7260555	7268945	8390	g_12901	g_19389
ptg000035l	7279504	7283051	3547	g_19389	g_35222
ptg000035l	7283416	7285292	1876	g_35222	g_19653
ptg000035l	7295951	7350231	54280	g_19653	g_25187
ptg000035l	7350512	7365904	15392	g_25187	g_35056
ptg000035l	7367247	7383808	16561	g_35056	g_18741
ptg000035l	7384026	7458153	74127	g_18741	g_33280
ptg000035l	7458728	7468012	9284	g_33280	g_23922
ptg000035l	7468560	7629369	160809	g_23922	g_28
ptg000035l	7629572	7629922	350	g_28	g_16925
ptg000035l	7653138	7787489	134351	g_16925	g_3177
ptg000035l	7788397	7791772	3375	g_3177	g_3868
ptg000035l	7792691	7796271	3580	g_3868	g_20445
ptg000035l	7796741	7805033	8292	g_20445	g_39461
ptg000035l	7806070	7808586	2516	g_39461	g_33480
ptg000035l	7819025	7821961	2936	g_33480	g_21481
ptg000035l	7827035	7830775	3740	g_21481	g_11506
ptg000035l	7832238	7836519	4281	g_11506	g_9316
ptg000035l	7847039	7852574	5535	g_9316	g_34399
ptg000035l	7852792	8065731	212939	g_34399	g_15054
ptg000035l	8066852	8092915	26063	g_15054	g_2664
ptg000035l	8095335	8121265	25930	g_2664	g_24001
ptg000035l	8125509	8142566	17057	g_24001	g_5645
ptg000035l	8153792	8190916	37124	g_5645	g_33069
ptg000035l	8202435	8202853	418	g_33069	g_987
ptg000035l	8204777	8205414	637	g_987	g_16881
ptg000035l	8207436	8209017	1581	g_16881	g_25226
ptg000035l	8224899	8254043	29144	g_25226	g_24357
ptg000035l	8273499	8311499	38000	g_24357	g_27040
ptg000035l	8320157	8322844	2687	g_27040	g_2254
ptg000035l	8332907	8338597	5690	g_2254	g_25742
ptg000035l	8339190	8384829	45639	g_25742	g_1167
ptg000035l	8395671	8402194	6523	g_1167	g_7922
ptg000035l	8411875	8415397	3522	g_7922	g_27883
ptg000035l	8416064	8418378	2314	g_27883	g_32630
ptg000035l	8430879	8441854	10975	g_32630	g_21869
ptg000035l	8442876	8638080	195204	g_21869	g_31283
ptg000035l	8639978	8734568	94590	g_31283	g_6197
ptg000035l	8734858	8796956	62098	g_6197	g_21560
ptg000035l	8797258	8819716	22458	g_21560	g_17419
ptg000035l	8825282	8827401	2119	g_17419	g_35562
ptg000035l	8832686	8850002	17316	g_35562	g_9342
ptg000035l	8872947	8875468	2521	g_9342	g_36357
ptg000035l	8886984	8891429	4445	g_36357	g_16918
ptg000035l	8895948	8898119	2171	g_16918	g_14519
ptg000035l	8912961	8930333	17372	g_14519	g_19817
ptg000035l	8934124	8934826	702	g_19817	g_13815
ptg000035l	8937682	8940216	2534	g_13815	g_22458
ptg000035l	8950577	8952838	2261	g_22458	g_38198
ptg000035l	8957607	8960788	3181	g_38198	g_3257
ptg000035l	8966074	8969904	3830	g_3257	g_2079
ptg000035l	8974165	8990162	15997	g_2079	g_38077
ptg000035l	8991789	8997830	6041	g_38077	g_18619
ptg000035l	8998339	9023312	24973	g_18619	g_5074
ptg000035l	9024922	9097211	72289	g_5074	g_19647
ptg000035l	9101487	9104174	2687	g_19647	g_37284
ptg000035l	9114201	9121961	7760	g_37284	g_19609
ptg000035l	9122830	9139457	16627	g_19609	g_14329
ptg000035l	9139699	9167660	27961	g_14329	g_10952
ptg000035l	9176425	9179239	2814	g_10952	g_34002
ptg000035l	9180743	9183280	2537	g_34002	g_3140
ptg000035l	9185487	9188012	2525	g_3140	g_23526
ptg000035l	9196356	9360667	164311	g_23526	g_37673
ptg000035l	9365725	9421593	55868	g_37673	g_7341
ptg000035l	9438946	9469786	30840	g_7341	g_54
ptg000035l	9471626	9475214	3588	g_54	g_22815
ptg000035l	9476346	9484215	7869	g_22815	g_39105
ptg000035l	9484866	9486691	1825	g_39105	g_14895
ptg000035l	9487203	9492051	4848	g_14895	g_10754
ptg000035l	9493185	9498961	5776	g_10754	g_36746
ptg000035l	9500256	9504320	4064	g_36746	g_37289
ptg000035l	9505414	9512354	6940	g_37289	g_21355
ptg000035l	9513654	9516255	2601	g_21355	g_30865
ptg000035l	9517237	9527999	10762	g_30865	g_9007
ptg000035l	9532700	9557109	24409	g_9007	g_11638
ptg000035l	9561906	9566874	4968	g_11638	g_14999
ptg000035l	9570975	9574038	3063	g_14999	g_16905
ptg000035l	9590715	9604605	13890	g_16905	g_5983
ptg000035l	9617852	9619253	1401	g_5983	g_39321
ptg000035l	9626254	9631434	5180	g_5917	g_37335
ptg000035l	9634268	9657383	23115	g_37335	g_30017
ptg000035l	9660122	9704060	43938	g_30017	g_24984
ptg000035l	9704566	9900413	195847	g_24984	g_27974
ptg000035l	9903748	9914780	11032	g_27974	g_24643
ptg000035l	9916981	9928355	11374	g_24643	g_4415
ptg000035l	9932007	9933405	1398	g_4415	g_35520
ptg000035l	9935635	9959740	24105	g_35520	g_4855
ptg000035l	9962459	9963857	1398	g_4855	g_4498
ptg000035l	9966108	9975642	9534	g_4498	g_14125
ptg000035l	9977076	9980785	3709	g_14125	g_26375
ptg000035l	9982569	9983892	1323	g_26375	g_14074
ptg000035l	9985112	9989425	4313	g_14074	g_25585
ptg000035l	9990872	9994578	3706	g_25585	g_32340
ptg000035l	9996020	10001812	5792	g_32340	g_16715
ptg000035l	10003247	10005822	2575	g_16715	g_25833
ptg000035l	10007386	10010280	2894	g_25833	g_2449
ptg000035l	10010963	10024924	13961	g_2449	g_26392
ptg000035l	10026997	10030463	3466	g_26392	g_4925
ptg000035l	10036993	10080046	43053	g_4925	g_31296
ptg000035l	10080537	10084949	4412	g_31296	g_8105
ptg000035l	10101868	10157180	55312	g_8105	g_2307
ptg000035l	10157440	10171772	14332	g_2307	g_13243
ptg000035l	10180402	10308463	128061	g_13243	g_14615
ptg000035l	10312117	10323243	11126	g_14615	g_26704
ptg000035l	10325697	10356331	30634	g_26704	g_9640
ptg000035l	10359320	10377113	17793	g_9640	g_1183
ptg000035l	10378243	10389814	11571	g_1183	g_21614
ptg000035l	10390326	10393178	2852	g_21614	g_36274
ptg000035l	10395381	10399627	4246	g_36274	g_17710
ptg000035l	10402451	10440439	37988	g_17710	g_14492
ptg000035l	10440660	10514259	73599	g_14492	g_25217
ptg000035l	10515477	10606090	90613	g_25217	g_23109
ptg000035l	10631579	10782578	150999	g_23109	g_20950
ptg000035l	10806624	10808592	1968	g_20950	g_4585
ptg000035l	10817598	10822127	4529	g_4585	g_31163
ptg000035l	10842519	10882656	40137	g_31163	g_9502
ptg000035l	10897305	10944943	47638	g_9502	g_23482
ptg000035l	10946856	10954641	7785	g_23482	g_3634
ptg000035l	10972036	11043830	71794	g_3634	g_12618
ptg000035l	11046892	11051351	4459	g_12618	g_32126
ptg000035l	11068559	11092301	23742	g_32126	g_23083
ptg000035l	11092663	11195144	102481	g_23083	g_30270
ptg000035l	11201228	11207573	6345	g_30270	g_25316
ptg000035l	11215866	11216601	735	g_25316	g_23196
ptg000035l	11224756	11243533	18777	g_23196	g_10366
ptg000035l	11247231	11249196	1965	g_10366	g_30446
ptg000035l	11252028	11255471	3443	g_30446	g_15538
ptg000035l	11258636	11263184	4548	g_15538	g_1415
ptg000035l	11275217	11294940	19723	g_1415	g_24387
ptg000035l	11295768	11297930	2162	g_24387	g_19046
ptg000035l	11302735	11306667	3932	g_19046	g_14517
ptg000035l	11316706	11389802	73096	g_14517	g_6933
ptg000035l	11408142	11409846	1704	g_6933	g_25280
ptg000035l	11417564	11423222	5658	g_25280	g_12620
ptg000035l	11433381	11446766	13385	g_12620	g_13354
ptg000035l	11459926	11536792	76866	g_13354	g_11569
ptg000035l	11556521	11557299	778	g_11569	g_10495
ptg000035l	11569608	11587405	17797	g_10495	g_11459
ptg000035l	11597077	11600350	3273	g_11459	g_9155
ptg000035l	11603078	11605752	2674	g_9155	g_37062
ptg000035l	11627920	11636556	8636	g_37062	g_6248
ptg000035l	11636816	11700091	63275	g_6248	g_4726
ptg000035l	11715718	11727143	11425	g_4726	g_25825
ptg000035l	11731064	11742286	11222	g_25825	g_29781
ptg000035l	11753187	11758344	5157	g_29781	g_8361
ptg000035l	11768432	11774919	6487	g_8361	g_16680
ptg000035l	11783740	11789858	6118	g_16680	g_37409
ptg000035l	11792534	11795366	2832	g_37409	g_28823
ptg000035l	11800743	11809751	9008	g_28823	g_10649
ptg000035l	11866862	11874819	7957	g_10649	g_36569
ptg000035l	11900893	11902796	1903	g_36569	g_12887
ptg000035l	11905001	11914979	9978	g_12887	g_29612
ptg000035l	11921812	11922813	1001	g_29612	g_27307
ptg000035l	11932296	11943757	11461	g_27307	g_23268
ptg000035l	11948460	11950036	1576	g_23268	g_32424
ptg000035l	11953386	12066135	112749	g_32424	g_4468
ptg000035l	12072979	12079628	6649	g_4468	g_7758
ptg000035l	12080692	12128260	47568	g_7758	g_7140
ptg000035l	12132411	12133287	876	g_7140	g_37642
ptg000035l	12138369	12141023	2654	g_37642	g_9798
ptg000035l	12144524	12160699	16175	g_9798	g_22627
ptg000035l	12176461	12202034	25573	g_22627	g_28030
ptg000035l	12202342	12207119	4777	g_28030	g_18131
ptg000035l	12224908	12230188	5280	g_18131	g_33852
ptg000035l	12262581	12284814	22233	g_33852	g_29547
ptg000035l	12295670	12303860	8190	g_29547	g_2672
ptg000035l	12305758	12315688	9930	g_2672	g_15774
ptg000035l	12317725	12324708	6983	g_15774	g_8924
ptg000035l	12337062	12348168	11106	g_8924	g_2782
ptg000035l	12358369	12485099	126730	g_2782	g_5764
ptg000035l	12489441	12513095	23654	g_5764	g_17970
ptg000035l	12515968	12517943	1975	g_17970	g_6641
ptg000035l	12522295	12592264	69969	g_6641	g_22194
ptg000035l	12605164	12634042	28878	g_22194	g_10586
ptg000035l	12637132	12639037	1905	g_10586	g_22843
ptg000035l	12643461	12658894	15433	g_22843	g_19576
ptg000035l	12660856	12662375	1519	g_19576	g_28264
ptg000035l	12664800	12667864	3064	g_28264	g_12163
ptg000035l	12670038	12673040	3002	g_12163	g_2127
ptg000035l	12681189	12684125	2936	g_2127	g_35237
ptg000035l	12686574	12689605	3031	g_35237	g_13339
ptg000035l	12723581	12743057	19476	g_13339	g_21652
ptg000035l	12744094	12816653	72559	g_21652	g_1593
ptg000035l	12820429	13144827	324398	g_1593	g_9395
ptg000035l	13171620	13180316	8696	g_9395	g_20315
ptg000035l	13192695	13216075	23380	g_20315	g_1196
ptg000035l	13216326	13229623	13297	g_1196	g_29586
ptg000035l	13229844	13244724	14880	g_29586	g_29951
ptg000035l	13245719	13306193	60474	g_29951	g_15896
ptg000035l	13370165	13434312	64147	g_15896	g_5591
ptg000035l	13435070	13444662	9592	g_5591	g_2521
ptg000035l	13445051	13457363	12312	g_2521	g_6473
ptg000035l	13457593	13541651	84058	g_6473	g_26521
ptg000035l	13545941	13557006	11065	g_26521	g_11729
ptg000035l	13561050	13791118	230068	g_11729	g_26706
ptg000035l	13792738	13795480	2742	g_26706	g_9212
ptg000035l	13797677	13806966	9289	g_9212	g_2586
ptg000035l	13820495	13896257	75762	g_2586	g_3559
ptg000035l	13897983	13971573	73590	g_3559	g_11083
ptg000035l	13979508	13985835	6327	g_11083	g_6390
ptg000035l	13995110	14018664	23554	g_6390	g_37010
ptg000035l	14035272	14077736	42464	g_37010	g_19484
ptg000035l	14079547	14151006	71459	g_19484	g_26038
ptg000035l	14154417	14164251	9834	g_26038	g_7074
ptg000035l	14166669	14346085	179416	g_7074	g_29220
ptg000035l	14359819	14437835	78016	g_29220	g_18374
ptg000035l	14443758	14449995	6237	g_18374	g_4144
ptg000035l	14450282	14460947	10665	g_4144	g_36695
ptg000035l	14468604	14513710	45106	g_36695	g_33195
ptg000035l	14515254	14540494	25240	g_33195	g_3848
ptg000035l	14541760	14547306	5546	g_3848	g_20325
ptg000035l	14547689	14817899	270210	g_20325	g_14198
ptg000035l	14823995	14824541	546	g_14198	g_19818
ptg000035l	14831126	14866365	35239	g_19818	g_8601
ptg000035l	14906550	14910885	4335	g_8601	g_6007
ptg000035l	14936102	14944764	8662	g_6007	g_27317
ptg000035l	14948240	15386857	438617	g_27317	g_25093
ptg000035l	15387309	15418048	30739	g_25093	g_35248
ptg000035l	15418260	15547931	129671	g_35248	g_10026
ptg000035l	15548209	15548302	93	g_10026	g_3090
ptg000035l	15548589	15610978	62389	g_3090	g_18765
ptg000035l	15611184	15625989	14805	g_18765	g_2303
ptg000035l	15626258	15627469	1211	g_2303	g_23527
ptg000035l	15651847	15733291	81444	g_23527	g_7779
ptg000035l	15745088	15746545	1457	g_7779	g_77
ptg000035l	15754062	15764804	10742	g_77	g_25656
ptg000035l	15765028	15765072	44	g_25656	g_22717
ptg000035l	15765575	15807198	41623	g_22717	g_23133
ptg000035l	15807434	15807456	22	g_23133	g_10518
ptg000035l	15808112	15808156	44	g_10518	g_9324
ptg000035l	15808533	15809311	778	g_9324	g_20029
ptg000035l	15809769	15813989	4220	g_20029	g_26001
ptg000035l	15826218	15887640	61422	g_26001	g_15981
ptg000035l	15900562	15903663	3101	g_15981	g_5420
ptg000035l	15904202	15986509	82307	g_5420	g_37154
ptg000035l	15989674	16065112	75438	g_37154	g_13943
ptg000035l	16065846	16080545	14699	g_13943	g_21795
ptg000035l	16080949	16099829	18880	g_21795	g_14137
ptg000035l	16100848	16159474	58626	g_14137	g_21532
ptg000035l	16169809	16193928	24119	g_21532	g_32815
ptg000035l	16210635	16221629	10994	g_32815	g_8043
ptg000035l	16227776	16341090	113314	g_8043	g_15849
ptg000035l	16341728	16355516	13788	g_15849	g_29600
ptg000035l	16356133	16425277	69144	g_29600	g_13485
ptg000035l	16425690	16432769	7079	g_13485	g_18891
ptg000035l	16435899	16460734	24835	g_18891	g_28828
ptg000035l	16461042	16464606	3564	g_28828	g_14905
ptg000036l	2045	15426	13381	g_37518	g_33457
ptg000036l	89295	179579	90284	g_33457	g_2029
ptg000036l	186071	196194	10123	g_2029	g_36065
ptg000036l	209831	243171	33340	g_36065	g_38558
ptg000036l	244844	253375	8531	g_38558	g_32784
ptg000036l	256935	258376	1441	g_32784	g_7496
ptg000036l	259254	287309	28055	g_7496	g_25899
ptg000036l	287560	296386	8826	g_25899	g_19089
ptg000036l	296700	309445	12745	g_19089	g_10272
ptg000036l	318066	368333	50267	g_10272	g_34487
ptg000036l	370524	376214	5690	g_34487	g_40174
ptg000036l	379760	382917	3157	g_40174	g_17704
ptg000036l	393974	429391	35417	g_17704	g_30831
ptg000036l	444554	469490	24936	g_30831	g_30707
ptg000036l	475556	528526	52970	g_30707	g_37333
ptg000036l	536645	547015	10370	g_37333	g_36366
ptg000036l	550062	586170	36108	g_36366	g_9689
ptg000036l	586757	599241	12484	g_9689	g_10132
ptg000036l	610621	613937	3316	g_10132	g_1348
ptg000036l	627204	683706	56502	g_1348	g_19957
ptg000036l	684044	684089	45	g_19957	g_21123
ptg000036l	684778	684823	45	g_21123	g_32753
ptg000036l	686253	713385	27132	g_32753	g_31636
ptg000036l	714602	761164	46562	g_31636	g_10425
ptg000036l	761490	797554	36064	g_10425	g_28707
ptg000036l	818578	829738	11160	g_28707	g_24649
ptg000036l	830433	897445	67012	g_24649	g_11052
ptg000036l	911961	995361	83400	g_11052	g_31292
ptg000036l	1008482	1022980	14498	g_31292	g_37850
ptg000036l	1037217	1088690	51473	g_37850	g_7183
ptg000036l	1088947	1206393	117446	g_7183	g_5998
ptg000036l	1206818	1223904	17086	g_5998	g_34536
ptg000036l	1236131	1273991	37860	g_34536	g_20014
ptg000036l	1275658	1290517	14859	g_20014	g_10893
ptg000036l	1303004	1368029	65025	g_10893	g_18038
ptg000036l	1369075	1396236	27161	g_18038	g_19625
ptg000036l	1396550	1415780	19230	g_19625	g_18569
ptg000036l	1416430	1418608	2178	g_18569	g_17641
ptg000036l	1418982	1423090	4108	g_17641	g_29961
ptg000036l	1424334	1424406	72	g_29961	g_28304
ptg000036l	1426259	1469584	43325	g_28304	g_14516
ptg000036l	1470009	1479015	9006	g_14516	g_10899
ptg000036l	1479467	1512947	33480	g_10899	g_25503
ptg000037l	155740	161757	6017	g_17476	g_20104
ptg000037l	162300	168394	6094	g_20104	g_32243
ptg000037l	168937	198273	29336	g_32243	g_14172
ptg000037l	199025	265423	66398	g_14172	g_25960
ptg000037l	274284	274864	580	g_25960	g_40260
ptg000037l	278392	283553	5161	g_40260	g_17603
ptg000037l	289940	342345	52405	g_17603	g_9988
ptg000037l	351732	354598	2866	g_9988	g_33002
ptg000037l	354972	359054	4082	g_33002	g_5940
ptg000037l	359950	361151	1201	g_5940	g_4065
ptg000037l	362179	367194	5015	g_4065	g_28766
ptg000037l	370768	376225	5457	g_28766	g_24461
ptg000037l	386459	414278	27819	g_24461	g_27629
ptg000037l	425449	446219	20770	g_27629	g_35223
ptg000037l	446956	460468	13512	g_35223	g_5597
ptg000037l	460926	478406	17480	g_5597	g_12841
ptg000037l	499196	544839	45643	g_12841	g_20682
ptg000037l	572425	641447	69022	g_20682	g_4813
ptg000037l	642595	685634	43039	g_4813	g_14566
ptg000037l	685972	727052	41080	g_14566	g_28844
ptg000037l	782620	789398	6778	g_28844	g_10964
ptg000037l	793138	895092	101954	g_10964	g_22665
ptg000037l	895670	917696	22026	g_22665	g_7238
ptg000037l	921554	928716	7162	g_7238	g_34449
ptg000037l	945983	1036007	90024	g_34449	g_6115
ptg000037l	1051414	1070618	19204	g_6115	g_29620
ptg000037l	1074232	1130303	56071	g_29620	g_17586
ptg000037l	1157959	1173867	15908	g_17586	g_13820
ptg000037l	1181003	1201737	20734	g_13820	g_28624
ptg000037l	1204145	1409690	205545	g_28624	g_7142
ptg000037l	1410883	1572390	161507	g_7142	g_36414
ptg000037l	1586577	1594550	7973	g_36414	g_40291
ptg000037l	1598224	1687037	88813	g_40291	g_9866
ptg000037l	1692572	1715404	22832	g_9866	g_13295
ptg000037l	1734551	1736788	2237	g_13295	g_29815
ptg000037l	1743777	1748490	4713	g_29815	g_37972
ptg000037l	1761867	1876619	114752	g_37972	g_22235
ptg000037l	1892150	1901337	9187	g_22235	g_3721
ptg000037l	1909050	1949796	40746	g_3721	g_1113
ptg000037l	1950110	1950155	45	g_1113	g_6696
ptg000037l	1950523	2061258	110735	g_6696	g_23491
ptg000037l	2075229	2140125	64896	g_23491	g_25343
ptg000037l	2140430	2224241	83811	g_25343	g_34634
ptg000037l	2224816	2226549	1733	g_34634	g_8658
ptg000037l	2226929	2231152	4223	g_8658	g_21078
ptg000037l	2231445	2349863	118418	g_21078	g_19811
ptg000037l	2351316	2368809	17493	g_19811	g_20749
ptg000037l	2376026	2376443	417	g_20749	g_15416
ptg000037l	2380228	2383181	2953	g_15416	g_4044
ptg000037l	2390096	2410841	20745	g_4044	g_13971
ptg000037l	2413873	2421679	7806	g_13971	g_29503
ptg000037l	2422023	2519537	97514	g_29503	g_23134
ptg000037l	2540810	2543806	2996	g_23134	g_27557
ptg000037l	2546737	2548103	1366	g_27557	g_29311
ptg000037l	2551698	2555454	3756	g_29311	g_3599
ptg000037l	2566817	2597644	30827	g_3599	g_6984
ptg000037l	2638673	2639735	1062	g_6984	g_34761
ptg000037l	2645213	2783618	138405	g_34761	g_16165
ptg000037l	2787774	2849978	62204	g_16165	g_5012
ptg000037l	2850343	2856022	5679	g_5012	g_6773
ptg000037l	2866248	2885661	19413	g_6773	g_24168
ptg000037l	2895875	2943202	47327	g_24168	g_35163
ptg000037l	2953453	2961732	8279	g_35163	g_32482
ptg000037l	2981673	2984162	2489	g_32482	g_22689
ptg000037l	2987475	2990358	2883	g_22689	g_26573
ptg000037l	2999670	3013550	13880	g_26573	g_6729
ptg000037l	3019877	3020687	810	g_6729	g_12855
ptg000037l	3022803	3025209	2406	g_12855	g_15734
ptg000037l	3041561	3050451	8890	g_15734	g_21616
ptg000037l	3055998	3075185	19187	g_21616	g_33763
ptg000037l	3075670	3208123	132453	g_33763	g_37348
ptg000037l	3239654	3240429	775	g_37348	g_37271
ptg000037l	3241619	3281203	39584	g_37271	g_21865
ptg000037l	3284465	3291983	7518	g_21865	g_27912
ptg000037l	3295460	3300694	5234	g_27912	g_33448
ptg000037l	3305938	3307347	1409	g_33448	g_25881
ptg000037l	3323358	3330305	6947	g_25881	g_24930
ptg000037l	3338106	3354937	16831	g_24930	g_22810
ptg000037l	3377559	3404401	26842	g_22810	g_12504
ptg000037l	3406098	3465134	59036	g_12504	g_18558
ptg000037l	3487502	3520605	33103	g_18558	g_2529
ptg000037l	3521021	3535296	14275	g_2529	g_29954
ptg000037l	3543757	3555991	12234	g_29954	g_17184
ptg000037l	3563971	3569428	5457	g_17184	g_11247
ptg000037l	3569628	3580768	11140	g_11247	g_31308
ptg000037l	3582498	3585619	3121	g_31308	g_37439
ptg000037l	3593163	3708763	115600	g_37439	g_7301
ptg000037l	3717409	3721477	4068	g_7301	g_40030
ptg000037l	3721707	3767181	45474	g_40030	g_25857
ptg000037l	3768941	3769078	137	g_25857	g_37019
ptg000037l	3776035	3777195	1160	g_20539	g_13355
ptg000037l	3787394	3787902	508	g_13355	g_22113
ptg000037l	3808756	3860302	51546	g_22113	g_26019
ptg000037l	3870080	3871594	1514	g_26019	g_34682
ptg000037l	3873300	3908598	35298	g_34682	g_37555
ptg000037l	3915378	3919458	4080	g_37555	g_630
ptg000037l	3926967	3927155	188	g_630	g_30344
ptg000037l	3933634	4042052	108418	g_30344	g_35542
ptg000037l	4042312	4114782	72470	g_35542	g_18982
ptg000037l	4117492	4139054	21562	g_18982	g_8925
ptg000037l	4141607	4261529	119922	g_8925	g_15866
ptg000037l	4277405	4280716	3311	g_15866	g_36517
ptg000037l	4283832	4324779	40947	g_36517	g_11275
ptg000037l	4337605	4342085	4480	g_11275	g_28164
ptg000037l	4342684	4347585	4901	g_28164	g_31002
ptg000037l	4356909	4360460	3551	g_31002	g_3051
ptg000037l	4368327	4526488	158161	g_3051	g_36608
ptg000037l	4529404	4535235	5831	g_36608	g_17944
ptg000037l	4543517	4551468	7951	g_17944	g_25342
ptg000037l	4554476	4557192	2716	g_25342	g_19265
ptg000037l	4574684	4635966	61282	g_19265	g_34054
ptg000037l	4636277	4676170	39893	g_34054	g_9714
ptg000037l	4693498	4698544	5046	g_9714	g_13392
ptg000037l	4714273	4720269	5996	g_13392	g_18210
ptg000037l	4720697	4739815	19118	g_18210	g_31216
ptg000037l	4753419	4784165	30746	g_31216	g_33007
ptg000037l	4785034	4803285	18251	g_33007	g_29980
ptg000037l	4804061	4838551	34490	g_29980	g_5264
ptg000037l	4856737	4858933	2196	g_5264	g_1888
ptg000037l	4884406	4892993	8587	g_1888	g_26266
ptg000037l	4898126	4917985	19859	g_26266	g_28600
ptg000037l	4918263	4938974	20711	g_28600	g_12176
ptg000037l	4939252	4974758	35506	g_12176	g_37914
ptg000037l	4975018	5033158	58140	g_37914	g_15399
ptg000037l	5044849	5049413	4564	g_15399	g_14306
ptg000037l	5070837	5075181	4344	g_14306	g_34530
ptg000037l	5089538	5158886	69348	g_34530	g_21419
ptg000037l	5160805	5446083	285278	g_21419	g_25023
ptg000037l	5446652	5504894	58242	g_25023	g_19437
ptg000037l	5507892	5513434	5542	g_19437	g_20293
ptg000037l	5513658	5516346	2688	g_20293	g_14818
ptg000037l	5521670	5523332	1662	g_14818	g_11297
ptg000037l	5526915	5528402	1487	g_11297	g_20224
ptg000037l	5536916	5537986	1070	g_20224	g_22791
ptg000037l	5542770	5558513	15743	g_22791	g_18020
ptg000037l	5576213	5577676	1463	g_18020	g_12625
ptg000037l	5593943	5598880	4937	g_12625	g_4879
ptg000037l	5678369	5791285	112916	g_4879	g_19512
ptg000037l	5793207	5834385	41178	g_19512	g_32952
ptg000037l	5834963	5842350	7387	g_32952	g_29486
ptg000037l	5852407	5897846	45439	g_29486	g_20344
ptg000037l	5900356	5965745	65389	g_20344	g_9270
ptg000037l	5979058	6002427	23369	g_9270	g_21338
ptg000037l	6008788	6015294	6506	g_21338	g_23744
ptg000037l	6028893	6049954	21061	g_23744	g_9500
ptg000037l	6050307	6105909	55602	g_39446	g_21729
ptg000037l	6106223	6188123	81900	g_21729	g_21820
ptg000037l	6194198	6239969	45771	g_21820	g_27792
ptg000037l	6247811	6294398	46587	g_27792	g_18772
ptg000037l	6313117	6314247	1130	g_18772	g_15713
ptg000037l	6322010	6323728	1718	g_15713	g_19470
ptg000037l	6326225	6352155	25930	g_19470	g_26813
ptg000037l	6353933	6372265	18332	g_26813	g_22356
ptg000037l	6374093	6380806	6713	g_22356	g_6045
ptg000037l	6382285	6470509	88224	g_6045	g_12488
ptg000037l	6473366	6489089	15723	g_12488	g_8625
ptg000037l	6502379	6530359	27980	g_8625	g_37009
ptg000037l	6532468	6563936	31468	g_37009	g_38287
ptg000037l	6574903	6588949	14046	g_38287	g_39036
ptg000037l	6597924	6603258	5334	g_21549	g_12612
ptg000037l	6617078	6621699	4621	g_12612	g_8349
ptg000037l	6634993	6696958	61965	g_8349	g_22487
ptg000037l	6708182	6710150	1968	g_22487	g_16311
ptg000037l	6710353	6835039	124686	g_16311	g_39965
ptg000037l	6837224	6837631	407	g_39965	g_3479
ptg000037l	6838917	6842578	3661	g_3479	g_1840
ptg000037l	6862916	6921833	58917	g_1840	g_7259
ptg000037l	6922048	6934814	12766	g_7259	g_35301
ptg000037l	6944740	6960156	15416	g_35301	g_18301
ptg000037l	6960542	6963276	2734	g_18301	g_39647
ptg000037l	6963512	7040355	76843	g_39647	g_12471
ptg000037l	7050152	7091052	40900	g_12471	g_25980
ptg000037l	7091276	7099782	8506	g_25980	g_24973
ptg000037l	7104701	7117317	12616	g_24973	g_12496
ptg000037l	7118223	7122607	4384	g_12496	g_16046
ptg000037l	7125113	7134885	9772	g_16046	g_10984
ptg000037l	7136075	7137908	1833	g_10984	g_11101
ptg000037l	7140951	7143507	2556	g_11101	g_23347
ptg000037l	7149335	7154391	5056	g_23347	g_35110
ptg000037l	7168691	7203038	34347	g_35110	g_40262
ptg000037l	7203799	7213718	9919	g_40262	g_26705
ptg000037l	7240917	7248226	7309	g_26705	g_7735
ptg000037l	7264176	7331195	67019	g_7735	g_24109
ptg000037l	7355536	7363120	7584	g_24109	g_10088
ptg000037l	7381968	7395320	13352	g_10088	g_7382
ptg000037l	7406041	7408968	2927	g_7382	g_9493
ptg000037l	7428407	7431751	3344	g_9493	g_35130
ptg000037l	7443308	7461971	18663	g_35130	g_3365
ptg000037l	7463082	7463250	168	g_3365	g_9958
ptg000037l	7481637	7481881	244	g_9958	g_35147
ptg000037l	7485760	7486972	1212	g_35147	g_32892
ptg000037l	7488588	7538483	49895	g_32892	g_3922
ptg000037l	7548191	7551746	3555	g_3922	g_16201
ptg000037l	7569412	7572704	3292	g_16201	g_568
ptg000037l	7578412	7579345	933	g_568	g_20645
ptg000037l	7583055	7598416	15361	g_20645	g_24895
ptg000037l	7603204	7618438	15234	g_24895	g_181
ptg000037l	7618725	7729430	110705	g_181	g_5421
ptg000037l	7729657	7747228	17571	g_5421	g_3067
ptg000037l	7752570	7844256	91686	g_3067	g_10823
ptg000037l	7860950	7987343	126393	g_10823	g_32233
ptg000037l	7991588	8010490	18902	g_32233	g_23599
ptg000037l	8014938	8087827	72889	g_23599	g_37891
ptg000037l	8095230	8097718	2488	g_37891	g_12861
ptg000037l	8101877	8133846	31969	g_12861	g_16897
ptg000037l	8134079	8155020	20941	g_16897	g_13275
ptg000037l	8158421	8161146	2725	g_13275	g_9448
ptg000037l	8169945	8171488	1543	g_9448	g_5693
ptg000037l	8174246	8250013	75767	g_5693	g_29667
ptg000037l	8252061	8352432	100371	g_29667	g_35930
ptg000037l	8352644	8362876	10232	g_35930	g_36761
ptg000037l	8364438	8364842	404	g_36761	g_20175
ptg000037l	8366743	8479426	112683	g_20175	g_34466
ptg000037l	8498638	8507782	9144	g_34466	g_13918
ptg000037l	8526258	8647303	121045	g_13918	g_24439
ptg000037l	8656516	8692105	35589	g_24439	g_17828
ptg000037l	8693967	8698033	4066	g_17828	g_4418
ptg000037l	8709432	8825998	116566	g_4418	g_28515
ptg000037l	8829656	8832571	2915	g_28515	g_14193
ptg000037l	8834792	8836220	1428	g_14193	g_18462
ptg000037l	8841187	8843425	2238	g_18462	g_40189
ptg000037l	8845358	8852219	6861	g_40189	g_9312
ptg000037l	8869648	8878773	9125	g_9312	g_13049
ptg000037l	8878979	8892878	13899	g_13049	g_27209
ptg000037l	8896982	8897261	279	g_27209	g_29719
ptg000037l	8899403	8906190	6787	g_29719	g_22254
ptg000037l	8910869	8915175	4306	g_22254	g_24801
ptg000037l	8919794	8925669	5875	g_24801	g_20843
ptg000037l	8932518	8936156	3638	g_20843	g_23261
ptg000037l	8937671	9045555	107884	g_23261	g_21681
ptg000037l	9045767	9059562	13795	g_21681	g_33485
ptg000037l	9059774	9112882	53108	g_33485	g_13419
ptg000037l	9115358	9124560	9202	g_13419	g_4067
ptg000037l	9136015	9140136	4121	g_4067	g_30569
ptg000037l	9142597	9144383	1786	g_30569	g_1764
ptg000037l	9148028	9151716	3688	g_1764	g_34176
ptg000037l	9156399	9161436	5037	g_34176	g_14225
ptg000037l	9163025	9172410	9385	g_14225	g_33964
ptg000037l	9172640	9172849	209	g_33964	g_25891
ptg000037l	9174408	9176137	1729	g_25891	g_32834
ptg000037l	9181789	9188178	6389	g_32834	g_37191
ptg000037l	9202752	9206245	3493	g_37191	g_9020
ptg000037l	9226118	9265219	39101	g_9020	g_13144
ptg000037l	9270845	9275353	4508	g_13144	g_23817
ptg000037l	9279650	9281995	2345	g_23817	g_13850
ptg000037l	9312337	9321244	8907	g_13850	g_31672
ptg000037l	9335481	9360565	25084	g_31672	g_12730
ptg000037l	9371144	9385012	13868	g_12730	g_11668
ptg000037l	9401717	9411530	9813	g_11668	g_10423
ptg000037l	9425939	9479876	53937	g_10423	g_35082
ptg000037l	9483634	9487487	3853	g_35082	g_5684
ptg000037l	9502046	9506240	4194	g_5684	g_30646
ptg000037l	9510349	9515603	5254	g_30646	g_37360
ptg000037l	9517209	9522436	5227	g_37360	g_38251
ptg000037l	9523626	9531851	8225	g_38251	g_33886
ptg000037l	9543425	9547802	4377	g_33886	g_12412
ptg000037l	9565781	9568337	2556	g_12412	g_40110
ptg000037l	9571530	9575921	4391	g_40110	g_2358
ptg000037l	9577591	9582041	4450	g_2358	g_7073
ptg000037l	9586294	9603432	17138	g_7073	g_17087
ptg000037l	9603770	9617124	13354	g_17087	g_20958
ptg000037l	9631828	9634197	2369	g_20958	g_13249
ptg000037l	9637035	9638418	1383	g_13249	g_17185
ptg000037l	9642100	9645593	3493	g_17185	g_15913
ptg000037l	9652512	9655858	3346	g_15913	g_38167
ptg000037l	9664287	9687408	23121	g_38167	g_32164
ptg000037l	9691504	9694889	3385	g_32164	g_25462
ptg000037l	9702278	9705943	3665	g_25462	g_11609
ptg000037l	9715781	9794290	78509	g_11609	g_11610
ptg000037l	9803446	9806269	2823	g_11610	g_12487
ptg000037l	9816146	9818723	2577	g_12487	g_26439
ptg000037l	9826253	9830179	3926	g_26439	g_31047
ptg000037l	9832908	9845056	12148	g_31047	g_30885
ptg000037l	9845607	9924344	78737	g_30885	g_35822
ptg000037l	9944677	9974944	30267	g_35822	g_21699
ptg000037l	9975456	10003149	27693	g_21699	g_22756
ptg000037l	10014832	10034911	20079	g_22756	g_11850
ptg000037l	10049710	10061884	12174	g_11850	g_13135
ptg000037l	10078741	10096571	17830	g_13135	g_24714
ptg000037l	10115840	10124901	9061	g_24714	g_198
ptg000037l	10125832	10129912	4080	g_198	g_39900
ptg000037l	10136916	10144677	7761	g_39900	g_6087
ptg000037l	10149591	10173959	24368	g_6087	g_1960
ptg000037l	10176189	10184074	7885	g_1960	g_12715
ptg000037l	10190159	10193318	3159	g_12715	g_23536
ptg000037l	10205608	10247671	42063	g_23536	g_8760
ptg000037l	10256043	10263676	7633	g_8760	g_6052
ptg000037l	10268063	10268167	104	g_6052	g_40006
ptg000037l	10269528	10270409	881	g_40006	g_7048
ptg000037l	10273237	10276298	3061	g_7048	g_28449
ptg000037l	10277909	10281484	3575	g_28449	g_33721
ptg000037l	10283731	10309120	25389	g_33721	g_31753
ptg000037l	10310538	10386028	75490	g_31753	g_34238
ptg000037l	10400323	10406522	6199	g_34238	g_2537
ptg000037l	10413045	10430519	17474	g_2537	g_9946
ptg000037l	10449923	10456491	6568	g_9946	g_15805
ptg000037l	10457918	10460134	2216	g_15805	g_2016
ptg000037l	10462689	10464152	1463	g_2016	g_21577
ptg000037l	10466533	10469256	2723	g_21577	g_21378
ptg000037l	10477010	10572003	94993	g_21378	g_28454
ptg000037l	10572206	10591620	19414	g_28454	g_16622
ptg000037l	10595859	10658937	63078	g_16622	g_2759
ptg000037l	10669642	10675841	6199	g_2759	g_7004
ptg000037l	10689599	10699264	9665	g_7004	g_25022
ptg000037l	10704212	10706918	2706	g_25022	g_921
ptg000037l	10716956	10719784	2828	g_921	g_17296
ptg000037l	10722876	10730632	7756	g_17296	g_35303
ptg000037l	10738582	10741905	3323	g_35303	g_21076
ptg000037l	10748439	10752827	4388	g_21076	g_25337
ptg000037l	10753822	10757413	3591	g_25337	g_4940
ptg000037l	10759810	10766453	6643	g_4940	g_39987
ptg000037l	10767817	10769237	1420	g_39987	g_35723
ptg000037l	10778832	10780945	2113	g_35723	g_37782
ptg000037l	10781205	10785797	4592	g_37782	g_23632
ptg000037l	10801816	10804443	2627	g_23632	g_27381
ptg000037l	10806521	10872750	66229	g_27381	g_9017
ptg000037l	10878190	10880413	2223	g_9017	g_29648
ptg000037l	10890436	10893749	3313	g_29648	g_13577
ptg000037l	10897126	10927015	29889	g_13577	g_30860
ptg000037l	10927818	10929156	1338	g_30860	g_16826
ptg000037l	10940205	10943114	2909	g_16826	g_6836
ptg000037l	10950073	10952319	2246	g_6836	g_12252
ptg000037l	10955081	10972051	16970	g_12252	g_30062
ptg000037l	10976352	10979691	3339	g_30062	g_18651
ptg000037l	10993321	11020448	27127	g_18651	g_2386
ptg000037l	11025026	11069136	44110	g_2386	g_9235
ptg000037l	11073842	11082739	8897	g_38591	g_19524
ptg000037l	11084284	11088739	4455	g_19524	g_10957
ptg000037l	11089565	11097176	7611	g_39083	g_20343
ptg000037l	11100708	11101558	850	g_20343	g_40209
ptg000037l	11105804	11107869	2065	g_40209	g_12953
ptg000037l	11109593	11110857	1264	g_12953	g_23724
ptg000037l	11111318	11112142	824	g_23724	g_7429
ptg000037l	11117185	11123146	5961	g_7429	g_13698
ptg000037l	11123850	11130863	7013	g_13698	g_5743
ptg000037l	11131189	11143592	12403	g_5743	g_16452
ptg000037l	11144784	11150743	5959	g_16452	g_15757
ptg000037l	11160287	11171578	11291	g_15757	g_11558
ptg000037l	11175988	11181151	5163	g_11558	g_1034
ptg000037l	11185003	11200680	15677	g_1034	g_5314
ptg000037l	11221887	11225025	3138	g_5314	g_10077
ptg000037l	11228425	11230530	2105	g_10077	g_37302
ptg000037l	11238216	11240091	1875	g_37302	g_14666
ptg000037l	11241618	11243745	2127	g_14666	g_35050
ptg000037l	11245108	11246961	1853	g_35050	g_19531
ptg000037l	11247768	11252405	4637	g_19531	g_21226
ptg000037l	11254680	11262650	7970	g_21226	g_35209
ptg000037l	11264005	11290057	26052	g_35209	g_38019
ptg000037l	11300656	11304934	4278	g_38019	g_1702
ptg000037l	11305340	11307700	2360	g_1702	g_31316
ptg000037l	11316078	11322972	6894	g_31316	g_37253
ptg000037l	11324555	11326195	1640	g_37253	g_8981
ptg000037l	11331899	11335199	3300	g_8981	g_20193
ptg000037l	11342975	11347236	4261	g_20193	g_9638
ptg000037l	11356609	11363838	7229	g_9638	g_39906
ptg000037l	11371315	11374090	2775	g_39906	g_409
ptg000037l	11376092	11388047	11955	g_409	g_27746
ptg000037l	11407977	11528490	120513	g_27746	g_541
ptg000037l	11533790	11568694	34904	g_541	g_34921
ptg000037l	11577496	11589254	11758	g_34921	g_21515
ptg000037l	11600934	11609441	8507	g_21515	g_35366
ptg000037l	11616979	11645403	28424	g_35366	g_106
ptg000037l	11657265	11660170	2905	g_106	g_3355
ptg000037l	11689306	11714975	25669	g_3355	g_17526
ptg000037l	11733326	11777904	44578	g_17526	g_25422
ptg000037l	11786823	11789598	2775	g_25422	g_8729
ptg000037l	11790945	11796117	5172	g_8729	g_26149
ptg000037l	11814754	11922823	108069	g_26149	g_25035
ptg000037l	11926132	11936395	10263	g_25035	g_8187
ptg000037l	11939396	12116248	176852	g_8187	g_28013
ptg000037l	12116544	12174829	58285	g_28013	g_15727
ptg000037l	12175062	12188259	13197	g_15727	g_16685
ptg000037l	12189038	12233346	44308	g_16685	g_31842
ptg000037l	12294804	12378765	83961	g_31842	g_17853
ptg000037l	12387529	12468109	80580	g_17853	g_5852
ptg000037l	12474582	12479722	5140	g_5852	g_39729
ptg000037l	12480708	12499723	19015	g_39729	g_10183
ptg000037l	12518125	12523321	5196	g_10183	g_8443
ptg000037l	12529393	12530681	1288	g_8443	g_20115
ptg000037l	12543435	12544080	645	g_20115	g_24058
ptg000037l	12547016	12549525	2509	g_24058	g_26244
ptg000037l	12569375	12632518	63143	g_26244	g_16521
ptg000037l	12637208	12640139	2931	g_16521	g_32749
ptg000037l	12660135	12662465	2330	g_32749	g_17773
ptg000037l	12665662	12680618	14956	g_17773	g_14230
ptg000037l	12695357	12751660	56303	g_14230	g_29009
ptg000037l	12775135	12777782	2647	g_29009	g_3935
ptg000037l	12779425	12781318	1893	g_3935	g_10779
ptg000037l	12785582	12956864	171282	g_10779	g_29800
ptg000037l	12957688	13341949	384261	g_29800	g_437
ptg000037l	13344311	13352709	8398	g_437	g_32256
ptg000037l	13364147	13369630	5483	g_32256	g_32329
ptg000037l	13374991	13395271	20280	g_32329	g_30550
ptg000037l	13404989	13406671	1682	g_30550	g_26938
ptg000037l	13413959	13432456	18497	g_26938	g_14690
ptg000037l	13433340	13478664	45324	g_14690	g_40192
ptg000037l	13501266	13520384	19118	g_40192	g_35581
ptg000037l	13520593	13530657	10064	g_35581	g_18752
ptg000037l	13547540	13547576	36	g_18752	g_37329
ptg000037l	13547848	13561196	13348	g_37329	g_24288
ptg000037l	13568502	13571303	2801	g_24288	g_8136
ptg000037l	13582036	13597700	15664	g_8136	g_15059
ptg000037l	13618159	13631102	12943	g_15059	g_7740
ptg000037l	13642646	13645729	3083	g_7740	g_17120
ptg000037l	13646496	13659619	13123	g_17120	g_25780
ptg000037l	13662397	13727075	64678	g_25780	g_10749
ptg000037l	13740099	13754131	14032	g_10749	g_32027
ptg000037l	13765188	13769713	4525	g_32027	g_14537
ptg000037l	13769937	13770556	619	g_14537	g_10027
ptg000037l	13774206	13859297	85091	g_10027	g_27056
ptg000037l	13870955	13874808	3853	g_27056	g_19544
ptg000037l	13885338	13885713	375	g_19544	g_12918
ptg000037l	13886039	13887916	1877	g_12918	g_40117
ptg000037l	13896548	13899516	2968	g_40117	g_3329
ptg000037l	13902959	13911739	8780	g_3329	g_4831
ptg000037l	13925837	14051070	125233	g_4831	g_6379
ptg000037l	14053297	14055263	1966	g_6379	g_7863
ptg000037l	14068552	14103191	34639	g_7863	g_12033
ptg000037l	14107710	14114494	6784	g_12033	g_29987
ptg000037l	14116194	14119485	3291	g_29987	g_781
ptg000037l	14123036	14137664	14628	g_781	g_28466
ptg000037l	14138106	14147646	9540	g_28466	g_39315
ptg000037l	14147981	14149362	1381	g_39315	g_31789
ptg000037l	14156149	14162466	6317	g_31789	g_9221
ptg000037l	14169586	14172194	2608	g_9221	g_15956
ptg000037l	14181095	14184212	3117	g_15956	g_9291
ptg000037l	14187044	14189730	2686	g_9291	g_11922
ptg000037l	14191480	14193941	2461	g_11922	g_13226
ptg000037l	14204689	14211989	7300	g_13226	g_26157
ptg000037l	14217801	14218427	626	g_26157	g_2661
ptg000037l	14219817	14220306	489	g_2661	g_27425
ptg000037l	14222105	14224246	2141	g_27425	g_2328
ptg000037l	14226211	14229478	3267	g_2328	g_34572
ptg000037l	14231244	14232509	1265	g_34572	g_23087
ptg000037l	14234600	14235178	578	g_23087	g_7410
ptg000037l	14236351	14284925	48574	g_7410	g_20683
ptg000037l	14285362	14583287	297925	g_20683	g_13572
ptg000037l	14583523	14632246	48723	g_13572	g_34752
ptg000037l	14634201	14708495	74294	g_34752	g_29148
ptg000037l	14727592	14737346	9754	g_29148	g_37211
ptg000037l	14746661	14751824	5163	g_37211	g_14102
ptg000037l	14769912	14827244	57332	g_14102	g_10929
ptg000037l	14831839	14835321	3482	g_10929	g_12696
ptg000037l	14835545	14933886	98341	g_12696	g_35186
ptg000037l	14958972	14966244	7272	g_35186	g_8523
ptg000037l	14966570	14993831	27261	g_8523	g_9548
ptg000037l	14996644	14999904	3260	g_9548	g_34677
ptg000037l	15004920	15006147	1227	g_34677	g_3064
ptg000037l	15008986	15024272	15286	g_3064	g_19542
ptg000037l	15030917	15049965	19048	g_19542	g_26989
ptg000037l	15053708	15058050	4342	g_26989	g_38046
ptg000037l	15083411	15087365	3954	g_38046	g_985
ptg000037l	15101419	15102346	927	g_985	g_15902
ptg000037l	15104202	15245658	141456	g_15902	g_27197
ptg000037l	15247507	15271906	24399	g_27197	g_5656
ptg000037l	15273381	15326017	52636	g_5656	g_16492
ptg000037l	15326847	15339256	12409	g_16492	g_16770
ptg000037l	15346802	15352040	5238	g_16770	g_14338
ptg000037l	15359986	15424426	64440	g_14338	g_13889
ptg000037l	15438860	15443088	4228	g_13889	g_37692
ptg000037l	15446694	15448912	2218	g_37692	g_8461
ptg000037l	15464099	15712651	248552	g_8461	g_472
ptg000037l	15712878	15811263	98385	g_472	g_36477
ptg000037l	15811748	15843620	31872	g_36477	g_4295
ptg000037l	15844171	15909690	65519	g_4295	g_26755
ptg000037l	15910640	16007653	97013	g_26755	g_39441
ptg000037l	16007922	16060776	52854	g_39441	g_21002
ptg000037l	16063454	16072122	8668	g_21002	g_33779
ptg000037l	16090153	16172390	82237	g_33779	g_20698
ptg000037l	16192331	16196976	4645	g_20698	g_162
ptg000037l	16208999	16264701	55702	g_162	g_879
ptg000037l	16268772	16274416	5644	g_879	g_26793
ptg000037l	16280488	16388224	107736	g_26793	g_21227
ptg000037l	16426425	16479961	53536	g_21227	g_7086
ptg000037l	16480362	16491948	11586	g_7086	g_30679
ptg000037l	16492412	16502666	10254	g_30679	g_1950
ptg000037l	16502923	16522575	19652	g_1950	g_9461
ptg000037l	16536741	16537019	278	g_9461	g_15812
ptg000037l	16538104	16641141	103037	g_15812	g_6631
ptg000037l	16643532	16812557	169025	g_6631	g_11663
ptg000037l	16812781	16841803	29022	g_11663	g_13442
ptg000037l	16859065	16859372	307	g_13442	g_27834
ptg000037l	16859875	16862518	2643	g_27834	g_16601
ptg000037l	16873694	16889058	15364	g_16601	g_9601
ptg000037l	16907930	16909654	1724	g_9601	g_28055
ptg000037l	16914312	16959657	45345	g_28055	g_3395
ptg000037l	16959863	16971121	11258	g_3395	g_25868
ptg000037l	16975432	16995055	19623	g_25868	g_24844
ptg000037l	17013197	17015252	2055	g_24844	g_1581
ptg000037l	17024245	17039508	15263	g_1581	g_40084
ptg000037l	17046239	17048765	2526	g_40084	g_10207
ptg000037l	17050272	17058481	8209	g_10207	g_5316
ptg000037l	17076857	17077911	1054	g_5316	g_36956
ptg000037l	17079307	17119478	40171	g_36956	g_10110
ptg000037l	17119714	17133603	13889	g_10110	g_758
ptg000037l	17136039	17136902	863	g_758	g_34674
ptg000037l	17141341	17143155	1814	g_34674	g_24563
ptg000037l	17143556	17143681	125	g_24563	g_36506
ptg000037l	17145787	17163284	17497	g_36506	g_6261
ptg000037l	17170052	17177619	7567	g_6261	g_34343
ptg000037l	17178047	17180615	2568	g_34343	g_21776
ptg000037l	17185658	17188860	3202	g_21776	g_30882
ptg000037l	17195387	17204622	9235	g_30882	g_24253
ptg000037l	17218007	17222586	4579	g_24253	g_2823
ptg000037l	17228310	17228910	600	g_2823	g_1295
ptg000037l	17237845	17239556	1711	g_1295	g_25968
ptg000037l	17242457	17247712	5255	g_25968	g_18805
ptg000037l	17270061	17274273	4212	g_18805	g_40072
ptg000037l	17275447	17295130	19683	g_40072	g_9590
ptg000037l	17299216	17305722	6506	g_9590	g_33749
ptg000037l	17315217	17321179	5962	g_33749	g_25620
ptg000037l	17321802	17322662	860	g_25620	g_10761
ptg000037l	17330217	17336192	5975	g_10761	g_2897
ptg000037l	17345844	17415829	69985	g_2897	g_33770
ptg000037l	17432828	17476815	43987	g_33770	g_27487
ptg000037l	17486989	17574070	87081	g_27487	g_33348
ptg000037l	17577252	17580335	3083	g_33348	g_26533
ptg000037l	17588957	17590726	1769	g_26533	g_8541
ptg000037l	17594331	17595815	1484	g_8541	g_17542
ptg000037l	17599532	17600303	771	g_17542	g_29216
ptg000037l	17604580	17606336	1756	g_29216	g_31169
ptg000037l	17616809	17636616	19807	g_31169	g_1131
ptg000037l	17643939	17709858	65919	g_1131	g_4137
ptg000037l	17710277	17721397	11120	g_4137	g_20781
ptg000037l	17722923	17724860	1937	g_20781	g_24798
ptg000037l	17726011	17733291	7280	g_24798	g_37977
ptg000037l	17733584	17739935	6351	g_37977	g_3082
ptg000037l	17752021	17757269	5248	g_3082	g_988
ptg000037l	17759158	17761347	2189	g_988	g_20575
ptg000037l	17765368	17851128	85760	g_20575	g_31003
ptg000037l	17857600	17860425	2825	g_31003	g_21917
ptg000037l	17866289	17875208	8919	g_21917	g_7236
ptg000037l	17879949	17903436	23487	g_7236	g_31979
ptg000037l	17928486	17932896	4410	g_31979	g_26753
ptg000037l	17945315	17948363	3048	g_26753	g_10769
ptg000037l	17952458	17984403	31945	g_10769	g_1683
ptg000037l	17985728	17986042	314	g_1683	g_5768
ptg000037l	17994774	17999193	4419	g_5768	g_38270
ptg000037l	18007797	18012291	4494	g_38270	g_19637
ptg000037l	18020001	18057810	37809	g_19637	g_21158
ptg000037l	18058360	18216326	157966	g_21158	g_26035
ptg000037l	18216544	18231450	14906	g_26035	g_9392
ptg000037l	18231779	18250006	18227	g_9392	g_13799
ptg000037l	18251397	18251503	106	g_13799	g_15888
ptg000037l	18251961	18275186	23225	g_15888	g_37932
ptg000037l	18275518	18349625	74107	g_37932	g_31185
ptg000037l	18351092	18397385	46293	g_31185	g_7175
ptg000037l	18466288	18505001	38713	g_7175	g_33525
ptg000037l	18507297	18511650	4353	g_33525	g_28537
ptg000037l	18511901	18563776	51875	g_28537	g_19739
ptg000037l	18564042	18567724	3682	g_19739	g_40202
ptg000037l	18570728	18580251	9523	g_40202	g_2135
ptg000037l	18586655	18690603	103948	g_2135	g_31309
ptg000037l	18692188	18694777	2589	g_31309	g_12522
ptg000037l	18696186	18752412	56226	g_12522	g_12386
ptg000037l	18754097	18759741	5644	g_12386	g_20321
ptg000037l	18760037	18780924	20887	g_20321	g_23522
ptg000037l	18795149	18810880	15731	g_23522	g_34036
ptg000037l	18813259	18818307	5048	g_34036	g_14648
ptg000037l	18824120	18924988	100868	g_14648	g_35586
ptg000037l	18932755	18947895	15140	g_35586	g_31394
ptg000037l	18953828	19021482	67654	g_31394	g_1941
ptg000037l	19036242	19040198	3956	g_1941	g_37428
ptg000037l	19043461	19095662	52201	g_37428	g_28917
ptg000037l	19096312	19305093	208781	g_28917	g_14217
ptg000037l	19305371	19592158	286787	g_14217	g_2305
ptg000037l	19592361	19696556	104195	g_2305	g_19997
ptg000037l	19696828	19796148	99320	g_19997	g_25511
ptg000037l	19796459	19951244	154785	g_25511	g_13321
ptg000037l	19964397	19975851	11454	g_13321	g_24902
ptg000037l	19976153	19976337	184	g_24902	g_10461
ptg000037l	19996990	20056276	59286	g_10461	g_7443
ptg000037l	20056581	20072320	15739	g_7443	g_32196
ptg000037l	20072523	20081347	8824	g_32196	g_12400
ptg000037l	20099562	20135782	36220	g_12400	g_34369
ptg000037l	20136426	20394915	258489	g_34369	g_36755
ptg000037l	20395532	20415959	20427	g_36755	g_32153
ptg000037l	20436210	20488269	52059	g_32153	g_16588
ptg000037l	20490911	20526919	36008	g_16588	g_28944
ptg000037l	20527470	20534365	6895	g_28944	g_2583
ptg000037l	20534913	20556345	21432	g_2583	g_5469
ptg000037l	20570770	20700392	129622	g_5469	g_22070
ptg000037l	20720523	20732928	12405	g_22070	g_16502
ptg000037l	20734187	20787932	53745	g_16502	g_14953
ptg000037l	20803992	20806555	2563	g_14953	g_28535
ptg000037l	20808677	20854063	45386	g_28535	g_28529
ptg000037l	20856593	20914397	57804	g_28529	g_5148
ptg000037l	20914846	20956380	41534	g_5148	g_28929
ptg000037l	20957444	21051620	94176	g_28929	g_12474
ptg000037l	21066228	21069843	3615	g_12474	g_26720
ptg000037l	21087725	21094946	7221	g_26720	g_36490
ptg000037l	21108435	21133256	24821	g_36490	g_12248
ptg000037l	21153163	21171036	17873	g_12248	g_34217
ptg000037l	21172001	21210260	38259	g_34217	g_11963
ptg000037l	21216384	21273786	57402	g_11963	g_4918
ptg000037l	21280276	21383619	103343	g_4918	g_14457
ptg000037l	21394538	21577097	182559	g_14457	g_10398
ptg000037l	21577312	21601013	23701	g_10398	g_23198
ptg000037l	21601954	21664257	62303	g_23198	g_1461
ptg000037l	21665893	21824307	158414	g_1461	g_30298
ptg000037l	21825713	22061547	235834	g_30298	g_35415
ptg000037l	22075608	22088341	12733	g_35415	g_22719
ptg000037l	22088547	22107056	18509	g_22719	g_9199
ptg000037l	22107850	22136497	28647	g_9199	g_17161
ptg000037l	22136715	22151933	15218	g_17161	g_21432
ptg000037l	22152154	22182937	30783	g_21432	g_15341
ptg000037l	22183500	22224832	41332	g_15341	g_17025
ptg000037l	22226248	22262504	36256	g_17025	g_16303
ptg000037l	22265125	22486289	221164	g_16303	g_34657
ptg000037l	22486852	22525781	38929	g_34657	g_9243
ptg000037l	22526092	22653467	127375	g_9243	g_33538
ptg000037l	22654525	22723818	69293	g_33538	g_32452
ptg000037l	22724090	22799780	75690	g_32452	g_8013
ptg000037l	22813207	22813314	107	g_8013	g_36792
ptg000037l	22813523	22921470	107947	g_36792	g_22155
ptg000037l	22922147	23002412	80265	g_22155	g_11332
ptg000037l	23004109	23065482	61373	g_11332	g_6944
ptg000037l	23065787	23068903	3116	g_6944	g_14523
ptg000037l	23084554	23109003	24449	g_14523	g_32865
ptg000037l	23109419	23237910	128491	g_32865	g_23610
ptg000037l	23241976	23388493	146517	g_23610	g_5753
ptg000037l	23403753	23407398	3645	g_5753	g_33791
ptg000037l	23413322	23417625	4303	g_33791	g_35256
ptg000037l	23425875	23428724	2849	g_35256	g_32627
ptg000037l	23435016	23461924	26908	g_32627	g_2048
ptg000039l	323699	324051	352	g_10849	g_23241
ptg000039l	324767	528965	204198	g_23241	g_16025
ptg000039l	536121	542319	6198	g_16025	g_20257
ptg000039l	545166	576106	30940	g_20257	g_7210
ptg000039l	576354	651480	75126	g_7210	g_9521
ptg000039l	667357	750340	82983	g_9521	g_34916
ptg000039l	766249	788577	22328	g_34916	g_37023
ptg000039l	788822	842278	53456	g_37023	g_23497
ptg000039l	849685	855430	5745	g_23497	g_1184
ptg000039l	860066	887349	27283	g_1184	g_19356
ptg000039l	887633	968148	80515	g_19356	g_3105
ptg000039l	972246	1100267	128021	g_3105	g_12761
ptg000039l	1100617	1100868	251	g_12761	g_27363
ptg000039l	1101230	1153181	51951	g_27363	g_6271
ptg000039l	1153441	1169723	16282	g_6271	g_19388
ptg000039l	1169938	1191393	21455	g_19388	g_3475
ptg000039l	1192814	1273682	80868	g_3475	g_4889
ptg000039l	1279679	1290261	10582	g_4889	g_8369
ptg000039l	1293241	1356273	63032	g_8369	g_21521
ptg000039l	1356908	1455721	98813	g_21521	g_36120
ptg000039l	1456269	1538967	82698	g_36120	g_26680
ptg000039l	1554530	1565105	10575	g_26680	g_24869
ptg000039l	1566259	1670215	103956	g_24869	g_14976
ptg000039l	1677646	1727482	49836	g_14976	g_16022
ptg000039l	1732911	1763824	30913	g_16022	g_35031
ptg000039l	1771081	1778179	7098	g_35031	g_32755
ptg000039l	1782663	1799159	16496	g_32755	g_14714
ptg000039l	1807936	1907035	99099	g_14714	g_26757
ptg000039l	1928575	1963722	35147	g_26757	g_20275
ptg000039l	1965064	2004664	39600	g_20275	g_30662
ptg000039l	2020358	2238175	217817	g_30662	g_34806
ptg000039l	2238801	2334139	95338	g_34806	g_2879
ptg000039l	2337130	2380836	43706	g_2879	g_10172
ptg000039l	2383526	2388036	4510	g_10172	g_37919
ptg000039l	2393755	2412323	18568	g_37919	g_38126
ptg000039l	2415750	2416660	910	g_38126	g_22944
ptg000039l	2419667	2434392	14725	g_22944	g_30498
ptg000039l	2450139	2452550	2411	g_30498	g_1337
ptg000039l	2463243	2465289	2046	g_1337	g_38836
ptg000039l	2467296	2470994	3698	g_5976	g_13976
ptg000039l	2472501	2498230	25729	g_13976	g_20620
ptg000039l	2498538	2509209	10671	g_20620	g_27996
ptg000039l	2510981	2541033	30052	g_27996	g_24152
ptg000039l	2556687	2563551	6864	g_24152	g_31720
ptg000039l	2572603	2592344	19741	g_31720	g_37449
ptg000039l	2608259	2640712	32453	g_37449	g_18327
ptg000039l	2649019	2682033	33014	g_18327	g_27260
ptg000039l	2712477	2743331	30854	g_27260	g_25181
ptg000039l	2749694	2757737	8043	g_25181	g_9963
ptg000039l	2764778	2766812	2034	g_9963	g_36192
ptg000039l	2770558	2793513	22955	g_36192	g_16716
ptg000039l	2793959	2795074	1115	g_16716	g_12930
ptg000039l	2795289	2839137	43848	g_12930	g_10254
ptg000039l	2865559	2871884	6325	g_10254	g_19691
ptg000039l	2874877	2885543	10666	g_19691	g_7796
ptg000039l	2887373	2888072	699	g_7796	g_15113
ptg000039l	2891776	2894439	2663	g_15113	g_27196
ptg000039l	2913957	2938600	24643	g_27196	g_33471
ptg000039l	2947388	2977030	29642	g_33471	g_26288
ptg000039l	2977608	2978851	1243	g_26288	g_34199
ptg000039l	2979189	2997931	18742	g_34199	g_12962
ptg000039l	2998707	3070583	71876	g_12962	g_27620
ptg000039l	3070933	3177304	106371	g_27620	g_24068
ptg000039l	3179631	3275119	95488	g_24068	g_30934
ptg000039l	3276183	3313915	37732	g_30934	g_5045
ptg000039l	3315021	3359201	44180	g_5045	g_26382
ptg000039l	3376906	3387731	10825	g_26382	g_19064
ptg000039l	3400276	3479400	79124	g_19064	g_29681
ptg000039l	3481947	3520940	38993	g_29681	g_27793
ptg000039l	3538716	3546836	8120	g_27793	g_11832
ptg000039l	3564548	3584969	20421	g_11832	g_30711
ptg000039l	3597958	3602408	4450	g_30711	g_37819
ptg000039l	3619450	3628700	9250	g_37819	g_5444
ptg000039l	3641503	3645020	3517	g_5444	g_29495
ptg000039l	3648831	3651103	2272	g_29495	g_30431
ptg000039l	3656594	3670430	13836	g_30431	g_18315
ptg000039l	3671851	3677812	5961	g_18315	g_20420
ptg000039l	3682081	3697780	15699	g_20420	g_33542
ptg000039l	3705902	3919994	214092	g_33542	g_28815
ptg000039l	3922120	3932014	9894	g_28815	g_29467
ptg000039l	3936121	3941755	5634	g_29467	g_31895
ptg000039l	3945213	4065964	120751	g_31895	g_4677
ptg000039l	4066908	4072154	5246	g_4677	g_9430
ptg000039l	4074773	4088838	14065	g_9430	g_11825
ptg000039l	4093100	4099568	6468	g_11825	g_29038
ptg000039l	4101113	4112047	10934	g_29038	g_25914
ptg000039l	4114476	4123525	9049	g_25914	g_21276
ptg000039l	4123833	4126944	3111	g_21276	g_24657
ptg000039l	4130126	4141791	11665	g_24657	g_2658
ptg000039l	4146431	4150064	3633	g_2658	g_39947
ptg000039l	4157167	4176607	19440	g_39947	g_19881
ptg000039l	4229007	4287752	58745	g_19881	g_35436
ptg000039l	4307267	4311173	3906	g_35436	g_13787
ptg000039l	4320893	4322207	1314	g_13787	g_2134
ptg000039l	4322950	4324124	1174	g_2134	g_36511
ptg000039l	4327729	4355289	27560	g_36511	g_6210
ptg000039l	4374283	4506741	132458	g_6210	g_5142
ptg000039l	4506953	4582068	75115	g_5142	g_4720
ptg000039l	4582313	4677554	95241	g_4720	g_23893
ptg000039l	4684314	5081919	397605	g_23893	g_16294
ptg000039l	5082125	5160255	78130	g_16294	g_6589
ptg000039l	5180883	5202997	22114	g_6589	g_16180
ptg000039l	5205305	5216260	10955	g_16180	g_6353
ptg000039l	5219665	5240477	20812	g_6353	g_16144
ptg000039l	5245256	5245769	513	g_16144	g_30068
ptg000039l	5252835	5255167	2332	g_30068	g_26589
ptg000039l	5275144	5292391	17247	g_26589	g_20176
ptg000039l	5303121	5314940	11819	g_20176	g_21848
ptg000039l	5339459	5389846	50387	g_21848	g_21763
ptg000039l	5406709	5413338	6629	g_21763	g_13191
ptg000039l	5415026	5421034	6008	g_13191	g_6559
ptg000039l	5421621	5424847	3226	g_6559	g_30630
ptg000039l	5425987	5445908	19921	g_30630	g_26230
ptg000039l	5448840	5455711	6871	g_26230	g_11307
ptg000039l	5457294	5462533	5239	g_11307	g_23504
ptg000039l	5468952	5475108	6156	g_23504	g_3441
ptg000039l	5478354	5480050	1696	g_39529	g_15618
ptg000039l	5482119	5484399	2280	g_15618	g_30701
ptg000039l	5487463	5489158	1695	g_39463	g_22596
ptg000039l	5491223	5493506	2283	g_22596	g_24612
ptg000039l	5496758	5498564	1806	g_24612	g_30625
ptg000039l	5500627	5625613	124986	g_30625	g_36052
ptg000039l	5626146	5676460	50314	g_36052	g_39466
ptg000039l	5676993	5687383	10390	g_39466	g_18249
ptg000039l	5687592	5716223	28631	g_18249	g_30732
ptg000039l	5716756	5754378	37622	g_30732	g_38865
ptg000039l	5754911	5765276	10365	g_38865	g_13583
ptg000039l	5765485	5794133	28648	g_13583	g_39128
ptg000039l	5794666	5808003	13337	g_39128	g_5808
ptg000039l	5809100	5810856	1756	g_5808	g_6202
ptg000039l	5812212	5814567	2355	g_6202	g_18482
ptg000039l	5816150	5820519	4369	g_18482	g_15380
ptg000039l	5821708	5842094	20386	g_15380	g_31925
ptg000039l	5843624	5846894	3270	g_31925	g_8827
ptg000039l	5852562	5881793	29231	g_8827	g_18429
ptg000039l	5887934	6067211	179277	g_18429	g_32423
ptg000039l	6067615	6074541	6926	g_32423	g_6956
ptg000039l	6075803	6163081	87278	g_6956	g_10895
ptg000039l	6163287	6165295	2008	g_10895	g_8378
ptg000039l	6185832	6194376	8544	g_8378	g_10938
ptg000039l	6196275	6304527	108252	g_10938	g_15698
ptg000039l	6304763	6391629	86866	g_15698	g_27416
ptg000039l	6400774	6549049	148275	g_27416	g_15136
ptg000039l	6557886	6582121	24235	g_15136	g_21692
ptg000039l	6582576	6584583	2007	g_21692	g_25308
ptg000039l	6589397	6600428	11031	g_25308	g_18893
ptg000039l	6601177	6602116	939	g_18893	g_34603
ptg000039l	6603420	6604505	1085	g_34603	g_25389
ptg000039l	6605541	6606681	1140	g_25389	g_21981
ptg000039l	6608454	6613401	4947	g_21981	g_24762
ptg000039l	6628462	6634802	6340	g_24762	g_15740
ptg000039l	6645069	6993406	348337	g_15740	g_15439
ptg000039l	6993735	6999312	5577	g_15439	g_8426
ptg000039l	7013564	7013997	433	g_8426	g_11598
ptg000039l	7044997	7129604	84607	g_11598	g_33657
ptg000039l	7144339	7152989	8650	g_33657	g_11888
ptg000039l	7156986	7176373	19387	g_11888	g_37674
ptg000039l	7178972	7181086	2114	g_37674	g_7575
ptg000039l	7193923	7198922	4999	g_7575	g_22307
ptg000039l	7208689	7217556	8867	g_22307	g_40054
ptg000039l	7226973	7228561	1588	g_40054	g_8656
ptg000039l	7231589	7234331	2742	g_8656	g_13472
ptg000039l	7246937	7251021	4084	g_13472	g_31401
ptg000039l	7267791	7284143	16352	g_31401	g_26195
ptg000039l	7288853	7387980	99127	g_26195	g_22332
ptg000039l	7394611	7396183	1572	g_22332	g_34579
ptg000039l	7416070	7550127	134057	g_34579	g_29456
ptg000039l	7564112	7567593	3481	g_29456	g_3025
ptg000039l	7570682	7578181	7499	g_3025	g_30945
ptg000039l	7584726	7598322	13596	g_30945	g_23242
ptg000039l	7608786	7610542	1756	g_23242	g_20362
ptg000039l	7614953	7683049	68096	g_20362	g_29787
ptg000039l	7684228	7689444	5216	g_29787	g_25102
ptg000039l	7696009	7709142	13133	g_25102	g_32978
ptg000039l	7713091	7717340	4249	g_32978	g_34539
ptg000039l	7719790	7732892	13102	g_34539	g_13319
ptg000039l	7734025	7736812	2787	g_13319	g_33620
ptg000039l	7739465	7760938	21473	g_33620	g_674
ptg000039l	7763281	7794117	30836	g_674	g_19483
ptg000039l	7810738	7817092	6354	g_19483	g_16834
ptg000039l	7818484	7820704	2220	g_16834	g_19083
ptg000039l	7821390	7841912	20522	g_19083	g_9529
ptg000039l	7842610	7860277	17667	g_9529	g_25723
ptg000039l	7861754	7863681	1927	g_25723	g_19439
ptg000039l	7866843	7869771	2928	g_19439	g_8502
ptg000039l	7873111	7933910	60799	g_8502	g_2397
ptg000039l	7943565	7954076	10511	g_2397	g_35783
ptg000039l	7954354	7968750	14396	g_35783	g_3324
ptg000039l	7979094	7992129	13035	g_3324	g_25101
ptg000039l	8012834	8024394	11560	g_25101	g_7109
ptg000039l	8037292	8045866	8574	g_7109	g_13254
ptg000039l	8067169	8072371	5202	g_13254	g_20047
ptg000039l	8074254	8077658	3404	g_20047	g_22417
ptg000039l	8077930	8080616	2686	g_22417	g_40223
ptg000039l	8084742	8121944	37202	g_40223	g_19051
ptg000039l	8126450	8139003	12553	g_19051	g_23776
ptg000039l	8145891	8164100	18209	g_23776	g_4896
ptg000039l	8183665	8329662	145997	g_4896	g_16999
ptg000039l	8335423	8351261	15838	g_16999	g_10745
ptg000039l	8351547	8372078	20531	g_10745	g_14154
ptg000039l	8441369	8489260	47891	g_14154	g_25394
ptg000039l	8504576	8589385	84809	g_25394	g_25737
ptg000039l	8589744	8591396	1652	g_25737	g_30907
ptg000039l	8591779	8632514	40735	g_30907	g_1420
ptg000039l	8636492	8646533	10041	g_1420	g_6299
ptg000039l	8651176	8678495	27319	g_6299	g_1323
ptg000039l	8678917	8825980	147063	g_1323	g_37583
ptg000039l	8826255	8857470	31215	g_37583	g_21278
ptg000039l	8863273	8865098	1825	g_21278	g_36975
ptg000039l	8871788	8883608	11820	g_36975	g_27914
ptg000039l	8904602	8911387	6785	g_27914	g_33697
ptg000039l	8916058	8922091	6033	g_33697	g_24187
ptg000039l	8922408	9030266	107858	g_24187	g_36452
ptg000039l	9035783	9185541	149758	g_36452	g_38146
ptg000039l	9196093	9224328	28235	g_38146	g_4383
ptg000039l	9225632	9226965	1333	g_4383	g_4097
ptg000039l	9228541	9244146	15605	g_4097	g_30129
ptg000039l	9245045	9295601	50556	g_30129	g_19729
ptg000039l	9309163	9310576	1413	g_19729	g_7612
ptg000039l	9316971	9324605	7634	g_7612	g_18861
ptg000039l	9327235	9335388	8153	g_18861	g_24772
ptg000039l	9338012	9350565	12553	g_24772	g_26258
ptg000039l	9352190	9357353	5163	g_26258	g_37114
ptg000039l	9359412	9363549	4137	g_37114	g_5593
ptg000039l	9374607	9380727	6120	g_5593	g_19244
ptg000039l	9408152	9414892	6740	g_19244	g_4326
ptg000039l	9415227	9477071	61844	g_4326	g_29256
ptg000039l	9477334	9543812	66478	g_29256	g_17169
ptg000039l	9544150	9637860	93710	g_17169	g_37046
ptg000039l	9663471	9765672	102201	g_37046	g_959
ptg000039l	9771194	9773485	2291	g_959	g_38305
ptg000039l	9773697	9788825	15128	g_38305	g_21245
ptg000039l	9789046	9789518	472	g_21245	g_34952
ptg000039l	9803695	9822027	18332	g_34952	g_27767
ptg000039l	9822239	9830572	8333	g_27767	g_35048
ptg000039l	9832392	9924084	91692	g_35048	g_9281
ptg000039l	9933117	9937393	4276	g_9281	g_35758
ptg000039l	9950442	9952885	2443	g_35758	g_39619
ptg000039l	9953106	9965558	12452	g_39619	g_6127
ptg000039l	9970104	9973868	3764	g_6127	g_19160
ptg000039l	9981318	10002859	21541	g_19160	g_30051
ptg000039l	10028114	10046341	18227	g_30051	g_3990
ptg000039l	10046547	10130993	84446	g_3990	g_36046
ptg000039l	10131433	10241376	109943	g_36046	g_18587
ptg000039l	10241597	10553522	311925	g_18587	g_36921
ptg000039l	10557847	10559533	1686	g_36921	g_4552
ptg000039l	10562662	11152558	589896	g_4552	g_10611
ptg000039l	11168496	11178507	10011	g_39717	g_11188
ptg000039l	11178767	11269526	90759	g_11188	g_28548
ptg000039l	11285871	11296704	10833	g_28548	g_30706
ptg000039l	11297927	11298274	347	g_30706	g_17596
ptg000039l	11301645	11302503	858	g_17596	g_37384
ptg000039l	11307008	11319746	12738	g_37384	g_16498
ptg000039l	11319967	11331702	11735	g_16498	g_36615
ptg000039l	11333522	11453359	119837	g_36615	g_27777
ptg000039l	11453889	11925650	471761	g_27777	g_38934
ptg000039l	11926724	11945564	18840	g_38934	g_29084
ptg000039l	11945995	12127172	181177	g_29084	g_35148
ptg000039l	12127834	12133038	5204	g_35148	g_21654
ptg000039l	12136537	12138569	2032	g_21654	g_15753
ptg000039l	12141797	12144882	3085	g_15753	g_23194
ptg000039l	12153882	12160016	6134	g_23194	g_3285
ptg000039l	12166398	12171798	5400	g_3285	g_23074
ptg000039l	12172412	12174624	2212	g_23074	g_28570
ptg000039l	12177480	12182022	4542	g_28570	g_19095
ptg000039l	12186947	12213273	26326	g_19095	g_34073
ptg000039l	12229174	12231910	2736	g_34073	g_21977
ptg000039l	12232227	12247771	15544	g_21977	g_24858
ptg000039l	12251516	12315089	63573	g_24858	g_22346
ptg000039l	12316387	12346937	30550	g_22346	g_23313
ptg000039l	12348170	12391876	43706	g_23313	g_17563
ptg000039l	12399276	12403880	4604	g_17563	g_23182
ptg000039l	12406620	12425426	18806	g_23182	g_5979
ptg000039l	12438638	12444193	5555	g_5979	g_34097
ptg000039l	12451908	12454219	2311	g_34097	g_12747
ptg000039l	12460123	12468943	8820	g_12747	g_25665
ptg000039l	12471824	12472785	961	g_25665	g_17334
ptg000039l	12474722	12476656	1934	g_17334	g_34696
ptg000039l	12485706	12488986	3280	g_39275	g_4308
ptg000039l	12490816	12494981	4165	g_4308	g_20401
ptg000039l	12499127	12501910	2783	g_20401	g_13679
ptg000039l	12504194	12508012	3818	g_13679	g_12385
ptg000039l	12510936	12513210	2274	g_12385	g_37206
ptg000039l	12523491	12524659	1168	g_37206	g_27437
ptg000039l	12533456	12548083	14627	g_27437	g_25619
ptg000039l	12553526	12556490	2964	g_25619	g_34393
ptg000039l	12564046	12572839	8793	g_10965	g_34314
ptg000039l	12583119	12602300	19181	g_34314	g_9272
ptg000039l	12607633	12616814	9181	g_9272	g_9168
ptg000039l	12617116	12620517	3401	g_9168	g_16233
ptg000039l	12633659	12637694	4035	g_16233	g_28068
ptg000039l	12649900	12659722	9822	g_28068	g_15049
ptg000039l	12671269	12885513	214244	g_15049	g_11462
ptg000039l	12885713	13121820	236107	g_11462	g_33641
ptg000039l	13122194	13129998	7804	g_33641	g_22425
ptg000039l	13130207	13310032	179825	g_22425	g_29868
ptg000039l	13310304	13415906	105602	g_29868	g_2827
ptg000039l	13500453	13595986	95533	g_2827	g_13323
ptg000039l	13597119	13670706	73587	g_13323	g_19279
ptg000039l	13675679	13677989	2310	g_39654	g_35255
ptg000039l	13678213	13720164	41951	g_35255	g_31238
ptg000039l	13727500	13730987	3487	g_31238	g_6800
ptg000039l	13738100	13742056	3956	g_6800	g_20756
ptg000039l	13745556	13747950	2394	g_20756	g_37067
ptg000039l	13748969	13753501	4532	g_37067	g_11854
ptg000039l	13768521	13772316	3795	g_11854	g_15311
ptg000039l	13775276	13786241	10965	g_15311	g_40078
ptg000039l	13786657	13787767	1110	g_40078	g_10046
ptg000039l	13796451	13801260	4809	g_10046	g_31325
ptg000039l	13813894	13817678	3784	g_31325	g_35705
ptg000039l	13820585	13829731	9146	g_35705	g_37742
ptg000039l	13841973	13846343	4370	g_37742	g_1842
ptg000039l	13865425	13867504	2079	g_1842	g_23006
ptg000039l	13868154	13872051	3897	g_23006	g_28084
ptg000039l	13873342	13931432	58090	g_28084	g_30018
ptg000039l	13943163	13947188	4025	g_30018	g_14091
ptg000039l	13966597	13968322	1725	g_14091	g_22670
ptg000039l	13972826	13988090	15264	g_22670	g_1116
ptg000039l	13993552	14006109	12557	g_1116	g_30927
ptg000039l	14009922	14028447	18525	g_30927	g_10232
ptg000039l	14029169	14032412	3243	g_10232	g_10900
ptg000039l	14048066	14051769	3703	g_10900	g_14145
ptg000039l	14071091	14097848	26757	g_14145	g_9483
ptg000039l	14112263	14113820	1557	g_9483	g_6362
ptg000039l	14119387	14124804	5417	g_6362	g_17905
ptg000039l	14135550	14195510	59960	g_17905	g_30265
ptg000039l	14202921	14210465	7544	g_30265	g_9816
ptg000039l	14211837	14228677	16840	g_9816	g_35132
ptg000039l	14232344	14253450	21106	g_35132	g_26173
ptg000039l	14291248	14296132	4884	g_26173	g_32314
ptg000039l	14297390	14299364	1974	g_32314	g_18140
ptg000039l	14305232	14306928	1696	g_18140	g_18911
ptg000039l	14309173	14315103	5930	g_18911	g_31215
ptg000039l	14317603	14318373	770	g_31215	g_15630
ptg000039l	14320966	14323493	2527	g_15630	g_1680
ptg000039l	14329131	14340922	11791	g_1680	g_17917
ptg000039l	14341270	14342248	978	g_17917	g_6223
ptg000039l	14347022	14347762	740	g_6223	g_652
ptg000039l	14351225	14352757	1532	g_652	g_23898
ptg000039l	14354630	14369650	15020	g_23898	g_34276
ptg000039l	14377526	14382996	5470	g_34276	g_12373
ptg000039l	14388559	14428996	40437	g_12373	g_16941
ptg000039l	14432704	14441713	9009	g_16941	g_32857
ptg000039l	14443215	14443556	341	g_32857	g_18960
ptg000039l	14444164	14459222	15058	g_18960	g_2676
ptg000039l	14460040	14462572	2532	g_2676	g_25167
ptg000039l	14467519	14478456	10937	g_25167	g_39141
ptg000039l	14478707	14506656	27949	g_39141	g_36819
ptg000039l	14507431	14508641	1210	g_36819	g_5639
ptg000039l	14511368	14533364	21996	g_5639	g_5647
ptg000039l	14535656	14547364	11708	g_5647	g_9289
ptg000039l	14549639	14574445	24806	g_9289	g_13784
ptg000039l	14578401	14578847	446	g_13784	g_24046
ptg000039l	14584324	14586694	2370	g_24046	g_3190
ptg000039l	14594738	14597837	3099	g_3190	g_29533
ptg000039l	14608834	14618118	9284	g_29533	g_30420
ptg000039l	14619968	14623318	3350	g_30420	g_2407
ptg000039l	14629501	14631161	1660	g_2407	g_30424
ptg000039l	14651409	14653835	2426	g_30424	g_24673
ptg000039l	14662260	14663383	1123	g_24673	g_4872
ptg000039l	14666394	14667372	978	g_4872	g_7378
ptg000039l	14674438	14675119	681	g_7378	g_16978
ptg000039l	14677220	14677809	589	g_16978	g_27863
ptg000039l	14679197	14681926	2729	g_27863	g_16626
ptg000039l	14683314	14687156	3842	g_16626	g_31704
ptg000039l	14688691	14700812	12121	g_31704	g_14913
ptg000039l	14705761	14706829	1068	g_14913	g_497
ptg000039l	14707478	14710861	3383	g_497	g_13219
ptg000039l	14726873	14821748	94875	g_13219	g_17197
ptg000039l	14824515	14826989	2474	g_17197	g_23428
ptg000039l	14830415	14833104	2689	g_23428	g_32123
ptg000039l	14836201	14838004	1803	g_32123	g_2438
ptg000039l	14841946	14901302	59356	g_2438	g_38844
ptg000039l	14916269	14929151	12882	g_29697	g_25425
ptg000039l	14935796	14938656	2860	g_25425	g_33374
ptg000039l	14945142	14956471	11329	g_33374	g_2923
ptg000039l	14975000	14988031	13031	g_2923	g_6621
ptg000039l	14991228	15002791	11563	g_6621	g_35609
ptg000039l	15003962	15004882	920	g_35609	g_34169
ptg000039l	15008421	15010295	1874	g_34169	g_28136
ptg000039l	15022814	15070683	47869	g_28136	g_23302
ptg000039l	15071068	15071380	312	g_23302	g_6006
ptg000039l	15071775	15132703	60928	g_6006	g_22221
ptg000039l	15135633	15135694	61	g_22221	g_40220
ptg000039l	15156269	15165234	8965	g_40220	g_6192
ptg000039l	15185977	15237797	51820	g_6192	g_12394
ptg000039l	15246201	15248398	2197	g_12394	g_7339
ptg000039l	15252678	15295373	42695	g_7339	g_1773
ptg000039l	15303827	15325042	21215	g_1773	g_37017
ptg000039l	15332472	15385012	52540	g_37017	g_15769
ptg000039l	15402954	15403776	822	g_15769	g_12120
ptg000039l	15406226	15408463	2237	g_12120	g_38124
ptg000039l	15417196	15424197	7001	g_38124	g_27942
ptg000039l	15429645	15434267	4622	g_27942	g_23312
ptg000039l	15454272	15466393	12121	g_23312	g_30188
ptg000039l	15466701	15474498	7797	g_30188	g_32441
ptg000039l	15476321	15477634	1313	g_32441	g_6460
ptg000039l	15480176	15482545	2369	g_6460	g_13160
ptg000039l	15484623	15518372	33749	g_13160	g_26756
ptg000039l	15520512	15523720	3208	g_26756	g_13371
ptg000039l	15529495	15570339	40844	g_13371	g_20334
ptg000039l	15570548	15617495	46947	g_20334	g_26740
ptg000039l	15623222	15627602	4380	g_26740	g_35150
ptg000039l	15630211	15637878	7667	g_35150	g_19792
ptg000039l	15667354	15668428	1074	g_19792	g_35040
ptg000039l	15681943	15690034	8091	g_35040	g_17074
ptg000039l	15691854	15695607	3753	g_17074	g_19607
ptg000039l	15702794	15709885	7091	g_19607	g_33261
ptg000039l	15731945	15764671	32726	g_33261	g_18700
ptg000039l	15774245	15778614	4369	g_18700	g_34289
ptg000039l	15803060	15805753	2693	g_34289	g_27143
ptg000039l	15808087	15828128	20041	g_27143	g_32374
ptg000039l	15833581	15876448	42867	g_32374	g_30822
ptg000039l	15877095	15882920	5825	g_30822	g_19929
ptg000039l	15883378	15883452	74	g_19929	g_14959
ptg000039l	15883709	16038108	154399	g_14959	g_8842
ptg000039l	16038814	16235914	197100	g_8842	g_20281
ptg000039l	16236620	16267779	31159	g_20281	g_3551
ptg000039l	16275278	16282092	6814	g_3551	g_13408
ptg000039l	16304036	16309003	4967	g_13408	g_15090
ptg000039l	16309854	16326621	16767	g_15090	g_16721
ptg000039l	16327118	16328395	1277	g_16721	g_29308
ptg000039l	16329966	16352501	22535	g_29308	g_39802
ptg000039l	16353049	16401560	48511	g_39802	g_14156
ptg000039l	16402327	16434360	32033	g_14156	g_14056
ptg000039l	16436944	16474698	37754	g_14056	g_14057
ptg000039l	16492975	16497435	4460	g_14057	g_5413
ptg000039l	16500387	16507327	6940	g_5413	g_3582
ptg000039l	16508218	16509457	1239	g_3582	g_39967
ptg000039l	16520889	16524786	3897	g_39967	g_3095
ptg000039l	16528764	16534274	5510	g_3095	g_100
ptg000039l	16537478	16560700	23222	g_100	g_5655
ptg000039l	16563209	16595932	32723	g_5655	g_24011
ptg000039l	16604010	16744341	140331	g_24011	g_30604
ptg000039l	16750159	16768671	18512	g_30604	g_15424
ptg000039l	16771759	16789264	17505	g_15424	g_24900
ptg000039l	16801627	16804616	2989	g_24900	g_27871
ptg000039l	16807816	16830786	22970	g_27871	g_11084
ptg000039l	16843131	16846220	3089	g_11084	g_9098
ptg000039l	16847883	16926320	78437	g_9098	g_4915
ptg000039l	16943654	16998107	54453	g_4915	g_22559
ptg000039l	17000038	17029222	29184	g_22559	g_4732
ptg000039l	17029740	17054123	24383	g_4732	g_27861
ptg000039l	17056186	17130088	73902	g_27861	g_11077
ptg000039l	17130456	17138711	8255	g_11077	g_13066
ptg000039l	17140780	17164996	24216	g_13066	g_7041
ptg000039l	17166132	17198045	31913	g_7041	g_23301
ptg000039l	17199175	17218374	19199	g_23301	g_26365
ptg000039l	17218742	17227597	8855	g_26365	g_18423
ptg000039l	17229648	17238607	8959	g_18423	g_35257
ptg000039l	17240670	17292522	51852	g_35257	g_27618
ptg000039l	17312733	17313786	1053	g_27618	g_26748
ptg000039l	17317502	17320126	2624	g_26748	g_34260
ptg000039l	17332434	17336829	4395	g_34260	g_39047
ptg000039l	17337614	17340152	2538	g_17428	g_12442
ptg000039l	17342235	17349912	7677	g_12442	g_27289
ptg000039l	17351178	17401534	50356	g_27289	g_9726
ptg000039l	17411416	17414408	2992	g_9726	g_40074
ptg000039l	17419524	17421896	2372	g_40074	g_35880
ptg000039l	17437446	17481382	43936	g_35880	g_29255
ptg000039l	17494788	17499826	5038	g_29255	g_6195
ptg000039l	17509211	17514531	5320	g_6195	g_26318
ptg000039l	17518187	17521961	3774	g_26318	g_7364
ptg000039l	17528341	17551517	23176	g_7364	g_18792
ptg000039l	17555203	17562172	6969	g_18792	g_17473
ptg000039l	17569400	17573695	4295	g_17473	g_15412
ptg000039l	17580308	17596970	16662	g_15412	g_27835
ptg000039l	17667707	17686266	18559	g_27835	g_13065
ptg000039l	17697349	17703495	6146	g_13065	g_22910
ptg000039l	17739065	17768242	29177	g_22910	g_21065
ptg000039l	17770112	17787513	17401	g_21065	g_29363
ptg000039l	17787773	17798255	10482	g_29363	g_12857
ptg000039l	17799325	17840558	41233	g_12857	g_11066
ptg000039l	17841980	17846721	4741	g_11066	g_13102
ptg000039l	17848004	17899613	51609	g_13102	g_7396
ptg000039l	17913487	17960114	46627	g_7396	g_5271
ptg000039l	17968039	18064047	96008	g_5271	g_29793
ptg000039l	18064601	18209510	144909	g_29793	g_10733
ptg000039l	18214125	18218002	3877	g_10733	g_30854
ptg000039l	18222094	18227608	5514	g_30854	g_10922
ptg000039l	18235087	18236686	1599	g_10922	g_6203
ptg000039l	18237653	18250490	12837	g_6203	g_32832
ptg000039l	18253970	18264991	11021	g_32832	g_12910
ptg000039l	18271459	18287165	15706	g_12910	g_9625
ptg000039l	18293525	18311175	17650	g_9625	g_12506
ptg000039l	18315993	18322992	6999	g_12506	g_20303
ptg000039l	18327804	18338163	10359	g_20303	g_16979
ptg000039l	18341716	18355041	13325	g_16979	g_10310
ptg000039l	18359333	18364482	5149	g_10310	g_30393
ptg000039l	18365926	18371074	5148	g_30393	g_3972
ptg000039l	18372515	18381943	9428	g_3972	g_15023
ptg000039l	18386391	18391263	4872	g_15023	g_17568
ptg000039l	18393628	18394922	1294	g_17568	g_18107
ptg000039l	18397632	18420033	22401	g_18107	g_30475
ptg000039l	18430009	18478594	48585	g_30475	g_3033
ptg000039l	18479688	18531089	51401	g_3033	g_15803
ptg000039l	18562232	18643647	81415	g_15803	g_14431
ptg000039l	18646997	18657445	10448	g_14431	g_3184
ptg000039l	18662163	18758543	96380	g_3184	g_2150
ptg000039l	18760178	18760800	622	g_2150	g_2991
ptg000039l	18761329	18765828	4499	g_2991	g_8221
ptg000039l	18767460	18768082	622	g_8221	g_30143
ptg000039l	18768611	18809243	40632	g_30143	g_15367
ptg000039l	18843589	18849416	5827	g_15367	g_17681
ptg000039l	18850542	18859295	8753	g_17681	g_21813
ptg000039l	18871161	18908758	37597	g_21813	g_22510
ptg000039l	18909321	18919891	10570	g_22510	g_24362
ptg000039l	18927974	18939070	11096	g_24362	g_28065
ptg000039l	18939369	19025541	86172	g_28065	g_15536
ptg000039l	19025837	19153061	127224	g_15536	g_8112
ptg000039l	19165899	19176516	10617	g_8112	g_38340
ptg000039l	19186132	19198563	12431	g_38340	g_26979
ptg000039l	19218176	19234826	16650	g_26979	g_34789
ptg000039l	19235572	19246364	10792	g_34789	g_20061
ptg000039l	19250434	19279009	28575	g_20061	g_27216
ptg000039l	19287450	19498086	210636	g_27216	g_24092
ptg000039l	19502487	19529264	26777	g_24092	g_14337
ptg000039l	19530034	19552112	22078	g_14337	g_37744
ptg000039l	19552585	19555071	2486	g_37744	g_7500
ptg000039l	19555547	19561884	6337	g_7500	g_4148
ptg000039l	19562111	19566531	4420	g_4148	g_865
ptg000039l	19566758	19574053	7295	g_865	g_19553
ptg000039l	19574280	19580971	6691	g_19553	g_539
ptg000039l	19581198	19585541	4343	g_539	g_242
ptg000039l	19585768	19596346	10578	g_242	g_31419
ptg000039l	19597053	19631504	34451	g_31419	g_37964
ptg000039l	19639443	19641340	1897	g_37964	g_15951
ptg000039l	19641597	19648789	7192	g_15951	g_34326
ptg000039l	19661613	19662955	1342	g_34326	g_39334
ptg000039l	19663284	19669880	6596	g_39334	g_12681
ptg000039l	19671812	19674865	3053	g_39515	g_39835
ptg000039l	19676972	19702406	25434	g_9574	g_7248
ptg000039l	19782685	19867678	84993	g_7248	g_18392
ptg000039l	19868241	19965402	97161	g_18392	g_9809
ptg000039l	19997831	20110576	112745	g_9809	g_16122
ptg000039l	20119009	20119242	233	g_16122	g_20540
ptg000039l	20121275	20123236	1961	g_20540	g_30833
ptg000039l	20127345	20134489	7144	g_30833	g_15809
ptg000039l	20146145	20161914	15769	g_15809	g_34400
ptg000039l	20179751	20182439	2688	g_34400	g_10847
ptg000039l	20193638	20201535	7897	g_10847	g_26162
ptg000039l	20210049	20269126	59077	g_26162	g_19587
ptg000039l	20273828	20350587	76759	g_19587	g_11527
ptg000039l	20356081	20430148	74067	g_11527	g_17312
ptg000039l	20437540	20460804	23264	g_17312	g_27292
ptg000039l	20476115	20478190	2075	g_27292	g_21833
ptg000039l	20494661	20521910	27249	g_21833	g_28470
ptg000039l	20522527	20624984	102457	g_28470	g_22827
ptg000039l	20629128	20691992	62864	g_22827	g_35658
ptg000039l	20705252	20738025	32773	g_35658	g_36283
ptg000039l	20738846	20755837	16991	g_36283	g_18304
ptg000039l	20756211	20756308	97	g_18304	g_14562
ptg000039l	20756586	20765506	8920	g_14562	g_33043
ptg000039l	20765760	20769540	3780	g_33043	g_3743
ptg000039l	20770364	20773630	3266	g_3743	g_7950
ptg000039l	20774505	20787840	13335	g_7950	g_12766
ptg000039l	20788715	20844374	55659	g_12766	g_15494
ptg000039l	20844592	20844777	185	g_15494	g_26829
ptg000039l	20852657	20862822	10165	g_26829	g_7358
ptg000039l	20867953	20869696	1743	g_7358	g_22428
ptg000039l	20870335	20873157	2822	g_22428	g_15754
ptg000039l	20874017	20894345	20328	g_15754	g_2089
ptg000039l	20895295	20907070	11775	g_2089	g_1740
ptg000039l	20908471	20925796	17325	g_1740	g_123
ptg000039l	20926815	20941763	14948	g_123	g_5344
ptg000039l	20942281	20952487	10206	g_5344	g_37469
ptg000039l	20954105	20973517	19412	g_37469	g_19946
ptg000039l	20974035	20984241	10206	g_19946	g_1229
ptg000039l	20985859	21013874	28015	g_1229	g_25114
ptg000039l	21014437	21030685	16248	g_25114	g_25262
ptg000039l	21032035	21053258	21223	g_25262	g_27539
ptg000039l	21054388	21060688	6300	g_27539	g_25651
ptg000039l	21066483	21072381	5898	g_25651	g_2794
ptg000039l	21073018	21135192	62174	g_2794	g_28256
ptg000039l	21167411	21232839	65428	g_28256	g_15271
ptg000039l	21233423	21252129	18706	g_15271	g_8444
ptg000039l	21268405	21364850	96445	g_8444	g_6939
ptg000039l	21393686	21430382	36696	g_6939	g_10808
ptg000039l	21444299	21453500	9201	g_14405	g_38803
ptg000039l	21455352	21472988	17636	g_20955	g_3054
ptg000039l	21476408	21509974	33566	g_3054	g_27076
ptg000039l	21516414	21533747	17333	g_27076	g_14581
ptg000039l	21543582	21544003	421	g_14581	g_29153
ptg000039l	21544596	21547287	2691	g_29153	g_12969
ptg000039l	21547532	21548009	477	g_12969	g_24854
ptg000039l	21549112	21635244	86132	g_24854	g_3471
ptg000039l	21635792	21661589	25797	g_3471	g_5395
ptg000039l	21662068	21686021	23953	g_5395	g_5777
ptg000039l	21697819	21697862	43	g_5777	g_37911
ptg000039l	21698431	21709608	11177	g_37911	g_25367
ptg000039l	21710990	21714485	3495	g_25367	g_6662
ptg000039l	21717336	21724588	7252	g_6662	g_2565
ptg000039l	21737273	21757162	19889	g_2565	g_33512
ptg000039l	21766734	21770941	4207	g_33512	g_37892
ptg000039l	21771964	21800097	28133	g_37892	g_17433
ptg000039l	21805928	21823232	17304	g_17433	g_39336
ptg000039l	21824272	21829749	5477	g_39336	g_36140
ptg000039l	21837577	21885700	48123	g_36140	g_13929
ptg000039l	21899687	21901732	2045	g_13929	g_31103
ptg000039l	21902385	21917016	14631	g_31103	g_14399
ptg000039l	21929885	21936529	6644	g_14399	g_23862
ptg000039l	21939495	21941201	1706	g_23862	g_40246
ptg000039l	21951613	21963102	11489	g_40246	g_16600
ptg000039l	21971644	21974109	2465	g_16600	g_30924
ptg000039l	21983072	21990388	7316	g_30924	g_35269
ptg000039l	22002592	22046752	44160	g_35269	g_20080
ptg000039l	22057324	22090238	32914	g_20080	g_36115
ptg000039l	22090633	22150434	59801	g_36115	g_10686
ptg000039l	22153626	22182954	29328	g_10686	g_18103
ptg000039l	22184162	22201829	17667	g_18103	g_36840
ptg000039l	22203035	22305633	102598	g_36840	g_37280
ptg000039l	22305971	22324750	18779	g_37280	g_35888
ptg000039l	22324971	22325028	57	g_35888	g_23233
ptg000039l	22325366	22343314	17948	g_23233	g_39371
ptg000039l	22343953	22485367	141414	g_39371	g_35207
ptg000039l	22486200	22488434	2234	g_35207	g_24702
ptg000039l	22489330	22492173	2843	g_24702	g_15386
ptg000039l	22493078	22498511	5433	g_15386	g_27484
ptg000039l	22505096	22513531	8435	g_27484	g_1599
ptg000039l	22521515	22527450	5935	g_1599	g_3505
ptg000039l	22528616	22555261	26645	g_3505	g_19909
ptg000039l	22556409	22567934	11525	g_19909	g_29897
ptg000039l	22569016	22585980	16964	g_29897	g_11858
ptg000039l	22587122	22589317	2195	g_11858	g_2777
ptg000039l	22601458	22615800	14342	g_2777	g_32279
ptg000039l	22627907	22694738	66831	g_32279	g_28746
ptg000039l	22702814	22843597	140783	g_28746	g_1310
ptg000039l	22847774	22893424	45650	g_1310	g_13378
ptg000039l	22894257	22896716	2459	g_13378	g_11455
ptg000039l	22906141	22920093	13952	g_11455	g_8258
ptg000039l	22920866	22932353	11487	g_8258	g_8469
ptg000039l	22933213	22960255	27042	g_8469	g_18968
ptg000039l	22960812	22984887	24075	g_18968	g_34649
ptg000039l	22985183	22985261	78	g_34649	g_14475
ptg000039l	22985797	23036166	50369	g_14475	g_12754
ptg000039l	23041177	23058894	17717	g_12754	g_7990
ptg000039l	23075537	23085978	10441	g_7990	g_24726
ptg000039l	23098381	23099816	1435	g_24726	g_6311
ptg000039l	23104973	23130293	25320	g_6311	g_13072
ptg000039l	23137449	23238364	100915	g_13072	g_35901
ptg000039l	23246583	23267270	20687	g_35901	g_32316
ptg000039l	23272862	23275318	2456	g_32316	g_34794
ptg000039l	23295164	23297546	2382	g_34794	g_11175
ptg000039l	23319675	23353943	34268	g_11175	g_5300
ptg000039l	23354488	23419966	65478	g_5300	g_18168
ptg000039l	23427756	23444421	16665	g_18168	g_29893
ptg000039l	23444886	23469491	24605	g_29893	g_32624
ptg000039l	23473555	23480865	7310	g_32624	g_14806
ptg000039l	23483132	23489875	6743	g_14806	g_36088
ptg000039l	23490990	23498096	7106	g_36088	g_37987
ptg000039l	23500363	23525193	24830	g_37987	g_28887
ptg000039l	23526068	23575264	49196	g_28887	g_32533
ptg000039l	23575641	23575706	65	g_32533	g_37667
ptg000039l	23579764	23579897	133	g_37667	g_6912
ptg000039l	23582707	23582772	65	g_6912	g_7436
ptg000039l	23586830	23593976	7146	g_7436	g_37849
ptg000039l	23596339	23621169	24830	g_37849	g_33504
ptg000039l	23622122	23765451	143329	g_33504	g_38935
ptg000039l	23765921	23842901	76980	g_38935	g_23132
ptg000039l	23844064	23850046	5982	g_23132	g_24147
ptg000039l	23853611	23859432	5821	g_24147	g_18358
ptg000039l	23866741	23877902	11161	g_18358	g_5806
ptg000039l	23881118	23935273	54155	g_5806	g_10690
ptg000039l	23938894	23958386	19492	g_10690	g_8887
ptg000039l	23964568	23971488	6920	g_8887	g_4566
ptg000039l	23986361	24000347	13986	g_4566	g_7699
ptg000039l	24000916	24079677	78761	g_7699	g_4644
ptg000039l	24080662	24126221	45559	g_4644	g_37392
ptg000039l	24126556	24287731	161175	g_37392	g_27611
ptg000039l	24308708	24311775	3067	g_27611	g_9710
ptg000039l	24317923	24332553	14630	g_9710	g_18854
ptg000039l	24332753	24373180	40427	g_18854	g_18022
ptg000039l	24375648	24381626	5978	g_18022	g_23649
ptg000039l	24399783	24427309	27526	g_23649	g_2732
ptg000039l	24429127	24438741	9614	g_2732	g_5411
ptg000039l	24443366	24450010	6644	g_5411	g_34100
ptg000039l	24459364	24465475	6111	g_34100	g_33194
ptg000040l	439109	449995	10886	g_26082	g_20942
ptg000040l	460191	465303	5112	g_20942	g_33602
ptg000040l	481986	567603	85617	g_33602	g_12688
ptg000040l	569984	574503	4519	g_12688	g_8097
ptg000040l	596005	601336	5331	g_8097	g_26107
ptg000040l	601596	612284	10688	g_26107	g_213
ptg000040l	614031	662503	48472	g_213	g_25657
ptg000040l	668281	824995	156714	g_25657	g_24514
ptg000040l	831048	837840	6792	g_24514	g_21737
ptg000040l	853899	871708	17809	g_21737	g_30897
ptg000040l	905708	914286	8578	g_30897	g_11097
ptg000040l	934426	951265	16839	g_11097	g_20629
ptg000040l	960554	978406	17852	g_20629	g_22801
ptg000040l	983282	1009578	26296	g_22801	g_1154
ptg000040l	1009976	1100889	90913	g_1154	g_26177
ptg000040l	1101497	1875026	773529	g_26177	g_33514
ptg000040l	1875349	1950778	75429	g_33514	g_26460
ptg000040l	1963834	2077557	113723	g_26460	g_9250
ptg000040l	2089138	2274864	185726	g_9250	g_29849
ptg000040l	2275148	2350553	75405	g_29849	g_7900
ptg000040l	2351656	2411748	60092	g_7900	g_29098
ptg000040l	2411978	2492593	80615	g_29098	g_17978
ptg000040l	2492841	2493392	551	g_17978	g_33947
ptg000040l	2493592	2494678	1086	g_33947	g_16717
ptg000040l	2494896	2495001	105	g_16717	g_29957
ptg000040l	2501811	2513629	11818	g_29957	g_12250
ptg000040l	2513958	2570129	56171	g_12250	g_40063
ptg000040l	2570536	2570656	120	g_40063	g_9036
ptg000040l	2572800	2588180	15380	g_9036	g_2642
ptg000040l	2594779	2599777	4998	g_2642	g_19321
ptg000040l	2607255	2629235	21980	g_19321	g_12529
ptg000040l	2629567	2689132	59565	g_12529	g_15
ptg000040l	2690475	2698830	8355	g_15	g_10372
ptg000040l	2713488	2826609	113121	g_10372	g_26517
ptg000040l	2826851	3049396	222545	g_26517	g_7531
ptg000040l	3057978	3058473	495	g_7531	g_9696
ptg000040l	3061684	3136577	74893	g_9696	g_18444
ptg000040l	3141262	3153927	12665	g_18444	g_660
ptg000040l	3161844	3187595	25751	g_660	g_6683
ptg000040l	3198709	3242697	43988	g_6683	g_34355
ptg000040l	3266122	3307612	41490	g_34355	g_6019
ptg000040l	3308592	3336657	28065	g_6019	g_30439
ptg000040l	3338436	3353019	14583	g_30439	g_18484
ptg000040l	3354440	3470195	115755	g_18484	g_33711
ptg000040l	3476209	3479559	3350	g_33711	g_9135
ptg000040l	3481850	3572098	90248	g_9135	g_29607
ptg000040l	3594893	3905856	310963	g_29607	g_14527
ptg000040l	3924413	3968300	43887	g_14527	g_8701
ptg000040l	3979501	3991166	11665	g_8701	g_15211
ptg000040l	3992214	3999754	7540	g_15211	g_13638
ptg000040l	4006289	4016455	10166	g_13638	g_8512
ptg000040l	4031098	4039914	8816	g_8512	g_34246
ptg000040l	4041254	4046460	5206	g_34246	g_24060
ptg000040l	4047080	4118436	71356	g_24060	g_27440
ptg000040l	4120103	4250946	130843	g_27440	g_27168
ptg000040l	4253030	4265427	12397	g_27168	g_897
ptg000040l	4266770	4297935	31165	g_897	g_8775
ptg000040l	4316906	4408703	91797	g_8775	g_15678
ptg000040l	4416210	4421353	5143	g_15678	g_29757
ptg000040l	4421811	4423774	1963	g_29757	g_5239
ptg000040l	4443429	4589632	146203	g_5239	g_14618
ptg000040l	4608285	4609944	1659	g_14618	g_27258
ptg000040l	4617043	4678806	61763	g_27258	g_17392
ptg000040l	4683950	4689855	5905	g_17392	g_6737
ptg000040l	4697670	4724798	27128	g_6737	g_5552
ptg000040l	4725307	4733717	8410	g_5552	g_39975
ptg000040l	4751622	4753197	1575	g_39975	g_4303
ptg000040l	4760726	4765232	4506	g_4303	g_19157
ptg000040l	4774607	4788667	14060	g_19157	g_34601
ptg000040l	4790058	4799182	9124	g_34601	g_11812
ptg000040l	4801027	4804645	3618	g_11812	g_32681
ptg000040l	4825787	4880799	55012	g_32681	g_23743
ptg000040l	4882949	4887906	4957	g_23743	g_34772
ptg000040l	4891331	4895511	4180	g_34772	g_13675
ptg000040l	4909268	4930856	21588	g_13675	g_20105
ptg000040l	4931395	4933347	1952	g_20105	g_20248
ptg000040l	4947542	5011472	63930	g_20248	g_38090
ptg000040l	5016757	5017483	726	g_38090	g_12552
ptg000040l	5017725	5076797	59072	g_12552	g_15934
ptg000040l	5099160	5204371	105211	g_15934	g_33440
ptg000040l	5204955	5235280	30325	g_33440	g_18121
ptg000041l	43099	52105	9006	g_20342	g_35845
ptg000041l	52329	54473	2144	g_35845	g_36890
ptg000041l	60384	63056	2672	g_36890	g_16554
ptg000041l	73638	105666	32028	g_16554	g_26922
ptg000041l	107381	117515	10134	g_26922	g_25155
ptg000041l	136028	143370	7342	g_25155	g_26043
ptg000041l	145871	146885	1014	g_26043	g_28845
ptg000041l	147694	148147	453	g_28845	g_11891
ptg000041l	170919	208825	37906	g_11891	g_26649
ptg000041l	214145	301285	87140	g_26649	g_37802
ptg000041l	302151	308456	6305	g_37802	g_29194
ptg000041l	309028	317176	8148	g_29194	g_30510
ptg000041l	317661	350771	33110	g_30510	g_24548
ptg000041l	351241	351319	78	g_24548	g_3274
ptg000041l	352041	352357	316	g_3274	g_8390
ptg000041l	352827	353273	446	g_8390	g_8206
ptg000041l	353563	382456	28893	g_8206	g_34268
ptg000041l	388883	392812	3929	g_34268	g_22377
ptg000042l	181685	243570	61885	g_11697	g_28636
ptg000042l	244379	274886	30507	g_28636	g_23662
ptg000042l	288093	305358	17265	g_23662	g_7591
ptg000042l	317818	344339	26521	g_7591	g_28704
ptg000042l	344692	407848	63156	g_28704	g_9733
ptg000042l	409519	493577	84058	g_9733	g_5323
ptg000043l	88648	91338	2690	g_10933	g_14553
ptg000043l	107386	111547	4161	g_14553	g_20467
ptg000043l	121051	122277	1226	g_20467	g_22620
ptg000043l	126509	127785	1276	g_22620	g_24525
ptg000043l	132402	135995	3593	g_24525	g_37537
ptg000043l	137023	137198	175	g_37537	g_40295
ptg000043l	148318	179991	31673	g_40295	g_10475
ptg000043l	180227	185819	5592	g_10475	g_1029
ptg000043l	187030	190926	3896	g_1029	g_24484
ptg000043l	207326	270725	63399	g_24484	g_21816
ptg000043l	275340	278043	2703	g_21816	g_8348
ptg000043l	278447	304907	26460	g_8348	g_2061
ptg000043l	307720	313259	5539	g_2061	g_18419
ptg000043l	316126	324399	8273	g_18419	g_4371
ptg000043l	326383	343902	17519	g_4371	g_8119
ptg000043l	346027	351180	5153	g_8119	g_31780
ptg000043l	359208	362469	3261	g_31780	g_38239
ptg000043l	363514	365970	2456	g_38239	g_13205
ptg000043l	370032	438586	68554	g_13205	g_20754
ptg000043l	458132	464993	6861	g_20754	g_33161
ptg000043l	473762	490496	16734	g_33161	g_36333
ptg000043l	492372	495277	2905	g_36333	g_6409
ptg000043l	508282	527554	19272	g_6409	g_30482
ptg000043l	535296	538818	3522	g_30482	g_21890
ptg000043l	543291	570222	26931	g_21890	g_34651
ptg000043l	570518	570722	204	g_34651	g_9764
ptg000043l	571051	572179	1128	g_9764	g_34453
ptg000043l	573111	575219	2108	g_34453	g_13623
ptg000043l	575626	580427	4801	g_13623	g_38762
ptg000043l	581323	584860	3537	g_38762	g_23658
ptg000043l	588135	601274	13139	g_23658	g_4435
ptg000043l	604528	610247	5719	g_4435	g_17622
ptg000043l	611503	629321	17818	g_17622	g_21452
ptg000043l	638108	641801	3693	g_21452	g_7481
ptg000043l	658513	660840	2327	g_7481	g_33831
ptg000043l	681472	682749	1277	g_33831	g_35143
ptg000043l	686231	688368	2137	g_35143	g_14455
ptg000043l	705306	716720	11414	g_14455	g_20943
ptg000043l	717914	733363	15449	g_20943	g_26363
ptg000043l	745344	747911	2567	g_26363	g_25940
ptg000043l	752779	761260	8481	g_25940	g_35308
ptg000043l	772386	777517	5131	g_35308	g_31857
ptg000043l	787536	789299	1763	g_31857	g_20055
ptg000043l	790330	799835	9505	g_20055	g_10986
ptg000043l	804195	808901	4706	g_10986	g_4129
ptg000043l	818592	842267	23675	g_4129	g_26618
ptg000043l	854979	858956	3977	g_26618	g_33692
ptg000043l	888968	907287	18319	g_33692	g_34001
ptg000043l	916929	923690	6761	g_34001	g_25713
ptg000043l	927477	929347	1870	g_25713	g_28684
ptg000043l	931199	935906	4707	g_28684	g_17301
ptg000043l	941430	953124	11694	g_17301	g_21462
ptg000043l	958979	965488	6509	g_21462	g_25784
ptg000043l	965730	1059689	93959	g_25784	g_12925
ptg000043l	1060708	1206256	145548	g_12925	g_23257
ptg000043l	1217267	1228773	11506	g_23257	g_15129
ptg000043l	1236803	1239292	2489	g_15129	g_25412
ptg000043l	1249644	1249748	104	g_25412	g_29163
ptg000043l	1260391	1288948	28557	g_29163	g_37485
ptg000043l	1294630	1298477	3847	g_37485	g_29930
ptg000043l	1299559	1316520	16961	g_29930	g_8477
ptg000043l	1318055	1322715	4660	g_8477	g_32945
ptg000043l	1330240	1334942	4702	g_32945	g_16237
ptg000043l	1348933	1349046	113	g_16237	g_38160
ptg000043l	1349279	1353989	4710	g_38160	g_25261
ptg000043l	1371803	1428018	56215	g_25261	g_13798
ptg000043l	1439861	1452637	12776	g_13798	g_25453
ptg000043l	1456772	1459332	2560	g_25453	g_20658
ptg000043l	1460927	1761448	300521	g_20658	g_24713
ptg000043l	1763391	2106283	342892	g_24713	g_31794
ptg000043l	2111196	2171155	59959	g_31794	g_36638
ptg000043l	2171394	2188610	17216	g_36638	g_30728
ptg000043l	2198411	2205585	7174	g_30728	g_1107
ptg000043l	2213198	2224421	11223	g_1107	g_16799
ptg000043l	2224624	2242889	18265	g_16799	g_30074
ptg000043l	2268380	2284710	16330	g_30074	g_12312
ptg000043l	2286005	2312258	26253	g_12312	g_35963
ptg000043l	2355102	2528899	173797	g_35963	g_20267
ptg000043l	2529495	2535915	6420	g_20267	g_15458
ptg000043l	2538754	2559701	20947	g_15458	g_21787
ptg000043l	2565607	2617968	52361	g_21787	g_14036
ptg000043l	2621886	2627896	6010	g_14036	g_4651
ptg000043l	2634903	2637468	2565	g_4651	g_21251
ptg000043l	2643351	2836190	192839	g_21251	g_16285
ptg000043l	2850710	2875868	25158	g_16285	g_33246
ptg000043l	2876785	2881668	4883	g_33246	g_13860
ptg000043l	2891213	3065785	174572	g_13860	g_19105
ptg000043l	3073679	3074939	1260	g_19105	g_7298
ptg000043l	3079290	3081696	2406	g_7298	g_18852
ptg000043l	3091602	3136607	45005	g_18852	g_3762
ptg000043l	3150021	3158458	8437	g_3762	g_34774
ptg000043l	3183327	3323589	140262	g_34774	g_448
ptg000043l	3328370	3332055	3685	g_448	g_11213
ptg000043l	3337362	3373095	35733	g_11213	g_24073
ptg000043l	3379885	3399116	19231	g_24073	g_35045
ptg000043l	3399532	3424184	24652	g_35045	g_5218
ptg000043l	3441962	3595592	153630	g_5218	g_26294
ptg000043l	3604116	3614070	9954	g_26294	g_8635
ptg000043l	3614513	3620649	6136	g_8635	g_34814
ptg000043l	3621362	3683164	61802	g_34814	g_21344
ptg000043l	3692493	3694957	2464	g_21344	g_30215
ptg000043l	3696114	3773827	77713	g_30215	g_31438
ptg000043l	3791332	3792799	1467	g_31438	g_29992
ptg000043l	3796287	3800074	3787	g_29992	g_2463
ptg000043l	3803565	3804895	1330	g_2463	g_39941
ptg000043l	3806491	3808318	1827	g_39941	g_2230
ptg000043l	3811189	3814738	3549	g_2230	g_21168
ptg000043l	3818967	3825084	6117	g_21168	g_2266
ptg000043l	3827807	3828664	857	g_2266	g_25188
ptg000043l	3834187	3848655	14468	g_25188	g_10780
ptg000043l	3855326	3855823	497	g_10780	g_8491
ptg000043l	3856992	3859895	2903	g_8491	g_20934
ptg000043l	3860719	3863904	3185	g_20934	g_25692
ptg000043l	3871388	3873971	2583	g_25692	g_5304
ptg000043l	3887177	3889213	2036	g_5304	g_31832
ptg000043l	3896849	3897965	1116	g_31832	g_2876
ptg000043l	3898516	4010559	112043	g_2876	g_31479
ptg000043l	4014680	4044425	29745	g_31479	g_18540
ptg000043l	4047659	4076166	28507	g_18540	g_22220
ptg000043l	4077695	4082600	4905	g_22220	g_38199
ptg000043l	4083727	4088061	4334	g_38199	g_27025
ptg000043l	4091207	4107757	16550	g_27025	g_18676
ptg000043l	4114468	4124191	9723	g_18676	g_27034
ptg000043l	4140321	4155859	15538	g_27034	g_36325
ptg000043l	4163212	4214148	50936	g_36325	g_27242
ptg000043l	4221057	4223279	2222	g_27242	g_11551
ptg000043l	4227712	4251592	23880	g_11551	g_15066
ptg000043l	4254932	4256252	1320	g_15066	g_14436
ptg000043l	4261558	4267024	5466	g_14436	g_36096
ptg000043l	4270955	4271536	581	g_36096	g_5062
ptg000043l	4288103	4290972	2869	g_5062	g_11931
ptg000043l	4306159	4361442	55283	g_11931	g_35455
ptg000043l	4375956	4419359	43403	g_35455	g_9382
ptg000043l	4429248	4580104	150856	g_9382	g_22932
ptg000043l	4580355	4588561	8206	g_22932	g_10527
ptg000043l	4588953	4622684	33731	g_10527	g_9204
ptg000043l	4623703	4681360	57657	g_9204	g_23446
ptg000043l	4701621	4998876	297255	g_23446	g_7101
ptg000043l	5019602	5030704	11102	g_7101	g_27351
ptg000043l	5046170	5046801	631	g_27351	g_4461
ptg000043l	5058248	5064502	6254	g_4461	g_25088
ptg000043l	5089055	5091317	2262	g_25088	g_23615
ptg000043l	5117182	5134463	17281	g_23615	g_38382
ptg000043l	5135653	5287940	152287	g_38382	g_17031
ptg000043l	5288182	5387482	99300	g_17031	g_30156
ptg000043l	5393665	5394894	1229	g_30156	g_9665
ptg000043l	5404141	5410301	6160	g_9665	g_18217
ptg000043l	5411788	5496857	85069	g_18217	g_8278
ptg000043l	5497174	5503127	5953	g_8278	g_8145
ptg000043l	5506345	5506755	410	g_8145	g_10894
ptg000043l	5508385	5509652	1267	g_10894	g_37331
ptg000043l	5510166	5512813	2647	g_37331	g_24314
ptg000043l	5520632	5691095	170463	g_24314	g_26046
ptg000043l	5703015	5728750	25735	g_26046	g_9184
ptg000043l	5729757	5729936	179	g_9184	g_7742
ptg000043l	5730178	5776385	46207	g_7742	g_33115
ptg000043l	5782777	5784577	1800	g_33115	g_35013
ptg000043l	5792380	5794852	2472	g_35013	g_5557
ptg000043l	5799225	5802239	3014	g_5557	g_9380
ptg000043l	5808959	5813951	4992	g_9380	g_36900
ptg000043l	5818455	5822096	3641	g_36900	g_12976
ptg000043l	5848740	5894374	45634	g_12976	g_21454
ptg000043l	5894574	5901760	7186	g_21454	g_27552
ptg000043l	5902623	5920522	17899	g_27552	g_23351
ptg000043l	5925782	5928282	2500	g_23351	g_8397
ptg000043l	5942537	5946564	4027	g_8397	g_40043
ptg000043l	5946773	5960407	13634	g_40043	g_2840
ptg000043l	5963685	5964507	822	g_2840	g_2031
ptg000043l	5966309	5966489	180	g_2031	g_35469
ptg000043l	5966962	6068107	101145	g_35469	g_18019
ptg000043l	6068977	6084785	15808	g_18019	g_2026
ptg000043l	6085036	6187902	102866	g_2026	g_38686
ptg000043l	6189681	6231023	41342	g_38686	g_5679
ptg000043l	6237928	6822663	584735	g_5679	g_32826
ptg000043l	6823388	6981526	158138	g_32826	g_21349
ptg000043l	6981858	7024285	42427	g_21349	g_19816
ptg000043l	7024617	7098281	73664	g_19816	g_17523
ptg000043l	7116823	7123283	6460	g_17523	g_21596
ptg000043l	7129385	7141883	12498	g_21596	g_9715
ptg000043l	7145152	7149450	4298	g_9715	g_20573
ptg000043l	7166051	7194464	28413	g_20573	g_11699
ptg000043l	7209108	7227743	18635	g_11699	g_36209
ptg000043l	7245167	7248263	3096	g_36209	g_36121
ptg000043l	7255854	7258362	2508	g_36121	g_4485
ptg000043l	7268530	7288897	20367	g_4485	g_22175
ptg000043l	7300533	7301778	1245	g_22175	g_30683
ptg000043l	7304742	7309433	4691	g_30683	g_40116
ptg000043l	7324890	7336055	11165	g_40116	g_12914
ptg000043l	7337951	7345996	8045	g_12914	g_29137
ptg000043l	7346673	7356958	10285	g_29137	g_35154
ptg000043l	7357731	7368733	11002	g_35154	g_24382
ptg000043l	7373073	7374020	947	g_24382	g_38499
ptg000043l	7374244	7377388	3144	g_38499	g_29420
ptg000043l	7379668	7380683	1015	g_29420	g_35638
ptg000043l	7381085	7384514	3429	g_35638	g_15154
ptg000043l	7395445	7398155	2710	g_15154	g_20577
ptg000043l	7401017	7424894	23877	g_20577	g_12246
ptg000043l	7432709	7447207	14498	g_12246	g_4520
ptg000043l	7466851	7470569	3718	g_4520	g_26531
ptg000043l	7481524	7510221	28697	g_26531	g_27667
ptg000043l	7528453	7551969	23516	g_27667	g_16518
ptg000043l	7552199	7552610	411	g_16518	g_15574
ptg000043l	7553613	7629625	76012	g_15574	g_36978
ptg000043l	7648864	7655075	6211	g_36978	g_17067
ptg000043l	7661426	7696557	35131	g_17067	g_8153
ptg000043l	7697444	7758135	60691	g_8153	g_3829
ptg000043l	7771639	7776861	5222	g_3829	g_5830
ptg000043l	7777307	7778670	1363	g_5830	g_21642
ptg000043l	7779062	7800786	21724	g_21642	g_12912
ptg000043l	7810580	7813710	3130	g_12912	g_744
ptg000043l	7817213	7823326	6113	g_744	g_16024
ptg000043l	7824171	7833210	9039	g_16024	g_36683
ptg000043l	7846936	7855881	8945	g_36683	g_12355
ptg000043l	7856801	7859730	2929	g_12355	g_10817
ptg000043l	7860107	7864388	4281	g_10817	g_35877
ptg000043l	7865679	7870574	4895	g_35877	g_4376
ptg000043l	7886743	7894437	7694	g_4376	g_18176
ptg000043l	7908523	7949757	41234	g_18176	g_17674
ptg000043l	7949969	7954217	4248	g_17674	g_10805
ptg000043l	7965871	7974531	8660	g_10805	g_18145
ptg000043l	7983553	8053608	70055	g_18145	g_2461
ptg000043l	8076671	8083252	6581	g_2461	g_17013
ptg000043l	8083533	8088558	5025	g_17013	g_15768
ptg000043l	8102485	8131871	29386	g_15768	g_5977
ptg000043l	8150164	8259045	108881	g_5977	g_22204
ptg000043l	8260640	8322410	61770	g_22204	g_5382
ptg000043l	8327056	8447532	120476	g_5382	g_14450
ptg000043l	8451101	8591956	140855	g_14450	g_27956
ptg000043l	8592747	8621454	28707	g_27956	g_36826
ptg000043l	8621654	8743564	121910	g_36826	g_24024
ptg000043l	8759738	8857497	97759	g_24024	g_573
ptg000043l	8877059	8879725	2666	g_573	g_7606
ptg000043l	8881907	8942108	60201	g_7606	g_28527
ptg000043l	8942323	9074429	132106	g_28527	g_17267
ptg000043l	9076112	9084115	8003	g_17267	g_20760
ptg000043l	9094908	9096961	2053	g_20760	g_40210
ptg000043l	9107106	9157980	50874	g_40210	g_14693
ptg000043l	9170258	9179108	8850	g_14693	g_1393
ptg000043l	9193881	9199469	5588	g_1393	g_35034
ptg000043l	9211365	9229199	17834	g_35034	g_36418
ptg000043l	9229930	9230263	333	g_36418	g_37975
ptg000043l	9231420	9231700	280	g_37975	g_16603
ptg000043l	9232566	9329531	96965	g_16603	g_2290
ptg000043l	9346628	9348651	2023	g_2290	g_25184
ptg000043l	9349055	9476699	127644	g_25184	g_2559
ptg000043l	9486234	9519424	33190	g_2559	g_4462
ptg000043l	9524820	9584942	60122	g_4462	g_4924
ptg000043l	9591965	9634928	42963	g_4924	g_38631
ptg000043l	9635188	9696428	61240	g_38631	g_36715
ptg000043l	9696718	9720124	23406	g_36715	g_20708
ptg000043l	9762393	9766474	4081	g_20708	g_2500
ptg000043l	9773406	9878965	105559	g_2500	g_30422
ptg000043l	9888099	9910582	22483	g_30422	g_29548
ptg000043l	9910800	9927634	16834	g_29548	g_11489
ptg000043l	9937775	9962423	24648	g_11489	g_39185
ptg000043l	9963391	9963494	103	g_39185	g_24244
ptg000043l	9964296	9997915	33619	g_24244	g_11820
ptg000043l	9998238	10030321	32083	g_28669	g_19943
ptg000043l	10052195	10052586	391	g_19943	g_30829
ptg000043l	10052897	10066599	13702	g_30829	g_8936
ptg000043l	10075478	10142800	67322	g_8936	g_21004
ptg000043l	10156214	10159195	2981	g_21004	g_35294
ptg000043l	10175291	10178606	3315	g_35294	g_1930
ptg000043l	10191048	10195127	4079	g_1930	g_14607
ptg000043l	10206029	10216413	10384	g_14607	g_32641
ptg000043l	10218233	10222830	4597	g_32641	g_18723
ptg000043l	10223105	10223728	623	g_18723	g_4656
ptg000043l	10232505	10238821	6316	g_4656	g_7734
ptg000043l	10250240	10353157	102917	g_7734	g_17364
ptg000043l	10362901	10371413	8512	g_17364	g_38571
ptg000043l	10387781	10448888	61107	g_36605	g_6728
ptg000043l	10455193	10523836	68643	g_6728	g_2391
ptg000043l	10539408	10550233	10825	g_2391	g_16339
ptg000043l	10588805	10596474	7669	g_16339	g_14411
ptg000043l	10596800	10720510	123710	g_14411	g_28035
ptg000043l	10720806	10845945	125139	g_28035	g_3557
ptg000043l	10848716	10884811	36095	g_3557	g_19877
ptg000043l	10885116	10885240	124	g_19877	g_12623
ptg000043l	10885698	10903002	17304	g_12623	g_22121
ptg000043l	10925986	11027302	101316	g_22121	g_31
ptg000043l	11028405	11046302	17897	g_31	g_1927
ptg000043l	11046565	11049487	2922	g_1927	g_25740
ptg000044l	7487	42698	35211	g_35475	g_11826
ptg000044l	44000	130511	86511	g_11826	g_31277
ptg000044l	131071	151141	20070	g_31277	g_40069
ptg000044l	164288	164336	48	g_40069	g_9517
ptg000044l	170766	174140	3374	g_9517	g_11594
ptg000044l	182676	196172	13496	g_11594	g_27231
ptg000044l	212369	214611	2242	g_27231	g_14640
ptg000044l	227824	229511	1687	g_14640	g_34374
ptg000044l	235199	237075	1876	g_34374	g_38381
ptg000044l	245973	252756	6783	g_15423	g_37600
ptg000044l	254616	258821	4205	g_37600	g_31732
ptg000044l	261908	283215	21307	g_31732	g_20393
ptg000044l	283691	346959	63268	g_20393	g_5934
ptg000044l	347558	378029	30471	g_5934	g_11899
ptg000044l	382770	384621	1851	g_11899	g_13172
ptg000044l	385037	418725	33688	g_13172	g_25454
ptg000044l	420924	422826	1902	g_25454	g_11002
ptg000044l	447102	457791	10689	g_11002	g_12652
ptg000044l	458081	459856	1775	g_12652	g_340
ptg000044l	462790	492486	29696	g_340	g_33924
ptg000044l	492695	530654	37959	g_33924	g_17725
ptg000044l	606764	662002	55238	g_17725	g_31648
ptg000044l	699878	704112	4234	g_31648	g_33933
ptg000044l	708672	919093	210421	g_33933	g_3372
ptg000044l	937103	948715	11612	g_3372	g_6475
ptg000044l	975672	978612	2940	g_6475	g_22727
ptg000044l	979523	986979	7456	g_22727	g_40227
ptg000044l	999471	1027106	27635	g_40227	g_11790
ptg000044l	1027315	1054100	26785	g_11790	g_18760
ptg000044l	1056163	1058631	2468	g_18760	g_28912
ptg000044l	1077754	1083353	5599	g_28912	g_30908
ptg000044l	1112035	1120741	8706	g_30908	g_2579
ptg000044l	1121487	1123757	2270	g_2579	g_10004
ptg000044l	1136191	1138126	1935	g_10004	g_24556
ptg000044l	1142389	1143808	1419	g_24556	g_11645
ptg000044l	1145620	1150163	4543	g_11645	g_26263
ptg000044l	1154443	1157253	2810	g_26263	g_27771
ptg000044l	1162940	1175276	12336	g_27771	g_14871
ptg000044l	1187027	1193863	6836	g_14871	g_4189
ptg000044l	1203279	1205166	1887	g_4189	g_30175
ptg000044l	1211772	1220347	8575	g_30175	g_25813
ptg000044l	1226615	1237055	10440	g_25813	g_15959
ptg000044l	1252500	1263356	10856	g_15959	g_11894
ptg000044l	1263676	1264220	544	g_11894	g_1650
ptg000044l	1264444	1274244	9800	g_1650	g_8508
ptg000044l	1274552	1315446	40894	g_8508	g_8557
ptg000044l	1315664	1329081	13417	g_8557	g_25673
ptg000044l	1329371	1339742	10371	g_25673	g_5073
ptg000044l	1344328	1376909	32581	g_5073	g_3189
ptg000044l	1385235	1387462	2227	g_3189	g_32387
ptg000044l	1400609	1417323	16714	g_32387	g_15962
ptg000044l	1434386	1436495	2109	g_15962	g_27953
ptg000044l	1447294	1467974	20680	g_27953	g_4892
ptg000044l	1468195	1468301	106	g_4892	g_30612
ptg000044l	1485800	1498642	12842	g_30612	g_31826
ptg000044l	1504879	1529253	24374	g_31826	g_19545
ptg000044l	1533364	1640467	107103	g_19545	g_1999
ptg000044l	1642200	1663243	21043	g_1999	g_39697
ptg000044l	1663803	1725375	61572	g_39697	g_6102
ptg000044l	1725743	1741378	15635	g_6102	g_38363
ptg000044l	1742397	1844518	102121	g_38363	g_17063
ptg000044l	1855319	1998790	143471	g_17063	g_1712
ptg000044l	1999038	2069722	70684	g_1712	g_30110
ptg000044l	2069949	2079403	9454	g_30110	g_20157
ptg000044l	2079708	2091587	11879	g_20157	g_38283
ptg000044l	2095881	2100610	4729	g_38283	g_26488
ptg000044l	2125537	2148829	23292	g_26488	g_37615
ptg000044l	2149173	2159957	10784	g_37615	g_4870
ptg000044l	2160280	2360711	200431	g_4870	g_15388
ptg000044l	2361598	2518232	156634	g_15388	g_35497
ptg000044l	2518450	2625328	106878	g_35497	g_4338
ptg000044l	2625720	2796412	170692	g_4338	g_35657
ptg000044l	2796738	2840815	44077	g_35657	g_7351
ptg000044l	2841561	2849676	8115	g_38937	g_38479
ptg000044l	2850839	2869451	18612	g_29505	g_19445
ptg000044l	2870183	2883964	13781	g_19445	g_23234
ptg000044l	2887566	2899198	11632	g_23234	g_31498
ptg000044l	2918959	2928418	9459	g_31498	g_7972
ptg000044l	2928651	2942172	13521	g_7972	g_34085
ptg000044l	2942432	2982512	40080	g_34085	g_8037
ptg000044l	2991614	2993816	2202	g_8037	g_25250
ptg000044l	2997961	3019410	21449	g_25250	g_7724
ptg000044l	3026835	3044149	17314	g_7724	g_1711
ptg000044l	3066444	3069527	3083	g_1711	g_36788
ptg000044l	3069889	3071582	1693	g_36788	g_30909
ptg000044l	3083807	3090359	6552	g_30909	g_39674
ptg000044l	3091429	3145204	53775	g_39674	g_20397
ptg000044l	3158661	3170579	11918	g_20397	g_35420
ptg000044l	3171661	3175721	4060	g_35420	g_36917
ptg000044l	3198372	3204158	5786	g_36917	g_29343
ptg000044l	3204370	3209288	4918	g_29343	g_21579
ptg000044l	3213909	3218454	4545	g_21579	g_12709
ptg000044l	3219859	3220993	1134	g_12709	g_7599
ptg000044l	3223845	3280475	56630	g_7599	g_18324
ptg000044l	3281920	3836626	554706	g_18324	g_11873
ptg000044l	3838282	3859666	21384	g_11873	g_25090
ptg000044l	3863804	3868687	4883	g_25090	g_20898
ptg000044l	3870106	3976019	105913	g_20898	g_14541
ptg000044l	3986880	3994175	7295	g_14541	g_677
ptg000044l	3995506	4267477	271971	g_677	g_27597
ptg000044l	4268196	4282971	14775	g_27597	g_2217
ptg000044l	4304667	4309815	5148	g_2217	g_3415
ptg000044l	4324825	4415276	90451	g_3415	g_9360
ptg000044l	4416139	4435659	19520	g_9360	g_37281
ptg000044l	4449471	4453219	3748	g_37281	g_21757
ptg000044l	4458917	4464305	5388	g_21757	g_37780
ptg000044l	4474906	4475913	1007	g_37780	g_33902
ptg000044l	4477025	4511405	34380	g_33902	g_31086
ptg000044l	4528464	4536552	8088	g_31086	g_16487
ptg000044l	4536932	4553765	16833	g_16487	g_954
ptg000044l	4560921	4562348	1427	g_954	g_14331
ptg000044l	4573649	4577761	4112	g_14331	g_35480
ptg000044l	4582421	4597189	14768	g_35480	g_13057
ptg000044l	4602379	4633038	30659	g_13057	g_1464
ptg000044l	4636395	4693836	57441	g_1464	g_25360
ptg000044l	4700649	4777084	76435	g_25360	g_25923
ptg000044l	4790826	4794702	3876	g_25923	g_26080
ptg000044l	4795529	4806101	10572	g_26080	g_15741
ptg000044l	4806391	4834954	28563	g_15741	g_20062
ptg000044l	4836626	4837937	1311	g_20062	g_38544
ptg000044l	4838320	4838424	104	g_38544	g_39273
ptg000044l	4839929	4840522	593	g_39273	g_38552
ptg000044l	4840827	4847817	6990	g_38552	g_21983
ptg000044l	4853553	4959419	105866	g_21983	g_8412
ptg000044l	4963381	4976665	13284	g_8412	g_26351
ptg000044l	4979237	4980552	1315	g_26351	g_22983
ptg000044l	4980806	5001973	21167	g_22983	g_5882
ptg000044l	5004547	5006651	2104	g_5882	g_11777
ptg000044l	5006968	5013631	6663	g_11777	g_13225
ptg000044l	5022597	5030975	8378	g_13225	g_25091
ptg000044l	5033457	5039869	6412	g_25091	g_17595
ptg000044l	5047403	5053878	6475	g_17595	g_4697
ptg000044l	5056384	5058610	2226	g_4697	g_19500
ptg000044l	5058810	5061847	3037	g_19500	g_35664
ptg000044l	5070926	5089194	18268	g_35664	g_20951
ptg000044l	5093000	5098018	5018	g_20951	g_17857
ptg000044l	5100613	5103514	2901	g_17857	g_27052
ptg000044l	5105330	5106982	1652	g_27052	g_36464
ptg000044l	5109549	5293200	183651	g_36464	g_10908
ptg000044l	5320581	5331665	11084	g_10908	g_24554
ptg000044l	5335033	5344310	9277	g_24554	g_27938
ptg000044l	5350470	5362603	12133	g_27938	g_21318
ptg000044l	5382153	5392525	10372	g_21318	g_7015
ptg000044l	5422781	5751261	328480	g_7015	g_25878
ptg000044l	5753202	5779104	25902	g_25878	g_35351
ptg000044l	5798291	5800659	2368	g_35351	g_25397
ptg000044l	5802997	5804463	1466	g_25397	g_4635
ptg000044l	5806852	5811757	4905	g_4635	g_31116
ptg000044l	5814006	5895553	81547	g_31116	g_14754
ptg000044l	5895828	5926114	30286	g_14754	g_25332
ptg000044l	5926632	6060200	133568	g_25332	g_29716
ptg000044l	6061867	6143212	81345	g_29716	g_31078
ptg000044l	6147133	6148129	996	g_31078	g_1894
ptg000044l	6149995	6154833	4838	g_1894	g_3284
ptg000044l	6178232	6183382	5150	g_3284	g_33848
ptg000044l	6185130	6237752	52622	g_33848	g_31880
ptg000044l	6263031	6280724	17693	g_31880	g_31700
ptg000044l	6282353	6287742	5389	g_31700	g_3572
ptg000044l	6300521	6311353	10832	g_3572	g_6808
ptg000044l	6328916	6388015	59099	g_6808	g_40213
ptg000044l	6410136	6412428	2292	g_40213	g_21446
ptg000044l	6415884	6422068	6184	g_21446	g_30789
ptg000044l	6423096	6425167	2071	g_30789	g_28201
ptg000044l	6427478	6432806	5328	g_28201	g_31738
ptg000044l	6454796	6458789	3993	g_31738	g_822
ptg000044l	6466711	6471959	5248	g_822	g_37566
ptg000044l	6475329	6475772	443	g_37566	g_16078
ptg000044l	6484142	6485758	1616	g_16078	g_31381
ptg000044l	6490605	6517771	27166	g_31381	g_24882
ptg000044l	6518109	6518434	325	g_24882	g_36599
ptg000044l	6518697	6553401	34704	g_36599	g_18585
ptg000044l	6564848	6574746	9898	g_18585	g_33594
ptg000044l	6575309	6576264	955	g_33594	g_8585
ptg000044l	6577428	6593162	15734	g_8585	g_31203
ptg000044l	6597540	6598800	1260	g_31203	g_1351
ptg000044l	6599588	6611424	11836	g_1351	g_15456
ptg000044l	6615191	6621263	6072	g_15456	g_37828
ptg000044l	6632153	6649670	17517	g_37828	g_26692
ptg000044l	6652384	6675308	22924	g_26692	g_19611
ptg000044l	6695204	6745988	50784	g_19611	g_25996
ptg000044l	6756263	6763867	7604	g_25996	g_33168
ptg000044l	6764109	6768986	4877	g_33168	g_21473
ptg000044l	6779445	6785096	5651	g_21473	g_23484
ptg000044l	6799002	6913413	114411	g_23484	g_12455
ptg000044l	6935566	6983799	48233	g_12455	g_40108
ptg000044l	6985025	6992789	7764	g_40108	g_12238
ptg000044l	7007682	7019557	11875	g_12238	g_1913
ptg000044l	7021449	7029759	8310	g_1913	g_3985
ptg000044l	7042945	7053647	10702	g_3985	g_961
ptg000044l	7055252	7070183	14931	g_961	g_14162
ptg000044l	7086434	7091968	5534	g_14162	g_33934
ptg000044l	7100810	7121235	20425	g_33934	g_24343
ptg000044l	7133023	7137452	4429	g_24343	g_7784
ptg000044l	7146989	7149955	2966	g_7784	g_31319
ptg000044l	7161882	7167636	5754	g_31319	g_4810
ptg000044l	7172690	7173129	439	g_4810	g_33761
ptg000044l	7177274	7205197	27923	g_33761	g_23135
ptg000044l	7211876	7218216	6340	g_23135	g_15489
ptg000044l	7219500	7230139	10639	g_15489	g_21572
ptg000044l	7237070	7248962	11892	g_21572	g_13162
ptg000044l	7260247	7262625	2378	g_13162	g_26064
ptg000044l	7268228	7273522	5294	g_26064	g_9089
ptg000044l	7300821	7345451	44630	g_9089	g_33477
ptg000044l	7361034	7398579	37545	g_33477	g_12301
ptg000044l	7400213	7432509	32296	g_12301	g_3696
ptg000044l	7440798	7466247	25449	g_3696	g_5697
ptg000044l	7467035	7477723	10688	g_5697	g_14637
ptg000044l	7484748	7501236	16488	g_14637	g_2803
ptg000044l	7511299	7536670	25371	g_2803	g_8952
ptg000044l	7553075	7571061	17986	g_8952	g_2101
ptg000044l	7575865	7593705	17840	g_2101	g_28214
ptg000044l	7613994	7616603	2609	g_28214	g_22508
ptg000044l	7622442	7630573	8131	g_22508	g_36146
ptg000044l	7634346	7639812	5466	g_36146	g_19661
ptg000044l	7649640	7657414	7774	g_19661	g_8780
ptg000044l	7660159	7664610	4451	g_8780	g_21685
ptg000044l	7668191	7686371	18180	g_21685	g_24685
ptg000044l	7691330	7692384	1054	g_24685	g_30211
ptg000044l	7696104	7697121	1017	g_30211	g_13189
ptg000044l	7698965	7722612	23647	g_13189	g_7045
ptg000044l	7753962	7763976	10014	g_7045	g_3558
ptg000044l	7779680	7819593	39913	g_3558	g_13344
ptg000044l	7819877	7820434	557	g_13344	g_6322
ptg000044l	7860369	7910409	50040	g_6322	g_21095
ptg000044l	7910738	7938838	28100	g_21095	g_2656
ptg000044l	7939977	7944958	4981	g_2656	g_22360
ptg000044l	7956544	7969798	13254	g_22360	g_13676
ptg000044l	7978079	8012501	34422	g_13676	g_11069
ptg000044l	8026418	8130512	104094	g_11069	g_25340
ptg000044l	8135520	8179560	44040	g_25340	g_20167
ptg000044l	8179814	8219138	39324	g_20167	g_18045
ptg000044l	8227479	8293742	66263	g_18045	g_14910
ptg000044l	8299884	8307829	7945	g_14910	g_9354
ptg000044l	8320267	8327947	7680	g_9354	g_16146
ptg000044l	8332944	8336000	3056	g_16146	g_10706
ptg000044l	8341651	8393836	52185	g_10706	g_33322
ptg000044l	8399308	8422629	23321	g_33322	g_8963
ptg000044l	8423048	8455884	32836	g_8963	g_30504
ptg000044l	8464999	8482786	17787	g_30504	g_14073
ptg000044l	8504558	8509874	5316	g_14073	g_31439
ptg000044l	8511785	8738381	226596	g_31439	g_35465
ptg000044l	8739514	8850046	110532	g_35465	g_12402
ptg000044l	8850654	9111116	260462	g_12402	g_18638
ptg000044l	9113703	9147171	33468	g_18638	g_9796
ptg000044l	9149228	9154364	5136	g_9796	g_17215
ptg000044l	9164934	9198170	33236	g_17215	g_22538
ptg000044l	9202148	9211029	8881	g_22538	g_9755
ptg000044l	9295064	9371116	76052	g_9755	g_16585
ptg000044l	9383328	9399764	16436	g_16585	g_33190
ptg000044l	9400798	9514568	113770	g_33190	g_5429
ptg000044l	9516935	9518083	1148	g_5429	g_26152
ptg000044l	9520788	9523767	2979	g_26152	g_35210
ptg000044l	9538621	9597109	58488	g_35210	g_1125
ptg000044l	9604111	9608976	4865	g_1125	g_26587
ptg000044l	9611122	9612934	1812	g_26587	g_24982
ptg000044l	9618746	9656780	38034	g_24982	g_10914
ptg000044l	9676426	9679355	2929	g_10914	g_19616
ptg000044l	9679558	9682970	3412	g_19616	g_28111
ptg000044l	9686568	9691660	5092	g_28111	g_31836
ptg000044l	9697198	9702900	5702	g_31836	g_18386
ptg000044l	9709786	9725283	15497	g_18386	g_34197
ptg000044l	9727544	9747735	20191	g_34197	g_5994
ptg000044l	9752591	9756370	3779	g_5994	g_18767
ptg000044l	9758190	9782807	24617	g_18767	g_18404
ptg000044l	9783682	9795277	11595	g_18404	g_25951
ptg000044l	9805322	9813070	7748	g_25951	g_11666
ptg000044l	9821895	9839696	17801	g_11666	g_29364
ptg000044l	9842517	9843372	855	g_29364	g_33239
ptg000044l	9846545	9853438	6893	g_33239	g_5687
ptg000044l	9857794	9872408	14614	g_5687	g_34321
ptg000044l	9873023	9889532	16509	g_34321	g_37790
ptg000044l	9889792	10118919	229127	g_37790	g_38110
ptg000044l	10125585	10146634	21049	g_38110	g_18664
ptg000044l	10161682	10191318	29636	g_18664	g_36635
ptg000044l	10197752	10217878	20126	g_36635	g_37309
ptg000044l	10224137	10227952	3815	g_37309	g_16780
ptg000044l	10236479	10255555	19076	g_16780	g_8027
ptg000044l	10255827	10256991	1164	g_8027	g_9018
ptg000044l	10259872	10302694	42822	g_9018	g_40290
ptg000044l	10318251	10320562	2311	g_40290	g_35696
ptg000044l	10323926	10324620	694	g_35696	g_36262
ptg000044l	10330171	10336645	6474	g_36262	g_14876
ptg000044l	10352381	10370782	18401	g_14876	g_21868
ptg000044l	10371090	10379974	8884	g_21868	g_10565
ptg000044l	10401112	10411664	10552	g_10565	g_28851
ptg000044l	10413138	10414702	1564	g_28851	g_12744
ptg000044l	10415829	10452890	37061	g_12744	g_24378
ptg000044l	10463613	10466804	3191	g_24378	g_13357
ptg000044l	10468389	10475387	6998	g_13357	g_27426
ptg000044l	10480200	10486881	6681	g_27426	g_30133
ptg000044l	10495197	10591327	96130	g_30133	g_14700
ptg000044l	10591575	10769580	178005	g_14700	g_2845
ptg000044l	10771455	10821764	50309	g_2845	g_9237
ptg000044l	10851395	10862775	11380	g_9237	g_29276
ptg000044l	10871888	10894926	23038	g_29276	g_32375
ptg000044l	10898526	10970216	71690	g_32375	g_34920
ptg000044l	10978981	10982434	3453	g_39715	g_21775
ptg000044l	10983919	10986428	2509	g_21775	g_20245
ptg000044l	11000546	11002938	2392	g_20245	g_25414
ptg000044l	11010500	11018888	8388	g_25414	g_39778
ptg000044l	11019112	11020404	1292	g_39778	g_40254
ptg000044l	11021411	11024685	3274	g_40254	g_19396
ptg000044l	11026884	11031485	4601	g_19396	g_29168
ptg000044l	11032200	11035975	3775	g_29168	g_40272
ptg000044l	11040509	11044184	3675	g_40272	g_29747
ptg000044l	11045302	11048432	3130	g_29747	g_24311
ptg000044l	11050073	11054060	3987	g_24311	g_4571
ptg000044l	11068396	11071010	2614	g_4571	g_31454
ptg000044l	11071216	11119782	48566	g_31454	g_29804
ptg000044l	11122190	11125402	3212	g_29804	g_35487
ptg000044l	11125842	11138855	13013	g_35487	g_19378
ptg000044l	11150822	11152434	1612	g_19378	g_27704
ptg000044l	11161232	11165562	4330	g_27704	g_39939
ptg000044l	11178251	11181173	2922	g_39939	g_2096
ptg000044l	11191505	11197529	6024	g_2096	g_25525
ptg000044l	11197768	11205628	7860	g_25525	g_10486
ptg000044l	11210957	11214242	3285	g_10486	g_33824
ptg000044l	11215162	11218559	3397	g_33824	g_4500
ptg000044l	11219416	11220261	845	g_4500	g_35230
ptg000044l	11222510	11227552	5042	g_35230	g_22330
ptg000044l	11228562	11229805	1243	g_22330	g_11685
ptg000044l	11231947	11233260	1313	g_11685	g_38504
ptg000044l	11235730	11240901	5171	g_28005	g_31932
ptg000044l	11244317	11250386	6069	g_31932	g_27198
ptg000044l	11263963	11268217	4254	g_27198	g_26086
ptg000044l	11270200	11294184	23984	g_26086	g_1343
ptg000044l	11294654	11301666	7012	g_1343	g_34565
ptg000044l	11302136	11309481	7345	g_34565	g_118
ptg000044l	11323091	11329844	6753	g_118	g_9722
ptg000044l	11332529	11334864	2335	g_9722	g_15514
ptg000044l	11340856	11343546	2690	g_15514	g_7494
ptg000044l	11344749	11346150	1401	g_7494	g_36740
ptg000044l	11349724	11350525	801	g_36740	g_15612
ptg000044l	11357213	11362297	5084	g_15612	g_37115
ptg000044l	11374463	11378871	4408	g_37115	g_2962
ptg000044l	11394464	11399340	4876	g_2962	g_39956
ptg000044l	11399642	11429068	29426	g_39956	g_16650
ptg000044l	11437029	11437839	810	g_16650	g_10069
ptg000044l	11438912	11450267	11355	g_10069	g_15083
ptg000044l	11474825	11485146	10321	g_15083	g_12263
ptg000044l	11485778	11512860	27082	g_12263	g_20762
ptg000044l	11520993	11525051	4058	g_20762	g_22123
ptg000044l	11532119	11542945	10826	g_22123	g_33343
ptg000044l	11543601	11552991	9390	g_33343	g_12025
ptg000044l	11556244	11556628	384	g_12025	g_32724
ptg000044l	11557065	11561079	4014	g_32724	g_36081
ptg000044l	11566553	11584250	17697	g_36081	g_15629
ptg000044l	11588824	11592677	3853	g_15629	g_37105
ptg000044l	11599325	11614053	14728	g_37105	g_24712
ptg000044l	11622775	11625034	2259	g_24712	g_14083
ptg000044l	11636884	11646708	9824	g_14083	g_30228
ptg000044l	11659754	11661413	1659	g_30228	g_18559
ptg000044l	11674447	11676204	1757	g_18559	g_33980
ptg000044l	11680428	11693533	13105	g_33980	g_26224
ptg000044l	11703021	11705712	2691	g_26224	g_6277
ptg000044l	11706164	11709017	2853	g_6277	g_8731
ptg000044l	11709523	11714736	5213	g_8731	g_32177
ptg000044l	11720538	11724298	3760	g_32177	g_598
ptg000044l	11729171	11745729	16558	g_598	g_22380
ptg000044l	11746799	11750574	3775	g_22380	g_3633
ptg000044l	11750822	11760180	9358	g_3633	g_20988
ptg000044l	11770524	11772526	2002	g_20988	g_28126
ptg000044l	11783526	11788165	4639	g_28126	g_9704
ptg000044l	11792762	11803781	11019	g_9704	g_11000
ptg000044l	11818477	11822805	4328	g_11000	g_37463
ptg000044l	11829101	11830995	1894	g_37463	g_29613
ptg000044l	11835201	11853734	18533	g_29613	g_27869
ptg000044l	11860355	11866462	6107	g_27869	g_24279
ptg000044l	11871289	11872773	1484	g_24279	g_1926
ptg000044l	11879712	11882554	2842	g_1926	g_16280
ptg000044l	11893097	11949553	56456	g_16280	g_388
ptg000044l	11966380	11969523	3143	g_388	g_39905
ptg000044l	11977974	11979614	1640	g_39905	g_6148
ptg000044l	11981614	11982413	799	g_6148	g_39448
ptg000044l	11982943	11983128	185	g_39448	g_40010
ptg000044l	11984463	11999186	14723	g_40010	g_24905
ptg000044l	11999811	12045575	45764	g_24905	g_35423
ptg000044l	12052757	12056907	4150	g_35423	g_24498
ptg000044l	12063077	12123730	60653	g_24498	g_12009
ptg000044l	12144293	12150725	6432	g_12009	g_14345
ptg000044l	12202606	12221521	18915	g_14345	g_15296
ptg000044l	12222720	12345948	123228	g_15296	g_12328
ptg000044l	12364888	12439743	74855	g_12328	g_2683
ptg000044l	12450607	12455030	4423	g_2683	g_32740
ptg000044l	12460290	12463703	3413	g_32740	g_16533
ptg000044l	12465724	12483598	17874	g_16533	g_28479
ptg000044l	12490477	12493650	3173	g_28479	g_16400
ptg000044l	12500921	12514427	13506	g_16400	g_11266
ptg000044l	12515059	12609242	94183	g_11266	g_15357
ptg000044l	12614234	12618228	3994	g_15357	g_28514
ptg000044l	12632504	12634678	2174	g_28514	g_7809
ptg000044l	12641091	12642319	1228	g_7809	g_25935
ptg000044l	12644992	12648912	3920	g_25935	g_21571
ptg000044l	12651450	12671282	19832	g_21571	g_29922
ptg000044l	12673821	12676629	2808	g_29922	g_38318
ptg000044l	12689965	12701902	11937	g_38318	g_24616
ptg000044l	12708635	12713002	4367	g_24616	g_18221
ptg000044l	12721826	12723294	1468	g_18221	g_35757
ptg000044l	12723569	12781522	57953	g_35757	g_9005
ptg000044l	12784825	12789625	4800	g_9005	g_30204
ptg000044l	12800726	12802902	2176	g_30204	g_35224
ptg000044l	12806980	12822000	15020	g_35224	g_2909
ptg000044l	12823028	12848972	25944	g_2909	g_36873
ptg000044l	12864079	12880731	16652	g_36873	g_2629
ptg000044l	12887184	12889936	2752	g_2629	g_13032
ptg000044l	12897247	12901924	4677	g_13032	g_37902
ptg000044l	12921675	12928044	6369	g_37902	g_27770
ptg000044l	12929345	12930968	1623	g_27770	g_9455
ptg000044l	12937671	12942884	5213	g_9455	g_35325
ptg000044l	12958558	12975637	17079	g_35325	g_15195
ptg000044l	12975972	12987768	11796	g_15195	g_35203
ptg000044l	12989375	12990887	1512	g_35203	g_9133
ptg000044l	13000634	13003635	3001	g_9133	g_14571
ptg000044l	13009642	13017225	7583	g_14571	g_2059
ptg000044l	13036582	13041846	5264	g_2059	g_7528
ptg000044l	13048632	13052262	3630	g_7528	g_37777
ptg000044l	13058011	13060351	2340	g_37777	g_29906
ptg000044l	13063108	13072771	9663	g_29906	g_36981
ptg000044l	13082248	13084766	2518	g_36981	g_10208
ptg000044l	13096725	13111410	14685	g_10208	g_10838
ptg000044l	13123631	13124646	1015	g_10838	g_16465
ptg000044l	13149332	13249898	100566	g_16465	g_20561
ptg000044l	13252254	13254747	2493	g_20561	g_17878
ptg000044l	13264775	13297732	32957	g_17878	g_27754
ptg000044l	13307102	13309506	2404	g_27754	g_3150
ptg000044l	13311275	13313612	2337	g_3150	g_19518
ptg000044l	13320453	13320539	86	g_19518	g_6061
ptg000044l	13323960	13325703	1743	g_6061	g_21008
ptg000044l	13329512	13335101	5589	g_21008	g_30008
ptg000044l	13356913	13360630	3717	g_30008	g_36633
ptg000044l	13361625	13362303	678	g_36633	g_32960
ptg000044l	13367099	13409964	42865	g_32960	g_3724
ptg000044l	13416041	13419682	3641	g_3724	g_9612
ptg000044l	13429271	13520132	90861	g_9612	g_5292
ptg000044l	13530344	13566017	35673	g_5292	g_11170
ptg000044l	13580947	13602659	21712	g_11170	g_22579
ptg000044l	13603093	13621697	18604	g_22579	g_30386
ptg000044l	13625978	13633638	7660	g_30386	g_32061
ptg000044l	13637189	13637801	612	g_32061	g_5717
ptg000044l	13640850	13642925	2075	g_5717	g_37265
ptg000044l	13644717	13649988	5271	g_37265	g_10464
ptg000044l	13666171	13667461	1290	g_10464	g_14863
ptg000044l	13667664	13670832	3168	g_14863	g_7316
ptg000044l	13679596	13682580	2984	g_7316	g_20883
ptg000044l	13686849	13688399	1550	g_20883	g_35910
ptg000044l	13690266	13762011	71745	g_35910	g_26944
ptg000044l	13787890	13788706	816	g_26944	g_29828
ptg000044l	13793723	13795223	1500	g_29828	g_33704
ptg000044l	13799944	13800881	937	g_33704	g_5967
ptg000044l	13805340	13863414	58074	g_5967	g_28077
ptg000044l	13875486	13888236	12750	g_28077	g_19474
ptg000044l	13889504	13893769	4265	g_19474	g_1324
ptg000044l	13899447	13902832	3385	g_1324	g_11044
ptg000044l	13920276	13988477	68201	g_11044	g_2771
ptg000044l	13990590	14010585	19995	g_2771	g_31223
ptg000044l	14011718	14015916	4198	g_31223	g_16580
ptg000044l	14016818	14025129	8311	g_16580	g_12528
ptg000044l	14027921	14037715	9794	g_12528	g_11493
ptg000044l	14041718	14058695	16977	g_11493	g_9906
ptg000044l	14058901	14111429	52528	g_9906	g_8279
ptg000044l	14119388	14127140	7752	g_8279	g_11106
ptg000044l	14130938	14136730	5792	g_11106	g_30042
ptg000044l	14148412	14167646	19234	g_30042	g_2681
ptg000044l	14167897	14194362	26465	g_2681	g_23756
ptg000044l	14194676	14199685	5009	g_23756	g_4919
ptg000044l	14224458	14228962	4504	g_4919	g_39986
ptg000044l	14234393	14244051	9658	g_39986	g_31159
ptg000044l	14260314	14266795	6481	g_31159	g_16578
ptg000044l	14276572	14338333	61761	g_16578	g_26880
ptg000044l	14355686	14358166	2480	g_26880	g_15419
ptg000044l	14363925	14418133	54208	g_15419	g_18855
ptg000044l	14426124	14427855	1731	g_18855	g_2402
ptg000044l	14435761	14439696	3935	g_2402	g_13993
ptg000044l	14440916	14505376	64460	g_13993	g_3538
ptg000044l	14505732	14550014	44282	g_3538	g_28964
ptg000044l	14552634	14574947	22313	g_28964	g_22480
ptg000044l	14580330	14622828	42498	g_22480	g_1983
ptg000044l	14644683	14663808	19125	g_1983	g_22634
ptg000044l	14676934	14849729	172795	g_22634	g_6986
ptg000044l	14851549	14856713	5164	g_6986	g_1255
ptg000044l	14859794	14861046	1252	g_1255	g_10951
ptg000044l	14876496	14902682	26186	g_10951	g_27922
ptg000044l	14904598	14911287	6689	g_27922	g_13848
ptg000044l	14935199	14935464	265	g_13848	g_27439
ptg000044l	14935928	14939657	3729	g_27439	g_24267
ptg000044l	14958573	15019682	61109	g_24267	g_38563
ptg000044l	15020167	15082693	62526	g_38563	g_39248
ptg000044l	15083085	15099315	16230	g_39248	g_24450
ptg000044l	15103192	15165439	62247	g_24450	g_18405
ptg000044l	15182906	15255943	73037	g_18405	g_2810
ptg000044l	15267250	15273817	6567	g_2810	g_6368
ptg000044l	15287529	15448407	160878	g_6368	g_28226
ptg000044l	15448823	15733611	284788	g_28226	g_20711
ptg000044l	15734276	15843616	109340	g_20711	g_3217
ptg000044l	15849501	15855647	6146	g_3217	g_38005
ptg000044l	15856537	15865724	9187	g_38005	g_36821
ptg000044l	15867070	15938330	71260	g_36821	g_29385
ptg000044l	15938641	15985883	47242	g_29385	g_10615
ptg000044l	16029053	16045306	16253	g_10615	g_11157
ptg000044l	16067960	16072152	4192	g_11157	g_26124
ptg000044l	16076035	16093187	17152	g_26124	g_35216
ptg000044l	16093699	16288603	194904	g_35216	g_15223
ptg000044l	16303875	16361929	58054	g_15223	g_910
ptg000044l	16371310	16582217	210907	g_910	g_18655
ptg000044l	16599622	16604840	5218	g_18655	g_35488
ptg000044l	16611918	16640534	28616	g_35488	g_13498
ptg000044l	16641454	16652816	11362	g_13498	g_6462
ptg000044l	16656105	16662259	6154	g_6462	g_3213
ptg000044l	16664731	16666450	1719	g_3213	g_10236
ptg000044l	16673889	16674360	471	g_10236	g_14071
ptg000044l	16685161	16699612	14451	g_14071	g_7657
ptg000044l	16701387	16895816	194429	g_7657	g_2491
ptg000044l	16898467	16900583	2116	g_2491	g_7651
ptg000044l	16904110	16909083	4973	g_7651	g_27814
ptg000044l	16910099	17054728	144629	g_27814	g_7318
ptg000044l	17073840	17075399	1559	g_7318	g_7522
ptg000044l	17082204	17088663	6459	g_7522	g_12461
ptg000044l	17093578	17134939	41361	g_12461	g_15132
ptg000044l	17137028	17182943	45915	g_15132	g_27937
ptg000044l	17185315	17195339	10024	g_27937	g_34645
ptg000044l	17196115	17203494	7379	g_34645	g_24381
ptg000044l	17208455	17217256	8801	g_24381	g_18409
ptg000044l	17222217	17231019	8802	g_18409	g_12069
ptg000044l	17235980	17246617	10637	g_12069	g_31635
ptg000044l	17251500	17294346	42846	g_31635	g_13137
ptg000044l	17297814	17307488	9674	g_13137	g_12713
ptg000044l	17316880	17320482	3602	g_12713	g_7162
ptg000044l	17320691	17628285	307594	g_7162	g_32455
ptg000044l	17628599	17630329	1730	g_32455	g_3640
ptg000044l	17640066	17642752	2686	g_3640	g_17460
ptg000044l	17649571	17651941	2370	g_17460	g_24840
ptg000044l	17657921	17667069	9148	g_24840	g_13271
ptg000044l	17667992	17747225	79233	g_13271	g_2437
ptg000044l	17750887	17751127	240	g_2437	g_6410
ptg000044l	17753898	17754784	886	g_6410	g_19972
ptg000044l	17760160	17770067	9907	g_19972	g_31344
ptg000044l	17773654	17786204	12550	g_31344	g_25734
ptg000044l	17792440	17796370	3930	g_25734	g_13641
ptg000044l	17800905	17909149	108244	g_13641	g_29166
ptg000044l	17923799	17947207	23408	g_29166	g_5022
ptg000044l	17948448	17948596	148	g_5022	g_11547
ptg000044l	17949513	18012645	63132	g_11547	g_9198
ptg000044l	18014156	18106898	92742	g_9198	g_32120
ptg000044l	18107308	18115771	8463	g_32120	g_1743
ptg000044l	18116145	18150446	34301	g_1743	g_4521
ptg000044l	18152161	18227511	75350	g_4521	g_1880
ptg000044l	18227729	18229275	1546	g_1880	g_34852
ptg000044l	18231818	18232400	582	g_34852	g_32552
ptg000044l	18234544	18253959	19415	g_32552	g_20006
ptg000044l	18259948	18265810	5862	g_20006	g_4874
ptg000044l	18274047	18276035	1988	g_4874	g_33670
ptg000044l	18277606	18280146	2540	g_33670	g_12748
ptg000044l	18302345	18335271	32926	g_12748	g_27412
ptg000044l	18340051	18348417	8366	g_27412	g_23681
ptg000044l	18372896	18444875	71979	g_23681	g_14811
ptg000044l	18445093	18500317	55224	g_14811	g_17458
ptg000044l	18500739	18539809	39070	g_17458	g_34284
ptg000044l	18543713	18573038	29325	g_34284	g_36780
ptg000044l	18573331	18604462	31131	g_36780	g_9595
ptg000044l	18619851	18622037	2186	g_9595	g_28785
ptg000044l	18623434	18638355	14921	g_28785	g_19849
ptg000044l	18644450	18698551	54101	g_19849	g_31940
ptg000044l	18717500	18783625	66125	g_31940	g_6354
ptg000044l	18817629	18833828	16199	g_6354	g_16595
ptg000044l	18835476	18840809	5333	g_16595	g_5196
ptg000044l	18842203	18848437	6234	g_5196	g_20816
ptg000044l	18852000	18859921	7921	g_20816	g_30254
ptg000044l	18871532	18987040	115508	g_30254	g_26609
ptg000044l	18988476	19016062	27586	g_26609	g_29234
ptg000044l	19034678	19059965	25287	g_29234	g_3924
ptg000044l	19074852	19079695	4843	g_3924	g_31241
ptg000044l	19079973	19104042	24069	g_31241	g_11817
ptg000044l	19117517	19130010	12493	g_11817	g_6513
ptg000044l	19141370	19142541	1171	g_6513	g_36542
ptg000044l	19147673	19149958	2285	g_36542	g_28889
ptg000044l	19160831	19165633	4802	g_28889	g_29114
ptg000044l	19185120	19229651	44531	g_29114	g_10051
ptg000044l	19233498	19238316	4818	g_10051	g_40079
ptg000044l	19246290	19246682	392	g_40079	g_24188
ptg000044l	19285093	19297259	12166	g_24188	g_13769
ptg000044l	19320115	19337974	17859	g_13769	g_25039
ptg000044l	19350476	19357339	6863	g_25039	g_9025
ptg000044l	19359839	19363584	3745	g_9025	g_20040
ptg000044l	19369468	19392720	23252	g_20040	g_28204
ptg000044l	19414770	19425823	11053	g_28204	g_27961
ptg000044l	19435259	19436970	1711	g_27961	g_2171
ptg000044l	19441687	19605155	163468	g_2171	g_947
ptg000044l	19605964	19612158	6194	g_947	g_20854
ptg000044l	19612394	19621932	9538	g_20854	g_20599
ptg000044l	19626175	19719757	93582	g_20599	g_37092
ptg000044l	19732167	19748380	16213	g_37092	g_16472
ptg000044l	19749009	19798496	49487	g_16472	g_16414
ptg000044l	19800040	19824698	24658	g_16414	g_19872
ptg000044l	19825858	19857008	31150	g_19872	g_19062
ptg000044l	19860845	19993631	132786	g_19062	g_13811
ptg000044l	19994086	20096625	102539	g_13811	g_18116
ptg000044l	20096918	20119253	22335	g_18116	g_17394
ptg000044l	20119519	20238518	118999	g_17394	g_38258
ptg000044l	20238763	20300342	61579	g_38258	g_8737
ptg000044l	20302141	20331524	29383	g_8737	g_25100
ptg000044l	20332018	20332077	59	g_25100	g_32773
ptg000044l	20332292	20397400	65108	g_32773	g_3949
ptg000044l	20397651	20425237	27586	g_3949	g_637
ptg000044l	20426082	20486814	60732	g_637	g_34048
ptg000044l	20487125	20487269	144	g_34048	g_27389
ptg000044l	20487826	20538561	50735	g_27389	g_17920
ptg000044l	20538770	20717817	179047	g_17920	g_35141
ptg000044l	20718830	20718986	156	g_35141	g_27151
ptg000044l	20719339	20840240	120901	g_27151	g_24701
ptg000044l	20840793	20841321	528	g_24701	g_22501
ptg000044l	20842134	20904648	62514	g_22501	g_14255
ptg000044l	20905157	20961415	56258	g_14255	g_7595
ptg000044l	20962146	21006546	44400	g_7595	g_12028
ptg000044l	21007133	21028295	21162	g_12028	g_22876
ptg000044l	21028531	21064539	36008	g_22876	g_26508
ptg000044l	21082184	21089988	7804	g_26508	g_962
ptg000044l	21090392	21098813	8421	g_962	g_15237
ptg000044l	21101607	21230750	129143	g_15237	g_19424
ptg000044l	21231103	21336312	105209	g_19424	g_5517
ptg000044l	21336953	21343169	6216	g_5517	g_6770
ptg000044l	21345716	21353537	7821	g_6770	g_19771
ptg000044l	21358580	21377405	18825	g_19771	g_17259
ptg000044l	21377641	21402574	24933	g_17259	g_15969
ptg000044l	21403158	21486746	83588	g_15969	g_16987
ptg000044l	21487804	21498783	10979	g_16987	g_18918
ptg000045l	53577	267818	214241	g_91	g_35297
ptg000045l	269227	297736	28509	g_35297	g_17216
ptg000045l	322039	322439	400	g_17216	g_25964
ptg000045l	344137	495976	151839	g_25964	g_23959
ptg000045l	496926	524923	27997	g_23959	g_2468
ptg000045l	525873	531527	5654	g_2468	g_15871
ptg000045l	532474	550674	18200	g_15871	g_24684
ptg000045l	551624	555917	4293	g_24684	g_37097
ptg000045l	556867	562442	5575	g_37097	g_32985
ptg000045l	563392	589867	26475	g_32985	g_12846
ptg000045l	590817	596339	5522	g_12846	g_29901
ptg000045l	597289	603516	6227	g_29901	g_365
ptg000045l	604466	633182	28716	g_365	g_14797
ptg000045l	642694	642718	24	g_14797	g_9115
ptg000045l	643743	714753	71010	g_9115	g_1624
ptg000045l	715361	729743	14382	g_1624	g_40028
ptg000045l	735535	735898	363	g_40028	g_7197
ptg000045l	737286	761183	23897	g_7197	g_31693
ptg000045l	761536	963455	201919	g_31693	g_31081
ptg000045l	963949	1187965	224016	g_31081	g_17788
ptg000045l	1188270	1197358	9088	g_17788	g_27451
ptg000045l	1202750	1209672	6922	g_27451	g_4582
ptg000045l	1222106	1229818	7712	g_4582	g_37799
ptg000045l	1232399	1258532	26133	g_37799	g_3556
ptg000045l	1262810	1283728	20918	g_3556	g_2292
ptg000045l	1284363	1290349	5986	g_2292	g_10214
ptg000045l	1313097	1315988	2891	g_10214	g_15202
ptg000046l	111639	119928	8289	g_20940	g_19565
ptg000046l	120215	223015	102800	g_19565	g_18582
ptg000046l	223524	225401	1877	g_18582	g_24757
ptg000046l	225646	350291	124645	g_24757	g_11848
ptg000046l	350593	356291	5698	g_11848	g_10367
ptg000046l	356548	440414	83866	g_10367	g_25208
ptg000046l	441292	463155	21863	g_25208	g_15364
ptg000046l	463838	465637	1799	g_15364	g_26520
ptg000046l	466098	503035	36937	g_26520	g_34293
ptg000046l	503994	573032	69038	g_34293	g_31605
ptg000046l	573895	583053	9158	g_31605	g_13603
ptg000046l	584134	630624	46490	g_13603	g_21586
ptg000046l	631517	632458	941	g_21586	g_36210
ptg000046l	632820	659369	26549	g_36210	g_16707
ptg000046l	660858	660905	47	g_16707	g_13341
ptg000046l	662077	769441	107364	g_13341	g_38303
ptg000046l	770046	812440	42394	g_38303	g_10275
ptg000046l	813105	970642	157537	g_10275	g_26414
ptg000046l	971946	997613	25667	g_26414	g_18927
ptg000046l	998275	998410	135	g_18927	g_26645
ptg000046l	998955	999007	52	g_26645	g_22782
ptg000046l	999447	1021879	22432	g_22782	g_36512
ptg000046l	1022193	1144981	122788	g_36512	g_8309
ptg000046l	1145220	1146532	1312	g_8309	g_13114
ptg000046l	1146780	1244932	98152	g_13114	g_11511
ptg000046l	1245402	1317376	71974	g_11511	g_15186
ptg000046l	1318392	1318444	52	g_15186	g_27823
ptg000046l	1318992	1328603	9611	g_27823	g_37268
ptg000046l	1329340	1419392	90052	g_37268	g_15076
ptg000046l	1420397	1508895	88498	g_15076	g_23121
ptg000046l	1525769	1801890	276121	g_23121	g_31447
ptg000046l	1802642	1840498	37856	g_31447	g_31991
ptg000047l	126370	176312	49942	g_15477	g_36231
ptg000047l	179452	211526	32074	g_36231	g_36304
ptg000047l	218067	221432	3365	g_36304	g_642
ptg000047l	221695	224282	2587	g_642	g_37847
ptg000047l	242656	257942	15286	g_37847	g_6952
ptg000047l	260727	262303	1576	g_6952	g_34663
ptg000047l	266035	270378	4343	g_34663	g_22164
ptg000047l	271916	274627	2711	g_22164	g_7658
ptg000047l	277876	302129	24253	g_7658	g_22023
ptg000047l	313152	560739	247587	g_22023	g_25749
ptg000047l	560984	566662	5678	g_25749	g_27095
ptg000047l	578862	582077	3215	g_27095	g_28189
ptg000047l	597011	687402	90391	g_28189	g_6628
ptg000047l	687731	689861	2130	g_6628	g_34454
ptg000047l	702157	725987	23830	g_34454	g_38779
ptg000047l	728246	734325	6079	g_38779	g_29485
ptg000047l	739427	771515	32088	g_29485	g_28451
ptg000047l	790618	813556	22938	g_28451	g_29067
ptg000047l	824707	877961	53254	g_29067	g_29032
ptg000047l	889524	919343	29819	g_29032	g_12102
ptg000047l	921193	923331	2138	g_12102	g_16346
ptg000047l	934418	1038439	104021	g_16346	g_30378
ptg000047l	1051282	1063429	12147	g_30378	g_17606
ptg000047l	1091579	1093641	2062	g_17606	g_12977
ptg000047l	1117598	1125514	7916	g_12977	g_33123
ptg000047l	1126372	1179828	53456	g_33123	g_19802
ptg000047l	1205068	1208310	3242	g_19802	g_40205
ptg000047l	1208567	1267137	58570	g_40205	g_17581
ptg000047l	1278074	1322715	44641	g_17581	g_40281
ptg000047l	1339770	1344204	4434	g_40281	g_32513
ptg000047l	1344632	1381415	36783	g_32513	g_36433
ptg000047l	1392742	1552824	160082	g_36433	g_5851
ptg000047l	1569691	1574132	4441	g_5851	g_27444
ptg000047l	1576349	1602412	26063	g_27444	g_17703
ptg000047l	1602660	1605902	3242	g_17703	g_33872
ptg000047l	1615944	1650666	34722	g_33872	g_23212
ptg000047l	1654145	1671086	16941	g_23212	g_14654
ptg000047l	1672761	1690499	17738	g_14654	g_28239
ptg000047l	1693307	1695453	2146	g_28239	g_11639
ptg000047l	1758392	1779571	21179	g_11639	g_29934
ptg000047l	1786815	1790414	3599	g_29934	g_15603
ptg000047l	1811399	1811760	361	g_15603	g_14525
ptg000047l	1829529	1846488	16959	g_14525	g_217
ptg000047l	1858337	1892477	34140	g_217	g_14656
ptg000047l	1905617	1929694	24077	g_14656	g_13819
ptg000047l	2013669	2073063	59394	g_13819	g_5675
ptg000047l	2087169	2176403	89234	g_5675	g_9616
ptg000047l	2178316	2179999	1683	g_9616	g_23609
ptg000047l	2191794	2525449	333655	g_23609	g_25180
ptg000047l	2525970	2543909	17939	g_25180	g_35109
ptg000047l	2544169	2544207	38	g_35109	g_31114
ptg000047l	2544533	3073811	529278	g_31114	g_19278
ptg000047l	3074719	3075553	834	g_19278	g_33582
ptg000047l	3075786	3098987	23201	g_33582	g_40160
ptg000047l	3101507	3105221	3714	g_40160	g_16662
ptg000047l	3108679	3112145	3466	g_16662	g_177
ptg000047l	3113017	3115918	2901	g_177	g_34999
ptg000047l	3117483	3119030	1547	g_34999	g_33315
ptg000047l	3126705	3133047	6342	g_33315	g_32606
ptg000047l	3137038	3139745	2707	g_32606	g_2395
ptg000047l	3143302	3160895	17593	g_2395	g_21288
ptg000047l	3161540	3172900	11360	g_21288	g_12535
ptg000047l	3198001	3198605	604	g_12535	g_33454
ptg000047l	3202459	3214296	11837	g_33454	g_21258
ptg000047l	3218873	3227466	8593	g_21258	g_27238
ptg000047l	3238567	3239508	941	g_27238	g_8564
ptg000047l	3243545	3317314	73769	g_8564	g_20776
ptg000047l	3331213	3474444	143231	g_20776	g_38507
ptg000047l	3475170	3516718	41548	g_38507	g_39086
ptg000047l	3517414	3567109	49695	g_39086	g_38731
ptg000047l	3567835	3827702	259867	g_38731	g_35787
ptg000047l	3827926	3850824	22898	g_35787	g_15057
ptg000047l	3854574	3941148	86574	g_15057	g_19502
ptg000047l	3946903	3971496	24593	g_19502	g_17839
ptg000047l	3980819	4009456	28637	g_17839	g_18128
ptg000047l	4027708	4030603	2895	g_18128	g_691
ptg000047l	4036998	4049456	12458	g_691	g_26240
ptg000047l	4062408	4131555	69147	g_26240	g_30458
ptg000047l	4145833	4167286	21453	g_30458	g_25792
ptg000047l	4176179	4187796	11617	g_25792	g_16602
ptg000047l	4189220	4193496	4276	g_16602	g_21771
ptg000047l	4208573	4214377	5804	g_21771	g_27156
ptg000047l	4221721	4223941	2220	g_27156	g_9434
ptg000047l	4228393	4229216	823	g_9434	g_29738
ptg000047l	4235125	4249846	14721	g_29738	g_3442
ptg000047l	4308704	4382740	74036	g_3442	g_4014
ptg000047l	4396599	4405530	8931	g_4014	g_33752
ptg000047l	4421355	4435130	13775	g_33752	g_28530
ptg000047l	4435360	4513985	78625	g_28530	g_17576
ptg000047l	4519755	4524811	5056	g_17576	g_27804
ptg000047l	4536204	4547914	11710	g_27804	g_1138
ptg000047l	4548324	4622655	74331	g_1138	g_9855
ptg000047l	4631462	4685344	53882	g_9855	g_31446
ptg000047l	4716968	4820122	103154	g_31446	g_13448
ptg000047l	4822777	4824548	1771	g_13448	g_38289
ptg000047l	4837303	4842015	4712	g_38289	g_13123
ptg000047l	4842793	4846845	4052	g_13123	g_22752
ptg000047l	4866982	4872657	5675	g_22752	g_7618
ptg000047l	4877575	4886703	9128	g_7618	g_28122
ptg000047l	4904701	4922475	17774	g_28122	g_28778
ptg000047l	4929175	4937102	7927	g_28778	g_32812
ptg000047l	4941109	4947917	6808	g_32812	g_5826
ptg000047l	4950174	4951097	923	g_5826	g_32470
ptg000047l	4951606	4952674	1068	g_32470	g_35718
ptg000047l	4967878	4990001	22123	g_35718	g_16480
ptg000047l	5098048	5133869	35821	g_16480	g_32872
ptg000047l	5135404	5138055	2651	g_32872	g_39973
ptg000047l	5140999	5142917	1918	g_39973	g_4247
ptg000047l	5146181	5181590	35409	g_4247	g_11003
ptg000047l	5181838	5262910	81072	g_11003	g_36152
ptg000047l	5274267	5329218	54951	g_36152	g_31320
ptg000047l	5345262	5349368	4106	g_31320	g_33850
ptg000047l	5351310	5361435	10125	g_33850	g_35319
ptg000047l	5382268	5388808	6540	g_13266	g_17070
ptg000047l	5392821	5398887	6066	g_17070	g_34823
ptg000047l	5411751	5411789	38	g_34823	g_13925
ptg000047l	5412043	5416534	4491	g_13925	g_17894
ptg000047l	5434077	5435649	1572	g_17894	g_26888
ptg000047l	5448419	5625151	176732	g_26888	g_10515
ptg000047l	5638809	5642057	3248	g_10515	g_1513
ptg000047l	5668654	5930520	261866	g_1513	g_26714
ptg000047l	5930774	5931183	409	g_26714	g_34799
ptg000047l	5968454	6029004	60550	g_34799	g_24312
ptg000047l	6048745	6115940	67195	g_24312	g_6377
ptg000047l	6117151	6118383	1232	g_6377	g_4587
ptg000047l	6119323	6121441	2118	g_4587	g_16536
ptg000047l	6124838	6126717	1879	g_16536	g_6731
ptg000047l	6133212	6138370	5158	g_6731	g_20759
ptg000047l	6144613	6145663	1050	g_20759	g_27013
ptg000047l	6170212	6181028	10816	g_27013	g_28011
ptg000047l	6182268	6183927	1659	g_28011	g_36583
ptg000047l	6190568	6192498	1930	g_36583	g_10454
ptg000047l	6202332	6210770	8438	g_10454	g_15482
ptg000047l	6212179	6327390	115211	g_15482	g_504
ptg000047l	6340431	6354231	13800	g_504	g_21375
ptg000047l	6355745	6358957	3212	g_21375	g_15983
ptg000047l	6369909	6407762	37853	g_15983	g_17497
ptg000047l	6412330	6432485	20155	g_17497	g_10766
ptg000047l	6439175	6443909	4734	g_10766	g_30511
ptg000047l	6450527	6473483	22956	g_30511	g_27601
ptg000047l	6478036	6482125	4089	g_27601	g_26538
ptg000047l	6497984	6505857	7873	g_26538	g_9881
ptg000047l	6506285	6558152	51867	g_9881	g_13762
ptg000047l	6559090	6724646	165556	g_13762	g_31716
ptg000047l	6724918	6728452	3534	g_31716	g_9332
ptg000047l	6728658	6731709	3051	g_9332	g_2049
ptg000047l	6731924	6884287	152363	g_2049	g_31025
ptg000047l	6884673	6885230	557	g_31025	g_26536
ptg000047l	6902356	6908189	5833	g_26536	g_9171
ptg000047l	6921395	6922992	1597	g_9171	g_19767
ptg000047l	6925269	6927216	1947	g_19767	g_32930
ptg000047l	6931075	6932827	1752	g_32930	g_4682
ptg000047l	6947453	6953410	5957	g_4682	g_6784
ptg000047l	6958201	6975418	17217	g_6784	g_30447
ptg000047l	6981845	6987700	5855	g_30447	g_14882
ptg000047l	6992486	6996876	4390	g_14882	g_27310
ptg000047l	7000988	7005040	4052	g_27310	g_5437
ptg000047l	7012779	7013762	983	g_5437	g_36937
ptg000047l	7017492	7062673	45181	g_36937	g_31647
ptg000047l	7062927	7064626	1699	g_31647	g_24120
ptg000047l	7071166	7146912	75746	g_24120	g_28745
ptg000047l	7149995	7159293	9298	g_28745	g_21314
ptg000047l	7166097	7282116	116019	g_21314	g_14116
ptg000047l	7306459	7317095	10636	g_14116	g_18907
ptg000047l	7320975	7372213	51238	g_18907	g_9435
ptg000047l	7389226	7420991	31765	g_9435	g_1334
ptg000047l	7427038	7428124	1086	g_1334	g_320
ptg000047l	7438929	7443785	4856	g_320	g_746
ptg000047l	7464365	7487014	22649	g_746	g_33524
ptg000047l	7488207	7495775	7568	g_33524	g_14677
ptg000047l	7498811	7500777	1966	g_14677	g_21877
ptg000047l	7503813	7536839	33026	g_21877	g_16120
ptg000047l	7544078	7569905	25827	g_16120	g_18729
ptg000047l	7577985	7581500	3515	g_18729	g_3916
ptg000047l	7589210	7592172	2962	g_3916	g_20766
ptg000047l	7604613	7615299	10686	g_20766	g_26985
ptg000047l	7618108	7626983	8875	g_26985	g_23507
ptg000047l	7634313	7637808	3495	g_23507	g_4715
ptg000047l	7648479	7666956	18477	g_4715	g_30730
ptg000047l	7668455	7675043	6588	g_30730	g_4325
ptg000047l	7689747	7793374	103627	g_4325	g_38866
ptg000047l	7796486	8027391	230905	g_38866	g_166
ptg000047l	8032821	8033718	897	g_166	g_28314
ptg000047l	8033918	8034492	574	g_28314	g_19947
ptg000047l	8042246	8050348	8102	g_19947	g_24590
ptg000047l	8063461	8065741	2280	g_24590	g_32355
ptg000047l	8066331	8069704	3373	g_32355	g_17843
ptg000047l	8083869	8163547	79678	g_17843	g_9061
ptg000047l	8179218	8207573	28355	g_9061	g_13868
ptg000047l	8211720	8212501	781	g_13868	g_6507
ptg000047l	8212713	8212808	95	g_6507	g_2258
ptg000047l	8220703	8223063	2360	g_2258	g_38246
ptg000047l	8224562	8238917	14355	g_38246	g_11694
ptg000047l	8239912	8241305	1393	g_11694	g_13941
ptg000047l	8242303	8284190	41887	g_13941	g_6161
ptg000047l	8292067	8310511	18444	g_6161	g_15537
ptg000047l	8317805	8318908	1103	g_15537	g_13370
ptg000047l	8344346	8358388	14042	g_13370	g_29913
ptg000047l	8360717	8397158	36441	g_29913	g_4784
ptg000047l	8405688	8442862	37174	g_4784	g_24392
ptg000047l	8445308	8520763	75455	g_24392	g_1250
ptg000047l	8530773	8573345	42572	g_1250	g_16976
ptg000047l	8578457	8603029	24572	g_16976	g_24419
ptg000047l	8612828	8626617	13789	g_24419	g_14046
ptg000047l	8633320	8634814	1494	g_14046	g_32853
ptg000047l	8638880	8641134	2254	g_32853	g_5284
ptg000047l	8648840	8650018	1178	g_5284	g_32023
ptg000047l	8655220	8658253	3033	g_32023	g_29605
ptg000047l	8659720	8729669	69949	g_29605	g_20380
ptg000047l	8729914	8730857	943	g_20380	g_9481
ptg000047l	8733398	8811868	78470	g_9481	g_32443
ptg000047l	8812170	8828843	16673	g_32443	g_9592
ptg000047l	8829202	8862651	33449	g_9592	g_24754
ptg000047l	8862881	8881021	18140	g_24754	g_1514
ptg000047l	8891291	8893176	1885	g_1514	g_13938
ptg000047l	8894599	8896217	1618	g_13938	g_25370
ptg000047l	8900735	8902789	2054	g_25370	g_18829
ptg000047l	8903172	8957864	54692	g_18829	g_30449
ptg000047l	8958064	8994459	36395	g_30449	g_32070
ptg000047l	8999459	9000424	965	g_32070	g_37733
ptg000047l	9003980	9005054	1074	g_37733	g_18517
ptg000047l	9010293	9012154	1861	g_18517	g_3431
ptg000047l	9015586	9096070	80484	g_3431	g_17844
ptg000047l	9096822	9120967	24145	g_17844	g_8365
ptg000047l	9153425	9171447	18022	g_8365	g_14138
ptg000047l	9179885	9196027	16142	g_14138	g_10083
ptg000047l	9202351	9204892	2541	g_10083	g_18431
ptg000047l	9217095	9218245	1150	g_18431	g_14028
ptg000047l	9233713	9247070	13357	g_38826	g_28222
ptg000047l	9286049	9334290	48241	g_28222	g_34067
ptg000047l	9337912	9381055	43143	g_34067	g_37412
ptg000047l	9381351	9384381	3030	g_37412	g_13671
ptg000047l	9387949	9394692	6743	g_13671	g_33031
ptg000047l	9403370	9404760	1390	g_33031	g_18807
ptg000047l	9407252	9416521	9269	g_18807	g_10116
ptg000047l	9416952	9424753	7801	g_10116	g_36154
ptg000047l	9426648	9429469	2821	g_36154	g_5307
ptg000047l	9452014	9463800	11786	g_5307	g_37627
ptg000047l	9465064	9479951	14887	g_37627	g_4558
ptg000047l	9481183	9488190	7007	g_4558	g_11013
ptg000047l	9489422	9495958	6536	g_11013	g_14465
ptg000047l	9496269	9498124	1855	g_14465	g_21786
ptg000047l	9498617	9501863	3246	g_21786	g_31393
ptg000047l	9502147	9504250	2103	g_31393	g_3652
ptg000047l	9504534	9511382	6848	g_3652	g_20808
ptg000047l	9511666	9513770	2104	g_20808	g_17089
ptg000047l	9514054	9561371	47317	g_17089	g_23689
ptg000047l	9562231	9569899	7668	g_23689	g_32640
ptg000047l	9570392	9583944	13552	g_32640	g_29107
ptg000047l	9589748	9592229	2481	g_29107	g_23298
ptg000047l	9593715	9611178	17463	g_23298	g_6992
ptg000047l	9728726	9731678	2952	g_6992	g_14740
ptg000047l	9743151	9745827	2676	g_14740	g_516
ptg000047l	9748165	9749382	1217	g_516	g_27219
ptg000047l	9749687	9754649	4962	g_27219	g_4781
ptg000047l	9756741	9763633	6892	g_4781	g_39833
ptg000047l	9771332	9807561	36229	g_13285	g_22759
ptg000047l	9845737	9848533	2796	g_22759	g_696
ptg000047l	9849429	9852232	2803	g_696	g_36579
ptg000047l	9853134	10067806	214672	g_36579	g_32258
ptg000047l	10073793	10074757	964	g_32258	g_32377
ptg000047l	10079752	10081554	1802	g_32377	g_33113
ptg000047l	10086735	10088375	1640	g_33113	g_18450
ptg000047l	10091037	10096145	5108	g_18450	g_2881
ptg000047l	10099812	10114827	15015	g_2881	g_40085
ptg000047l	10124820	10127503	2683	g_40085	g_10451
ptg000047l	10138806	10194459	55653	g_10451	g_25516
ptg000047l	10194764	10381752	186988	g_25516	g_5651
ptg000047l	10382057	10525290	143233	g_5651	g_17239
ptg000047l	10550893	10555937	5044	g_17239	g_35840
ptg000047l	10563937	10599927	35990	g_35840	g_2598
ptg000047l	10615313	10672166	56853	g_2598	g_29918
ptg000047l	10673236	10675466	2230	g_29918	g_4420
ptg000047l	10683658	10684444	786	g_4420	g_25227
ptg000047l	10686112	10696333	10221	g_25227	g_28093
ptg000047l	10697340	10744837	47497	g_28093	g_7666
ptg000047l	10755992	10762150	6158	g_7666	g_38300
ptg000047l	10771769	10772329	560	g_38300	g_58
ptg000047l	10773976	10775508	1532	g_58	g_8869
ptg000047l	10777317	10830112	52795	g_8869	g_13912
ptg000047l	10831273	10834615	3342	g_13912	g_14187
ptg000047l	10843051	10867888	24837	g_14187	g_18913
ptg000047l	10868946	10873104	4158	g_18913	g_10212
ptg000047l	10884696	10907396	22700	g_10212	g_10209
ptg000047l	10908682	10914668	5986	g_10209	g_13723
ptg000047l	10922841	10925004	2163	g_13723	g_8416
ptg000047l	10927660	10993769	66109	g_8416	g_28024
ptg000047l	10994062	11039381	45319	g_28024	g_19504
ptg000047l	11049346	11053539	4193	g_19504	g_15775
ptg000047l	11055405	11056468	1063	g_15775	g_159
ptg000047l	11064191	11065589	1398	g_159	g_17085
ptg000047l	11072154	11072799	645	g_17085	g_32187
ptg000047l	11073911	11073988	77	g_32187	g_26702
ptg000047l	11076262	11078767	2505	g_26702	g_25285
ptg000047l	11092826	11187774	94948	g_25285	g_29160
ptg000047l	11193118	11195297	2179	g_29160	g_8489
ptg000047l	11196068	11196481	413	g_8489	g_40047
ptg000047l	11203443	11247731	44288	g_40047	g_28168
ptg000047l	11249800	11339705	89905	g_28168	g_40170
ptg000047l	11360844	11362106	1262	g_40170	g_17402
ptg000047l	11366365	11366675	310	g_17402	g_27728
ptg000047l	11380469	11383474	3005	g_27728	g_4440
ptg000047l	11388465	11417177	28712	g_4440	g_19807
ptg000047l	11441898	11470242	28344	g_19807	g_16279
ptg000047l	11476894	11478865	1971	g_16279	g_22218
ptg000047l	11484470	11495939	11469	g_22218	g_1030
ptg000047l	11497096	11498645	1549	g_1030	g_4902
ptg000047l	11505547	11543069	37522	g_4902	g_27189
ptg000047l	11546771	11554607	7836	g_27189	g_37124
ptg000047l	11554840	11558516	3676	g_37124	g_6648
ptg000047l	11577922	11618903	40981	g_6648	g_19702
ptg000047l	11638140	11639723	1583	g_19702	g_3401
ptg000047l	11641913	11645228	3315	g_3401	g_3477
ptg000047l	11659301	11661497	2196	g_3477	g_16427
ptg000047l	11666633	11670396	3763	g_16427	g_10381
ptg000047l	11678180	11678714	534	g_10381	g_30868
ptg000047l	11689207	11690645	1438	g_30868	g_9533
ptg000047l	11696070	11711668	15598	g_9533	g_9421
ptg000047l	11714735	11723121	8386	g_9421	g_22931
ptg000047l	11727707	11733191	5484	g_22931	g_18006
ptg000047l	11734952	11758573	23621	g_18006	g_5696
ptg000047l	11760357	11762743	2386	g_5696	g_5268
ptg000047l	11766419	11770858	4439	g_5268	g_34689
ptg000047l	11776672	11788336	11664	g_34689	g_29960
ptg000047l	11801562	11829084	27522	g_29960	g_1379
ptg000047l	11852053	11889876	37823	g_1379	g_17440
ptg000047l	11890238	11898354	8116	g_17440	g_27882
ptg000047l	11906605	11953130	46525	g_27882	g_4806
ptg000047l	11969291	11982671	13380	g_4806	g_11263
ptg000047l	11983318	11984907	1589	g_11263	g_2937
ptg000047l	11988462	11999097	10635	g_2937	g_28775
ptg000047l	12024729	12026139	1410	g_28775	g_11622
ptg000047l	12027973	12029455	1482	g_11622	g_17938
ptg000047l	12036407	12050389	13982	g_17938	g_26832
ptg000047l	12053068	12053917	849	g_26832	g_20405
ptg000047l	12056873	12142687	85814	g_20405	g_3155
ptg000047l	12148045	12149840	1795	g_3155	g_9636
ptg000047l	12162033	12244530	82497	g_9636	g_24893
ptg000047l	12249868	12293292	43424	g_24893	g_12109
ptg000047l	12305178	12356621	51443	g_12109	g_14563
ptg000047l	12366806	12386350	19544	g_14563	g_12195
ptg000047l	12391043	12401866	10823	g_12195	g_8143
ptg000047l	12406221	12426384	20163	g_8143	g_31594
ptg000047l	12426659	12433934	7275	g_31594	g_496
ptg000047l	12436160	12447947	11787	g_496	g_11038
ptg000047l	12448162	12451431	3269	g_11038	g_32173
ptg000047l	12459887	12476859	16972	g_32173	g_20966
ptg000047l	12480247	12486016	5769	g_20966	g_27360
ptg000047l	12493521	12540908	47387	g_27360	g_2816
ptg000047l	12542813	12553626	10813	g_2816	g_13996
ptg000047l	12557581	12565297	7716	g_13996	g_11269
ptg000047l	12567067	12583656	16589	g_11269	g_6632
ptg000047l	12588031	12597372	9341	g_6632	g_1535
ptg000047l	12612021	12613128	1107	g_1535	g_13165
ptg000047l	12615679	12617307	1628	g_13165	g_485
ptg000047l	12639685	12694932	55247	g_485	g_35053
ptg000047l	12696163	12717004	20841	g_35053	g_22443
ptg000047l	12720361	12722707	2346	g_22443	g_16821
ptg000047l	12729607	12739990	10383	g_16821	g_33199
ptg000047l	12745045	12753747	8702	g_33199	g_27924
ptg000047l	12753968	12823984	70016	g_27924	g_32703
ptg000047l	12830051	12833682	3631	g_32703	g_17524
ptg000047l	12855531	12860934	5403	g_17524	g_19773
ptg000047l	12868891	12904614	35723	g_19773	g_11499
ptg000047l	12915171	12945058	29887	g_11499	g_20409
ptg000047l	12948827	12950753	1926	g_20409	g_16483
ptg000047l	12952370	12988897	36527	g_16483	g_7071
ptg000047l	12989100	13014939	25839	g_7071	g_35868
ptg000047l	13017193	13018867	1674	g_35868	g_13427
ptg000047l	13029535	13036408	6873	g_13427	g_28560
ptg000047l	13036632	13145561	108929	g_28560	g_870
ptg000047l	13146349	13235783	89434	g_870	g_11040
ptg000047l	13345513	13350198	4685	g_11040	g_27935
ptg000047l	13360443	13360858	415	g_27935	g_40051
ptg000047l	13365327	13365726	399	g_40051	g_8581
ptg000047l	13366619	13497229	130610	g_8581	g_16207
ptg000047l	13502931	13534003	31072	g_16207	g_33537
ptg000047l	13556860	13558429	1569	g_33537	g_15123
ptg000047l	13560078	13564267	4189	g_15123	g_34666
ptg000047l	13564494	13565162	668	g_34666	g_12783
ptg000047l	13570379	13570476	97	g_12783	g_11526
ptg000047l	13571560	13575213	3653	g_11526	g_34801
ptg000047l	13584500	13592806	8306	g_34801	g_31179
ptg000047l	13600864	13646320	45456	g_31179	g_10170
ptg000047l	13656385	13660843	4458	g_10170	g_24532
ptg000047l	13686160	13693269	7109	g_24532	g_25939
ptg000047l	13697061	13724543	27482	g_25939	g_28578
ptg000047l	13733316	13791793	58477	g_28578	g_22520
ptg000047l	13792999	13793542	543	g_22520	g_20231
ptg000047l	13798128	13805801	7673	g_20231	g_31410
ptg000047l	13815207	13850410	35203	g_31410	g_32179
ptg000047l	13851570	13859124	7554	g_32179	g_33484
ptg000047l	13864742	13867575	2833	g_33484	g_14727
ptg000047l	13873652	13874312	660	g_14727	g_30266
ptg000047l	13878853	13879758	905	g_30266	g_21118
ptg000047l	13883463	13911393	27930	g_21118	g_12784
ptg000047l	13912799	13974615	61816	g_12784	g_15330
ptg000047l	13976935	14013014	36079	g_15330	g_5500
ptg000047l	14016691	14020454	3763	g_5500	g_16672
ptg000047l	14025209	14030425	5216	g_16672	g_28074
ptg000047l	14033616	14044200	10584	g_28074	g_26947
ptg000047l	14045270	14046592	1322	g_26947	g_18895
ptg000047l	14054701	14055088	387	g_18895	g_2298
ptg000047l	14057165	14059433	2268	g_2298	g_16763
ptg000047l	14061075	14078708	17633	g_16763	g_19591
ptg000047l	14087716	14193811	106095	g_19591	g_32368
ptg000047l	14194011	14300534	106523	g_32368	g_4140
ptg000047l	14302968	14303252	284	g_4140	g_13247
ptg000047l	14319239	14320456	1217	g_13247	g_13294
ptg000047l	14326334	14329479	3145	g_13294	g_2767
ptg000047l	14342696	14358717	16021	g_2767	g_20787
ptg000047l	14383978	14392885	8907	g_20787	g_27302
ptg000047l	14406125	14423644	17519	g_27302	g_8357
ptg000047l	14431760	14516183	84423	g_8357	g_1560
ptg000047l	14518962	14539793	20831	g_1560	g_14741
ptg000047l	14540227	14564002	23775	g_14741	g_21444
ptg000047l	14567322	14584343	17021	g_21444	g_29004
ptg000047l	14597687	14602018	4331	g_29004	g_8225
ptg000047l	14603919	14631371	27452	g_8225	g_29281
ptg000047l	14641422	14643285	1863	g_29281	g_11941
ptg000047l	14655037	14659057	4020	g_11941	g_3347
ptg000047l	14665879	14669247	3368	g_3347	g_14099
ptg000047l	14671252	14699225	27973	g_14099	g_1882
ptg000047l	14704998	14709385	4387	g_1882	g_18996
ptg000047l	14710744	14711703	959	g_18996	g_33283
ptg000047l	14712176	14715777	3601	g_33283	g_16742
ptg000047l	14729882	14737601	7719	g_16742	g_8146
ptg000047l	14750030	14751754	1724	g_8146	g_31338
ptg000047l	14762217	14763742	1525	g_31338	g_31076
ptg000047l	14765618	14781692	16074	g_31076	g_23694
ptg000047l	14783236	14786346	3110	g_23694	g_18842
ptg000047l	14791803	14840109	48306	g_18842	g_30361
ptg000047l	14841006	14847522	6516	g_30361	g_32974
ptg000047l	14855299	15173003	317704	g_32974	g_12443
ptg000047l	15175483	15187834	12351	g_12443	g_31119
ptg000047l	15191935	15193029	1094	g_31119	g_1744
ptg000047l	15196513	15308251	111738	g_1744	g_1938
ptg000047l	15309246	15347235	37989	g_1938	g_6328
ptg000047l	15351876	15354580	2704	g_6328	g_9786
ptg000047l	15358998	15362099	3101	g_9786	g_28596
ptg000047l	15366946	15374369	7423	g_28596	g_16458
ptg000047l	15375772	15546642	170870	g_16458	g_991
ptg000047l	15546899	15581167	34268	g_991	g_27567
ptg000047l	15581415	15584312	2897	g_27567	g_13975
ptg000047l	15585262	15601626	16364	g_13975	g_20979
ptg000047l	15603796	15816841	213045	g_20979	g_32554
ptg000047l	15818667	15819677	1010	g_32554	g_11703
ptg000047l	15820613	15822714	2101	g_11703	g_18541
ptg000047l	15830238	15833284	3046	g_18541	g_37192
ptg000047l	15833811	15845817	12006	g_37192	g_19248
ptg000047l	15853939	15871988	18049	g_19248	g_8159
ptg000047l	15872215	15879496	7281	g_8159	g_37322
ptg000047l	15881073	15894080	13007	g_37322	g_30957
ptg000047l	15894334	15898002	3668	g_30957	g_33754
ptg000047l	15902401	15915857	13456	g_33754	g_33966
ptg000047l	15923036	15935963	12927	g_33966	g_1156
ptg000047l	15938732	15962578	23846	g_1156	g_37008
ptg000047l	15968991	15973239	4248	g_37008	g_22937
ptg000047l	15981354	15990304	8950	g_22937	g_10340
ptg000047l	15995349	16008500	13151	g_10340	g_8304
ptg000047l	16013262	16019611	6349	g_8304	g_8867
ptg000047l	16034073	16125253	91180	g_8867	g_3876
ptg000047l	16126743	16209552	82809	g_3876	g_22481
ptg000047l	16209833	16217405	7572	g_22481	g_2190
ptg000047l	16217656	16225574	7918	g_2190	g_7686
ptg000047l	16225888	16266529	40641	g_7686	g_36546
ptg000047l	16267989	16490043	222054	g_36546	g_6868
ptg000047l	16494334	16520475	26141	g_6868	g_16083
ptg000047l	16529068	16531734	2666	g_16083	g_4115
ptg000047l	16536398	16566050	29652	g_4115	g_22087
ptg000047l	16569682	16570038	356	g_22087	g_40218
ptg000047l	16570469	16575210	4741	g_40218	g_30280
ptg000047l	16586310	16591821	5511	g_30280	g_4098
ptg000047l	16594032	16598505	4473	g_4098	g_20530
ptg000047l	16601156	16603388	2232	g_20530	g_28335
ptg000047l	16607275	16647416	40141	g_28335	g_17912
ptg000047l	16652173	16735795	83622	g_17912	g_10285
ptg000047l	16736088	16796327	60239	g_10285	g_35017
ptg000047l	16808571	16924601	116030	g_35017	g_4965
ptg000047l	16947193	16950722	3529	g_4965	g_29097
ptg000047l	16956010	16960361	4351	g_29097	g_17474
ptg000047l	16978614	16979699	1085	g_17474	g_19251
ptg000047l	16982882	16992329	9447	g_19251	g_30214
ptg000047l	16993191	17073061	79870	g_30214	g_26238
ptg000047l	17073402	17083698	10296	g_26238	g_326
ptg000047l	17085494	17085816	322	g_326	g_3165
ptg000047l	17087429	17100139	12710	g_3165	g_31157
ptg000047l	17100753	17192704	91951	g_31157	g_8246
ptg000047l	17192940	17210155	17215	g_8246	g_24347
ptg000047l	17229867	17240308	10441	g_24347	g_1845
ptg000047l	17247901	17252153	4252	g_1845	g_16888
ptg000047l	17253001	17255890	2889	g_16888	g_23732
ptg000047l	17258839	17339006	80167	g_23732	g_29998
ptg000047l	17340660	17341236	576	g_29998	g_37188
ptg000047l	17342548	17432029	89481	g_37188	g_5088
ptg000047l	17439303	17474452	35149	g_5088	g_37546
ptg000047l	17490404	17501608	11204	g_37546	g_16368
ptg000047l	17511714	17524420	12706	g_16368	g_10593
ptg000047l	17531657	17726154	194497	g_10593	g_10104
ptg000047l	17732269	17736097	3828	g_10104	g_12536
ptg000047l	17749280	17780206	30926	g_12536	g_8474
ptg000047l	17780982	17783287	2305	g_8474	g_14392
ptg000047l	17787996	17804375	16379	g_14392	g_8354
ptg000047l	17809888	17816720	6832	g_8354	g_28474
ptg000047l	17835932	17852334	16402	g_28474	g_12594
ptg000047l	17862787	18003672	140885	g_12594	g_24138
ptg000047l	18004430	18133312	128882	g_24138	g_29895
ptg000047l	18144177	18197060	52883	g_29895	g_28347
ptg000047l	18197371	18397903	200532	g_28347	g_24511
ptg000047l	18398139	18422981	24842	g_24511	g_23384
ptg000047l	18434118	18484368	50250	g_23384	g_33785
ptg000047l	18484988	18621246	136258	g_33785	g_33191
ptg000047l	18630399	18634650	4251	g_33191	g_31520
ptg000047l	18644208	18649967	5759	g_31520	g_1050
ptg000047l	18660734	18688730	27996	g_1050	g_40217
ptg000047l	18690392	18690424	32	g_40217	g_22038
ptg000047l	18693792	18706415	12623	g_22038	g_8452
ptg000047l	18708335	18710202	1867	g_8452	g_13551
ptg000047l	18715292	18744679	29387	g_13551	g_14861
ptg000047l	18748191	18935752	187561	g_14861	g_26422
ptg000047l	18936192	19141716	205524	g_26422	g_18920
ptg000047l	19143698	19557455	413757	g_18920	g_16669
ptg000047l	19557823	19597762	39939	g_16669	g_16204
ptg000047l	19598268	19629181	30913	g_16204	g_9509
ptg000047l	19631007	19635461	4454	g_9509	g_13767
ptg000047l	19637270	19650490	13220	g_13767	g_27112
ptg000047l	19651904	19670766	18862	g_27112	g_11082
ptg000047l	19671335	19671771	436	g_11082	g_11874
ptg000047l	19673674	19677100	3426	g_11874	g_7393
ptg000047l	19687837	19691242	3405	g_7393	g_13896
ptg000047l	19709033	19715724	6691	g_13896	g_22147
ptg000047l	19716497	19768901	52404	g_22147	g_33806
ptg000047l	19771919	19887430	115511	g_33806	g_39060
ptg000047l	19888185	19897764	9579	g_39060	g_35649
ptg000047l	19898048	19937437	39389	g_35649	g_1432
ptg000047l	19938231	20006789	68558	g_1432	g_2753
ptg000047l	20007037	20029806	22769	g_2753	g_9331
ptg000047l	20038017	20061590	23573	g_9331	g_27466
ptg000047l	20061823	20178933	117110	g_27466	g_18354
ptg000047l	20180858	20187741	6883	g_18354	g_4301
ptg000047l	20195464	20264545	69081	g_4301	g_27353
ptg000047l	20278072	20292809	14737	g_27353	g_25446
ptg000047l	20314171	20346212	32041	g_25446	g_1427
ptg000047l	20346550	20403957	57407	g_1427	g_31793
ptg000047l	20419954	20487246	67292	g_31793	g_16581
ptg000047l	20491934	20504299	12365	g_16581	g_5891
ptg000047l	20515998	20546964	30966	g_5891	g_3386
ptg000047l	20547995	20562706	14711	g_3386	g_33985
ptg000047l	20563002	20609067	46065	g_33985	g_35336
ptg000047l	20614135	20698164	84029	g_35336	g_14588
ptg000047l	20698418	20704242	5824	g_14588	g_8185
ptg000047l	20712816	20717542	4726	g_8185	g_24574
ptg000047l	20718201	20797490	79289	g_24574	g_1584
ptg000047l	20798101	20815170	17069	g_1584	g_34058
ptg000047l	20825649	20840815	15166	g_34058	g_22653
ptg000047l	20842452	20891074	48622	g_22653	g_18888
ptg000047l	20891310	20929308	37998	g_18888	g_13528
ptg000047l	20930567	20933352	2785	g_13528	g_29315
ptg000047l	20941615	20954708	13093	g_29315	g_34546
ptg000047l	20976955	20979474	2519	g_34546	g_30220
ptg000047l	20980565	21008708	28143	g_30220	g_24883
ptg000047l	21009271	21022419	13148	g_24883	g_24014
ptg000047l	21022706	21052671	29965	g_24014	g_11196
ptg000047l	21060294	21217500	157206	g_11196	g_30624
ptg000047l	21219131	21248401	29270	g_30624	g_22849
ptg000047l	21248838	21373511	124673	g_22849	g_14746
ptg000047l	21373858	21425685	51827	g_14746	g_19026
ptg000047l	21426707	21561011	134304	g_19026	g_27019
ptg000047l	21561244	21569307	8063	g_27019	g_4135
ptg000047l	21569576	21663640	94064	g_4135	g_16802
ptg000047l	21664251	21746583	82332	g_16802	g_31676
ptg000047l	21746993	21757834	10841	g_31676	g_19863
ptg000047l	21758433	21775066	16633	g_19863	g_7841
ptg000047l	21776196	21807546	31350	g_7841	g_6356
ptg000047l	21810856	21985141	174285	g_6356	g_18992
ptg000047l	22000713	22009545	8832	g_18992	g_20947
ptg000047l	22010318	22013755	3437	g_20947	g_3002
ptg000047l	22023941	22086689	62748	g_3002	g_34693
ptg000047l	22087120	22194347	107227	g_34693	g_5095
ptg000047l	22194892	22224397	29505	g_5095	g_18001
ptg000047l	22224990	22263073	38083	g_18001	g_27988
ptg000047l	22286724	22342361	55637	g_27988	g_27365
ptg000047l	22342780	22343315	535	g_27365	g_12186
ptg000047l	22343560	22371078	27518	g_12186	g_16413
ptg000047l	22376093	22410787	34694	g_16413	g_19171
ptg000047l	22414074	22476695	62621	g_19171	g_29093
ptg000047l	22490192	22491063	871	g_29093	g_23245
ptg000047l	22497489	22499745	2256	g_23245	g_14749
ptg000047l	22508045	22515018	6973	g_14749	g_15392
ptg000047l	22515959	22522997	7038	g_15392	g_37341
ptg000047l	22523626	22577366	53740	g_37341	g_24162
ptg000047l	22580977	22594938	13961	g_24162	g_37145
ptg000047l	22595822	22606610	10788	g_37145	g_10816
ptg000047l	22607359	22608870	1511	g_10816	g_23395
ptg000047l	22622971	22627851	4880	g_23395	g_10154
ptg000047l	22630178	22656398	26220	g_10154	g_24748
ptg000047l	22670333	22806895	136562	g_24748	g_12439
ptg000047l	22811149	22877602	66453	g_12439	g_35451
ptg000047l	22878054	22923513	45459	g_35451	g_32077
ptg000047l	22923878	22929078	5200	g_32077	g_39098
ptg000047l	22939645	23011059	71414	g_16109	g_1965
ptg000047l	23011265	23265962	254697	g_1965	g_3524
ptg000047l	23266189	23336236	70047	g_3524	g_11204
ptg000047l	23337153	23376389	39236	g_11204	g_15627
ptg000047l	23377270	23384164	6894	g_15627	g_22811
ptg000047l	23384526	23538340	153814	g_22811	g_17927
ptg000047l	23539479	23543952	4473	g_17927	g_36093
ptg000047l	23544476	23570980	26504	g_36093	g_31710
ptg000047l	23587472	23591618	4146	g_31710	g_31819
ptg000047l	23593411	23597172	3761	g_31819	g_35267
ptg000047l	23597948	23604557	6609	g_35267	g_19992
ptg000047l	23605702	23609917	4215	g_19992	g_32462
ptg000048l	67266	75160	7894	g_1481	g_26869
ptg000048l	86769	107974	21205	g_26869	g_12144
ptg000048l	108476	177370	68894	g_12144	g_28641
ptg000048l	182479	226154	43675	g_28641	g_36362
ptg000048l	226890	226966	76	g_36362	g_27585
ptg000048l	227700	308920	81220	g_27585	g_37869
ptg000048l	309555	397926	88371	g_37869	g_16325
ptg000048l	398405	503900	105495	g_16325	g_13262
ptg000048l	505075	556169	51094	g_13262	g_28911
ptg000048l	556537	654835	98298	g_28911	g_2635
ptg000048l	655053	655097	44	g_2635	g_30311
ptg000048l	655447	673601	18154	g_30311	g_26853
ptg000048l	688258	719670	31412	g_26853	g_17567
ptg000048l	720593	830261	109668	g_17567	g_29347
ptg000048l	833308	881720	48412	g_29347	g_38903
ptg000048l	882058	882884	826	g_38903	g_19442
ptg000048l	883450	914042	30592	g_19442	g_24648
ptg000048l	914563	937913	23350	g_24648	g_3201
ptg000048l	946185	964196	18011	g_3201	g_8957
ptg000048l	966038	1074470	108432	g_8957	g_24626
ptg000048l	1074840	1102031	27191	g_24626	g_16434
ptg000048l	1102261	1122750	20489	g_16434	g_8341
ptg000048l	1124444	1160628	36184	g_8341	g_18809
ptg000048l	1182878	1191017	8139	g_18809	g_12444
ptg000048l	1206783	1207702	919	g_12444	g_37550
ptg000048l	1208046	1211819	3773	g_37550	g_10549
ptg000048l	1219409	1255369	35960	g_10549	g_3307
ptg000048l	1256211	1291416	35205	g_3307	g_27396
ptg000048l	1296599	1339754	43155	g_27396	g_12888
ptg000048l	1345091	1390390	45299	g_12888	g_34237
ptg000048l	1396825	1404894	8069	g_34237	g_7663
ptg000048l	1405328	1433359	28031	g_7663	g_21496
ptg000048l	1433775	1468189	34414	g_21496	g_17873
ptg000048l	1468998	1555485	86487	g_17873	g_10791
ptg000048l	1556615	1560742	4127	g_10791	g_16542
ptg000048l	1564530	1591671	27141	g_16542	g_27658
ptg000048l	1597655	1602390	4735	g_27658	g_33064
ptg000048l	1603067	1778412	175345	g_33064	g_35500
ptg000048l	1810391	1839865	29474	g_35500	g_2550
ptg000048l	1882163	1896253	14090	g_2550	g_14935
ptg000048l	1897128	1899781	2653	g_14935	g_27718
ptg000048l	1900041	2040946	140905	g_27718	g_20223
ptg000048l	2060051	2088957	28906	g_20223	g_2337
ptg000048l	2139233	2315595	176362	g_2337	g_23584
ptg000048l	2316161	2316817	656	g_23584	g_20183
ptg000048l	2317494	2449108	131614	g_20183	g_28755
ptg000049l	88555	108817	20262	g_37768	g_17763
ptg000049l	109653	176183	66530	g_17763	g_2490
ptg000049l	203907	212740	8833	g_2490	g_29090
ptg000049l	214319	327599	113280	g_29090	g_39509
ptg000049l	328097	338265	10168	g_39509	g_38839
ptg000049l	341319	464661	123342	g_38839	g_2705
ptg000049l	476620	527571	50951	g_2705	g_33865
ptg000049l	549826	563765	13939	g_33865	g_8734
ptg000049l	566450	738357	171907	g_8734	g_24272
ptg000049l	750675	1017055	266380	g_24272	g_8807
ptg000049l	1034277	1055346	21069	g_8807	g_9899
ptg000049l	1063966	1142418	78452	g_9899	g_15643
ptg000049l	1152989	1296082	143093	g_15643	g_24101
ptg000049l	1296516	1480504	183988	g_24101	g_8770
ptg000049l	1480779	1505290	24511	g_8770	g_11345
ptg000049l	1505565	1519777	14212	g_11345	g_16404
ptg000049l	1520655	1545953	25298	g_16404	g_10619
ptg000049l	1546315	1720325	174010	g_10619	g_10036
ptg000049l	1723810	1865093	141283	g_10036	g_33011
ptg000049l	1865749	1954411	88662	g_33011	g_4150
ptg000049l	1954632	1978509	23877	g_4150	g_29730
ptg000049l	1983041	1985085	2044	g_29730	g_9631
ptg000049l	1997125	1998812	1687	g_9631	g_29955
ptg000049l	1999030	2047406	48376	g_29955	g_39436
ptg000049l	2047657	2050384	2727	g_39436	g_11048
ptg000049l	2054516	2055291	775	g_11048	g_29649
ptg000049l	2059250	2061541	2291	g_29649	g_34190
ptg000049l	2063091	2065361	2270	g_34190	g_4881
ptg000049l	2066779	2067440	661	g_4881	g_13734
ptg000049l	2073587	2127701	54114	g_13734	g_31554
ptg000049l	2129034	2134612	5578	g_31554	g_38427
ptg000049l	2138498	2189247	50749	g_38427	g_24509
ptg000049l	2197149	2241462	44313	g_24509	g_24241
ptg000049l	2251949	2299203	47254	g_24241	g_8755
ptg000049l	2302636	2310361	7725	g_8755	g_22373
ptg000049l	2315063	2330849	15786	g_22373	g_4406
ptg000049l	2338285	2418750	80465	g_4406	g_407
ptg000049l	2420096	2487501	67405	g_407	g_16391
ptg000049l	2487704	2590503	102799	g_16391	g_18912
ptg000049l	2596189	2673948	77759	g_18912	g_9152
ptg000049l	2677390	2678492	1102	g_9152	g_9887
ptg000049l	2679348	2686172	6824	g_9887	g_16555
ptg000049l	2687028	2783125	96097	g_16555	g_16053
ptg000049l	2786128	2789194	3066	g_16053	g_14805
ptg000049l	2790912	2792807	1895	g_14805	g_11927
ptg000049l	2793343	2794417	1074	g_11927	g_29581
ptg000049l	2807332	2819597	12265	g_29581	g_21655
ptg000049l	2819965	2980370	160405	g_21655	g_15695
ptg000049l	2981383	2982725	1342	g_15695	g_21169
ptg000049l	2983873	3015119	31246	g_21169	g_17299
ptg000049l	3020049	3027755	7706	g_39271	g_28285
ptg000049l	3034095	3036669	2574	g_28285	g_30020
ptg000049l	3038325	3041047	2722	g_30020	g_30235
ptg000049l	3047031	3052007	4976	g_30235	g_18640
ptg000049l	3054237	3082184	27947	g_18640	g_14904
ptg000049l	3083005	3088058	5053	g_14904	g_26243
ptg000049l	3091591	3092189	598	g_26243	g_29133
ptg000049l	3103666	3113269	9603	g_29133	g_9805
ptg000049l	3114225	3132701	18476	g_9805	g_30477
ptg000049l	3146138	3153465	7327	g_30477	g_18072
ptg000049l	3158758	3162224	3466	g_18072	g_10239
ptg000049l	3162784	3201441	38657	g_10239	g_3993
ptg000049l	3222616	3241881	19265	g_3993	g_15907
ptg000049l	3242162	3303256	61094	g_15907	g_4632
ptg000049l	3303690	3406991	103301	g_4632	g_39749
ptg000049l	3407458	3422977	15519	g_39749	g_33276
ptg000049l	3453252	3558094	104842	g_33276	g_32979
ptg000049l	3563544	3599354	35810	g_32979	g_11348
ptg000049l	3602475	3618003	15528	g_11348	g_21780
ptg000049l	3624119	3717408	93289	g_21780	g_15455
ptg000049l	3717896	3732644	14748	g_15455	g_25877
ptg000049l	3742720	3818817	76097	g_25877	g_32515
ptg000049l	3824920	3838249	13329	g_32515	g_32638
ptg000049l	3855318	3894427	39109	g_32638	g_6181
ptg000049l	3909124	3926569	17445	g_6181	g_38135
ptg000049l	3942515	4027102	84587	g_38135	g_5898
ptg000049l	4027500	4067942	40442	g_5898	g_28977
ptg000049l	4069508	4093966	24458	g_28977	g_37878
ptg000049l	4161444	4452672	291228	g_37878	g_21297
ptg000049l	4460113	4461664	1551	g_21297	g_21063
ptg000049l	4466483	4723235	256752	g_21063	g_10437
ptg000049l	4727336	4817010	89674	g_10437	g_21965
ptg000049l	4817291	4878370	61079	g_21965	g_11765
ptg000049l	4881870	5039341	157471	g_11765	g_9897
ptg000049l	5045367	5101057	55690	g_9897	g_25323
ptg000049l	5121138	5129535	8397	g_25323	g_22006
ptg000049l	5148066	5186265	38199	g_22006	g_1647
ptg000049l	5188109	5323523	135414	g_1647	g_3710
ptg000049l	5326811	5353332	26521	g_3710	g_20925
ptg000049l	5353856	5583080	229224	g_20925	g_38331
ptg000049l	5584327	5934878	350551	g_38331	g_15492
ptg000049l	5941750	5944357	2607	g_15492	g_17260
ptg000049l	5953308	5958609	5301	g_17260	g_16185
ptg000049l	5958866	6068718	109852	g_16185	g_24873
ptg000049l	6075696	6163743	88047	g_24873	g_10926
ptg000049l	6163952	6222741	58789	g_10926	g_27201
ptg000049l	6230335	6251439	21104	g_27201	g_10548
ptg000049l	6251831	6264143	12312	g_10548	g_13636
ptg000049l	6295741	6351292	55551	g_13636	g_31910
ptg000049l	6352619	6364603	11984	g_31910	g_37063
ptg000049l	6368615	6421969	53354	g_37063	g_8783
ptg000049l	6431630	6441293	9663	g_8783	g_27564
ptg000049l	6447697	6448981	1284	g_27564	g_3892
ptg000049l	6451067	6454790	3723	g_3892	g_13388
ptg000049l	6458727	6461089	2362	g_13388	g_40122
ptg000049l	6468277	6488279	20002	g_40122	g_7212
ptg000049l	6491923	6492396	473	g_7212	g_16522
ptg000049l	6499802	6694624	194822	g_16522	g_7228
ptg000049l	6711417	6768455	57038	g_7228	g_11709
ptg000049l	6769180	6771587	2407	g_11709	g_17321
ptg000049l	6778137	6780431	2294	g_17321	g_22889
ptg000049l	6781409	6787517	6108	g_22889	g_40232
ptg000049l	6787861	6794145	6284	g_40232	g_21022
ptg000049l	6803460	6809377	5917	g_21022	g_31505
ptg000049l	6817306	6817433	127	g_31505	g_33731
ptg000049l	6824898	6826242	1344	g_33731	g_11800
ptg000049l	6828091	6838184	10093	g_38679	g_34672
ptg000049l	6839078	6844573	5495	g_34672	g_19220
ptg000049l	6847080	6848406	1326	g_19220	g_34606
ptg000049l	6851881	6855475	3594	g_34606	g_7542
ptg000049l	6870605	6877404	6799	g_7542	g_3185
ptg000049l	6883692	6900066	16374	g_3185	g_28377
ptg000049l	6904357	6928367	24010	g_28377	g_14144
ptg000049l	6929854	6957413	27559	g_14144	g_4280
ptg000049l	6961511	6975205	13694	g_4280	g_36019
ptg000049l	6979014	7009073	30059	g_36019	g_8213
ptg000049l	7009396	7078016	68620	g_8213	g_25348
ptg000049l	7083890	7089344	5454	g_25348	g_17781
ptg000049l	7090606	7096761	6155	g_17781	g_29521
ptg000049l	7097819	7109128	11309	g_29521	g_16914
ptg000049l	7109367	7458143	348776	g_16914	g_39596
ptg000049l	7458664	7459241	577	g_39596	g_15022
ptg000049l	7459540	7467236	7696	g_15022	g_30362
ptg000049l	7469252	7471321	2069	g_30362	g_37256
ptg000049l	7472040	7479034	6994	g_37256	g_33817
ptg000049l	7481398	7486392	4994	g_33817	g_31739
ptg000049l	7487213	7500270	13057	g_31739	g_25866
ptg000049l	7502332	7505066	2734	g_25866	g_34392
ptg000049l	7506521	7518394	11873	g_34392	g_2393
ptg000049l	7519263	7548659	29396	g_2393	g_31514
ptg000049l	7549402	7647660	98258	g_31514	g_22886
ptg000049l	7648508	7654782	6274	g_22886	g_2376
ptg000049l	7655852	7659144	3292	g_2376	g_28355
ptg000049l	7660262	7666165	5903	g_28355	g_8914
ptg000049l	7667286	7674418	7132	g_8914	g_31431
ptg000049l	7675539	7679438	3899	g_31431	g_5355
ptg000049l	7680580	7688428	7848	g_5355	g_1776
ptg000049l	7689581	7693246	3665	g_1776	g_28178
ptg000049l	7702703	7748480	45777	g_28178	g_19513
ptg000049l	7750260	7753596	3336	g_19513	g_18402
ptg000049l	7769614	7771121	1507	g_18402	g_21082
ptg000049l	7771966	7774604	2638	g_21082	g_17676
ptg000049l	7788857	7836570	47713	g_17676	g_37746
ptg000049l	7842582	7853293	10711	g_37746	g_26553
ptg000049l	7858590	7861708	3118	g_26553	g_11320
ptg000049l	7868724	7874433	5709	g_11320	g_32956
ptg000049l	7876702	7880762	4060	g_32956	g_24129
ptg000049l	7881637	7900286	18649	g_24129	g_22240
ptg000049l	7902555	7908436	5881	g_22240	g_26036
ptg000049l	7915478	7916897	1419	g_26036	g_29412
ptg000049l	7919166	7925047	5881	g_29412	g_15922
ptg000049l	7932041	7933521	1480	g_15922	g_21701
ptg000049l	7938821	7944694	5873	g_21701	g_24599
ptg000049l	7945571	7952597	7026	g_24599	g_20826
ptg000049l	7954183	7955554	1371	g_20826	g_7732
ptg000049l	7957820	7962077	4257	g_7732	g_33921
ptg000049l	7964695	7970720	6025	g_33921	g_17669
ptg000049l	7971670	7973630	1960	g_17669	g_16060
ptg000049l	7974814	7976378	1564	g_16060	g_27001
ptg000049l	8000779	8040251	39472	g_27001	g_37417
ptg000049l	8054073	8069150	15077	g_37417	g_14578
ptg000049l	8069479	8080793	11314	g_14578	g_1703
ptg000049l	8093660	8097192	3532	g_1703	g_34011
ptg000049l	8112557	8308220	195663	g_34011	g_39205
ptg000049l	8310570	8319348	8778	g_39205	g_16485
ptg000049l	8323507	8325343	1836	g_16485	g_9191
ptg000049l	8328515	8329550	1035	g_9191	g_114
ptg000049l	8332917	8333232	315	g_114	g_36601
ptg000049l	8336112	8369262	33150	g_36601	g_29294
ptg000049l	8371743	8374130	2387	g_29294	g_1444
ptg000049l	8378251	8379457	1206	g_1444	g_36106
ptg000049l	8380704	8382423	1719	g_36106	g_39613
ptg000049l	8383456	8388263	4807	g_39613	g_40239
ptg000049l	8392852	8398014	5162	g_40239	g_23494
ptg000049l	8398910	8405197	6287	g_23494	g_29504
ptg000049l	8417438	8427103	9665	g_29504	g_34694
ptg000049l	8432094	8516363	84269	g_34694	g_30150
ptg000049l	8522879	8524547	1668	g_30150	g_23723
ptg000049l	8527536	8579072	51536	g_23723	g_21027
ptg000049l	8588044	8594472	6428	g_21027	g_37217
ptg000050l	309142	367962	58820	g_34869	g_20294
ptg000050l	392401	492208	99807	g_20294	g_14752
ptg000050l	503258	572827	69569	g_14752	g_20483
ptg000050l	574836	611938	37102	g_20483	g_3665
ptg000050l	618388	623074	4686	g_3665	g_34227
ptg000050l	624258	646047	21789	g_34227	g_11885
ptg000050l	657024	727063	70039	g_11885	g_18268
ptg000050l	729012	804241	75229	g_18268	g_15644
ptg000050l	804660	931027	126367	g_15644	g_35489
ptg000050l	931245	931291	46	g_35489	g_26491
ptg000050l	931623	931699	76	g_26491	g_25974
ptg000050l	931920	932330	410	g_25974	g_5833
ptg000050l	932905	932981	76	g_5833	g_8862
ptg000050l	933583	933629	46	g_8862	g_14410
ptg000050l	933961	934217	256	g_14410	g_22449
ptg000050l	934510	934608	98	g_22449	g_14043
ptg000050l	935183	935259	76	g_14043	g_15946
ptg000050l	935681	1001984	66303	g_15946	g_823
ptg000050l	1002895	1137791	134896	g_823	g_21784
ptg000050l	1150525	1203593	53068	g_21784	g_33925
ptg000050l	1216826	1245910	29084	g_38705	g_14109
ptg000051l	14135	52323	38188	g_19112	g_36318
ptg000051l	55460	55881	421	g_36318	g_30077
ptg000051l	62421	70092	7671	g_30077	g_25913
ptg000051l	75656	137541	61885	g_25913	g_13919
ptg000051l	138635	205061	66426	g_13919	g_37205
ptg000051l	205873	205945	72	g_37205	g_7304
ptg000051l	206523	231303	24780	g_7304	g_37991
ptg000051l	242682	244006	1324	g_37991	g_21617
ptg000051l	244317	251424	7107	g_21617	g_37668
ptg000051l	276169	278556	2387	g_37668	g_29920
ptg000051l	279590	279752	162	g_29920	g_14052
ptg000051l	280321	292433	12112	g_14052	g_23177
ptg000051l	300602	371308	70706	g_23177	g_36889
ptg000051l	372963	475147	102184	g_36889	g_13268
ptg000051l	482803	486497	3694	g_13268	g_9116
ptg000051l	499818	529564	29746	g_9116	g_10409
ptg000051l	530688	771359	240671	g_10409	g_19035
ptg000051l	775112	781219	6107	g_19035	g_27707
ptg000051l	817243	831180	13937	g_27707	g_3627
ptg000051l	831458	884029	52571	g_3627	g_1230
ptg000051l	900504	914993	14489	g_1230	g_33223
ptg000051l	924790	991747	66957	g_33223	g_5859
ptg000051l	993816	1109523	115707	g_5859	g_7047
ptg000051l	1111325	1130666	19341	g_7047	g_10809
ptg000051l	1146639	1151355	4716	g_10809	g_19708
ptg000051l	1177285	1197671	20386	g_19708	g_10153
ptg000051l	1214702	1294791	80089	g_10153	g_291
ptg000051l	1295111	1303176	8065	g_291	g_10988
ptg000051l	1303457	1369182	65725	g_10988	g_31735
ptg000051l	1372954	1386994	14040	g_31735	g_37865
ptg000051l	1391419	1414650	23231	g_37865	g_4878
ptg000051l	1421679	1432588	10909	g_4878	g_26866
ptg000051l	1442319	1446459	4140	g_26866	g_7400
ptg000051l	1455604	1459872	4268	g_7400	g_15558
ptg000051l	1462843	1483993	21150	g_15558	g_17860
ptg000051l	1507845	1509084	1239	g_17860	g_33577
ptg000051l	1512137	1531889	19752	g_33577	g_27784
ptg000051l	1536676	1546598	9922	g_27784	g_8835
ptg000051l	1549906	1590993	41087	g_8835	g_35975
ptg000051l	1591199	1740590	149391	g_35975	g_17517
ptg000051l	1752262	1787015	34753	g_17517	g_25440
ptg000051l	1803827	1804676	849	g_25440	g_28804
ptg000051l	1806732	1826730	19998	g_28804	g_21431
ptg000051l	1828139	1867815	39676	g_21431	g_34297
ptg000051l	1868297	1970688	102391	g_34297	g_253
ptg000051l	1971113	1978528	7415	g_253	g_13612
ptg000051l	1979243	2001621	22378	g_39283	g_18881
ptg000051l	2005987	2007573	1586	g_18881	g_22475
ptg000051l	2008049	2026151	18102	g_22475	g_11272
ptg000051l	2026600	2040270	13670	g_11272	g_36101
ptg000051l	2045190	2075535	30345	g_36101	g_15879
ptg000051l	2082587	2097475	14888	g_39678	g_4681
ptg000051l	2098323	2219218	120895	g_4681	g_15094
ptg000051l	2219544	2242919	23375	g_15094	g_2548
ptg000051l	2245471	2300714	55243	g_2548	g_30667
ptg000051l	2303263	2371094	67831	g_30667	g_17686
ptg000051l	2374138	2379278	5140	g_17686	g_11070
ptg000051l	2380864	2381070	206	g_11070	g_31516
ptg000051l	2381540	2381807	267	g_31516	g_28534
ptg000051l	2382403	2390405	8002	g_28534	g_6173
ptg000051l	2391580	2414760	23180	g_6173	g_7566
ptg000051l	2430099	2567567	137468	g_7566	g_26493
ptg000051l	2569593	2569622	29	g_26493	g_10107
ptg000051l	2572276	2573961	1685	g_10107	g_26685
ptg000052l	166497	251845	85348	g_21641	g_23235
ptg000052l	256433	257553	1120	g_23235	g_36919
ptg000052l	261415	265009	3594	g_36919	g_40138
ptg000052l	266526	269447	2921	g_40138	g_14843
ptg000052l	294262	297280	3018	g_14843	g_17544
ptg000052l	300381	301254	873	g_17544	g_30605
ptg000052l	312725	321392	8667	g_30605	g_37045
ptg000052l	335388	337751	2363	g_37045	g_3877
ptg000052l	348127	352025	3898	g_3877	g_8586
ptg000052l	362453	452611	90158	g_8586	g_8905
ptg000052l	460047	472339	12292	g_8905	g_28296
ptg000052l	479644	480258	614	g_28296	g_3639
ptg000052l	482965	483551	586	g_3639	g_18684
ptg000052l	484270	632481	148211	g_18684	g_27483
ptg000052l	634507	641768	7261	g_27483	g_21840
ptg000052l	654407	680277	25870	g_21840	g_1679
ptg000052l	698802	702470	3668	g_1679	g_590
ptg000052l	705511	722110	16599	g_590	g_4274
ptg000052l	727987	731903	3916	g_4274	g_39006
ptg000052l	738381	738932	551	g_39006	g_38569
ptg000052l	742804	743583	779	g_38569	g_35777
ptg000052l	749653	768247	18594	g_35777	g_14978
ptg000052l	769670	946218	176548	g_14978	g_28368
ptg000052l	947274	955974	8700	g_28368	g_31786
ptg000052l	956342	1047796	91454	g_31786	g_24728
ptg000052l	1050075	1130236	80161	g_24728	g_6105
ptg000052l	1134049	1135422	1373	g_6105	g_39830
ptg000052l	1135622	1138970	3348	g_39830	g_9003
ptg000052l	1144552	1146938	2386	g_9003	g_33949
ptg000052l	1154901	1164636	9735	g_33949	g_396
ptg000052l	1190066	1192074	2008	g_396	g_13735
ptg000052l	1199015	1200084	1069	g_13735	g_23759
ptg000052l	1201918	1207447	5529	g_23759	g_3671
ptg000052l	1208726	1234155	25429	g_3671	g_36545
ptg000052l	1235439	1241446	6007	g_36545	g_7647
ptg000052l	1245066	1351438	106372	g_7647	g_21723
ptg000052l	1370609	1669694	299085	g_21723	g_18672
ptg000052l	1670917	1673426	2509	g_18672	g_35246
ptg000052l	1680369	1681202	833	g_35246	g_14460
ptg000052l	1684263	1704398	20135	g_14460	g_15349
ptg000052l	1711230	1721653	10423	g_15349	g_12790
ptg000052l	1734818	1735949	1131	g_12790	g_18226
ptg000052l	1746275	1748955	2680	g_18226	g_19935
ptg000052l	1749902	1754476	4574	g_19935	g_14864
ptg000052l	1762065	1959678	197613	g_14864	g_15540
ptg000052l	1979917	2153109	173192	g_15540	g_16085
ptg000052l	2154101	2196683	42582	g_16085	g_18123
ptg000052l	2198955	2208705	9750	g_18123	g_1763
ptg000052l	2210750	2222445	11695	g_1763	g_31427
ptg000052l	2231794	2232817	1023	g_31427	g_26004
ptg000052l	2243383	2256179	12796	g_26004	g_11878
ptg000052l	2256691	2261134	4443	g_11878	g_17562
ptg000052l	2271098	2276449	5351	g_6962	g_14848
ptg000052l	2287182	2296488	9306	g_14848	g_31734
ptg000052l	2376925	2520230	143305	g_31734	g_32790
ptg000052l	2520679	2534526	13847	g_32790	g_13625
ptg000052l	2541647	2548020	6373	g_13625	g_24402
ptg000052l	2548975	2550782	1807	g_24402	g_31589
ptg000052l	2556526	2562626	6100	g_31589	g_10898
ptg000052l	2575076	2622698	47622	g_10898	g_16005
ptg000052l	2626644	2630316	3672	g_16005	g_11940
ptg000052l	2638199	2639023	824	g_11940	g_8840
ptg000052l	2639857	2645874	6017	g_8840	g_13322
ptg000052l	2655287	2856076	200789	g_13322	g_28037
ptg000052l	2856288	2909037	52749	g_28037	g_23209
ptg000052l	2909276	2977662	68386	g_23209	g_4242
ptg000052l	2983026	3005024	21998	g_4242	g_761
ptg000052l	3005296	3029311	24015	g_761	g_33233
ptg000052l	3034601	3078181	43580	g_33233	g_7879
ptg000052l	3083581	3127119	43538	g_7879	g_1862
ptg000052l	3142407	3143538	1131	g_1862	g_23612
ptg000052l	3148381	3179448	31067	g_23612	g_32551
ptg000052l	3188389	3196479	8090	g_32551	g_23635
ptg000052l	3201924	3204692	2768	g_23635	g_14774
ptg000052l	3208228	3212162	3934	g_14774	g_39719
ptg000052l	3213347	3221965	8618	g_39719	g_33116
ptg000052l	3222357	3343451	121094	g_33116	g_25638
ptg000052l	3352824	3357135	4311	g_25638	g_12646
ptg000052l	3361392	3362102	710	g_12646	g_8852
ptg000052l	3363998	3366278	2280	g_8852	g_22668
ptg000052l	3377791	3381451	3660	g_22668	g_7716
ptg000052l	3382501	3389097	6596	g_7716	g_20333
ptg000052l	3393950	3397340	3390	g_20333	g_14723
ptg000052l	3407713	3407865	152	g_14723	g_26233
ptg000052l	3408071	3409415	1344	g_26233	g_9534
ptg000052l	3413119	3414383	1264	g_9534	g_29871
ptg000052l	3415365	3421821	6456	g_29871	g_38189
ptg000052l	3435385	3441692	6307	g_38189	g_35912
ptg000052l	3451696	3482628	30932	g_35912	g_11094
ptg000052l	3488456	3629753	141297	g_11094	g_32172
ptg000052l	3650805	3747119	96314	g_32172	g_1608
ptg000052l	3761321	3763615	2294	g_1608	g_19390
ptg000052l	3767661	3768865	1204	g_19390	g_4526
ptg000052l	3782498	3794952	12454	g_4526	g_39978
ptg000052l	3796379	3798811	2432	g_39978	g_10582
ptg000052l	3800646	3815634	14988	g_10582	g_31030
ptg000052l	3823306	3827205	3899	g_31030	g_9725
ptg000052l	3830895	3971903	141008	g_9725	g_11550
ptg000052l	3972538	4008178	35640	g_11550	g_37199
ptg000052l	4008600	4020392	11792	g_37199	g_23878
ptg000052l	4021447	4055460	34013	g_23878	g_32676
ptg000052l	4055681	4179598	123917	g_32676	g_28905
ptg000052l	4184714	4210972	26258	g_28905	g_617
ptg000052l	4277833	4311470	33637	g_617	g_5308
ptg000052l	4317529	4356267	38738	g_5308	g_370
ptg000052l	4363354	4439537	76183	g_370	g_25547
ptg000052l	4466970	4474043	7073	g_25547	g_16757
ptg000052l	4478627	4479570	943	g_16757	g_32893
ptg000052l	4483253	4483593	340	g_32893	g_6038
ptg000052l	4485773	4491249	5476	g_6038	g_18922
ptg000052l	4493707	4502414	8707	g_18922	g_37127
ptg000052l	4503779	4508075	4296	g_37127	g_2561
ptg000052l	4508949	4513185	4236	g_39168	g_33515
ptg000052l	4514059	4518104	4045	g_38910	g_11880
ptg000052l	4518844	4528896	10052	g_11880	g_12765
ptg000052l	4529770	4533812	4042	g_39651	g_3303
ptg000052l	4534716	4538749	4033	g_38475	g_15862
ptg000052l	4539587	4617455	77868	g_38784	g_2179
ptg000052l	4620342	4621821	1479	g_2179	g_29371
ptg000052l	4627018	4631056	4038	g_29371	g_23824
ptg000052l	4635506	4637458	1952	g_23824	g_11341
ptg000052l	4641848	4644538	2690	g_11341	g_9735
ptg000052l	4652272	4695586	43314	g_9735	g_23057
ptg000052l	4709269	4712586	3317	g_23057	g_15824
ptg000052l	4713997	4716831	2834	g_15824	g_39995
ptg000052l	4721327	4724404	3077	g_39995	g_5203
ptg000052l	4731136	4733422	2286	g_5203	g_3770
ptg000052l	4740878	4742721	1843	g_3770	g_3350
ptg000052l	4743791	4746786	2995	g_3350	g_7770
ptg000052l	4761537	4818617	57080	g_7770	g_12472
ptg000052l	4820674	4876984	56310	g_12472	g_15405
ptg000052l	4877214	4918562	41348	g_15405	g_15568
ptg000052l	4918864	5008779	89915	g_15568	g_853
ptg000052l	5027445	5093376	65931	g_853	g_11981
ptg000052l	5097091	5344539	247448	g_11981	g_39605
ptg000052l	5344808	5357514	12706	g_39605	g_31154
ptg000052l	5359259	5364268	5009	g_31154	g_22830
ptg000052l	5366396	5371535	5139	g_22830	g_29574
ptg000052l	5372898	5379501	6603	g_29574	g_8659
ptg000052l	5390853	5412978	22125	g_8659	g_5032
ptg000052l	5416607	5421266	4659	g_5032	g_15661
ptg000052l	5429652	5655725	226073	g_15661	g_15091
ptg000052l	5663034	5869760	206726	g_15091	g_31667
ptg000052l	5871369	5943340	71971	g_31667	g_12416
ptg000052l	5951555	5954422	2867	g_12416	g_30137
ptg000052l	5963213	5986007	22794	g_30137	g_35719
ptg000052l	6007099	6079254	72155	g_35719	g_1570
ptg000052l	6098431	6233880	135449	g_1570	g_23792
ptg000052l	6237457	6541638	304181	g_23792	g_32980
ptg000052l	6550297	6550412	115	g_32980	g_11523
ptg000052l	6550690	6589938	39248	g_11523	g_7561
ptg000052l	6597749	6599879	2130	g_7561	g_17401
ptg000052l	6604947	6700375	95428	g_17401	g_6966
ptg000052l	6701058	6704517	3459	g_6966	g_40026
ptg000052l	6729777	6752146	22369	g_40026	g_5844
ptg000052l	6752424	6810291	57867	g_5844	g_30053
ptg000052l	6810557	6865099	54542	g_30053	g_30450
ptg000052l	6877481	6907210	29729	g_30450	g_5295
ptg000052l	6927768	6965068	37300	g_5295	g_1906
ptg000052l	6980900	7032563	51663	g_1906	g_23343
ptg000052l	7074105	7090483	16378	g_23343	g_33189
ptg000052l	7090734	7102312	11578	g_33189	g_15247
ptg000052l	7105927	7111585	5658	g_15247	g_8501
ptg000052l	7133152	7387142	253990	g_8501	g_6525
ptg000052l	7387342	7402007	14665	g_6525	g_25669
ptg000052l	7426568	7457260	30692	g_25669	g_12407
ptg000052l	7457481	7502804	45323	g_12407	g_25712
ptg000052l	7525097	7525125	28	g_25712	g_25739
ptg000052l	7525328	7549716	24388	g_25739	g_20416
ptg000052l	7555983	7584450	28467	g_20416	g_14040
ptg000052l	7585643	7738038	152395	g_14040	g_33753
ptg000052l	7739473	7933488	194015	g_33753	g_15533
ptg000052l	7934690	8205248	270558	g_15533	g_5431
ptg000052l	8206045	8206226	181	g_5431	g_15843
ptg000052l	8206663	8207159	496	g_15843	g_14585
ptg000052l	8207467	8207796	329	g_14585	g_15433
ptg000052l	8208614	8278968	70354	g_15433	g_35068
ptg000052l	8280947	8384701	103754	g_35068	g_28568
ptg000052l	8385270	8390338	5068	g_28568	g_14351
ptg000052l	8391057	8391126	69	g_14351	g_21508
ptg000052l	8392682	8486785	94103	g_21508	g_20690
ptg000052l	8488353	8580273	91920	g_20690	g_8600
ptg000052l	8581025	8605777	24752	g_8600	g_22505
ptg000052l	8606706	8656158	49452	g_22505	g_6874
ptg000052l	8656802	8750790	93988	g_6874	g_23169
ptg000052l	8751710	8754639	2929	g_23169	g_21930
ptg000052l	8755427	8875321	119894	g_21930	g_11955
ptg000052l	8875833	8915324	39491	g_11955	g_19686
ptg000052l	8919245	8920938	1693	g_19686	g_25427
ptg000052l	8921468	8956237	34769	g_25427	g_3349
ptg000052l	8957970	8989984	32014	g_3349	g_8161
ptg000052l	8990541	9041556	51015	g_8161	g_39726
ptg000052l	9041795	9056530	14735	g_39726	g_19219
ptg000052l	9062465	9145768	83303	g_19219	g_18998
ptg000052l	9159739	9272152	112413	g_18998	g_31521
ptg000052l	9279513	9283775	4262	g_31521	g_10341
ptg000052l	9285904	9299280	13376	g_10341	g_40208
ptg000052l	9310602	9311096	494	g_40208	g_20329
ptg000052l	9336309	9367756	31447	g_20329	g_15651
ptg000052l	9380846	9403268	22422	g_15651	g_14957
ptg000052l	9403612	9427162	23550	g_14957	g_20747
ptg000052l	9429605	9509079	79474	g_20747	g_1381
ptg000052l	9509822	9593341	83519	g_1381	g_31561
ptg000052l	9594252	9861198	266946	g_31561	g_37957
ptg000052l	9861995	9927708	65713	g_37957	g_330
ptg000052l	9928202	10006595	78393	g_330	g_36525
ptg000052l	10009300	10039204	29904	g_36525	g_22184
ptg000052l	10051730	10103118	51388	g_22184	g_15074
ptg000052l	10104083	10105808	1725	g_15074	g_10714
ptg000052l	10107358	10107779	421	g_10714	g_2878
ptg000052l	10108765	10116581	7816	g_2878	g_37652
ptg000052l	10116922	10158372	41450	g_37652	g_7450
ptg000052l	10173887	10178753	4866	g_7450	g_4660
ptg000052l	10182578	10188834	6256	g_4660	g_11274
ptg000052l	10190633	10240431	49798	g_11274	g_9621
ptg000052l	10240996	10246899	5903	g_9621	g_1241
ptg000052l	10247210	10255514	8304	g_1241	g_16723
ptg000052l	10257365	10306163	48798	g_16723	g_8344
ptg000052l	10307927	10335079	27152	g_8344	g_35492
ptg000052l	10336930	10356362	19432	g_35492	g_5033
ptg000052l	10357666	10364559	6893	g_5033	g_11007
ptg000052l	10367302	10368892	1590	g_11007	g_6723
ptg000052l	10369404	10505377	135973	g_6723	g_10228
ptg000052l	10532086	10536124	4038	g_10228	g_4707
ptg000052l	10559897	10571805	11908	g_4707	g_204
ptg000052l	10581391	10592299	10908	g_204	g_30771
ptg000052l	10608057	10665430	57373	g_30771	g_32165
ptg000052l	10666440	10680994	14554	g_32165	g_13899
ptg000052l	10681860	10704031	22171	g_13899	g_21953
ptg000052l	10710049	10727169	17120	g_21953	g_19879
ptg000052l	10737413	10811752	74339	g_19879	g_15497
ptg000052l	10822479	10823587	1108	g_15497	g_26844
ptg000052l	10825439	10931905	106466	g_26844	g_11418
ptg000052l	10937915	11020743	82828	g_11418	g_1611
ptg000052l	11032327	11049709	17382	g_1611	g_36435
ptg000052l	11054606	11063753	9147	g_36435	g_16433
ptg000052l	11081151	11090114	8963	g_16433	g_12624
ptg000052l	11094364	11096526	2162	g_12624	g_6217
ptg000052l	11117282	11144338	27056	g_6217	g_31872
ptg000052l	11149248	11152209	2961	g_31872	g_9778
ptg000052l	11157358	11158079	721	g_9778	g_14068
ptg000052l	11164917	11167607	2690	g_14068	g_3172
ptg000052l	11170864	11177321	6457	g_3172	g_25827
ptg000052l	11177899	11193654	15755	g_25827	g_39989
ptg000052l	11199425	11199460	35	g_39989	g_5064
ptg000052l	11200116	11215135	15019	g_5064	g_36346
ptg000052l	11221041	11279132	58091	g_36346	g_9889
ptg000052l	11283153	11325398	42245	g_9889	g_28567
ptg000052l	11329666	11331651	1985	g_28567	g_26910
ptg000052l	11332715	11438304	105589	g_26910	g_12627
ptg000052l	11441123	11463658	22535	g_12627	g_21845
ptg000052l	11465055	11496243	31188	g_21845	g_10680
ptg000052l	11497643	11850481	352838	g_10680	g_4430
ptg000052l	11857593	11862949	5356	g_4430	g_32564
ptg000052l	11863983	11901017	37034	g_32564	g_31575
ptg000052l	11903962	11904973	1011	g_31575	g_14767
ptg000052l	11909565	11951393	41828	g_14767	g_16186
ptg000052l	11963030	11968619	5589	g_16186	g_12880
ptg000052l	11971307	12003123	31816	g_12880	g_34804
ptg000052l	12003596	12128920	125324	g_34804	g_23863
ptg000052l	12129432	12149475	20043	g_23863	g_2590
ptg000052l	12162118	12246650	84532	g_2590	g_26864
ptg000052l	12250282	12365965	115683	g_26864	g_11934
ptg000052l	12383915	12386444	2529	g_11934	g_4805
ptg000052l	12386818	12387145	327	g_4805	g_21270
ptg000052l	12396599	12399752	3153	g_21270	g_25366
ptg000052l	12408511	12415030	6519	g_25366	g_20830
ptg000052l	12423985	12427874	3889	g_20830	g_1094
ptg000052l	12449857	12484820	34963	g_1094	g_8151
ptg000052l	12485215	12512864	27649	g_8151	g_29963
ptg000052l	12513118	12526731	13613	g_29963	g_38117
ptg000052l	12528656	12542545	13889	g_38117	g_10033
ptg000052l	12550630	12586200	35570	g_10033	g_2726
ptg000052l	12606873	12651906	45033	g_2726	g_35693
ptg000052l	12654061	12735666	81605	g_35693	g_16435
ptg000052l	12743933	12746738	2805	g_16435	g_25872
ptg000052l	12754109	12797062	42953	g_25872	g_24628
ptg000052l	12797521	12809490	11969	g_24628	g_21327
ptg000052l	12811390	12813649	2259	g_21327	g_14610
ptg000052l	12814532	12816938	2406	g_14610	g_26182
ptg000052l	12833882	12855707	21825	g_26182	g_31474
ptg000052l	12861738	12863758	2020	g_31474	g_15600
ptg000052l	12868287	12870615	2328	g_15600	g_580
ptg000052l	12874486	12894898	20412	g_580	g_15999
ptg000052l	12901337	12912004	10667	g_15999	g_31548
ptg000052l	12921500	12924998	3498	g_31548	g_33878
ptg000052l	12972614	12974342	1728	g_33878	g_21989
ptg000052l	12976310	13000655	24345	g_21989	g_34618
ptg000052l	13008251	13104405	96154	g_34618	g_35516
ptg000052l	13105976	13114377	8401	g_35516	g_18175
ptg000052l	13114778	13114860	82	g_18175	g_688
ptg000052l	13122615	13125093	2478	g_688	g_36320
ptg000052l	13132325	13134131	1806	g_36320	g_24295
ptg000052l	13135726	13148279	12553	g_24295	g_11772
ptg000052l	13156249	13214107	57858	g_11772	g_4411
ptg000052l	13214340	13221587	7247	g_4411	g_5903
ptg000052l	13235955	13241176	5221	g_5903	g_1897
ptg000052l	13248203	13258518	10315	g_1897	g_25421
ptg000052l	13259216	13273270	14054	g_25421	g_30320
ptg000052l	13274798	13294811	20013	g_30320	g_37748
ptg000052l	13296092	13302167	6075	g_37748	g_21036
ptg000052l	13304415	13305230	815	g_21036	g_4328
ptg000052l	13307754	13309170	1416	g_4328	g_11518
ptg000052l	13313070	13361237	48167	g_11518	g_2119
ptg000052l	13364485	13367100	2615	g_2119	g_25705
ptg000052l	13370510	13370923	413	g_25705	g_22600
ptg000052l	13373763	13375941	2178	g_22600	g_25747
ptg000052l	13376953	13418291	41338	g_25747	g_33470
ptg000052l	13428380	13468537	40157	g_33470	g_2702
ptg000052l	13468857	13472682	3825	g_2702	g_16383
ptg000052l	13477899	13517875	39976	g_16383	g_29782
ptg000052l	13519113	13543345	24232	g_29782	g_8909
ptg000052l	13550092	13563245	13153	g_8909	g_8249
ptg000052l	13574458	13575814	1356	g_8249	g_35914
ptg000052l	13581835	13582190	355	g_35914	g_24608
ptg000052l	13587095	13596184	9089	g_24608	g_21220
ptg000052l	13596497	13611385	14888	g_21220	g_29199
ptg000052l	13611636	13632722	21086	g_29199	g_15259
ptg000052l	13648242	13649640	1398	g_15259	g_31593
ptg000052l	13651819	13658308	6489	g_31593	g_13192
ptg000052l	13668494	13712959	44465	g_13192	g_7525
ptg000052l	13727440	13733179	5739	g_7525	g_1174
ptg000052l	13737777	13740448	2671	g_1174	g_15270
ptg000052l	13745574	13748373	2799	g_15270	g_473
ptg000052l	13751686	13754581	2895	g_473	g_13978
ptg000052l	13764112	13765258	1146	g_13978	g_4419
ptg000052l	13773100	13776728	3628	g_4419	g_1079
ptg000052l	13780463	13783177	2714	g_1079	g_18614
ptg000052l	13790178	13793934	3756	g_18614	g_8609
ptg000052l	13796405	13872028	75623	g_8609	g_20087
ptg000052l	13894205	13940825	46620	g_20087	g_32802
ptg000052l	13942330	13991345	49015	g_32802	g_28381
ptg000052l	13997471	14091024	93553	g_28381	g_27688
ptg000052l	14092535	14097889	5354	g_27688	g_37200
ptg000052l	14108796	14113960	5164	g_37200	g_12995
ptg000052l	14127386	14137998	10612	g_12995	g_11071
ptg000052l	14140374	14152224	11850	g_11071	g_10918
ptg000052l	14153432	14154733	1301	g_10918	g_19536
ptg000052l	14156528	14158515	1987	g_19536	g_33552
ptg000052l	14164579	14173435	8856	g_33552	g_22572
ptg000052l	14176127	14181330	5203	g_22572	g_32591
ptg000052l	14215194	14226798	11604	g_32591	g_15786
ptg000052l	14242898	14269096	26198	g_15786	g_2581
ptg000052l	14272725	14280348	7623	g_2581	g_21315
ptg000052l	14284826	14285872	1046	g_21315	g_26759
ptg000052l	14287345	14288262	917	g_26759	g_18683
ptg000052l	14294795	14315454	20659	g_18683	g_37163
ptg000052l	14318639	14320243	1604	g_37163	g_482
ptg000052l	14328348	14329298	950	g_482	g_17358
ptg000052l	14336036	14361603	25567	g_17358	g_14494
ptg000052l	14373541	14382308	8767	g_14494	g_20501
ptg000052l	14386375	14430027	43652	g_20501	g_1263
ptg000052l	14446991	14458585	11594	g_1263	g_3445
ptg000052l	14482923	14491928	9005	g_3445	g_9370
ptg000052l	14500914	14523665	22751	g_9370	g_7275
ptg000052l	14529748	14531703	1955	g_7275	g_27659
ptg000052l	14551753	14626487	74734	g_27659	g_17345
ptg000052l	14650779	14674898	24119	g_17345	g_31742
ptg000052l	14685049	14854604	169555	g_31742	g_27587
ptg000052l	14919907	15095165	175258	g_27587	g_2291
ptg000052l	15120311	15131096	10785	g_2291	g_36736
ptg000052l	15140551	15290713	150162	g_36736	g_25760
ptg000052l	15309059	15367372	58313	g_25760	g_35095
ptg000052l	15367998	15672994	304996	g_35095	g_10535
ptg000052l	15701634	15705823	4189	g_10535	g_16705
ptg000052l	15785169	15817333	32164	g_16705	g_2917
ptg000052l	15818316	15956346	138030	g_2917	g_5326
ptg000052l	15956585	15965261	8676	g_5326	g_31556
ptg000052l	15981897	16003140	21243	g_31556	g_33812
ptg000052l	16003784	16034845	31061	g_33812	g_19286
ptg000052l	16035273	16064251	28978	g_19286	g_9840
ptg000052l	16068151	16073480	5329	g_9840	g_13416
ptg000052l	16091612	16092282	670	g_13416	g_38638
ptg000052l	16093642	16094137	495	g_38638	g_5933
ptg000052l	16096685	16098523	1838	g_5933	g_35484
ptg000052l	16110053	16113975	3922	g_35484	g_30223
ptg000052l	16122024	16123841	1817	g_30223	g_1900
ptg000052l	16126302	16133988	7686	g_1900	g_16605
ptg000052l	16137213	16149983	12770	g_16605	g_19258
ptg000052l	16155560	16160078	4518	g_19258	g_23574
ptg000052l	16164516	16198040	33524	g_23574	g_12468
ptg000052l	16201162	16285625	84463	g_12468	g_22706
ptg000052l	16293176	16293884	708	g_22706	g_32617
ptg000052l	16295155	16323791	28636	g_32617	g_37701
ptg000052l	16335618	16353598	17980	g_37701	g_35088
ptg000052l	16356344	16357732	1388	g_35088	g_1428
ptg000052l	16363107	16386682	23575	g_1428	g_18254
ptg000052l	16390815	16402208	11393	g_18254	g_19820
ptg000052l	16413787	16415589	1802	g_19820	g_1363
ptg000052l	16420475	16422445	1970	g_1363	g_28109
ptg000052l	16425777	16427374	1597	g_28109	g_37180
ptg000052l	16428384	16435064	6680	g_37180	g_37810
ptg000052l	16436663	16442161	5498	g_37810	g_23379
ptg000052l	16443204	16481261	38057	g_23379	g_37379
ptg000052l	16481560	16510722	29162	g_37379	g_26668
ptg000052l	16516600	16522876	6276	g_26668	g_5118
ptg000052l	16536407	16551342	14935	g_5118	g_5948
ptg000052l	16552580	16554031	1451	g_5948	g_27700
ptg000052l	16562862	16615736	52874	g_27700	g_33121
ptg000052l	16616638	16649968	33330	g_33121	g_4317
ptg000052l	16652743	16665188	12445	g_4317	g_34442
ptg000052l	16666438	16683782	17344	g_34442	g_18236
ptg000052l	16690255	16695286	5031	g_18236	g_16583
ptg000052l	16714981	16715928	947	g_16583	g_31425
ptg000052l	16719537	16725031	5494	g_31425	g_17090
ptg000052l	16739649	16747029	7380	g_17090	g_11093
ptg000052l	16753415	16828471	75056	g_11093	g_7437
ptg000052l	16829265	16894077	64812	g_7437	g_3103
ptg000052l	16897078	16898299	1221	g_3103	g_4082
ptg000052l	16902751	16906978	4227	g_4082	g_14092
ptg000052l	16908450	16910395	1945	g_14092	g_11959
ptg000052l	16911724	16921898	10174	g_39827	g_16200
ptg000052l	16926481	16982318	55837	g_16200	g_22875
ptg000052l	16992887	16995647	2760	g_22875	g_10155
ptg000052l	16996327	16996987	660	g_10155	g_28852
ptg000052l	17001335	17015391	14056	g_28852	g_11458
ptg000052l	17016537	17017267	730	g_11458	g_16096
ptg000052l	17020189	17029648	9459	g_16096	g_31198
ptg000052l	17039811	17040546	735	g_31198	g_6734
ptg000052l	17042807	17047795	4988	g_6734	g_20818
ptg000052l	17049589	17056758	7169	g_20818	g_17932
ptg000052l	17062022	17066097	4075	g_17932	g_27171
ptg000052l	17070270	17071774	1504	g_27171	g_31859
ptg000052l	17072055	17072979	924	g_31859	g_30231
ptg000052l	17074004	17078253	4249	g_30231	g_35094
ptg000052l	17084476	17091038	6562	g_35094	g_29011
ptg000052l	17100024	17101817	1793	g_29011	g_8353
ptg000052l	17104395	17120359	15964	g_8353	g_30088
ptg000052l	17157876	17172951	15075	g_30088	g_9290
ptg000052l	17179985	17182605	2620	g_9290	g_30385
ptg000052l	17187773	17227619	39846	g_30385	g_31205
ptg000052l	17242059	17244476	2417	g_31205	g_1699
ptg000052l	17252803	17255017	2214	g_1699	g_23346
ptg000052l	17257289	17260441	3152	g_23346	g_16906
ptg000052l	17265690	17268458	2768	g_16906	g_5057
ptg000052l	17277486	17281173	3687	g_5057	g_34551
ptg000052l	17284449	17294487	10038	g_34551	g_22693
ptg000052l	17296575	17298255	1680	g_22693	g_36461
ptg000052l	17313204	17368044	54840	g_36461	g_3624
ptg000052l	17388375	17395816	7441	g_3624	g_25354
ptg000052l	17396976	17399798	2822	g_25354	g_25318
ptg000052l	17401286	17403444	2158	g_25318	g_25714
ptg000052l	17403912	17415154	11242	g_25714	g_33332
ptg000052l	17419615	17424503	4888	g_33332	g_13526
ptg000052l	17425653	17444821	19168	g_13526	g_578
ptg000052l	17445960	17454120	8160	g_578	g_6058
ptg000052l	17454883	17467374	12491	g_6058	g_1053
ptg000052l	17468562	17473654	5092	g_1053	g_1738
ptg000052l	17476028	17477088	1060	g_1738	g_9041
ptg000052l	17479270	17482368	3098	g_9041	g_22873
ptg000052l	17488368	17491746	3378	g_22873	g_12613
ptg000052l	17492231	17496119	3888	g_12613	g_29766
ptg000052l	17499392	17504297	4905	g_29766	g_23236
ptg000052l	17506379	17601234	94855	g_23236	g_3927
ptg000052l	17604249	17617566	13317	g_3927	g_24334
ptg000052l	17621233	17631599	10366	g_24334	g_1017
ptg000052l	17640647	17645873	5226	g_1017	g_27330
ptg000052l	17648845	17650168	1323	g_27330	g_14281
ptg000052l	17656722	17659012	2290	g_14281	g_6483
ptg000052l	17663993	17666978	2985	g_6483	g_25281
ptg000052l	17676063	17699028	22965	g_25281	g_28999
ptg000052l	17712388	17718091	5703	g_28999	g_7839
ptg000052l	17732214	17733225	1011	g_7839	g_37707
ptg000052l	17747919	17778803	30884	g_37707	g_11617
ptg000052l	17807119	17810289	3170	g_11617	g_27747
ptg000052l	17816529	17885448	68919	g_27747	g_7338
ptg000052l	17889215	17892497	3282	g_7338	g_8395
ptg000052l	17899062	17913314	14252	g_8395	g_811
ptg000052l	17913823	18002567	88744	g_811	g_20928
ptg000052l	18006641	18018738	12097	g_20928	g_26256
ptg000052l	18022422	18063017	40595	g_26256	g_11824
ptg000052l	18064267	18082285	18018	g_11824	g_11869
ptg000052l	18082536	18083696	1160	g_11869	g_18846
ptg000052l	18098098	18103741	5643	g_18846	g_8733
ptg000052l	18110059	18112322	2263	g_8733	g_14076
ptg000052l	18121610	18125566	3956	g_14076	g_17047
ptg000052l	18134151	18135144	993	g_17047	g_8694
ptg000052l	18136217	18247429	111212	g_8694	g_15950
ptg000052l	18249625	18253560	3935	g_15950	g_29040
ptg000052l	18258048	18349117	91069	g_29040	g_16441
ptg000052l	18354796	18481531	126735	g_16441	g_23289
ptg000052l	18483111	18533510	50399	g_23289	g_24591
ptg000052l	18533791	18568362	34571	g_24591	g_12647
ptg000052l	18587259	18661843	74584	g_12647	g_31037
ptg000052l	18662058	18665100	3042	g_31037	g_23963
ptg000052l	18666497	18666936	439	g_23963	g_38006
ptg000052l	18667268	18669705	2437	g_38006	g_30956
ptg000052l	18686873	18688226	1353	g_30956	g_8266
ptg000052l	18697244	18699633	2389	g_8266	g_9757
ptg000052l	18717428	18733572	16144	g_9757	g_30802
ptg000052l	18734675	18736074	1399	g_30802	g_5567
ptg000052l	18746376	18746822	446	g_5567	g_33931
ptg000052l	18750091	18751607	1516	g_33931	g_28351
ptg000052l	18761141	18763112	1971	g_28351	g_18781
ptg000052l	18764074	18859364	95290	g_18781	g_4515
ptg000052l	18859699	18891001	31302	g_4515	g_23280
ptg000052l	18892293	18895826	3533	g_23280	g_11788
ptg000052l	18899169	18906590	7421	g_11788	g_32860
ptg000052l	18912041	19059013	146972	g_32860	g_28895
ptg000052l	19065488	19112482	46994	g_28895	g_7623
ptg000052l	19119309	19132982	13673	g_7623	g_1959
ptg000052l	19136219	19217708	81489	g_1959	g_35204
ptg000052l	19225078	19309870	84792	g_35204	g_14478
ptg000052l	19344504	19345245	741	g_14478	g_10567
ptg000052l	19361222	19365612	4390	g_10567	g_21177
ptg000052l	19369244	19430700	61456	g_21177	g_8045
ptg000052l	19451361	19624952	173591	g_8045	g_23839
ptg000052l	19625158	19638693	13535	g_23839	g_3795
ptg000052l	19639958	19642549	2591	g_3795	g_9062
ptg000052l	19643103	19643357	254	g_9062	g_40064
ptg000052l	19647597	19772848	125251	g_40064	g_19467
ptg000052l	19776855	19814801	37946	g_19467	g_12989
ptg000052l	19832426	19833295	869	g_12989	g_11276
ptg000052l	19833579	19971010	137431	g_11276	g_29099
ptg000052l	19976630	19977507	877	g_29099	g_7904
ptg000052l	19984445	19997857	13412	g_7904	g_35138
ptg000052l	19998561	19999013	452	g_35138	g_27812
ptg000052l	20001690	20009046	7356	g_27812	g_15641
ptg000052l	20029731	20134582	104851	g_15641	g_32613
ptg000052l	20142701	20219116	76415	g_32613	g_1649
ptg000052l	20234669	20259640	24971	g_1649	g_31058
ptg000052l	20273734	20277017	3283	g_31058	g_22747
ptg000052l	20291227	20300408	9181	g_22747	g_39969
ptg000052l	20314111	20314135	24	g_39969	g_3653
ptg000052l	20314824	20346878	32054	g_3653	g_3021
ptg000052l	20360938	20368187	7249	g_3021	g_16847
ptg000052l	20378119	20382219	4100	g_16847	g_18624
ptg000052l	20384061	20386556	2495	g_18624	g_18165
ptg000052l	20389792	20430783	40991	g_18165	g_8203
ptg000052l	20431379	20435057	3678	g_8203	g_714
ptg000053l	14223	16146	1923	g_31124	g_37721
ptg000053l	18976	33002	14026	g_37721	g_31004
ptg000053l	38762	55094	16332	g_31004	g_22939
ptg000053l	55765	56151	386	g_22939	g_37554
ptg000053l	56432	68304	11872	g_37554	g_7445
ptg000053l	68753	68808	55	g_7445	g_29927
ptg000053l	69107	69227	120	g_29927	g_2729
ptg000054l	2339	41439	39100	g_21279	g_29373
ptg000054l	43326	123169	79843	g_29373	g_3814
ptg000054l	124998	134759	9761	g_3814	g_32127
ptg000054l	135670	152065	16395	g_32127	g_35444
ptg000054l	152655	176244	23589	g_35444	g_17892
ptg000054l	177503	209138	31635	g_17892	g_3376
ptg000054l	212284	300145	87861	g_3376	g_27665
ptg000054l	308736	321943	13207	g_27665	g_38056
ptg000054l	322989	329552	6563	g_38056	g_38876
ptg000054l	329854	329896	42	g_38876	g_34025
ptg000054l	350150	360263	10113	g_34025	g_7624
ptg000054l	360914	362212	1298	g_7624	g_34862
ptg000054l	362640	370604	7964	g_34862	g_2249
ptg000054l	377087	384924	7837	g_2249	g_1651
ptg000054l	387191	390634	3443	g_1651	g_23147
ptg000054l	392364	398683	6319	g_23147	g_3523
ptg000054l	399009	446403	47394	g_3523	g_21844
ptg000054l	446846	487893	41047	g_21844	g_36979
ptg000054l	490882	525911	35029	g_36979	g_22644
ptg000054l	526201	547401	21200	g_22644	g_11541
ptg000054l	563993	567115	3122	g_11541	g_28995
ptg000054l	568104	718610	150506	g_28995	g_34702
ptg000054l	718915	726892	7977	g_34702	g_18156
ptg000054l	727311	755172	27861	g_18156	g_32478
ptg000054l	755486	787420	31934	g_32478	g_1656
ptg000054l	816810	820568	3758	g_1656	g_12862
ptg000054l	839535	935523	95988	g_12862	g_10482
ptg000054l	955309	997089	41780	g_10482	g_31113
ptg000054l	997451	999667	2216	g_31113	g_26049
ptg000054l	1006951	1217789	210838	g_26049	g_28435
ptg000054l	1217995	1312441	94446	g_28435	g_32553
ptg000054l	1313115	1444792	131677	g_32553	g_32746
ptg000054l	1451290	1478655	27365	g_32746	g_8470
ptg000054l	1483313	1492077	8764	g_8470	g_2044
ptg000054l	1502129	1631670	129541	g_2044	g_18317
ptg000054l	1636013	1642166	6153	g_18317	g_1414
ptg000054l	1649859	1651797	1938	g_1414	g_19198
ptg000054l	1654672	1700102	45430	g_19198	g_26427
ptg000054l	1704546	1706272	1726	g_26427	g_4595
ptg000054l	1711998	1764958	52960	g_4595	g_26336
ptg000054l	1771736	1788863	17127	g_26336	g_200
ptg000054l	1807166	1850683	43517	g_200	g_23665
ptg000054l	1874928	1954583	79655	g_23665	g_20715
ptg000054l	1956193	2047935	91742	g_20715	g_30530
ptg000054l	2048285	2120298	72013	g_30530	g_25415
ptg000054l	2122280	2138285	16005	g_25415	g_30456
ptg000054l	2139560	2229044	89484	g_30456	g_2362
ptg000054l	2230834	2279341	48507	g_2362	g_14624
ptg000055l	440104	494884	54780	g_16713	g_13346
ptg000055l	495573	569121	73548	g_13346	g_21756
ptg000055l	571040	583154	12114	g_21756	g_25182
ptg000055l	583438	590695	7257	g_25182	g_38349
ptg000055l	607242	639880	32638	g_38349	g_21456
ptg000055l	640305	702421	62116	g_21456	g_35260
ptg000055l	703281	830601	127320	g_35260	g_15861
ptg000055l	833809	888120	54311	g_15861	g_17981
ptg000055l	899939	904859	4920	g_17981	g_22198
ptg000055l	910332	933932	23600	g_22198	g_4848
ptg000055l	934483	968360	33877	g_4848	g_31217
ptg000055l	968671	1119046	150375	g_31217	g_23619
ptg000055l	1119444	1133444	14000	g_23619	g_5521
ptg000055l	1133914	1226083	92169	g_5521	g_29482
ptg000055l	1226283	1228046	1763	g_29482	g_15004
ptg000055l	1231097	1249769	18672	g_15004	g_27186
ptg000055l	1250899	1262989	12090	g_27186	g_8653
ptg000055l	1264344	1329277	64933	g_8653	g_12874
ptg000055l	1330125	1379143	49018	g_12874	g_20123
ptg000055l	1382293	1416562	34269	g_20123	g_30987
ptg000055l	1421614	1539327	117713	g_30987	g_1186
ptg000055l	1550786	1624098	73312	g_1186	g_28297
ptg000055l	1624445	1650478	26033	g_28297	g_23806
ptg000055l	1650888	1650952	64	g_23806	g_28363
ptg000055l	1656709	1668532	11823	g_28363	g_28528
ptg000055l	1669125	1710485	41360	g_28528	g_24326
ptg000055l	1711618	1715995	4377	g_24326	g_19192
ptg000055l	1723611	1805319	81708	g_19192	g_17511
ptg000055l	1805780	1805998	218	g_17511	g_29474
ptg000055l	1806432	1806579	147	g_29474	g_21874
ptg000055l	1807040	1807258	218	g_21874	g_7619
ptg000055l	1807635	1807670	35	g_7619	g_36639
ptg000055l	1808101	1808319	218	g_36639	g_29354
ptg000055l	1808576	1858220	49644	g_29354	g_23603
ptg000055l	1858546	1858577	31	g_23603	g_40240
ptg000055l	1858939	1952932	93993	g_40240	g_8890
ptg000055l	1965230	2129058	163828	g_8890	g_12458
ptg000055l	2129576	2157828	28252	g_12458	g_39155
ptg000055l	2159936	2160282	346	g_39155	g_32949
ptg000056l	50072	64531	14459	g_8262	g_10384
ptg000056l	75929	105327	29398	g_10384	g_29544
ptg000056l	112329	145910	33581	g_29544	g_2377
ptg000056l	146284	193766	47482	g_2377	g_11956
ptg000056l	194710	202564	7854	g_11956	g_38996
ptg000056l	203367	215627	12260	g_38996	g_12817
ptg000056l	216571	235415	18844	g_12817	g_29946
ptg000056l	236359	266782	30423	g_29946	g_23440
ptg000056l	267726	275710	7984	g_23440	g_17926
ptg000056l	276654	278803	2149	g_17926	g_27384
ptg000056l	279060	289201	10141	g_27384	g_20026
ptg000056l	290145	316848	26703	g_20026	g_30035
ptg000056l	317792	379250	61458	g_30035	g_31182
ptg000056l	380194	385422	5228	g_31182	g_37950
ptg000056l	385868	385972	104	g_37950	g_955
ptg000056l	386655	406158	19503	g_955	g_23578
ptg000056l	407102	426631	19529	g_23578	g_14155
ptg000056l	427575	430194	2619	g_14155	g_10932
ptg000056l	430484	432018	1534	g_10932	g_17222
ptg000056l	432422	463506	31084	g_17222	g_3455
ptg000056l	464450	466599	2149	g_3455	g_23391
ptg000056l	466856	477039	10183	g_23391	g_35252
ptg000056l	477983	504984	27001	g_35252	g_25464
ptg000056l	505928	514032	8104	g_25464	g_36254
ptg000056l	514499	557076	42577	g_36254	g_36570
ptg000056l	557360	563432	6072	g_36570	g_22628
ptg000056l	564376	598179	33803	g_22628	g_36216
ptg000056l	599123	608084	8961	g_36216	g_21238
ptg000056l	627398	628490	1092	g_21238	g_35313
ptg000056l	651349	655894	4545	g_1298	g_17636
ptg000056l	665110	740437	75327	g_17636	g_37856
ptg000056l	740643	744093	3450	g_37856	g_18799
ptg000056l	769859	792519	22660	g_18799	g_14245
ptg000056l	797643	807419	9776	g_14245	g_27851
ptg000056l	809002	869047	60045	g_27851	g_3168
ptg000056l	869259	920806	51547	g_3168	g_1742
ptg000056l	921033	922617	1584	g_1742	g_13415
ptg000056l	951963	971609	19646	g_13415	g_5484
ptg000056l	972727	1003551	30824	g_5484	g_18189
ptg000056l	1004006	1057099	53093	g_18189	g_34030
ptg000056l	1057893	1058068	175	g_34030	g_26867
ptg000056l	1058409	1063522	5113	g_26867	g_11590
ptg000056l	1063755	1086337	22582	g_11590	g_17052
ptg000056l	1098569	1099303	734	g_17052	g_10329
ptg000056l	1099770	1107177	7407	g_10329	g_22036
ptg000056l	1115637	1143177	27540	g_22036	g_37620
ptg000056l	1144121	1160063	15942	g_37620	g_13598
ptg000056l	1161007	1168264	7257	g_13598	g_22924
ptg000056l	1178117	1237780	59663	g_22924	g_1433
ptg000056l	1238052	1258485	20433	g_1433	g_29214
ptg000056l	1268741	1271427	2686	g_29214	g_15970
ptg000056l	1273661	1290753	17092	g_15970	g_1037
ptg000056l	1291040	1353433	62393	g_1037	g_26130
ptg000056l	1354011	1391657	37646	g_26130	g_39564
ptg000056l	1392634	1410155	17521	g_39564	g_35049
ptg000056l	1415152	1422651	7499	g_35049	g_22068
ptg000056l	1423364	1423406	42	g_22068	g_18259
ptg000056l	1424014	1450961	26947	g_18259	g_3809
ptg000058l	30551	31477	926	g_11951	g_39630
ptg000058l	32141	64387	32246	g_39630	g_3470
ptg000058l	79521	123018	43497	g_3470	g_34230
ptg000058l	124037	183805	59768	g_34230	g_23890
ptg000058l	187341	190532	3191	g_23890	g_37482
ptg000058l	191101	199914	8813	g_37482	g_32538
ptg000058l	200483	207601	7118	g_32538	g_20030
ptg000058l	225172	240155	14983	g_20030	g_9367
ptg000059l	8254	16931	8677	g_5245	g_33954
ptg000059l	17155	26397	9242	g_33954	g_7860
ptg000059l	27515	34289	6774	g_7860	g_17659
ptg000059l	34939	130811	95872	g_17659	g_29143
ptg000059l	131689	147157	15468	g_29143	g_7013
ptg000059l	147771	187705	39934	g_7013	g_12317
ptg000059l	188235	225182	36947	g_12317	g_10799
ptg000059l	225397	255873	30476	g_10799	g_8793
ptg000059l	256895	277701	20806	g_8793	g_4427
ptg000059l	278168	299472	21304	g_4427	g_15534
ptg000059l	299867	299966	99	g_15534	g_14349
ptg000059l	300355	317484	17129	g_14349	g_20971
ptg000059l	327434	430496	103062	g_20971	g_36467
ptg000059l	440446	500597	60151	g_36467	g_12194
ptg000059l	502658	559010	56352	g_12194	g_14502
ptg000059l	559225	581006	21781	g_14502	g_1493
ptg000059l	581395	638547	57152	g_1493	g_34084
ptg000059l	638762	650769	12007	g_34084	g_30528
ptg000059l	651041	651645	604	g_30528	g_17278
ptg000059l	653183	775708	122525	g_17278	g_37960
ptg000059l	775959	778339	2380	g_37960	g_16783
ptg000059l	778899	787530	8631	g_16783	g_22847
ptg000059l	788690	872933	84243	g_22847	g_36632
ptg000059l	873190	907836	34646	g_36632	g_4452
ptg000059l	908681	1167411	258730	g_4452	g_12816
ptg000059l	1168163	1170236	2073	g_12816	g_4849
ptg000059l	1170778	1170923	145	g_4849	g_35966
ptg000059l	1171267	1192035	20768	g_35966	g_13556
ptg000059l	1192661	1208456	15795	g_13556	g_38049
ptg000059l	1208845	1242112	33267	g_38049	g_37798
ptg000059l	1242864	1253201	10337	g_37798	g_16273
ptg000059l	1253590	1396505	142915	g_16273	g_8067
ptg000059l	1397155	1397835	680	g_8067	g_26112
ptg000059l	1398230	1441124	42894	g_26112	g_32661
ptg000059l	1456208	1456946	738	g_32661	g_5703
ptg000059l	1457902	1459618	1716	g_5703	g_24633
ptg000059l	1473518	1474019	501	g_24633	g_21284
ptg000059l	1487154	1490286	3132	g_21284	g_34961
ptg000059l	1498317	1500243	1926	g_34961	g_11138
ptg000059l	1513686	1519747	6061	g_11138	g_37814
ptg000059l	1550505	1562931	12426	g_37814	g_24327
ptg000059l	1563554	1578864	15310	g_24327	g_685
ptg000059l	1596381	1644993	48612	g_685	g_23021
ptg000059l	1655471	1760319	104848	g_23021	g_6715
ptg000059l	1763988	1816054	52066	g_6715	g_10881
ptg000059l	1819135	1898108	78973	g_10881	g_26319
ptg000059l	1900724	2085189	184465	g_26319	g_34461
ptg000059l	2089324	2160401	71077	g_34461	g_1492
ptg000059l	2164493	2278309	113816	g_1492	g_32456
ptg000059l	2279559	2285124	5565	g_32456	g_17696
ptg000059l	2285942	2353221	67279	g_17696	g_14903
ptg000060l	57785	100044	42259	g_21083	g_28196
ptg000060l	104101	114673	10572	g_28196	g_37472
ptg000060l	131774	194917	63143	g_37472	g_16222
ptg000060l	196275	231535	35260	g_16222	g_18454
ptg000060l	240563	241263	700	g_18454	g_16416
ptg000060l	243265	260156	16891	g_16416	g_5167
ptg000060l	261454	333044	71590	g_5167	g_22757
ptg000060l	337119	426707	89588	g_22757	g_17782
ptg000060l	439288	462234	22946	g_17782	g_7888
ptg000060l	462827	472200	9373	g_7888	g_32855
ptg000060l	482120	482545	425	g_32855	g_11316
ptg000060l	494046	503752	9706	g_11316	g_25612
ptg000061l	97033	131270	34237	g_25937	g_2741
ptg000061l	138873	143525	4652	g_2741	g_28282
ptg000061l	143728	144790	1062	g_28282	g_30778
ptg000061l	156427	172618	16191	g_30778	g_10416
ptg000061l	187792	360713	172921	g_10416	g_18303
ptg000061l	361048	399178	38130	g_18303	g_24924
ptg000061l	399513	410476	10963	g_24924	g_7810
ptg000061l	410733	501730	90997	g_7810	g_13701
ptg000061l	502029	509432	7403	g_13701	g_2780
ptg000061l	517437	519944	2507	g_2780	g_16055
ptg000061l	523185	533534	10349	g_16055	g_12119
ptg000061l	538985	560194	21209	g_12119	g_20469
ptg000061l	582369	602808	20439	g_20469	g_12539
ptg000061l	605950	615981	10031	g_12539	g_27602
ptg000061l	616880	637693	20813	g_27602	g_6468
ptg000061l	643132	659441	16309	g_6468	g_35968
ptg000061l	684485	688812	4327	g_35968	g_1391
ptg000061l	693620	903998	210378	g_1391	g_30878
ptg000061l	904393	987812	83419	g_30878	g_31717
ptg000061l	988801	992935	4134	g_31717	g_11035
ptg000061l	993216	1051327	58111	g_11035	g_15656
ptg000061l	1052382	1062787	10405	g_15656	g_32709
ptg000061l	1081853	1183021	101168	g_32709	g_12957
ptg000061l	1184766	1184989	223	g_12957	g_40119
ptg000061l	1185442	1191595	6153	g_40119	g_7216
ptg000061l	1193507	1203846	10339	g_7216	g_30754
ptg000061l	1205759	1228814	23055	g_30754	g_30480
ptg000061l	1243271	1284979	41708	g_30480	g_14418
ptg000061l	1301479	1324900	23421	g_14418	g_37666
ptg000061l	1328294	1391342	63048	g_37666	g_4229
ptg000061l	1391554	1483341	91787	g_4229	g_28140
ptg000061l	1483958	1597620	113662	g_28140	g_26272
ptg000061l	1598066	1626683	28617	g_26272	g_22935
ptg000061l	1628065	1675448	47383	g_22935	g_20198
ptg000061l	1675816	1683846	8030	g_20198	g_34900
ptg000061l	1684118	1702801	18683	g_34900	g_29223
ptg000061l	1703217	1772755	69538	g_29223	g_26703
ptg000061l	1773231	1954922	181691	g_26703	g_28987
ptg000061l	1955140	1956465	1325	g_28987	g_20298
ptg000061l	1957046	1957737	691	g_20298	g_40075
ptg000061l	1958399	1959593	1194	g_40075	g_16877
ptg000061l	1959949	1960078	129	g_16877	g_19006
ptg000061l	1960374	1960413	39	g_19006	g_13536
ptg000061l	1961348	1961514	166	g_13536	g_5601
ptg000061l	1962599	1962909	310	g_5601	g_9758
ptg000061l	1964171	1972950	8779	g_9758	g_29655
ptg000061l	1973579	1981526	7947	g_29655	g_7317
ptg000061l	2006609	2007556	947	g_7317	g_8505
ptg000061l	2007837	2046168	38331	g_8505	g_6170
ptg000061l	2059721	2063138	3417	g_6170	g_24360
ptg000061l	2063593	2161934	98341	g_24360	g_4043
ptg000061l	2167459	2255802	88343	g_4043	g_35938
ptg000061l	2267081	2299239	32158	g_35938	g_26425
ptg000061l	2302555	2322975	20420	g_26425	g_14231
ptg000061l	2328299	2330428	2129	g_14231	g_36891
ptg000061l	2333770	2347123	13353	g_36891	g_14979
ptg000061l	2359192	2370499	11307	g_14979	g_37182
ptg000061l	2374823	2377575	2752	g_37182	g_9868
ptg000061l	2381381	2382561	1180	g_9868	g_19161
ptg000061l	2383052	2422287	39235	g_19161	g_9875
ptg000061l	2422643	2511962	89319	g_9875	g_31386
ptg000061l	2512255	2547075	34820	g_31386	g_16481
ptg000061l	2548676	2551667	2991	g_16481	g_2998
ptg000061l	2556683	2583962	27279	g_2998	g_6188
ptg000061l	2602809	2603003	194	g_6188	g_13571
ptg000061l	2603905	2650110	46205	g_13571	g_3745
ptg000061l	2662502	2672657	10155	g_3745	g_25599
ptg000061l	2693103	2700961	7858	g_25599	g_5512
ptg000061l	2701170	2704863	3693	g_5512	g_13180
ptg000061l	2716606	2761961	45355	g_13180	g_15001
ptg000061l	2762956	2787449	24493	g_15001	g_24845
ptg000061l	2788745	2794112	5367	g_24845	g_8052
ptg000061l	2794726	2814475	19749	g_8052	g_31304
ptg000061l	2822022	2860707	38685	g_31304	g_32499
ptg000061l	2866741	2869591	2850	g_32499	g_25082
ptg000061l	2871319	2891674	20355	g_25082	g_31531
ptg000061l	2900366	2904479	4113	g_31531	g_23096
ptg000061l	2910153	2910398	245	g_23096	g_19252
ptg000061l	2929619	2934695	5076	g_19252	g_2427
ptg000061l	2944848	2951235	6387	g_2427	g_17311
ptg000061l	2960431	2965373	4942	g_17311	g_19239
ptg000061l	2965993	2970210	4217	g_19239	g_25954
ptg000061l	2971136	2979222	8086	g_25954	g_24818
ptg000061l	2979635	2991785	12150	g_24818	g_35907
ptg000061l	2992009	3194995	202986	g_35907	g_18730
ptg000061l	3207506	3342189	134683	g_18730	g_15723
ptg000061l	3342407	3345507	3100	g_15723	g_13181
ptg000061l	3346849	3376248	29399	g_13181	g_30453
ptg000061l	3378496	3403539	25043	g_30453	g_37844
ptg000061l	3403793	3421911	18118	g_37844	g_5020
ptg000062l	24521	36502	11981	g_5010	g_31912
ptg000062l	37374	50776	13402	g_31912	g_22741
ptg000062l	51420	109301	57881	g_22741	g_29527
ptg000062l	128250	179535	51285	g_29527	g_17029
ptg000062l	180554	185390	4836	g_17029	g_8515
ptg000062l	186919	194216	7297	g_8515	g_22177
ptg000062l	194587	240895	46308	g_22177	g_31726
ptg000063l	23236	25659	2423	g_27195	g_34820
ptg000063l	31056	32601	1545	g_34820	g_4278
ptg000063l	37188	82852	45664	g_4278	g_12470
ptg000063l	83131	85520	2389	g_12470	g_30825
ptg000063l	87274	93112	5838	g_30825	g_19477
ptg000063l	115720	119221	3501	g_19477	g_3994
ptg000063l	135938	189873	53935	g_3994	g_4318
ptg000063l	190361	256448	66087	g_4318	g_24782
ptg000063l	275316	327610	52294	g_24782	g_8123
ptg000063l	342290	425121	82831	g_8123	g_33226
ptg000063l	427607	548218	120611	g_33226	g_37113
ptg000063l	548985	571987	23002	g_37113	g_19610
ptg000063l	575407	623006	47599	g_19610	g_28837
ptg000063l	623257	697230	73973	g_28837	g_29196
ptg000063l	704264	707227	2963	g_29196	g_31019
ptg000063l	722334	854523	132189	g_31019	g_26895
ptg000063l	855218	919370	64152	g_26895	g_18337
ptg000063l	919639	1035489	115850	g_18337	g_23151
ptg000063l	1036457	1036503	46	g_23151	g_27673
ptg000063l	1037063	1112054	74991	g_27673	g_228
ptg000063l	1113975	1244963	130988	g_228	g_23676
ptg000063l	1245262	1352589	107327	g_23676	g_8463
ptg000063l	1373574	1422941	49367	g_8463	g_20510
ptg000063l	1423177	1479473	56296	g_20510	g_13854
ptg000063l	1479691	1600351	120660	g_13854	g_11270
ptg000063l	1601880	1700889	99009	g_11270	g_265
ptg000063l	1702700	1702779	79	g_265	g_39902
ptg000063l	1703438	1731468	28030	g_39902	g_19368
ptg000063l	1747948	1759370	11422	g_19368	g_3313
ptg000063l	1760584	1777518	16934	g_3313	g_15326
ptg000063l	1780736	1826997	46261	g_15326	g_14438
ptg000063l	1827518	1844280	16762	g_14438	g_38700
ptg000063l	1844819	1844865	46	g_38700	g_23880
ptg000063l	1845185	1911799	66614	g_23880	g_10715
ptg000063l	1912032	1912146	114	g_10715	g_12116
ptg000063l	1912616	1913075	459	g_12116	g_734
ptg000063l	1919088	1923899	4811	g_734	g_5996
ptg000063l	1928221	1939642	11421	g_5996	g_2861
ptg000063l	1948154	1990812	42658	g_2861	g_29710
ptg000063l	1991051	2016639	25588	g_29710	g_4623
ptg000063l	2016878	2038846	21968	g_4623	g_23917
ptg000063l	2039085	2106141	67056	g_23917	g_19770
ptg000063l	2106437	2120477	14040	g_19770	g_32767
ptg000063l	2128282	2133389	5107	g_32767	g_7138
ptg000063l	2138823	2181641	42818	g_7138	g_20880
ptg000063l	2183077	2195510	12433	g_20880	g_37917
ptg000063l	2201220	2202499	1279	g_37917	g_22576
ptg000064l	16911	19376	2465	g_14717	g_18951
ptg000064l	32646	32882	236	g_18951	g_4821
ptg000064l	33274	33770	496	g_4821	g_7365
ptg000064l	34603	38778	4175	g_7365	g_4911
ptg000064l	47696	267666	219970	g_4911	g_31566
ptg000064l	286309	358188	71879	g_31566	g_3852
ptg000064l	377410	508629	131219	g_3852	g_12595
ptg000064l	513079	519763	6684	g_12595	g_17925
ptg000064l	523387	580677	57290	g_17925	g_23164
ptg000064l	587205	606673	19468	g_23164	g_18969
ptg000064l	628148	648899	20751	g_18969	g_3816
ptg000064l	649201	798745	149544	g_3816	g_36649
ptg000064l	799098	804820	5722	g_36649	g_17273
ptg000064l	805209	1053686	248477	g_17273	g_10169
ptg000064l	1054768	1140635	85867	g_10169	g_9972
ptg000064l	1143835	1168172	24337	g_9972	g_24193
ptg000064l	1169857	1197934	28077	g_24193	g_25724
ptg000064l	1198323	1223612	25289	g_25724	g_25112
ptg000064l	1224265	1242858	18593	g_25112	g_20938
ptg000064l	1243193	1247063	3870	g_20938	g_19318
ptg000064l	1247632	1264804	17172	g_19318	g_12544
ptg000064l	1265349	1270311	4962	g_12544	g_27468
ptg000064l	1271672	1298142	26470	g_27468	g_6505
ptg000064l	1299128	1340906	41778	g_6505	g_26482
ptg000064l	1342144	1721210	379066	g_26482	g_17328
ptg000064l	1721989	1781688	59699	g_17328	g_25670
ptg000065l	475978	509552	33574	g_9344	g_13543
ptg000065l	510343	610573	100230	g_13543	g_2691
ptg000065l	610860	633645	22785	g_2691	g_25870
ptg000065l	634727	655110	20383	g_25870	g_35941
ptg000065l	655613	710113	54500	g_35941	g_4596
ptg000065l	710364	807815	97451	g_4596	g_19440
ptg000065l	808075	855229	47154	g_19440	g_8307
ptg000065l	855777	855806	29	g_8307	g_3646
ptg000065l	856738	856767	29	g_3646	g_23077
ptg000065l	857684	891618	33934	g_23077	g_21448
ptg000065l	892208	976575	84367	g_21448	g_13280
ptg000065l	976940	1011911	34971	g_13280	g_1972
ptg000065l	1012342	1147409	135067	g_1972	g_36973
ptg000065l	1150681	1152678	1997	g_36973	g_34253
ptg000065l	1153601	1159798	6197	g_34253	g_19604
ptg000065l	1159998	1203113	43115	g_19604	g_983
ptg000065l	1204937	1238081	33144	g_983	g_19858
ptg000065l	1243591	1250770	7179	g_19858	g_121
ptg000065l	1251816	1254703	2887	g_121	g_13691
ptg000065l	1263331	1266065	2734	g_13691	g_25711
ptg000065l	1279777	1281685	1908	g_25711	g_31878
ptg000065l	1283435	1320591	37156	g_31878	g_23427
ptg000065l	1330851	1338668	7817	g_23427	g_3522
ptg000065l	1346260	1413926	67666	g_3522	g_4254
ptg000065l	1436935	1475960	39025	g_4254	g_35891
ptg000065l	1495138	1499592	4454	g_35891	g_27011
ptg000065l	1499840	1517066	17226	g_27011	g_3610
ptg000065l	1520825	1526746	5921	g_3610	g_20646
ptg000065l	1534551	1625171	90620	g_20646	g_5017
ptg000065l	1625491	1628504	3013	g_5017	g_19619
ptg000065l	1646432	1668066	21634	g_19619	g_18320
ptg000065l	1668497	1673485	4988	g_18320	g_26572
ptg000065l	1684964	1722777	37813	g_26572	g_5445
ptg000065l	1731883	1738664	6781	g_5445	g_5208
ptg000065l	1764384	1766177	1793	g_5208	g_26742
ptg000065l	1772911	1776446	3535	g_26742	g_11552
ptg000065l	1776859	1784627	7768	g_11552	g_1257
ptg000065l	1800802	1806493	5691	g_1257	g_22516
ptg000065l	1808641	1808702	61	g_38835	g_39222
ptg000065l	1809907	1834302	24395	g_39222	g_23459
ptg000065l	1834772	1865833	31061	g_23459	g_885
ptg000065l	1880430	1907047	26617	g_885	g_33718
ptg000065l	1919807	1924150	4343	g_33718	g_26675
ptg000065l	1935834	1987259	51425	g_26675	g_19533
ptg000065l	1988192	2015749	27557	g_13654	g_6673
ptg000065l	2016000	2025533	9533	g_6673	g_25600
ptg000065l	2088915	2243631	154716	g_25600	g_31024
ptg000065l	2243924	2258663	14739	g_31024	g_8277
ptg000065l	2262654	2396855	134201	g_8277	g_13664
ptg000065l	2397154	2402271	5117	g_13664	g_30652
ptg000065l	2411302	2429534	18232	g_30652	g_31924
ptg000065l	2456284	2457797	1513	g_31924	g_25735
ptg000065l	2471399	2473013	1614	g_25735	g_39683
ptg000065l	2473456	2480052	6596	g_39683	g_37002
ptg000065l	2484154	2527661	43507	g_37002	g_8030
ptg000065l	2531914	2565043	33129	g_8030	g_30081
ptg000065l	2576301	2621469	45168	g_30081	g_5598
ptg000065l	2622443	2628313	5870	g_5598	g_21522
ptg000065l	2628594	2693881	65287	g_21522	g_21650
ptg000065l	2694141	2735911	41770	g_21650	g_27985
ptg000065l	2736300	2736778	478	g_27985	g_11997
ptg000065l	2738262	2759224	20962	g_11997	g_15030
ptg000065l	2769075	2771085	2010	g_15030	g_37609
ptg000065l	2779347	2780127	780	g_37609	g_1412
ptg000065l	2787081	2818059	30978	g_1412	g_31406
ptg000065l	2818955	2819937	982	g_31406	g_9740
ptg000065l	2832124	2835396	3272	g_9740	g_7915
ptg000065l	2845027	2866991	21964	g_7915	g_23577
ptg000065l	2870408	2961511	91103	g_23577	g_10556
ptg000065l	2962953	2990386	27433	g_10556	g_40065
ptg000065l	3003516	3005455	1939	g_40065	g_9097
ptg000065l	3005808	3030657	24849	g_9097	g_14449
ptg000065l	3030998	3097735	66737	g_14449	g_7284
ptg000065l	3104719	3114754	10035	g_7284	g_7896
ptg000065l	3115776	3119689	3913	g_7896	g_8517
ptg000065l	3142459	3266499	124040	g_8517	g_14713
ptg000065l	3282535	3298425	15890	g_14713	g_18733
ptg000065l	3299084	3391299	92215	g_18733	g_11987
ptg000065l	3393961	3401788	7827	g_11987	g_5564
ptg000065l	3403311	3554501	151190	g_5564	g_641
ptg000065l	3554974	3621032	66058	g_641	g_2176
ptg000065l	3621607	3621725	118	g_2176	g_36230
ptg000065l	3622027	3640523	18496	g_36230	g_29459
ptg000065l	3649468	3765424	115956	g_29459	g_8265
ptg000065l	3780977	3786697	5720	g_8265	g_19748
ptg000065l	3787569	3815013	27444	g_19748	g_30669
ptg000065l	3821589	3876325	54736	g_30669	g_9941
ptg000065l	3877698	3882475	4777	g_9941	g_32778
ptg000065l	3895867	3920283	24416	g_32778	g_27925
ptg000065l	3929293	3947442	18149	g_27925	g_29966
ptg000065l	3947816	3948559	743	g_29966	g_14129
ptg000065l	3948783	3999129	50346	g_14129	g_30641
ptg000065l	3999368	4295677	296309	g_30641	g_14756
ptg000065l	4297789	4299210	1421	g_14756	g_32085
ptg000065l	4299881	4302357	2476	g_32085	g_1070
ptg000065l	4302992	4305269	2277	g_1070	g_35744
ptg000065l	4305931	4310475	4544	g_35744	g_12364
ptg000065l	4311107	4312738	1631	g_12364	g_25162
ptg000065l	4313481	4317073	3592	g_25162	g_37266
ptg000065l	4317708	4319445	1737	g_37266	g_30485
ptg000065l	4320068	4329803	9735	g_30485	g_10097
ptg000065l	4330462	4336061	5599	g_10097	g_825
ptg000065l	4336717	4338817	2100	g_825	g_34262
ptg000065l	4339464	4397241	57777	g_34262	g_3555
ptg000065l	4405436	4408369	2933	g_3555	g_7874
ptg000065l	4414288	4462701	48413	g_7874	g_28246
ptg000065l	4474211	4488967	14756	g_28246	g_10814
ptg000065l	4491082	4503355	12273	g_10814	g_20503
ptg000065l	4506278	4508347	2069	g_20503	g_33536
ptg000065l	4521768	4561436	39668	g_33536	g_8916
ptg000065l	4617514	4735368	117854	g_8916	g_4971
ptg000065l	4736103	4760504	24401	g_4971	g_32401
ptg000065l	4760881	4793976	33095	g_32401	g_2155
ptg000065l	4798849	4818177	19328	g_2155	g_11346
ptg000065l	4831424	4851365	19941	g_11346	g_22434
ptg000065l	4854599	4876536	21937	g_22434	g_36132
ptg000065l	4885088	4929110	44022	g_36132	g_29081
ptg000065l	4941105	4962266	21161	g_29081	g_2812
ptg000065l	4968763	4975236	6473	g_2812	g_33680
ptg000065l	4990722	4991116	394	g_33680	g_20322
ptg000065l	4991715	5086013	94298	g_20322	g_11625
ptg000065l	5103090	5183806	80716	g_11625	g_7446
ptg000065l	5199007	5210085	11078	g_7446	g_7096
ptg000065l	5216050	5284474	68424	g_7096	g_21
ptg000065l	5286454	5517351	230897	g_21	g_27765
ptg000065l	5518859	5586978	68119	g_27765	g_30307
ptg000065l	5588275	5636434	48159	g_30307	g_36361
ptg000065l	5636784	5703832	67048	g_36361	g_35980
ptg000065l	5707128	5824365	117237	g_35980	g_17649
ptg000065l	5825315	5852561	27246	g_17649	g_83
ptg000065l	5870881	5883322	12441	g_83	g_18859
ptg000065l	5892102	5895930	3828	g_18859	g_35359
ptg000065l	5897030	6039905	142875	g_35359	g_15303
ptg000065l	6040465	6103215	62750	g_15303	g_22156
ptg000065l	6106805	6109160	2355	g_22156	g_11536
ptg000065l	6127649	6165158	37509	g_11536	g_11244
ptg000065l	6165670	6170993	5323	g_11244	g_25894
ptg000065l	6171946	6243748	71802	g_25894	g_2229
ptg000065l	6244719	6282160	37441	g_2229	g_5725
ptg000065l	6294303	6557770	263467	g_5725	g_15164
ptg000065l	6558036	6692534	134498	g_15164	g_12716
ptg000065l	6786601	6814031	27430	g_12716	g_3781
ptg000065l	6815119	6821731	6612	g_3781	g_21096
ptg000065l	6837053	6856174	19121	g_21096	g_22821
ptg000065l	6860617	6900221	39604	g_22821	g_20372
ptg000065l	6900562	7001532	100970	g_20372	g_23843
ptg000065l	7016340	7038311	21971	g_23843	g_32446
ptg000065l	7042260	7046742	4482	g_32446	g_33938
ptg000065l	7051444	7135236	83792	g_33938	g_15072
ptg000065l	7135586	7371430	235844	g_15072	g_3049
ptg000065l	7371711	7426452	54741	g_3049	g_8939
ptg000065l	7433152	7453443	20291	g_8939	g_9117
ptg000065l	7454126	7656160	202034	g_9117	g_8289
ptg000065l	7656402	7669364	12962	g_8289	g_6030
ptg000065l	7685655	8003769	318114	g_6030	g_34975
ptg000065l	8011277	8036011	24734	g_34975	g_717
ptg000065l	8050639	8139981	89342	g_717	g_14291
ptg000065l	8150722	8167672	16950	g_14291	g_21677
ptg000065l	8168748	8183508	14760	g_21677	g_29345
ptg000065l	8196646	8202098	5452	g_29345	g_33708
ptg000065l	8205495	8286127	80632	g_33708	g_2802
ptg000065l	8287367	8328824	41457	g_2802	g_11567
ptg000065l	8337294	8359523	22229	g_11567	g_10467
ptg000065l	8367594	8375419	7825	g_10467	g_27864
ptg000065l	8377008	8422559	45551	g_27864	g_14830
ptg000065l	8435861	8454569	18708	g_14830	g_32048
ptg000065l	8465282	8471637	6355	g_32048	g_29464
ptg000065l	8494761	8549856	55095	g_29464	g_15976
ptg000065l	8557540	8575099	17559	g_15976	g_3657
ptg000065l	8576558	8582789	6231	g_3657	g_38848
ptg000065l	8583067	8586304	3237	g_38848	g_6426
ptg000066l	38171	48200	10029	g_34584	g_32842
ptg000067l	58768	99510	40742	g_32842	g_31262
ptg000067l	104801	119270	14469	g_31262	g_34544
ptg000067l	120395	137132	16737	g_34544	g_30186
ptg000067l	142336	151187	8851	g_30186	g_20216
ptg000067l	159366	162863	3497	g_20216	g_28464
ptg000067l	179460	207472	28012	g_28464	g_22527
ptg000067l	207891	207921	30	g_22527	g_34833
ptg000067l	208901	241051	32150	g_34833	g_14711
ptg000067l	254186	285380	31194	g_14711	g_9293
ptg000067l	285898	297066	11168	g_9293	g_25838
ptg000067l	303644	343836	40192	g_25838	g_7516
ptg000067l	345602	375084	29482	g_7516	g_336
ptg000067l	379315	387731	8416	g_336	g_6919
ptg000067l	389367	428601	39234	g_6919	g_26435
ptg000067l	430945	454363	23418	g_26435	g_22095
ptg000067l	464949	465451	502	g_22095	g_27399
ptg000067l	471560	474817	3257	g_27399	g_7866
ptg000067l	494914	620550	125636	g_7866	g_12011
ptg000067l	620939	621280	341	g_12011	g_8789
ptg000067l	621885	621947	62	g_8789	g_32286
ptg000067l	622438	622779	341	g_32286	g_5376
ptg000067l	623510	623550	40	g_5376	g_28212
ptg000067l	624119	637931	13812	g_28212	g_18985
ptg000067l	655405	660248	4843	g_18985	g_24390
ptg000067l	681386	690640	9254	g_24390	g_23660
ptg000067l	700090	721905	21815	g_23660	g_5586
ptg000067l	724607	729079	4472	g_5586	g_8379
ptg000067l	736992	767317	30325	g_8379	g_28956
ptg000067l	789265	852674	63409	g_28956	g_37422
ptg000067l	857944	916408	58464	g_37422	g_2210
ptg000067l	916749	918330	1581	g_2210	g_4679
ptg000067l	921791	944657	22866	g_4679	g_17749
ptg000067l	964719	990757	26038	g_17749	g_18832
ptg000067l	992940	1010334	17394	g_18832	g_9471
ptg000067l	1010639	1011436	797	g_9471	g_10067
ptg000067l	1012419	1014215	1796	g_10067	g_13050
ptg000067l	1016802	1016846	44	g_13050	g_1508
ptg000067l	1017160	1039324	22164	g_1508	g_11524
ptg000067l	1040257	1052733	12476	g_11524	g_75
ptg000067l	1058237	1059899	1662	g_75	g_3191
ptg000067l	1060597	1065552	4955	g_3191	g_30359
ptg000067l	1073375	1086561	13186	g_30359	g_19215
ptg000067l	1091589	1154708	63119	g_19215	g_13920
ptg000067l	1157552	1185022	27470	g_13920	g_7130
ptg000067l	1209041	1257030	47989	g_7130	g_10760
ptg000067l	1279069	1284909	5840	g_10760	g_36563
ptg000067l	1289783	1327683	37900	g_36563	g_17868
ptg000067l	1328711	1340436	11725	g_17868	g_24834
ptg000067l	1340819	1374292	33473	g_24834	g_32057
ptg000067l	1374642	1375084	442	g_32057	g_34161
ptg000067l	1382710	1403161	20451	g_34161	g_21024
ptg000067l	1405727	1577162	171435	g_21024	g_9713
ptg000067l	1577995	1613476	35481	g_9713	g_13629
ptg000067l	1623123	1623754	631	g_13629	g_2680
ptg000067l	1623987	1625604	1617	g_2680	g_18069
ptg000067l	1625804	1626097	293	g_18069	g_18269
ptg000067l	1626855	1628653	1798	g_18269	g_7325
ptg000067l	1628916	1628934	18	g_7325	g_31345
ptg000067l	1637688	1639155	1467	g_31345	g_1521
ptg000067l	1644214	1646717	2503	g_1521	g_6316
ptg000067l	1652005	1710480	58475	g_6316	g_13483
ptg000067l	1720108	1750843	30735	g_13483	g_21682
ptg000067l	1767277	1840836	73559	g_21682	g_36297
ptg000067l	1859437	1908631	49194	g_36297	g_30627
ptg000067l	1909374	1910219	845	g_30627	g_37013
ptg000067l	1910710	1923108	12398	g_37013	g_6185
ptg000067l	1923443	1924038	595	g_6185	g_1995
ptg000067l	1924253	1925059	806	g_1995	g_16815
ptg000067l	1933475	1949958	16483	g_16815	g_21553
ptg000067l	1950683	1958916	8233	g_21553	g_4842
ptg000067l	1972024	2108276	136252	g_4842	g_19984
ptg000067l	2109310	2128041	18731	g_19984	g_33321
ptg000067l	2128529	2128554	25	g_33321	g_24841
ptg000067l	2129435	2151647	22212	g_24841	g_12661
ptg000067l	2153062	2177740	24678	g_12661	g_37978
ptg000067l	2178297	2179501	1204	g_37978	g_31867
ptg000067l	2180514	2180794	280	g_31867	g_34687
ptg000067l	2181150	2186540	5390	g_34687	g_13175
ptg000067l	2186854	2192980	6126	g_13175	g_21379
ptg000067l	2194563	2202939	8376	g_21379	g_2120
ptg000067l	2203649	2203795	146	g_2120	g_34553
ptg000067l	2204313	2204697	384	g_34553	g_12168
ptg000067l	2205311	2210086	4775	g_12168	g_31833
ptg000067l	2216481	2233190	16709	g_31833	g_80
ptg000067l	2233537	2395879	162342	g_80	g_7416
ptg000067l	2414690	2433081	18391	g_7416	g_18109
ptg000067l	2434826	2435472	646	g_18109	g_24885
ptg000067l	2435693	2485020	49327	g_24885	g_24522
ptg000067l	2485826	2500882	15056	g_24522	g_20228
ptg000067l	2510904	2528438	17534	g_20228	g_8373
ptg000067l	2537469	2558385	20916	g_8373	g_18100
ptg000067l	2558936	2596655	37719	g_18100	g_17246
ptg000067l	2596948	2597584	636	g_17246	g_21394
ptg000067l	2598189	2661638	63449	g_21394	g_21436
ptg000067l	2666695	2737565	70870	g_21436	g_32301
ptg000067l	2742820	2742857	37	g_32301	g_6671
ptg000067l	2747788	2747825	37	g_6671	g_36945
ptg000067l	2749897	2750308	411	g_36945	g_17295
ptg000067l	2763560	2809186	45626	g_17295	g_9391
ptg000067l	2809572	2811681	2109	g_9391	g_13615
ptg000067l	2835001	2858803	23802	g_13615	g_33821
ptg000067l	2860124	2860890	766	g_33821	g_15106
ptg000067l	2895616	2899071	3455	g_15106	g_1944
ptg000067l	2899430	2962405	62975	g_1944	g_28701
ptg000067l	2963430	3006477	43047	g_28701	g_937
ptg000067l	3007217	3007694	477	g_937	g_21552
ptg000067l	3008071	3013980	5909	g_21552	g_36536
ptg000067l	3014234	3101355	87121	g_36536	g_36808
ptg000067l	3101813	3126489	24676	g_36808	g_36134
ptg000067l	3126890	3127035	145	g_36134	g_32992
ptg000067l	3127502	3140082	12580	g_32992	g_37252
ptg000069l	18344	90621	72277	g_15784	g_38324
ptg000069l	101587	163348	61761	g_38324	g_12558
ptg000069l	165276	166544	1268	g_12558	g_40098
ptg000069l	166957	169144	2187	g_40098	g_11487
ptg000069l	187360	193226	5866	g_11487	g_28280
ptg000069l	206914	258455	51541	g_28280	g_23068
ptg000069l	258931	290793	31862	g_23068	g_7596
ptg000069l	305139	306030	891	g_7596	g_31837
ptg000069l	306263	306399	136	g_31837	g_5630
ptg000069l	306632	306925	293	g_5630	g_26228
ptg000069l	307527	307581	54	g_26228	g_10280
ptg000069l	308111	328366	20255	g_10280	g_98
ptg000069l	337687	361559	23872	g_98	g_6104
ptg000069l	362008	362051	43	g_6104	g_32512
ptg000069l	362551	363163	612	g_32512	g_32957
ptg000069l	364248	366982	2734	g_32957	g_36537
ptg000069l	367188	401449	34261	g_36537	g_37254
ptg000069l	411076	423689	12613	g_37254	g_7133
ptg000069l	424255	493150	68895	g_7133	g_40219
ptg000069l	515615	519508	3893	g_40219	g_22181
ptg000070l	5940	42847	36907	g_5049	g_34435
ptg000070l	49675	52292	2617	g_34435	g_15551
ptg000070l	70901	75452	4551	g_15551	g_16197
ptg000070l	86243	146288	60045	g_16197	g_25115
ptg000070l	171877	268260	96383	g_25115	g_4041
ptg000070l	274627	280433	5806	g_4041	g_11601
ptg000070l	280777	296911	16134	g_11601	g_6921
ptg000070l	297255	312557	15302	g_6921	g_23420
ptg000070l	318603	320123	1520	g_23420	g_28840
ptg000070l	320791	326145	5354	g_28840	g_4012
ptg000070l	332197	335321	3124	g_4012	g_29218
ptg000070l	335665	339599	3934	g_29218	g_21470
ptg000070l	343849	354023	10174	g_21470	g_2716
ptg000070l	378709	401852	23143	g_2716	g_23784
ptg000070l	411021	426111	15090	g_23784	g_29933
ptg000070l	436994	445477	8483	g_29933	g_20236
ptg000070l	448023	449047	1024	g_20236	g_3403
ptg000070l	450135	463366	13231	g_3403	g_24601
ptg000070l	485983	510303	24320	g_24601	g_21871
ptg000070l	510686	623349	112663	g_21871	g_14748
ptg000070l	625333	694404	69071	g_14748	g_3416
ptg000070l	695402	760962	65560	g_3416	g_25789
ptg000070l	761201	769296	8095	g_25789	g_5776
ptg000070l	791105	818194	27089	g_5776	g_27320
ptg000070l	831030	833343	2313	g_27320	g_14769
ptg000070l	833760	864825	31065	g_14769	g_19189
ptg000070l	869019	915351	46332	g_19189	g_9849
ptg000070l	917548	964069	46521	g_9849	g_4603
ptg000070l	965384	968828	3444	g_4603	g_16731
ptg000070l	969109	976189	7080	g_16731	g_40161
ptg000070l	978662	998334	19672	g_40161	g_28821
ptg000070l	1003025	1040327	37302	g_28821	g_7543
ptg000070l	1045704	1089527	43823	g_7543	g_15822
ptg000070l	1091971	1096535	4564	g_15822	g_19996
ptg000070l	1116412	1286711	170299	g_19996	g_24206
ptg000070l	1311168	1314703	3535	g_24206	g_18255
ptg000070l	1346767	1402063	55296	g_18255	g_27533
ptg000070l	1406858	1412285	5427	g_27533	g_4886
ptg000070l	1420119	1453454	33335	g_4886	g_23772
ptg000070l	1454101	1527906	73805	g_23772	g_6329
ptg000070l	1529149	1809680	280531	g_6329	g_28797
ptg000070l	1810351	1997887	187536	g_28797	g_35651
ptg000070l	1998222	2002153	3931	g_35651	g_10041
ptg000070l	2002362	2010565	8203	g_10041	g_40077
ptg000070l	2011659	2310503	298844	g_40077	g_33652
ptg000070l	2336780	2348761	11981	g_33652	g_9576
ptg000070l	2349309	2408358	59049	g_9576	g_31916
ptg000070l	2408864	2509775	100911	g_31916	g_10085
ptg000070l	2511592	2543363	31771	g_10085	g_15266
ptg000070l	2545180	2555529	10349	g_15266	g_1619
ptg000070l	2557346	2578410	21064	g_1619	g_17503
ptg000070l	2580227	2595195	14968	g_17503	g_4510
ptg000070l	2597012	2612770	15758	g_4510	g_35918
ptg000070l	2614587	2687984	73397	g_35918	g_2588
ptg000070l	2689720	2689904	184	g_2588	g_16494
ptg000070l	2691343	2822221	130878	g_16494	g_29717
ptg000070l	2822649	2927519	104870	g_29717	g_23857
ptg000070l	2929336	2979105	49769	g_23857	g_37803
ptg000070l	2986664	2989467	2803	g_37803	g_11025
ptg000070l	2998833	3004950	6117	g_11025	g_1511
ptg000070l	3021436	3022275	839	g_1511	g_14828
ptg000070l	3023075	3023910	835	g_14828	g_26377
ptg000070l	3025762	3036026	10264	g_26377	g_28721
ptg000070l	3043763	3049381	5618	g_28721	g_26657
ptg000070l	3062203	3068522	6319	g_26657	g_32840
ptg000070l	3089217	3134331	45114	g_32840	g_24906
ptg000070l	3144856	3154203	9347	g_24906	g_6705
ptg000070l	3162533	3166996	4463	g_6705	g_35622
ptg000070l	3171171	3174225	3054	g_35622	g_23981
ptg000070l	3174884	3176832	1948	g_23981	g_5133
ptg000070l	3192490	3221014	28524	g_5133	g_22695
ptg000070l	3222265	3255040	32775	g_22695	g_3773
ptg000070l	3265894	3340699	74805	g_3773	g_24928
ptg000070l	3344440	3388911	44471	g_24928	g_38589
ptg000070l	3390053	3416229	26176	g_38589	g_11171
ptg000070l	3430969	3545550	114581	g_11171	g_9775
ptg000070l	3566751	3571847	5096	g_9775	g_24677
ptg000070l	3584355	3598920	14565	g_24677	g_27147
ptg000070l	3604743	3666115	61372	g_27147	g_5293
ptg000070l	3667738	3673581	5843	g_5293	g_1352
ptg000070l	3678689	3695513	16824	g_1352	g_15300
ptg000070l	3695737	3695775	38	g_15300	g_18937
ptg000070l	3696083	3705307	9224	g_18937	g_18047
ptg000070l	3722553	3818270	95717	g_18047	g_35933
ptg000070l	3818560	3822809	4249	g_35933	g_3252
ptg000070l	3842357	3849259	6902	g_3252	g_29921
ptg000070l	3949135	3980343	31208	g_29921	g_28789
ptg000070l	3980954	3999371	18417	g_28789	g_4569
ptg000070l	4000933	4009961	9028	g_4569	g_17064
ptg000070l	4010404	4010485	81	g_17064	g_16985
ptg000070l	4024033	4057903	33870	g_16985	g_6840
ptg000070l	4058598	4070445	11847	g_6840	g_15680
ptg000070l	4084751	4153319	68568	g_15680	g_15281
ptg000070l	4153951	4179697	25746	g_15281	g_39857
ptg000070l	4180104	4184847	4743	g_39857	g_23155
ptg000070l	4185431	4361329	175898	g_23155	g_9892
ptg000070l	4375415	4381306	5891	g_9892	g_3583
ptg000070l	4401158	4410555	9397	g_3583	g_31278
ptg000070l	4410944	4424962	14018	g_31278	g_11318
ptg000070l	4425336	4439286	13950	g_11318	g_599
ptg000070l	4450329	4467424	17095	g_599	g_30059
ptg000070l	4476504	4510628	34124	g_30059	g_26964
ptg000071l	17514	50178	32664	g_25848	g_23418
ptg000071l	52739	104757	52018	g_23418	g_16403
ptg000071l	105884	125032	19148	g_16403	g_12832
ptg000071l	126333	131389	5056	g_12832	g_22410
ptg000071l	135892	148600	12708	g_22410	g_4118
ptg000071l	156294	238401	82107	g_4118	g_36977
ptg000071l	242738	244644	1906	g_36977	g_3907
ptg000072l	18461	34138	15677	g_27772	g_1137
ptg000072l	40235	59939	19704	g_1137	g_11315
ptg000072l	60412	91916	31504	g_11315	g_13453
ptg000072l	112388	177966	65578	g_13453	g_4347
ptg000072l	178166	185691	7525	g_4347	g_19271
ptg000072l	186683	201820	15137	g_19271	g_4719
ptg000072l	212248	238411	26163	g_4719	g_25555
ptg000072l	238689	238742	53	g_25555	g_2963
ptg000072l	239041	274782	35741	g_2963	g_21898
ptg000072l	278734	345275	66541	g_21898	g_24349
ptg000072l	345589	345781	192	g_24349	g_11447
ptg000072l	351926	357974	6048	g_11447	g_15277
ptg000072l	358387	403894	45507	g_15277	g_40263
ptg000072l	442518	452045	9527	g_40263	g_26807
ptg000072l	458827	477577	18750	g_26807	g_37836
ptg000072l	478251	500472	22221	g_37836	g_35498
ptg000072l	517529	523580	6051	g_35498	g_37042
ptg000072l	531641	534209	2568	g_37042	g_33336
ptg000072l	537218	562320	25102	g_33336	g_6283
ptg000072l	567089	579121	12032	g_6283	g_34370
ptg000072l	597490	619325	21835	g_34370	g_15636
ptg000072l	632454	680377	47923	g_15636	g_5742
ptg000072l	693835	705865	12030	g_5742	g_21369
ptg000072l	711200	714254	3054	g_21369	g_9084
ptg000072l	716428	1106315	389887	g_9084	g_32193
ptg000072l	1106620	1160770	54150	g_32193	g_11453
ptg000072l	1161384	1566018	404634	g_11453	g_5041
ptg000072l	1567253	1720574	153321	g_5041	g_36407
ptg000072l	1736462	1748034	11572	g_36407	g_17667
ptg000072l	1755497	1762688	7191	g_17667	g_15745
ptg000072l	1771390	1803213	31823	g_15745	g_38542
ptg000072l	1803851	1804088	237	g_38542	g_5177
ptg000072l	1805837	1807625	1788	g_5177	g_7781
ptg000072l	1808314	1815845	7531	g_7781	g_36442
ptg000072l	1819617	1829778	10161	g_36442	g_3896
ptg000072l	1833340	1838107	4767	g_3896	g_24268
ptg000072l	1838370	1843916	5546	g_24268	g_35169
ptg000072l	1884400	1885893	1493	g_35169	g_26360
ptg000072l	1894182	1898131	3949	g_26360	g_23399
ptg000072l	1910035	1930774	20739	g_23399	g_37367
ptg000072l	1949455	2013199	63744	g_37367	g_28155
ptg000072l	2013468	2018533	5065	g_28155	g_9207
ptg000072l	2021241	2033847	12606	g_9207	g_5135
ptg000072l	2043378	2047751	4373	g_5135	g_11298
ptg000072l	2056224	2061088	4864	g_11298	g_30774
ptg000072l	2062236	2109080	46844	g_30774	g_23421
ptg000072l	2109316	2233290	123974	g_23421	g_10941
ptg000072l	2235116	2332763	97647	g_10941	g_33982
ptg000072l	2334766	2338789	4023	g_33982	g_28524
ptg000072l	2357058	2366917	9859	g_28524	g_31010
ptg000072l	2391821	2577397	185576	g_31010	g_26057
ptg000072l	2577756	2595414	17658	g_26057	g_197
ptg000072l	2596031	2602884	6853	g_197	g_27285
ptg000072l	2614169	2648356	34187	g_27285	g_36175
ptg000072l	2648631	2707430	58799	g_36175	g_9006
ptg000072l	2727476	2781579	54103	g_9006	g_9761
ptg000072l	2782646	2923478	140832	g_9761	g_29969
ptg000072l	2923801	3204984	281183	g_29969	g_5097
ptg000072l	3205199	3296767	91568	g_5097	g_28651
ptg000072l	3297036	3448131	151095	g_28651	g_16226
ptg000072l	3448928	3457335	8407	g_16226	g_22281
ptg000072l	3471025	3471696	671	g_22281	g_2916
ptg000072l	3472025	3564317	92292	g_2916	g_31184
ptg000072l	3577299	3589220	11921	g_31184	g_21880
ptg000072l	3589465	3671009	81544	g_21880	g_20289
ptg000072l	3673341	3747608	74267	g_20289	g_9767
ptg000072l	3747931	3785863	37932	g_9767	g_37944
ptg000072l	3786777	3811548	24771	g_37944	g_29243
ptg000072l	3819789	3848870	29081	g_29243	g_12610
ptg000072l	3849346	3868295	18949	g_12610	g_15819
ptg000072l	3875322	3902430	27108	g_15819	g_27764
ptg000072l	3907478	3918417	10939	g_27764	g_22766
ptg000072l	3918755	3942346	23591	g_22766	g_22486
ptg000072l	3958438	3965881	7443	g_22486	g_35288
ptg000072l	3966351	3968502	2151	g_35288	g_24751
ptg000072l	3971577	3980701	9124	g_24751	g_32271
ptg000072l	3987484	4151439	163955	g_32271	g_8324
ptg000072l	4151849	4153597	1748	g_8324	g_13989
ptg000072l	4153974	4172372	18398	g_13989	g_705
ptg000072l	4173534	4179912	6378	g_705	g_8985
ptg000072l	4180223	4181672	1449	g_8985	g_31284
ptg000072l	4182049	4206894	24845	g_31284	g_16528
ptg000072l	4210038	4215215	5177	g_16528	g_28773
ptg000072l	4216783	4222662	5879	g_28773	g_22399
ptg000072l	4222973	4226098	3125	g_22399	g_34861
ptg000072l	4226475	4227597	1122	g_34861	g_30136
ptg000072l	4227980	4229749	1769	g_30136	g_7877
ptg000072l	4230396	4232240	1844	g_7877	g_4116
ptg000072l	4232650	4233582	932	g_4116	g_17617
ptg000072l	4233959	4238682	4723	g_17617	g_19382
ptg000072l	4239065	4247809	8744	g_19382	g_14472
ptg000072l	4250661	4304390	53729	g_14472	g_29591
ptg000072l	4304647	4370919	66272	g_29591	g_25203
ptg000072l	4381295	4382487	1192	g_25203	g_9506
ptg000072l	4383206	4389016	5810	g_9506	g_35073
ptg000072l	4389327	4393435	4108	g_35073	g_26847
ptg000072l	4393812	4394757	945	g_26847	g_23432
ptg000072l	4395167	4403897	8730	g_23432	g_11576
ptg000072l	4406563	4411477	4914	g_11576	g_9220
ptg000072l	4411860	4418638	6778	g_9220	g_37868
ptg000072l	4419216	4421925	2709	g_37868	g_37382
ptg000072l	4423112	4423729	617	g_37382	g_6669
ptg000072l	4424109	4426988	2879	g_6669	g_15580
ptg000072l	4427299	4428474	1175	g_15580	g_19469
ptg000072l	4428719	4433304	4585	g_19469	g_21730
ptg000072l	4433507	4434088	581	g_21730	g_7072
ptg000072l	4434498	4435562	1064	g_7072	g_37476
ptg000072l	4435942	4444890	8948	g_37476	g_4755
ptg000072l	4445201	4446636	1435	g_4755	g_24745
ptg000072l	4447013	4448134	1121	g_24745	g_23480
ptg000072l	4448517	4450463	1946	g_23480	g_31388
ptg000072l	4450774	4471063	20289	g_31388	g_30729
ptg000072l	4481170	4487505	6335	g_30729	g_4222
ptg000072l	4493853	4500840	6987	g_4222	g_32128
ptg000072l	4524093	4525198	1105	g_32128	g_22440
ptg000072l	4541064	4546884	5820	g_22440	g_17266
ptg000072l	4556642	4562789	6147	g_17266	g_37636
ptg000072l	4579102	4597646	18544	g_37636	g_31068
ptg000072l	4614025	4657156	43131	g_31068	g_3641
ptg000072l	4657815	4657914	99	g_3641	g_5681
ptg000072l	4659239	4660218	979	g_5681	g_26013
ptg000072l	4660763	4683838	23075	g_26013	g_24197
ptg000072l	4684794	4693947	9153	g_24197	g_26821
ptg000072l	4694891	4697408	2517	g_26821	g_11265
ptg000072l	4698358	4701484	3126	g_11265	g_7402
ptg000072l	4702434	4705239	2805	g_7402	g_23749
ptg000072l	4706189	4708977	2788	g_23749	g_2660
ptg000072l	4709927	4712644	2717	g_2660	g_28025
ptg000072l	4713594	4722649	9055	g_28025	g_15523
ptg000072l	4723599	4728842	5243	g_15523	g_22026
ptg000072l	4729786	4789906	60120	g_22026	g_11338
ptg000072l	4804689	4808084	3395	g_11338	g_20407
ptg000072l	4813408	4822821	9413	g_20407	g_33220
ptg000072l	4843453	4869156	25703	g_33220	g_28951
ptg000072l	4876160	4898691	22531	g_28951	g_34413
ptg000072l	4904070	4922253	18183	g_34413	g_6578
ptg000072l	4925186	4925774	588	g_6578	g_9030
ptg000072l	4932221	4932368	147	g_9030	g_16981
ptg000072l	4933003	4934515	1512	g_16981	g_12457
ptg000072l	4940351	5092574	152223	g_12457	g_19399
ptg000072l	5092840	5116057	23217	g_19399	g_38687
ptg000072l	5116350	5166700	50350	g_38687	g_3790
ptg000072l	5166930	5202876	35946	g_3790	g_21304
ptg000072l	5203187	5220604	17417	g_21304	g_38169
ptg000072l	5252986	5260314	7328	g_38169	g_7431
ptg000072l	5273221	5275288	2067	g_7431	g_19871
ptg000072l	5288833	5295498	6665	g_19871	g_6073
ptg000072l	5295968	5313525	17557	g_6073	g_14753
ptg000072l	5313851	5347723	33872	g_14753	g_22968
ptg000072l	5361945	5365546	3601	g_22968	g_36241
ptg000072l	5365785	5385331	19546	g_36241	g_22004
ptg000073l	21540	21777	237	g_40283	g_32886
ptg000073l	22472	26950	4478	g_32886	g_10704
ptg000073l	27480	138833	111353	g_10704	g_1340
ptg000073l	139303	167036	27733	g_1340	g_27716
ptg000073l	168408	169625	1217	g_27716	g_3044
ptg000073l	171028	184623	13595	g_3044	g_24787
ptg000073l	199789	217603	17814	g_24787	g_17289
ptg000073l	218106	219989	1883	g_17289	g_31201
ptg000073l	225499	283754	58255	g_31201	g_32652
ptg000073l	284760	317031	32271	g_32652	g_2434
ptg000073l	330077	331433	1356	g_2434	g_36358
ptg000073l	332851	352551	19700	g_36358	g_16486
ptg000073l	352976	353757	781	g_16486	g_24741
ptg000073l	354035	354074	39	g_24741	g_33256
ptg000073l	354289	354427	138	g_33256	g_34550
ptg000073l	354639	381063	26424	g_34550	g_1641
ptg000074l	103463	197887	94424	g_8520	g_12228
ptg000074l	198957	202918	3961	g_12228	g_26684
ptg000074l	209981	224646	14665	g_26684	g_25376
ptg000074l	229732	239814	10082	g_25376	g_20874
ptg000074l	242987	246091	3104	g_20874	g_9227
ptg000074l	257371	337128	79757	g_9227	g_3842
ptg000074l	349521	365870	16349	g_3842	g_23025
ptg000074l	380976	383920	2944	g_23025	g_18227
ptg000074l	395257	396962	1705	g_18227	g_4511
ptg000074l	406058	414168	8110	g_4511	g_27844
ptg000074l	421295	439793	18498	g_27844	g_32628
ptg000074l	454407	497349	42942	g_32628	g_34462
ptg000074l	511085	547802	36717	g_34462	g_25001
ptg000074l	548377	631063	82686	g_25001	g_9082
ptg000074l	672309	695300	22991	g_9082	g_34878
ptg000074l	718819	788072	69253	g_34878	g_23409
ptg000074l	791853	821939	30086	g_23409	g_13683
ptg000074l	822169	835280	13111	g_13683	g_28015
ptg000074l	842333	847354	5021	g_28015	g_36701
ptg000074l	867331	948677	81346	g_36701	g_23349
ptg000074l	955453	1017695	62242	g_23349	g_23720
ptg000074l	1028468	1030455	1987	g_23720	g_19148
ptg000074l	1044020	1045745	1725	g_19148	g_27226
ptg000074l	1050127	1058700	8573	g_27226	g_29512
ptg000074l	1065700	1071409	5709	g_29512	g_1072
ptg000074l	1092457	1185278	92821	g_1072	g_29320
ptg000074l	1207234	1219694	12460	g_29320	g_5168
ptg000074l	1241589	1274180	32591	g_5168	g_16320
ptg000074l	1296068	1296674	606	g_16320	g_5667
ptg000074l	1302835	1303493	658	g_5667	g_23587
ptg000074l	1320918	1321076	158	g_23587	g_31564
ptg000074l	1330863	1332140	1277	g_31564	g_35008
ptg000074l	1333348	1453603	120255	g_35008	g_5962
ptg000074l	1462181	1478018	15837	g_5962	g_17042
ptg000074l	1496809	1503404	6595	g_17042	g_7376
ptg000074l	1514432	1517091	2659	g_7376	g_21894
ptg000074l	1532035	1629561	97526	g_21894	g_17468
ptg000074l	1632489	1654385	21896	g_17468	g_28096
ptg000074l	1661827	1665659	3832	g_28096	g_38953
ptg000074l	1665997	1670640	4643	g_38953	g_28855
ptg000074l	1678888	1689172	10284	g_28855	g_22606
ptg000074l	1707659	1749477	41818	g_22606	g_1727
ptg000074l	1749788	1755435	5647	g_1727	g_12053
ptg000074l	1762879	1789841	26962	g_12053	g_20745
ptg000074l	1795230	1821545	26315	g_20745	g_15309
ptg000074l	1821856	1827484	5628	g_15309	g_1226
ptg000074l	1834808	1860366	25558	g_1226	g_9865
ptg000074l	1865746	1879154	13408	g_9865	g_24338
ptg000074l	1882082	1902444	20362	g_24338	g_871
ptg000074l	1909901	1948758	38857	g_871	g_32273
ptg000074l	1951686	1965249	13563	g_32273	g_17494
ptg000074l	1984606	2060851	76245	g_17494	g_13804
ptg000074l	2061327	2064336	3009	g_13804	g_17351
ptg000074l	2083882	2234978	151096	g_17351	g_32062
ptg000074l	2244083	2271217	27134	g_32062	g_14357
ptg000074l	2271453	2686926	415473	g_14357	g_5101
ptg000074l	2691658	2703125	11467	g_5101	g_9878
ptg000074l	2708901	3029066	320165	g_9878	g_31070
ptg000074l	3048710	3051506	2796	g_31070	g_33147
ptg000074l	3057667	3062154	4487	g_33147	g_31570
ptg000074l	3087219	3109481	22262	g_31570	g_25432
ptg000074l	3110186	3110585	399	g_25432	g_14813
ptg000074l	3118335	3142306	23971	g_14813	g_7059
ptg000074l	3149435	3168132	18697	g_7059	g_37420
ptg000074l	3177505	3183297	5792	g_37420	g_40103
ptg000074l	3210292	3213625	3333	g_40103	g_11967
ptg000074l	3214477	3245142	30665	g_11967	g_40052
ptg000074l	3248813	3256785	7972	g_40052	g_8614
ptg000074l	3267439	3382544	115105	g_8614	g_34046
ptg000074l	3382945	3408384	25439	g_34046	g_15586
ptg000074l	3409043	3446405	37362	g_15586	g_14868
ptg000074l	3449269	3468184	18915	g_14868	g_37151
ptg000074l	3471449	3471667	218	g_37151	g_36390
ptg000074l	3472386	3548240	75854	g_36390	g_11561
ptg000074l	3557435	3560580	3145	g_11561	g_5210
ptg000074l	3571623	3573729	2106	g_5210	g_31669
ptg000074l	3574631	3577562	2931	g_31669	g_25797
ptg000074l	3584349	3588987	4638	g_25797	g_5928
ptg000074l	3608083	3613026	4943	g_5928	g_34809
ptg000074l	3623596	3631633	8037	g_34809	g_15673
ptg000074l	3639163	3670058	30895	g_15673	g_12046
ptg000074l	3670330	3672959	2629	g_12046	g_1715
ptg000074l	3686013	3703766	17753	g_1715	g_36329
ptg000074l	3704266	3834058	129792	g_36329	g_26849
ptg000074l	3852003	3854418	2415	g_26849	g_206
ptg000074l	3855416	3872613	17197	g_206	g_23906
ptg000074l	3872954	3886806	13852	g_23906	g_1385
ptg000074l	3887267	3921336	34069	g_1385	g_28519
ptg000074l	3921806	3978408	56602	g_28519	g_20076
ptg000074l	3978851	4151579	172728	g_20076	g_23549
ptg000074l	4152061	4203439	51378	g_23549	g_152
ptg000074l	4205475	4211445	5970	g_152	g_8638
ptg000074l	4212977	4214644	1667	g_8638	g_40053
ptg000074l	4223926	4236872	12946	g_40053	g_1524
ptg000074l	4237072	4278828	41756	g_1524	g_38421
ptg000074l	4281435	4344749	63314	g_26442	g_14954
ptg000074l	4346548	4361937	15389	g_14954	g_21233
ptg000074l	4362734	4362801	67	g_21233	g_1721
ptg000074l	4363739	4384277	20538	g_1721	g_4910
ptg000074l	4386031	4392068	6037	g_4910	g_10415
ptg000074l	4409108	4423525	14417	g_10415	g_9095
ptg000074l	4424139	4468101	43962	g_9095	g_5661
ptg000074l	4468322	4496551	28229	g_5661	g_17055
ptg000074l	4504647	4524848	20201	g_17055	g_18466
ptg000074l	4525621	4679356	153735	g_18466	g_39043
ptg000074l	4680123	4725938	45815	g_39043	g_29069
ptg000074l	4726726	4743251	16525	g_29069	g_31712
ptg000074l	4765077	4773623	8546	g_31712	g_23195
ptg000074l	4783723	4787059	3336	g_23195	g_37081
ptg000074l	4788114	4789522	1408	g_37081	g_329
ptg000074l	4789854	4793988	4134	g_329	g_33416
ptg000074l	4795043	4818197	23154	g_33416	g_35401
ptg000074l	4821034	4829432	8398	g_35401	g_32962
ptg000074l	4829887	4831145	1258	g_32962	g_942
ptg000074l	4831684	4840600	8916	g_942	g_26716
ptg000074l	4846894	4862743	15849	g_26716	g_23204
ptg000074l	4867199	4971668	104469	g_23204	g_30505
ptg000074l	4991262	5014908	23646	g_30505	g_3006
ptg000074l	5016846	5022265	5419	g_3006	g_18867
ptg000074l	5032587	5102802	70215	g_18867	g_2602
ptg000074l	5113037	5192140	79103	g_2602	g_12149
ptg000074l	5192730	5192861	131	g_12149	g_31240
ptg000074l	5194819	5223007	28188	g_31240	g_27769
ptg000074l	5223288	5250539	27251	g_27769	g_9742
ptg000074l	5250763	5315379	64616	g_9742	g_11358
ptg000074l	5317004	5317173	169	g_11358	g_10323
ptg000074l	5336172	5356621	20449	g_10323	g_28469
ptg000074l	5364098	5454568	90470	g_28469	g_562
ptg000074l	5472163	5496367	24204	g_562	g_22370
ptg000074l	5512961	5526503	13542	g_22370	g_13412
ptg000074l	5527009	5528784	1775	g_13412	g_25905
ptg000074l	5529455	5574334	44879	g_25905	g_33238
ptg000074l	5585107	5627778	42671	g_33238	g_30665
ptg000074l	5638555	5647768	9213	g_30665	g_21736
ptg000074l	5670113	5737881	67768	g_21736	g_2122
ptg000074l	5777812	5788097	10285	g_2122	g_5551
ptg000074l	5788321	5824295	35974	g_5551	g_25987
ptg000074l	5826926	5835654	8728	g_25987	g_33187
ptg000074l	5854566	5886674	32108	g_33187	g_814
ptg000074l	5887599	5899277	11678	g_814	g_13647
ptg000074l	5909678	5979898	70220	g_13647	g_21860
ptg000074l	6003584	6101835	98251	g_21860	g_1216
ptg000074l	6110023	6275988	165965	g_1216	g_19374
ptg000074l	6291539	6339112	47573	g_19374	g_725
ptg000074l	6347355	6369227	21872	g_725	g_5209
ptg000074l	6369469	6523175	153706	g_5209	g_17605
ptg000074l	6606512	6606657	145	g_17605	g_35893
ptg000074l	6606878	6675393	68515	g_35893	g_7028
ptg000074l	6695397	6787699	92302	g_7028	g_24555
ptg000074l	6804767	6805907	1140	g_24555	g_11863
ptg000074l	6828600	6833815	5215	g_11863	g_10642
ptg000074l	6847079	6860548	13469	g_10642	g_18088
ptg000074l	6879305	6885421	6116	g_18088	g_7030
ptg000074l	6887094	6942604	55510	g_7030	g_16459
ptg000074l	6959967	6963213	3246	g_16459	g_1312
ptg000074l	6984528	6989897	5369	g_1312	g_23567
ptg000074l	6997906	6998911	1005	g_23567	g_36762
ptg000074l	7008611	7009306	695	g_36762	g_20504
ptg000074l	7011069	7067063	55994	g_20504	g_33578
ptg000074l	7067611	7077987	10376	g_33578	g_18083
ptg000074l	7125938	7186094	60156	g_18083	g_34722
ptg000074l	7195325	7212763	17438	g_34722	g_38344
ptg000074l	7213536	7222423	8887	g_38344	g_13342
ptg000074l	7228575	7380595	152020	g_13342	g_17807
ptg000074l	7418556	7655705	237149	g_17807	g_16598
ptg000074l	7655923	7732481	76558	g_16598	g_15395
ptg000074l	7752771	8173032	420261	g_15395	g_30552
ptg000074l	8173304	8185209	11905	g_30552	g_35957
ptg000074l	8186063	8221101	35038	g_35957	g_4799
ptg000074l	8221520	8250054	28534	g_4799	g_9462
ptg000074l	8254008	8279659	25651	g_9462	g_27332
ptg000074l	8289120	8345043	55923	g_27332	g_26020
ptg000074l	8345285	8381684	36399	g_26020	g_6166
ptg000074l	8382604	8444230	61626	g_6166	g_32232
ptg000074l	8489772	8507315	17543	g_32232	g_8131
ptg000074l	8512158	8539182	27024	g_8131	g_13965
ptg000074l	8542537	8552751	10214	g_13965	g_20161
ptg000074l	8558086	8565960	7874	g_20161	g_9642
ptg000074l	8574978	8577921	2943	g_9642	g_8871
ptg000074l	8587675	8623444	35769	g_8871	g_11086
ptg000074l	8625008	8635232	10224	g_11086	g_22033
ptg000074l	8637606	8657098	19492	g_22033	g_5957
ptg000074l	8662535	8680554	18019	g_5957	g_37025
ptg000074l	8684038	8699244	15206	g_37025	g_30616
ptg000074l	8702727	8712583	9856	g_30616	g_1633
ptg000074l	8713307	8725147	11840	g_1633	g_980
ptg000074l	8737500	8774970	37470	g_980	g_27926
ptg000074l	8787008	8880257	93249	g_27926	g_28334
ptg000074l	8890006	8892828	2822	g_28334	g_32242
ptg000074l	8894150	8898499	4349	g_32242	g_26973
ptg000074l	8899447	8919055	19608	g_26973	g_1398
ptg000074l	8921911	8934004	12093	g_1398	g_7188
ptg000074l	8934900	8934955	55	g_7188	g_22645
ptg000074l	8935587	8947989	12402	g_22645	g_7178
ptg000074l	8956149	8979921	23772	g_7178	g_31694
ptg000074l	8991558	8993753	2195	g_31694	g_24414
ptg000074l	8999551	9010783	11232	g_24414	g_24472
ptg000074l	9011154	9026182	15028	g_24472	g_5047
ptg000074l	9027601	9046698	19097	g_5047	g_30365
ptg000074l	9049328	9064300	14972	g_30365	g_24767
ptg000074l	9085408	9130243	44835	g_24767	g_31051
ptg000074l	9130557	9141621	11064	g_31051	g_3118
ptg000074l	9162152	9264318	102166	g_3118	g_36323
ptg000074l	9266969	9271200	4231	g_36323	g_24284
ptg000074l	9307548	9315302	7754	g_24284	g_25880
ptg000074l	9315628	9600958	285330	g_25880	g_13517
ptg000074l	9613251	9614148	897	g_13517	g_990
ptg000074l	9620004	9620916	912	g_990	g_9464
ptg000074l	9626595	9628180	1585	g_9464	g_29604
ptg000074l	9660434	9661980	1546	g_29604	g_1419
ptg000074l	9664614	9669853	5239	g_1419	g_314
ptg000074l	9677379	9706261	28882	g_314	g_1338
ptg000074l	9727837	9729062	1225	g_1338	g_32204
ptg000074l	9732027	9758588	26561	g_32204	g_5741
ptg000074l	9758977	9763182	4205	g_5741	g_35962
ptg000074l	9763538	9767802	4264	g_35962	g_15559
ptg000074l	9784928	9825955	41027	g_15559	g_36578
ptg000074l	9826242	9857568	31326	g_36578	g_2474
ptg000074l	9857918	9857991	73	g_2474	g_25495
ptg000074l	9858269	9880386	22117	g_25495	g_15407
ptg000074l	9880697	9913571	32874	g_15407	g_37580
ptg000074l	9913795	10225019	311224	g_37580	g_30404
ptg000074l	10233706	10291401	57695	g_30404	g_7577
ptg000074l	10294115	10755549	461434	g_7577	g_26158
ptg000074l	10766493	10782213	15720	g_26158	g_20443
ptg000074l	10782428	10782867	439	g_20443	g_37698
ptg000074l	10783301	10783355	54	g_37698	g_27325
ptg000074l	10783831	10783865	34	g_27325	g_28743
ptg000074l	10784221	10784255	34	g_28743	g_24063
ptg000074l	10784938	10839942	55004	g_24063	g_11827
ptg000074l	10848236	10957384	109148	g_11827	g_15155
ptg000074l	10963162	11005047	41885	g_15155	g_25466
ptg000074l	11005505	11005546	41	g_25466	g_8404
ptg000074l	11005791	11024347	18556	g_8404	g_15598
ptg000074l	11035844	11040653	4809	g_15598	g_6935
ptg000074l	11041093	11106305	65212	g_6935	g_26653
ptg000074l	11106811	11160605	53794	g_26653	g_13291
ptg000074l	11168326	11177630	9304	g_13291	g_29360
ptg000074l	11178649	11207519	28870	g_29360	g_11986
ptg000074l	11209919	11214694	4775	g_11986	g_22799
ptg000074l	11226427	11320857	94430	g_22799	g_26624
ptg000074l	11321138	11338644	17506	g_26624	g_36139
ptg000074l	11347929	11351207	3278	g_36139	g_4165
ptg000074l	11368587	11376017	7430	g_4165	g_17058
ptg000074l	11381621	11384806	3185	g_17058	g_21417
ptg000074l	11399311	11412015	12704	g_21417	g_10413
ptg000074l	11416243	11416909	666	g_10413	g_33177
ptg000074l	11418321	11423818	5497	g_33177	g_29423
ptg000074l	11425884	11436007	10123	g_29423	g_9057
ptg000074l	11468340	11470729	2389	g_9057	g_20713
ptg000074l	11482480	11529820	47340	g_20713	g_6967
ptg000074l	11538280	11623400	85120	g_6967	g_37361
ptg000074l	11623624	11716163	92539	g_37361	g_35410
ptg000074l	11716447	11744178	27731	g_35410	g_39395
ptg000074l	11744534	11755075	10541	g_39395	g_6580
ptg000074l	11757312	11757374	62	g_6580	g_37434
ptg000074l	11759063	11789940	30877	g_37434	g_38721
ptg000074l	11790173	11792848	2675	g_38721	g_14200
ptg000074l	11794107	11863900	69793	g_14200	g_30219
ptg000074l	11864187	11867893	3706	g_30219	g_28482
ptg000074l	11875623	11890080	14457	g_28482	g_2725
ptg000074l	11894247	11903600	9353	g_2725	g_32489
ptg000074l	11904763	11911978	7215	g_32489	g_4963
ptg000074l	11914235	11926335	12100	g_4963	g_1596
ptg000074l	11955597	11997473	41876	g_1596	g_9341
ptg000074l	11997706	11998162	456	g_9341	g_2476
ptg000074l	12006833	12008226	1393	g_2476	g_20205
ptg000074l	12013599	12017683	4084	g_20205	g_1613
ptg000074l	12026147	12026733	586	g_1613	g_24696
ptg000074l	12030063	12030372	309	g_24696	g_3554
ptg000074l	12032874	12042172	9298	g_3554	g_22544
ptg000074l	12052106	12056499	4393	g_22544	g_39882
ptg000074l	12078773	12085236	6463	g_36702	g_36935
ptg000074l	12109188	12147371	38183	g_36935	g_20158
ptg000074l	12173025	12177007	3982	g_20158	g_5185
ptg000074l	12179474	12180184	710	g_5185	g_34417
ptg000074l	12185174	12210676	25502	g_34417	g_28317
ptg000074l	12229645	12335855	106210	g_28317	g_36078
ptg000074l	12344015	12384348	40333	g_36078	g_10174
ptg000074l	12384953	12421172	36219	g_10174	g_25086
ptg000074l	12421372	12478161	56789	g_25086	g_257
ptg000074l	12480059	12729352	249293	g_257	g_33329
ptg000074l	12733754	12793874	60120	g_33329	g_9662
ptg000074l	12807407	12849820	42413	g_9662	g_9193
ptg000074l	12871629	12876760	5131	g_9193	g_19277
ptg000074l	12877881	12912642	34761	g_19277	g_38354
ptg000074l	12913025	12955405	42380	g_38354	g_23386
ptg000074l	12962354	13001950	39596	g_23386	g_37934
ptg000074l	13008836	13011017	2181	g_37934	g_22895
ptg000074l	13018911	13023487	4576	g_22895	g_12477
ptg000074l	13028890	13029888	998	g_12477	g_40114
ptg000074l	13035234	13038305	3071	g_40114	g_10249
ptg000074l	13058133	13065420	7287	g_10249	g_35768
ptg000074l	13076776	13258588	181812	g_35768	g_7968
ptg000074l	13260814	13268739	7925	g_7968	g_29434
ptg000074l	13286547	13294076	7529	g_29434	g_13780
ptg000074l	13298685	13300650	1965	g_13780	g_40148
ptg000074l	13308004	13312218	4214	g_40148	g_15566
ptg000074l	13321991	13322588	597	g_15566	g_1286
ptg000074l	13327153	13335604	8451	g_1286	g_7260
ptg000074l	13339577	13351376	11799	g_7260	g_3890
ptg000074l	13353006	13366797	13791	g_3890	g_8482
ptg000074l	13377729	13380873	3144	g_8482	g_36708
ptg000074l	13382599	13424025	41426	g_36708	g_23623
ptg000074l	13446754	13450543	3789	g_23623	g_25219
ptg000074l	13453785	13455696	1911	g_25219	g_36465
ptg000074l	13461843	13477812	15969	g_36465	g_38811
ptg000074l	13478692	13487618	8926	g_38811	g_6630
ptg000074l	13494743	13504321	9578	g_6630	g_10012
ptg000074l	13510349	13514480	4131	g_10012	g_25242
ptg000074l	13523052	13527874	4822	g_25242	g_1877
ptg000074l	13533957	13537537	3580	g_1877	g_26147
ptg000074l	13540424	13542254	1830	g_26147	g_21487
ptg000074l	13548235	13570572	22337	g_21487	g_22192
ptg000074l	13581910	13584520	2610	g_22192	g_33192
ptg000074l	13589899	13591519	1620	g_33192	g_40284
ptg000074l	13594456	13673459	79003	g_40284	g_26608
ptg000074l	13687647	13703324	15677	g_26608	g_9253
ptg000074l	13727500	13742343	14843	g_9253	g_25882
ptg000074l	13753752	13776493	22741	g_25882	g_6664
ptg000074l	13793917	13836697	42780	g_6664	g_25211
ptg000074l	13857789	13862808	5019	g_25211	g_19768
ptg000074l	13864622	13875000	10378	g_19768	g_16445
ptg000074l	13895256	13906507	11251	g_16445	g_39354
ptg000074l	13908281	13993771	85490	g_39354	g_9883
ptg000074l	14005984	14532207	526223	g_9883	g_23208
ptg000074l	14532464	14589264	56800	g_23208	g_39053
ptg000074l	14589752	14589804	52	g_39053	g_38880
ptg000074l	14590853	14630831	39978	g_38880	g_4723
ptg000074l	14632684	14734373	101689	g_4723	g_3858
ptg000074l	14743239	14752850	9611	g_3858	g_22191
ptg000074l	14756640	14829645	73005	g_22191	g_7555
ptg000074l	14842264	14872891	30627	g_7555	g_8831
ptg000074l	14874004	14882389	8385	g_8831	g_36953
ptg000074l	14891977	14895432	3455	g_36953	g_1048
ptg000074l	14896301	14901626	5325	g_1048	g_29531
ptg000074l	14902495	14903754	1259	g_29531	g_34056
ptg000074l	14910958	14915448	4490	g_34056	g_12566
ptg000074l	14928408	14931131	2723	g_12566	g_20895
ptg000074l	14932712	14954898	22186	g_20895	g_35648
ptg000074l	14959260	14963307	4047	g_35648	g_21897
ptg000074l	14965504	14982681	17177	g_21897	g_12508
ptg000074l	14984146	14984662	516	g_12508	g_24948
ptg000074l	14991983	14993615	1632	g_24948	g_35282
ptg000074l	15000116	15002758	2642	g_35282	g_19525
ptg000074l	15008985	15009964	979	g_19525	g_11460
ptg000074l	15011737	15071480	59743	g_11460	g_29375
ptg000074l	15080076	15085672	5596	g_29375	g_32112
ptg000074l	15086955	15089667	2712	g_32112	g_20400
ptg000074l	15094215	15133147	38932	g_20400	g_7802
ptg000074l	15134892	15155386	20494	g_7802	g_21645
ptg000074l	15178200	15179880	1680	g_21645	g_35553
ptg000074l	15181639	15244626	62987	g_35553	g_5649
ptg000074l	15248819	15261481	12662	g_5649	g_22730
ptg000074l	15266598	15268110	1512	g_22730	g_7415
ptg000074l	15271099	15283490	12391	g_7415	g_8098
ptg000074l	15295188	15308482	13294	g_8098	g_9653
ptg000074l	15319814	15348266	28452	g_9653	g_28976
ptg000074l	15362187	15367400	5213	g_28976	g_3149
ptg000074l	15380384	15384408	4024	g_3149	g_20070
ptg000074l	15385256	15585383	200127	g_20070	g_33271
ptg000074l	15586456	15601284	14828	g_33271	g_27355
ptg000074l	15613838	15657927	44089	g_27355	g_37765
ptg000074l	15660758	15664834	4076	g_37765	g_32970
ptg000074l	15689655	15695102	5447	g_32970	g_27083
ptg000074l	15697089	15700519	3430	g_27083	g_30028
ptg000074l	15702046	15703560	1514	g_30028	g_9503
ptg000074l	15705113	15713670	8557	g_9503	g_1073
ptg000074l	15717592	15746950	29358	g_1073	g_5183
ptg000074l	15748062	15783312	35250	g_5183	g_36881
ptg000074l	15789416	15793533	4117	g_36881	g_27428
ptg000074l	15805552	15830623	25071	g_27428	g_17973
ptg000074l	15833918	15848056	14138	g_17973	g_31186
ptg000074l	15857792	15881825	24033	g_31186	g_9837
ptg000074l	15899034	15912889	13855	g_9837	g_23244
ptg000074l	15921038	15922257	1219	g_23244	g_27881
ptg000074l	15928545	15965106	36561	g_27881	g_33942
ptg000074l	15971260	16253876	282616	g_33942	g_22966
ptg000074l	16254205	16350518	96313	g_22966	g_24668
ptg000074l	16368270	16394630	26360	g_24668	g_3164
ptg000074l	16408659	16420311	11652	g_3164	g_37486
ptg000074l	16424095	16501965	77870	g_37486	g_23745
ptg000074l	16522640	16524303	1663	g_23745	g_960
ptg000074l	16534326	16541545	7219	g_960	g_36097
ptg000074l	16545688	16558227	12539	g_36097	g_24865
ptg000074l	16566398	16577818	11420	g_24865	g_29958
ptg000074l	16595448	16636873	41425	g_29958	g_5909
ptg000074l	16648772	16784300	135528	g_5909	g_24008
ptg000074l	16795004	16806926	11922	g_24008	g_22568
ptg000074l	16810114	16813027	2913	g_22568	g_12904
ptg000074l	16817036	16841291	24255	g_12904	g_27232
ptg000074l	16841542	16854437	12895	g_27232	g_2396
ptg000074l	16870127	16908655	38528	g_2396	g_34096
ptg000074l	16910056	16948184	38128	g_34096	g_15933
ptg000074l	16950052	17153918	203866	g_15933	g_15460
ptg000074l	17154601	17191799	37198	g_15460	g_6419
ptg000074l	17194192	17243373	49181	g_6419	g_37945
ptg000074l	17243630	17465001	221371	g_37945	g_36980
ptg000074l	17482976	17484419	1443	g_36980	g_18071
ptg000074l	17485670	17488153	2483	g_18071	g_40276
ptg000074l	17490440	17491638	1198	g_40276	g_31158
ptg000074l	17494542	17498784	4242	g_31158	g_4618
ptg000074l	17523474	17634071	110597	g_4618	g_24406
ptg000074l	17642741	17691784	49043	g_24406	g_18811
ptg000074l	17696260	17726988	30728	g_18811	g_8762
ptg000074l	17746707	17749999	3292	g_8762	g_37257
ptg000074l	17751956	17767819	15863	g_39867	g_4944
ptg000074l	17769841	17774083	4242	g_4944	g_30451
ptg000074l	17775598	17796679	21081	g_30451	g_21031
ptg000074l	17801983	17821045	19062	g_21031	g_3322
ptg000074l	17827843	17830506	2663	g_3322	g_29003
ptg000074l	17834841	17836930	2089	g_29003	g_23159
ptg000074l	17840764	17842917	2153	g_23159	g_32660
ptg000074l	17847299	17848427	1128	g_32660	g_16945
ptg000074l	17856229	17866712	10483	g_16945	g_31073
ptg000074l	17882569	17884343	1774	g_31073	g_34764
ptg000074l	17887973	17889272	1299	g_34764	g_11588
ptg000074l	17895985	17945774	49789	g_11588	g_866
ptg000074l	17958137	17997042	38905	g_866	g_35029
ptg000074l	18019079	18021615	2536	g_35029	g_32388
ptg000074l	18034317	18040388	6071	g_32388	g_11692
ptg000074l	18048532	18084326	35794	g_11692	g_25934
ptg000074l	18108687	18137933	29246	g_25934	g_27359
ptg000074l	18138277	18224753	86476	g_27359	g_28847
ptg000074l	18231979	18233415	1436	g_28847	g_3130
ptg000074l	18237408	18251429	14021	g_3130	g_33494
ptg000074l	18256936	18258661	1725	g_33494	g_17212
ptg000074l	18261696	18263253	1557	g_17212	g_1317
ptg000074l	18265764	18268648	2884	g_1317	g_37528
ptg000074l	18283570	18299130	15560	g_37528	g_876
ptg000074l	18303326	18307095	3769	g_876	g_10271
ptg000074l	18307433	18353634	46201	g_10271	g_37601
ptg000074l	18355135	18365035	9900	g_37601	g_26811
ptg000074l	18366381	18403916	37535	g_26811	g_28039
ptg000074l	18411726	18462217	50491	g_28039	g_21888
ptg000074l	18479687	18504800	25113	g_21888	g_23284
ptg000074l	18510790	18559342	48552	g_23284	g_22558
ptg000074l	18559587	18577794	18207	g_22558	g_34112
ptg000074l	18582236	18761805	179569	g_34112	g_1076
ptg000074l	18787761	18804857	17096	g_1076	g_12557
ptg000074l	18806003	18810618	4615	g_12557	g_30940
ptg000074l	18822485	18834723	12238	g_30940	g_31459
ptg000074l	18840554	18848542	7988	g_38520	g_22737
ptg000074l	18855163	18859379	4216	g_22737	g_30640
ptg000074l	18862404	18983120	120716	g_30640	g_2285
ptg000074l	18995523	19016909	21386	g_2285	g_26966
ptg000074l	19017639	19095822	78183	g_26966	g_32557
ptg000074l	19098577	19110686	12109	g_32557	g_28361
ptg000074l	19150286	19161306	11020	g_28361	g_5778
ptg000074l	19172592	19281856	109264	g_5778	g_23279
ptg000074l	19283400	19284704	1304	g_23279	g_24430
ptg000074l	19285222	19287066	1844	g_24430	g_6313
ptg000074l	19287374	19308938	21564	g_6313	g_16460
ptg000074l	19312688	19316056	3368	g_16460	g_560
ptg000074l	19322366	19474324	151958	g_560	g_6974
ptg000074l	19475694	19480100	4406	g_6974	g_36906
ptg000074l	19484599	19485664	1065	g_36906	g_18745
ptg000074l	19491213	19493835	2622	g_18745	g_33820
ptg000074l	19497266	19527965	30699	g_33820	g_8631
ptg000074l	19538728	19654943	116215	g_8631	g_18393
ptg000074l	19657564	19665028	7464	g_18393	g_27550
ptg000074l	19666627	19694478	27851	g_27550	g_28559
ptg000074l	19696365	19713688	17323	g_28559	g_68
ptg000074l	19714710	19724950	10240	g_68	g_1635
ptg000074l	19759923	19765927	6004	g_1635	g_27141
ptg000074l	19778798	19780580	1782	g_27141	g_27703
ptg000074l	19782178	19785870	3692	g_27703	g_26284
ptg000074l	19792976	19813629	20653	g_26284	g_17452
ptg000074l	19833336	19840942	7606	g_17452	g_35372
ptg000074l	19844350	19856977	12627	g_35372	g_3989
ptg000074l	19882195	19914065	31870	g_3989	g_4084
ptg000074l	19914289	19920050	5761	g_4084	g_10588
ptg000074l	19939381	19979564	40183	g_10588	g_9056
ptg000074l	19984034	19988533	4499	g_9056	g_14927
ptg000074l	19996507	20029770	33263	g_14927	g_12330
ptg000074l	20034119	20050074	15955	g_12330	g_3186
ptg000074l	20061490	20096500	35010	g_3186	g_22933
ptg000074l	20098625	20122898	24273	g_22933	g_23458
ptg000074l	20138644	20165976	27332	g_23458	g_10989
ptg000074l	20166328	20184595	18267	g_10989	g_29463
ptg000074l	20184969	20188433	3464	g_29463	g_6882
ptg000074l	20188822	20215130	26308	g_6882	g_3176
ptg000074l	20217286	20241518	24232	g_3176	g_35905
ptg000074l	20242399	20243426	1027	g_35905	g_24631
ptg000074l	20244532	20244633	101	g_24631	g_15936
ptg000074l	20245598	20245998	400	g_15936	g_11962
ptg000074l	20246759	20249345	2586	g_11962	g_27527
ptg000074l	20249758	20264803	15045	g_27527	g_30034
ptg000074l	20265216	20267408	2192	g_30034	g_8498
ptg000074l	20267716	20273666	5950	g_8498	g_26261
ptg000074l	20274052	20279834	5782	g_26261	g_31915
ptg000074l	20280127	20295128	15001	g_31915	g_33323
ptg000074l	20314335	20331780	17445	g_33323	g_5825
ptg000074l	20334387	20339526	5139	g_5825	g_13882
ptg000074l	20349645	20352578	2933	g_13882	g_21589
ptg000074l	20364507	20367256	2749	g_21589	g_14163
ptg000074l	20369275	20376191	6916	g_14163	g_12259
ptg000074l	20381775	20384255	2480	g_12259	g_19352
ptg000074l	20385558	20387568	2010	g_19352	g_14298
ptg000074l	20392346	20393616	1270	g_14298	g_34633
ptg000074l	20397604	20401666	4062	g_34633	g_9496
ptg000074l	20426688	20472220	45532	g_9496	g_23299
ptg000074l	20473173	20484404	11231	g_23299	g_37035
ptg000074l	20500706	20527408	26702	g_37035	g_10420
ptg000074l	20527986	20542199	14213	g_10420	g_19922
ptg000074l	20545877	20561280	15403	g_19922	g_37453
ptg000074l	20561552	20564277	2725	g_37453	g_4536
ptg000074l	20574603	20594184	19581	g_4536	g_543
ptg000074l	20605553	20658467	52914	g_543	g_19310
ptg000074l	20660366	20662664	2298	g_19310	g_20369
ptg000074l	20666092	20668378	2286	g_20369	g_13574
ptg000074l	20681368	20684791	3423	g_13574	g_255
ptg000074l	20690868	20691093	225	g_255	g_27356
ptg000074l	20693824	20694337	513	g_27356	g_35548
ptg000074l	20696512	20703917	7405	g_35548	g_10917
ptg000074l	20705315	20707036	1721	g_10917	g_21400
ptg000074l	20709435	20735812	26377	g_21400	g_17153
ptg000074l	20736966	20793411	56445	g_17153	g_14546
ptg000074l	20801635	20823745	22110	g_14546	g_30467
ptg000074l	20831979	20836023	4044	g_30467	g_25205
ptg000074l	20837114	20837859	745	g_25205	g_32621
ptg000074l	20842061	20852394	10333	g_32621	g_24838
ptg000074l	20875822	20882654	6832	g_24838	g_11803
ptg000074l	20888424	20891576	3152	g_11803	g_30172
ptg000074l	20892483	20893890	1407	g_30172	g_9904
ptg000074l	20896248	20902245	5997	g_9904	g_10035
ptg000074l	20906397	20909132	2735	g_10035	g_24737
ptg000074l	20911549	20912921	1372	g_24737	g_9839
ptg000074l	20914868	20916610	1742	g_9839	g_7483
ptg000074l	20916846	20922804	5958	g_7483	g_28579
ptg000074l	20923046	20927658	4612	g_28579	g_12454
ptg000074l	20936587	20939910	3323	g_12454	g_20112
ptg000074l	20940338	20994459	54121	g_20112	g_7885
ptg000074l	20995812	20998270	2458	g_7885	g_5817
ptg000074l	21007870	21011941	4071	g_5817	g_21713
ptg000074l	21013795	21016900	3105	g_21713	g_36719
ptg000074l	21033414	21073368	39954	g_36719	g_37691
ptg000074l	21074030	21103010	28980	g_37691	g_24433
ptg000074l	21117653	21299000	181347	g_24433	g_32231
ptg000074l	21299992	21308902	8910	g_32231	g_7186
ptg000074l	21313980	21318649	4669	g_7186	g_40027
ptg000074l	21321002	21327518	6516	g_40027	g_28103
ptg000074l	21328471	21333735	5264	g_28103	g_17162
ptg000074l	21335547	21345037	9490	g_17162	g_21872
ptg000074l	21356916	21375997	19081	g_21872	g_19681
ptg000074l	21382483	21387511	5028	g_19681	g_15886
ptg000074l	21388140	21517189	129049	g_15886	g_26597
ptg000074l	21518250	21547162	28912	g_26597	g_33338
ptg000074l	21547713	21584819	37106	g_33338	g_20251
ptg000074l	21609333	21611699	2366	g_20251	g_32989
ptg000074l	21634515	21662272	27757	g_32989	g_32206
ptg000074l	21662832	21722937	60105	g_32206	g_9431
ptg000074l	21726796	21739309	12513	g_9431	g_40231
ptg000074l	21742447	21744363	1916	g_40231	g_22772
ptg000074l	21747906	21753688	5782	g_22772	g_38335
ptg000074l	21753999	21768559	14560	g_38335	g_28270
ptg000074l	21772087	21793068	20981	g_28270	g_23258
ptg000074l	21796561	21804123	7562	g_23258	g_34540
ptg000074l	21804470	21807240	2770	g_34540	g_461
ptg000074l	21810762	21819468	8706	g_461	g_25552
ptg000074l	21821238	21824469	3231	g_25552	g_7371
ptg000074l	21828186	21856207	28021	g_7371	g_33378
ptg000074l	21859517	21902271	42754	g_33378	g_36259
ptg000074l	21906513	21907266	753	g_36259	g_40089
ptg000074l	21910235	21910787	552	g_40089	g_40090
ptg000074l	21911885	21915429	3544	g_40090	g_10658
ptg000074l	21915821	21921175	5354	g_10658	g_25309
ptg000074l	21923933	21929979	6046	g_25309	g_35470
ptg000074l	21931077	21955610	24533	g_35470	g_36967
ptg000074l	21967352	22023703	56351	g_36967	g_30502
ptg000074l	22024365	22045117	20752	g_30502	g_6097
ptg000074l	22050175	22097898	47723	g_6097	g_25906
ptg000074l	22116928	22124538	7610	g_25906	g_39998
ptg000074l	22128511	22132652	4141	g_39998	g_14381
ptg000074l	22132891	22135028	2137	g_14381	g_5335
ptg000074l	22138966	22146569	7603	g_5335	g_31123
ptg000074l	22161657	22174290	12633	g_31123	g_7489
ptg000074l	22178708	22251336	72628	g_7489	g_16066
ptg000074l	22253713	22255214	1501	g_16066	g_22037
ptg000074l	22275070	22289384	14314	g_22037	g_36245
ptg000074l	22293623	22297831	4208	g_36245	g_3869
ptg000074l	22302262	22303824	1562	g_3869	g_3240
ptg000074l	22306901	22311362	4461	g_3240	g_14407
ptg000074l	22315507	22395340	79833	g_14407	g_7340
ptg000074l	22400086	22418618	18532	g_7340	g_4299
ptg000074l	22432120	22453270	21150	g_4299	g_4429
ptg000074l	22456485	22462850	6365	g_4429	g_36299
ptg000074l	22465661	22466765	1104	g_36299	g_31180
ptg000074l	22467947	22577334	109387	g_31180	g_828
ptg000074l	22580715	22582414	1699	g_828	g_13927
ptg000074l	22583622	22584920	1298	g_13927	g_14939
ptg000074l	22588636	22610128	21492	g_14939	g_4949
ptg000074l	22610448	22641061	30613	g_4949	g_9295
ptg000074l	22642632	22683597	40965	g_9295	g_37403
ptg000074l	22702343	22740347	38004	g_37403	g_29341
ptg000074l	22764293	22961858	197565	g_29341	g_10049
ptg000074l	22977150	22999541	22391	g_10049	g_10010
ptg000074l	23008271	23019485	11214	g_10010	g_35092
ptg000074l	23022566	23030941	8375	g_35092	g_39430
ptg000074l	23035339	23151240	115901	g_14634	g_26526
ptg000074l	23151560	23155036	3476	g_26526	g_10937
ptg000074l	23155533	23218748	63215	g_10937	g_34093
ptg000074l	23220391	23224462	4071	g_34093	g_31600
ptg000074l	23231792	23238043	6251	g_31600	g_29472
ptg000074l	23242969	23250913	7944	g_29472	g_24250
ptg000074l	23258660	23264229	5569	g_24250	g_10282
ptg000074l	23272511	23287929	15418	g_10282	g_26343
ptg000074l	23290112	23356695	66583	g_26343	g_22342
ptg000074l	23356961	23388635	31674	g_22342	g_17941
ptg000074l	23410777	23668199	257422	g_17941	g_6637
ptg000074l	23670595	23673523	2928	g_6637	g_37898
ptg000074l	23683052	23688192	5140	g_37898	g_30016
ptg000074l	23694806	23702501	7695	g_30016	g_34760
ptg000074l	23709640	23710155	515	g_34760	g_18613
ptg000074l	23714301	23719769	5468	g_18613	g_13857
ptg000074l	23723852	23746351	22499	g_13857	g_3116
ptg000074l	23759533	23769950	10417	g_3116	g_14313
ptg000074l	23776452	23787524	11072	g_14313	g_40132
ptg000074l	23799007	23852399	53392	g_40132	g_38487
ptg000074l	23854555	23887096	32541	g_38487	g_19718
ptg000074l	23903279	23904979	1700	g_19718	g_743
ptg000074l	23906947	23907476	529	g_743	g_13741
ptg000074l	23909646	23911602	1956	g_13741	g_40125
ptg000074l	23928188	23929511	1323	g_40125	g_13511
ptg000074l	23934106	23936528	2422	g_13511	g_30634
ptg000074l	23938607	23944023	5416	g_30634	g_26857
ptg000074l	23946537	23949448	2911	g_26857	g_27065
ptg000074l	23950197	23972980	22783	g_27065	g_14084
ptg000074l	23986693	23995579	8886	g_14084	g_2826
ptg000074l	24029673	24037614	7941	g_2826	g_13033
ptg000074l	24038240	24051368	13128	g_13033	g_2694
ptg000074l	24060231	24071724	11493	g_2694	g_29806
ptg000074l	24071966	24124892	52926	g_29806	g_3730
ptg000074l	24137362	24151318	13956	g_3730	g_20777
ptg000074l	24154275	24156253	1978	g_20777	g_12631
ptg000074l	24163423	24167196	3773	g_12631	g_15257
ptg000074l	24170579	24176141	5562	g_15257	g_105
ptg000074l	24179627	24181433	1806	g_105	g_9066
ptg000074l	24183874	24190132	6258	g_9066	g_22322
ptg000074l	24191643	24195185	3542	g_22322	g_5459
ptg000074l	24198300	24212797	14497	g_5459	g_20479
ptg000074l	24218462	24225802	7340	g_20479	g_15990
ptg000074l	24230888	24260826	29938	g_15990	g_651
ptg000074l	24274753	24277383	2630	g_651	g_18246
ptg000074l	24278330	24312149	33819	g_18246	g_17726
ptg000074l	24313063	24333824	20761	g_17726	g_15503
ptg000074l	24334738	24356849	22111	g_15503	g_22758
ptg000074l	24358481	24361646	3165	g_22758	g_40230
ptg000074l	24362458	24397746	35288	g_40230	g_20186
ptg000074l	24399304	24422935	23631	g_20186	g_29372
ptg000074l	24424755	24427609	2854	g_29372	g_34255
ptg000074l	24428421	24432455	4034	g_34255	g_40287
ptg000074l	24435307	24439991	4684	g_40287	g_28769
ptg000074l	24440905	24471192	30287	g_28769	g_23611
ptg000074l	24472106	24480911	8805	g_23611	g_11033
ptg000074l	24482467	24486592	4125	g_11033	g_21708
ptg000074l	24487506	24503161	15655	g_21708	g_26788
ptg000074l	24504090	24512222	8132	g_26788	g_17307
ptg000074l	24514016	24535939	21923	g_17307	g_36271
ptg000074l	24538959	24555587	16628	g_36271	g_34709
ptg000074l	24570306	24598232	27926	g_34709	g_39031
ptg000074l	24599362	24648932	49570	g_39031	g_37190
ptg000074l	24658622	24661598	2976	g_37190	g_34060
ptg000074l	24668625	24807620	138995	g_34060	g_37812
ptg000074l	24807892	25158995	351103	g_37812	g_29282
ptg000074l	25159246	25196209	36963	g_29282	g_2625
ptg000074l	25196607	25391603	194996	g_2625	g_18995
ptg000074l	25411545	25420655	9110	g_18995	g_31440
ptg000074l	25424236	25546373	122137	g_31440	g_13186
ptg000074l	25548879	25553341	4462	g_13186	g_5186
ptg000074l	25554272	25670058	115786	g_5186	g_21322
ptg000074l	25709169	25728288	19119	g_21322	g_11831
ptg000074l	25733275	25735250	1975	g_11831	g_18770
ptg000074l	25738070	25747749	9679	g_18770	g_3466
ptg000074l	25750097	25751790	1693	g_3466	g_25840
ptg000074l	25754012	25764108	10096	g_25840	g_21908
ptg000074l	25765088	25812720	47632	g_21908	g_31969
ptg000074l	25824504	25862679	38175	g_31969	g_36392
ptg000074l	25863134	25878508	15374	g_36392	g_26072
ptg000074l	25972616	25974000	1384	g_26072	g_33101
ptg000074l	25975079	26031879	56800	g_33101	g_34972
ptg000074l	26046588	26051382	4794	g_34972	g_5528
ptg000074l	26058847	26091458	32611	g_5528	g_14081
ptg000074l	26100442	26105027	4585	g_14081	g_5249
ptg000074l	26112788	26118962	6174	g_5249	g_6290
ptg000074l	26119621	26121069	1448	g_6290	g_7039
ptg000074l	26121428	26169575	48147	g_7039	g_21052
ptg000074l	26180651	26184915	4264	g_21052	g_13163
ptg000074l	26195817	26203951	8134	g_13163	g_3899
ptg000074l	26211710	26220751	9041	g_3899	g_2698
ptg000074l	26225946	26243804	17858	g_2698	g_18201
ptg000074l	26246092	26278041	31949	g_18201	g_8233
ptg000074l	26296367	26382597	86230	g_8233	g_3453
ptg000074l	26397334	26455439	58105	g_3453	g_14451
ptg000074l	26467433	26493101	25668	g_14451	g_2841
ptg000074l	26493988	26495270	1282	g_2841	g_18250
ptg000074l	26496040	26497918	1878	g_18250	g_14912
ptg000074l	26525156	26537805	12649	g_14912	g_5503
ptg000074l	26542199	26542895	696	g_5503	g_22588
ptg000074l	26544857	26558073	13216	g_22588	g_26386
ptg000074l	26577830	26689232	111402	g_26386	g_37544
ptg000074l	26689615	26844161	154546	g_37544	g_9460
ptg000074l	26849751	26881307	31556	g_9460	g_29102
ptg000074l	26882915	26889283	6368	g_29102	g_15410
ptg000074l	26893532	26896063	2531	g_15410	g_36068
ptg000074l	26916671	26950320	33649	g_36068	g_18331
ptg000074l	26973438	27043613	70175	g_18331	g_12607
ptg000074l	27043852	27050398	6546	g_12607	g_30910
ptg000074l	27051498	27061505	10007	g_30910	g_34350
ptg000074l	27068204	27135673	67469	g_34350	g_32994
ptg000074l	27138568	27165686	27118	g_32994	g_15760
ptg000074l	27168759	27180462	11703	g_15760	g_35010
ptg000074l	27182251	27184097	1846	g_35010	g_24141
ptg000074l	27184513	27184991	478	g_24141	g_39426
ptg000074l	27186511	27198833	12322	g_39426	g_23943
ptg000074l	27211776	27216085	4309	g_23943	g_35827
ptg000074l	27217026	27288390	71364	g_35827	g_25610
ptg000074l	27289031	27356706	67675	g_25610	g_15421
ptg000074l	27358321	27463621	105300	g_15421	g_19340
ptg000074l	27464424	27479485	15061	g_19340	g_34533
ptg000074l	27485768	27517184	31416	g_34533	g_32720
ptg000074l	27517567	27523241	5674	g_32720	g_34904
ptg000074l	27530349	27536777	6428	g_34904	g_646
ptg000074l	27537214	27563881	26667	g_646	g_21281
ptg000074l	27564105	27567704	3599	g_21281	g_19526
ptg000074l	27574778	27579368	4590	g_19526	g_20196
ptg000074l	27601257	27620428	19171	g_20196	g_24624
ptg000074l	27627584	27630070	2486	g_24624	g_10161
ptg000074l	27637117	27639488	2371	g_10161	g_17838
ptg000074l	27659228	27754297	95069	g_17838	g_7795
ptg000074l	27825330	27932692	107362	g_7795	g_33757
ptg000074l	27936594	28233084	296490	g_33757	g_11872
ptg000074l	28233983	28371556	137573	g_11872	g_23533
ptg000074l	28372248	28479330	107082	g_23533	g_14139
ptg000074l	28487719	28492447	4728	g_14139	g_6695
ptg000074l	28498559	28506435	7876	g_6695	g_6807
ptg000074l	28515498	28601064	85566	g_6807	g_10127
ptg000074l	28601432	28601774	342	g_10127	g_35597
ptg000074l	28602145	28642610	40465	g_35597	g_4174
ptg000074l	28642906	28655439	12533	g_4174	g_30255
ptg000074l	28655699	28661560	5861	g_30255	g_10304
ptg000074l	28665172	28674820	9648	g_10304	g_8820
ptg000074l	28688671	28699370	10699	g_8820	g_32766
ptg000074l	28760560	28764189	3629	g_32766	g_10112
ptg000074l	28776518	28778174	1656	g_10112	g_27998
ptg000074l	28786859	28793353	6494	g_39025	g_14295
ptg000074l	28796446	28804583	8137	g_14295	g_5364
ptg000074l	28807781	28807890	109	g_5364	g_20742
ptg000074l	28810046	28813429	3383	g_20742	g_18124
ptg000074l	28818631	28821878	3247	g_18124	g_14133
ptg000074l	28831128	28835026	3898	g_14133	g_17980
ptg000074l	28840852	28844316	3464	g_17980	g_30390
ptg000074l	28845572	28846392	820	g_30390	g_35826
ptg000074l	28850432	28872243	21811	g_35826	g_34528
ptg000074l	28872845	28889079	16234	g_34528	g_5622
ptg000074l	28889483	29063831	174348	g_5622	g_18704
ptg000074l	29067497	29135896	68399	g_18704	g_14017
ptg000074l	29136522	29260151	123629	g_14017	g_34143
ptg000074l	29271298	29272509	1211	g_34143	g_37457
ptg000074l	29277302	29289403	12101	g_37457	g_29657
ptg000074l	29313408	29390870	77462	g_29657	g_24485
ptg000074l	29392972	29403636	10664	g_24485	g_12497
ptg000074l	29430265	29438973	8708	g_12497	g_12758
ptg000074l	29439881	29463295	23414	g_12758	g_28731
ptg000074l	29470898	29536333	65435	g_28731	g_24161
ptg000074l	29544390	29565678	21288	g_24161	g_34912
ptg000074l	29568074	29573623	5549	g_34912	g_25333
ptg000074l	29573922	29591246	17324	g_25333	g_9048
ptg000074l	29599456	29600802	1346	g_9048	g_17287
ptg000074l	29620617	29651757	31140	g_17287	g_33488
ptg000074l	29667642	29676838	9196	g_33488	g_37927
ptg000074l	29677302	29680099	2797	g_37927	g_38297
ptg000074l	29688292	29696289	7997	g_38297	g_7639
ptg000074l	29707196	29750294	43098	g_7639	g_22507
ptg000074l	29770987	29787859	16872	g_22507	g_9501
ptg000074l	29824876	29956658	131782	g_9501	g_24765
ptg000074l	29958963	30013412	54449	g_24765	g_35182
ptg000074l	30031963	30069335	37372	g_35182	g_2121
ptg000074l	30080745	30168804	88059	g_2121	g_15733
ptg000074l	30181766	30187080	5314	g_15733	g_19004
ptg000074l	30201501	30203797	2296	g_19004	g_28760
ptg000074l	30221177	30342374	121197	g_28760	g_9657
ptg000074l	30346701	30348788	2087	g_9657	g_15409
ptg000074l	30350146	30351727	1581	g_15409	g_27494
ptg000074l	30359287	30431017	71730	g_27494	g_31660
ptg000074l	30435058	30453951	18893	g_31660	g_23930
ptg000074l	30454256	30464779	10523	g_23930	g_11371
ptg000074l	30465054	30641822	176768	g_11371	g_10813
ptg000074l	30642022	30706901	64879	g_10813	g_1605
ptg000075l	5952	38495	32543	g_36303	g_6658
ptg000075l	46648	50463	3815	g_6658	g_6818
ptg000075l	53575	80200	26625	g_6818	g_18816
ptg000075l	84836	178667	93831	g_18816	g_26403
ptg000075l	195053	301606	106553	g_26403	g_5042
ptg000075l	303846	330725	26879	g_5042	g_17385
ptg000075l	334897	335981	1084	g_17385	g_10637
ptg000075l	338003	341515	3512	g_10637	g_14526
ptg000075l	344029	345501	1472	g_14526	g_40020
ptg000075l	346278	347734	1456	g_40020	g_6562
ptg000075l	349006	352327	3321	g_6562	g_26581
ptg000075l	354378	355792	1414	g_26581	g_7818
ptg000075l	357251	358527	1276	g_7818	g_40035
ptg000075l	359795	361739	1944	g_40035	g_34990
ptg000075l	382393	444537	62144	g_34990	g_15039
ptg000075l	444791	461683	16892	g_15039	g_6279
ptg000075l	462423	492699	30276	g_6279	g_29401
ptg000075l	517002	535934	18932	g_29401	g_11283
ptg000075l	538133	539596	1463	g_11283	g_40095
ptg000075l	542391	552253	9862	g_40095	g_33769
ptg000075l	563601	565218	1617	g_33769	g_8299
ptg000075l	569482	572177	2695	g_8299	g_23448
ptg000075l	575666	656846	81180	g_23448	g_37772
ptg000075l	657184	777949	120765	g_37772	g_4769
ptg000075l	795756	797667	1911	g_4769	g_36494
ptg000075l	798182	854430	56248	g_36494	g_4754
ptg000075l	865420	911096	45676	g_4754	g_17718
ptg000075l	920834	975531	54697	g_17718	g_35035
ptg000075l	977866	983103	5237	g_35035	g_30421
ptg000075l	995806	1005353	9547	g_30421	g_15420
ptg000075l	1010204	1016587	6383	g_15420	g_12523
ptg000075l	1026882	1038148	11266	g_12523	g_3913
ptg000075l	1052574	1063631	11057	g_3913	g_16591
ptg000075l	1066134	1074222	8088	g_16591	g_21433
ptg000075l	1074939	1100080	25141	g_21433	g_25148
ptg000075l	1100797	1108259	7462	g_25148	g_26784
ptg000075l	1110429	1149619	39190	g_26784	g_10774
ptg000075l	1149909	1187185	37276	g_10774	g_35185
ptg000075l	1194890	1199479	4589	g_35185	g_25672
ptg000075l	1214877	1217570	2693	g_25672	g_2539
ptg000075l	1220376	1227691	7315	g_2539	g_32668
ptg000075l	1233279	1234492	1213	g_32668	g_27991
ptg000075l	1237489	1273477	35988	g_27991	g_25221
ptg000075l	1274838	1287566	12728	g_25221	g_7535
ptg000075l	1288345	1294588	6243	g_7535	g_19833
ptg000076l	39337	45654	6317	g_12682	g_16830
ptg000076l	53628	62907	9279	g_16830	g_5056
ptg000076l	88448	103448	15000	g_5056	g_13187
ptg000076l	103648	139992	36344	g_13187	g_5015
ptg000076l	150214	155465	5251	g_5015	g_15749
ptg000076l	167629	172496	4867	g_15749	g_38791
ptg000076l	173089	179839	6750	g_38791	g_29592
ptg000076l	192150	202348	10198	g_29592	g_25776
ptg000076l	202635	203113	478	g_25776	g_40273
ptg000076l	203799	209632	5833	g_40273	g_6524
ptg000076l	227373	241826	14453	g_6524	g_8104
ptg000076l	242908	256428	13520	g_8104	g_20092
ptg000076l	280744	298422	17678	g_20092	g_614
ptg000076l	308321	405487	97166	g_614	g_34323
ptg000076l	411521	418279	6758	g_34323	g_170
ptg000076l	428896	442497	13601	g_170	g_30052
ptg000076l	452555	455179	2624	g_30052	g_31558
ptg000076l	465394	473333	7939	g_31558	g_38282
ptg000076l	473758	485623	11865	g_38282	g_1165
ptg000076l	495246	500427	5181	g_1165	g_11398
ptg000076l	507165	640497	133332	g_11398	g_10934
ptg000076l	640931	665293	24362	g_10934	g_1260
ptg000076l	677008	734037	57029	g_1260	g_39666
ptg000076l	734456	759650	25194	g_39666	g_17156
ptg000076l	775065	779806	4741	g_17156	g_35291
ptg000076l	790601	806979	16378	g_35291	g_17447
ptg000076l	808055	811999	3944	g_17447	g_35706
ptg000076l	814464	826011	11547	g_35706	g_25272
ptg000076l	859926	890796	30870	g_25272	g_28131
ptg000076l	909252	950287	41035	g_28131	g_16019
ptg000076l	958479	965172	6693	g_16019	g_7840
ptg000076l	965402	979881	14479	g_7840	g_24230
ptg000076l	1007371	1153460	146089	g_24230	g_35606
ptg000076l	1153873	1190714	36841	g_35606	g_34641
ptg000076l	1192657	1247501	54844	g_34641	g_18610
ptg000076l	1269572	1350789	81217	g_18610	g_27891
ptg000076l	1359758	1412614	52856	g_27891	g_29522
ptg000076l	1413390	1457036	43646	g_29522	g_19131
ptg000076l	1457797	1481507	23710	g_19131	g_12985
ptg000076l	1485019	1500712	15693	g_12985	g_19322
ptg000076l	1508915	1511370	2455	g_19322	g_11868
ptg000076l	1519315	1572858	53543	g_11868	g_8859
ptg000076l	1579901	1651897	71996	g_8859	g_39561
ptg000076l	1654113	1662339	8226	g_39561	g_28052
ptg000076l	1662899	1736021	73122	g_28052	g_36741
ptg000076l	1737274	1751449	14175	g_36741	g_6023
ptg000076l	1755511	1761803	6292	g_6023	g_11268
ptg000076l	1774217	1775609	1392	g_11268	g_5980
ptg000076l	1784048	1825871	41823	g_5980	g_21021
ptg000076l	1828628	1829412	784	g_21021	g_13384
ptg000076l	1829678	1830669	991	g_13384	g_5865
ptg000076l	1831353	1836065	4712	g_5865	g_5674
ptg000076l	1836707	1836794	87	g_5674	g_27500
ptg000076l	1837090	1882504	45414	g_27500	g_25068
ptg000076l	1882728	2123625	240897	g_25068	g_13722
ptg000078l	12344	25551	13207	g_26545	g_17454
ptg000078l	27073	32170	5097	g_17454	g_17999
ptg000078l	33606	47986	14380	g_17999	g_37784
ptg000078l	55670	66827	11157	g_37784	g_32398
ptg000078l	81084	82789	1705	g_32398	g_34305
ptg000078l	85504	88839	3335	g_34305	g_13198
ptg000078l	98535	102321	3786	g_13198	g_30239
ptg000078l	119128	127986	8858	g_30239	g_3087
ptg000078l	137739	148570	10831	g_3087	g_8431
ptg000078l	154572	158398	3826	g_8431	g_38268
ptg000078l	158925	172008	13083	g_38268	g_7273
ptg000078l	172526	193961	21435	g_7273	g_453
ptg000078l	194560	202330	7770	g_453	g_23158
ptg000078l	202902	247099	44197	g_23158	g_10720
ptg000078l	247299	247979	680	g_10720	g_14366
ptg000078l	248179	248215	36	g_14366	g_29836
ptg000078l	248457	248493	36	g_29836	g_30273
ptg000078l	248693	248729	36	g_30273	g_11936
ptg000078l	249199	249242	43	g_11936	g_8406
ptg000078l	249490	261537	12047	g_8406	g_27457
ptg000078l	281950	317111	35161	g_27457	g_8749
ptg000078l	317708	389162	71454	g_8749	g_28608
ptg000078l	401822	423473	21651	g_28608	g_36417
ptg000078l	436670	440244	3574	g_36417	g_28751
ptg000078l	446197	448165	1968	g_28751	g_22203
ptg000078l	451762	466264	14502	g_22203	g_35625
ptg000078l	472245	479623	7378	g_35625	g_34153
ptg000078l	498017	502419	4402	g_34153	g_25012
ptg000078l	508980	555438	46458	g_25012	g_16814
ptg000078l	555926	576299	20373	g_16814	g_7523
ptg000078l	582498	614010	31512	g_7523	g_25576
ptg000078l	615059	727833	112774	g_25576	g_33396
ptg000078l	738200	745159	6959	g_33396	g_2484
ptg000078l	756950	761201	4251	g_2484	g_11784
ptg000078l	776976	779161	2185	g_11784	g_36054
ptg000078l	796588	800486	3898	g_36054	g_36185
ptg000078l	826023	835883	9860	g_36185	g_29731
ptg000078l	849378	855127	5749	g_29731	g_3029
ptg000078l	868667	978349	109682	g_3029	g_17535
ptg000078l	989938	992922	2984	g_17535	g_9519
ptg000078l	994595	1005218	10623	g_9519	g_34316
ptg000078l	1015548	1019937	4389	g_34316	g_21590
ptg000078l	1025871	1070981	45110	g_21590	g_29631
ptg000078l	1083865	1088333	4468	g_29631	g_7136
ptg000078l	1094167	1108915	14748	g_7136	g_34870
ptg000078l	1132085	1137765	5680	g_34870	g_13621
ptg000078l	1152558	1169943	17385	g_13621	g_15463
ptg000078l	1171058	1171162	104	g_15463	g_40145
ptg000078l	1181525	1187687	6162	g_40145	g_20772
ptg000078l	1203124	1206250	3126	g_20772	g_1443
ptg000078l	1207269	1208074	805	g_1443	g_33114
ptg000078l	1215349	1220618	5269	g_33114	g_19300
ptg000078l	1229587	1238081	8494	g_19300	g_11603
ptg000078l	1239067	1239872	805	g_11603	g_14627
ptg000078l	1247031	1251651	4620	g_14627	g_4188
ptg000078l	1260710	1269189	8479	g_4188	g_20130
ptg000078l	1278896	1287828	8932	g_20130	g_292
ptg000078l	1288760	1297259	8499	g_292	g_31697
ptg000078l	1298278	1299083	805	g_31697	g_7354
ptg000078l	1306542	1311380	4838	g_7354	g_13753
ptg000078l	1320422	1328923	8501	g_13753	g_1269
ptg000078l	1338533	1404174	65641	g_1269	g_12106
ptg000078l	1404443	1405675	1232	g_12106	g_27139
ptg000078l	1413480	1416889	3409	g_27139	g_7823
ptg000078l	1421886	1426320	4434	g_7823	g_14262
ptg000078l	1436215	1438096	1881	g_14262	g_11370
ptg000078l	1450176	1452471	2295	g_11370	g_2582
ptg000078l	1470403	1487241	16838	g_2582	g_31811
ptg000078l	1488077	1517713	29636	g_31811	g_9261
ptg000078l	1520554	1522854	2300	g_9261	g_3915
ptg000078l	1532630	1535993	3363	g_3915	g_29448
ptg000078l	1556125	1598352	42227	g_29448	g_34557
ptg000078l	1604292	1605716	1424	g_34557	g_3821
ptg000078l	1611988	1615108	3120	g_3821	g_11419
ptg000078l	1621385	1637103	15718	g_11419	g_36421
ptg000078l	1646109	1653846	7737	g_36421	g_21385
ptg000078l	1654601	1681749	27148	g_21385	g_12070
ptg000078l	1691403	1696122	4719	g_12070	g_29759
ptg000078l	1714795	1726451	11656	g_29759	g_21809
ptg000078l	1728352	1733574	5222	g_21809	g_414
ptg000078l	1734146	1834802	100656	g_414	g_1638
ptg000078l	1857201	1864842	7641	g_1638	g_36232
ptg000078l	1865575	1876631	11056	g_36232	g_29267
ptg000078l	1886953	1893356	6403	g_29267	g_13287
ptg000078l	1912843	1917035	4192	g_13287	g_16232
ptg000078l	1917967	1925420	7453	g_16232	g_13540
ptg000078l	1925890	1935729	9839	g_13540	g_31771
ptg000078l	1954462	1960178	5716	g_31771	g_27502
ptg000078l	1966258	1971786	5528	g_27502	g_24363
ptg000078l	1984654	2032992	48338	g_24363	g_6884
ptg000078l	2042428	2054150	11722	g_6884	g_15325
ptg000078l	2058878	2065051	6173	g_15325	g_19864
ptg000078l	2076087	2077181	1094	g_19864	g_26374
ptg000079l	80608	210049	129441	g_36138	g_2520
ptg000079l	242616	368739	126123	g_2520	g_28493
ptg000079l	384113	384217	104	g_28493	g_39748
ptg000079l	385032	524249	139217	g_39748	g_18516
ptg000079l	531751	536697	4946	g_18516	g_9218
ptg000079l	538217	541745	3528	g_9218	g_16831
ptg000079l	547607	567971	20364	g_16831	g_29225
ptg000079l	589103	597055	7952	g_29225	g_36556
ptg000079l	597705	604750	7045	g_36556	g_12653
ptg000079l	619914	673740	53826	g_12653	g_12258
ptg000079l	698952	721010	22058	g_12258	g_1360
ptg000079l	737100	828225	91125	g_1360	g_11163
ptg000079l	837013	936893	99880	g_11163	g_8064
ptg000079l	939907	973855	33948	g_8064	g_13327
ptg000079l	975252	1045027	69775	g_13327	g_7504
ptg000079l	1045743	1049388	3645	g_7504	g_26359
ptg000079l	1060566	1149884	89318	g_26359	g_27571
ptg000079l	1151374	1273778	122404	g_27571	g_14602
ptg000079l	1276833	1284535	7702	g_14602	g_26812
ptg000079l	1292769	1295374	2605	g_26812	g_9145
ptg000079l	1296177	1296225	48	g_9145	g_31364
ptg000079l	1296479	1296521	42	g_31364	g_4049
ptg000079l	1310895	1321539	10644	g_4049	g_23653
ptg000079l	1347897	1380304	32407	g_23653	g_7194
ptg000080l	19634	139956	120322	g_12089	g_7433
ptg000080l	152047	158820	6773	g_7433	g_16803
ptg000080l	166085	175518	9433	g_16803	g_18339
ptg000080l	175763	186565	10802	g_18339	g_24786
ptg000080l	187245	248606	61361	g_24786	g_14468
ptg000080l	249511	274833	25322	g_14468	g_11719
ptg000080l	308831	309215	384	g_11719	g_25853
ptg000080l	309493	339050	29557	g_25853	g_20837
ptg000080l	339484	357173	17689	g_20837	g_37867
ptg000080l	359320	361578	2258	g_37867	g_4898
ptg000080l	387315	393798	6483	g_4898	g_29866
ptg000080l	394608	432070	37462	g_29866	g_22797
ptg000080l	433488	436872	3384	g_22797	g_31539
ptg000080l	437483	461710	24227	g_31539	g_23154
ptg000080l	470446	472246	1800	g_23154	g_3778
ptg000080l	473718	485611	11893	g_3778	g_27235
ptg000080l	499693	531721	32028	g_27235	g_12006
ptg000080l	549438	562817	13379	g_12006	g_17740
ptg000080l	565300	632293	66993	g_17740	g_17269
ptg000080l	634518	637299	2781	g_17269	g_7601
ptg000080l	637643	719340	81697	g_7601	g_5523
ptg000080l	720164	794404	74240	g_5523	g_32631
ptg000080l	801957	804923	2966	g_32631	g_25286
ptg000080l	812759	835423	22664	g_25286	g_4711
ptg000080l	842842	848781	5939	g_4711	g_11789
ptg000080l	859280	873720	14440	g_11789	g_19808
ptg000080l	883087	887126	4039	g_19808	g_32111
ptg000080l	897997	899841	1844	g_32111	g_886
ptg000080l	900305	919736	19431	g_886	g_33760
ptg000080l	936923	938356	1433	g_33760	g_18050
ptg000080l	941036	948221	7185	g_18050	g_24016
ptg000080l	950707	951677	970	g_24016	g_34379
ptg000080l	962022	964497	2475	g_34379	g_28150
ptg000080l	972252	985795	13543	g_28150	g_1607
ptg000080l	993984	1022453	28469	g_1607	g_32876
ptg000080l	1045410	1046529	1119	g_32876	g_26227
ptg000080l	1053962	1056438	2476	g_26227	g_37072
ptg000080l	1064129	1066852	2723	g_37072	g_17077
ptg000080l	1069808	1088634	18826	g_17077	g_9247
ptg000080l	1103550	1108651	5101	g_9247	g_5325
ptg000080l	1109433	1113854	4421	g_5325	g_19789
ptg000080l	1118015	1118495	480	g_19789	g_16824
ptg000080l	1119061	1125125	6064	g_16824	g_37577
ptg000080l	1128612	1136236	7624	g_37577	g_40206
ptg000080l	1149913	1159747	9834	g_40206	g_20103
ptg000080l	1162284	1165211	2927	g_20103	g_4209
ptg000080l	1180044	1184444	4400	g_4209	g_6234
ptg000080l	1186757	1188632	1875	g_6234	g_33252
ptg000080l	1188946	1209483	20537	g_33252	g_4079
ptg000080l	1210388	1211620	1232	g_4079	g_3986
ptg000080l	1211934	1224820	12886	g_3986	g_5550
ptg000080l	1226040	1392062	166022	g_5550	g_6973
ptg000080l	1469711	1800625	330914	g_6973	g_33103
ptg000080l	1807398	1814059	6661	g_33103	g_7630
ptg000080l	1814526	1816334	1808	g_7630	g_23322
ptg000080l	1831571	1833331	1760	g_23322	g_40238
ptg000080l	1867992	1900980	32988	g_40238	g_16145
ptg000080l	1907421	1915605	8184	g_16145	g_2825
ptg000080l	1938392	1941114	2722	g_2825	g_29378
ptg000080l	1948173	2083666	135493	g_29378	g_9909
ptg000080l	2088841	2104881	16040	g_9909	g_7486
ptg000080l	2119814	2148807	28993	g_7486	g_11741
ptg000080l	2153500	2165541	12041	g_11741	g_18163
ptg000080l	2167166	2172731	5565	g_18163	g_23308
ptg000080l	2178895	2193811	14916	g_23308	g_31165
ptg000080l	2194071	2214959	20888	g_31165	g_9732
ptg000080l	2226577	2293039	66462	g_9732	g_14277
ptg000080l	2374241	2390092	15851	g_14277	g_34504
ptg000080l	2397278	2451472	54194	g_34504	g_25000
ptg000080l	2452131	2453322	1191	g_25000	g_35865
ptg000080l	2453654	2505235	51581	g_35865	g_21599
ptg000080l	2508714	2595593	86879	g_21599	g_3789
ptg000080l	2599243	2608356	9113	g_3789	g_12768
ptg000080l	2618171	2648266	30095	g_12768	g_8160
ptg000080l	2650960	2651974	1014	g_8160	g_10921
ptg000080l	2656246	2760958	104712	g_10921	g_31366
ptg000080l	2765994	2782403	16409	g_31366	g_8286
ptg000080l	2784040	2790263	6223	g_8286	g_22710
ptg000080l	2795582	2799801	4219	g_22710	g_24036
ptg000080l	2805575	2980165	174590	g_24036	g_26688
ptg000080l	3002117	3054299	52182	g_26688	g_35713
ptg000080l	3060097	3065505	5408	g_35713	g_29101
ptg000080l	3066146	3070052	3906	g_29101	g_11943
ptg000080l	3077399	3082995	5596	g_11943	g_4179
ptg000080l	3083261	3086213	2952	g_4179	g_22196
ptg000080l	3087313	3088144	831	g_22196	g_30000
ptg000080l	3088633	3095798	7165	g_30000	g_30842
ptg000080l	3096046	3124516	28470	g_30842	g_16873
ptg000080l	3144961	3215234	70273	g_16873	g_13843
ptg000080l	3227508	3232545	5037	g_13843	g_7252
ptg000080l	3236167	3390133	153966	g_7252	g_3048
ptg000080l	3405913	3410987	5074	g_3048	g_21485
ptg000080l	3425634	3438969	13335	g_21485	g_14792
ptg000080l	3447766	3451259	3493	g_14792	g_12679
ptg000080l	3457585	3459219	1634	g_12679	g_21464
ptg000080l	3460906	3499167	38261	g_21464	g_37678
ptg000080l	3504011	3506121	2110	g_37678	g_29840
ptg000080l	3508333	3509188	855	g_29840	g_16784
ptg000080l	3525533	3527188	1655	g_16784	g_33474
ptg000080l	3529753	3532163	2410	g_33474	g_9121
ptg000080l	3544840	3547545	2705	g_9121	g_4793
ptg000080l	3562563	3638343	75780	g_4793	g_15947
ptg000080l	3639347	3669609	30262	g_15947	g_25315
ptg000080l	3670799	3703929	33130	g_25315	g_25501
ptg000080l	3715214	3771572	56358	g_25501	g_38105
ptg000080l	3772108	3777590	5482	g_38105	g_6778
ptg000080l	3781064	3789976	8912	g_6778	g_4300
ptg000080l	3793197	3843633	50436	g_4300	g_6867
ptg000080l	3850577	3853941	3364	g_6867	g_11425
ptg000080l	3860295	3861929	1634	g_11425	g_36521
ptg000080l	3871898	3888799	16901	g_36521	g_21412
ptg000080l	3907803	3924544	16741	g_21412	g_16395
ptg000080l	3932422	3934252	1830	g_16395	g_4750
ptg000080l	3936960	3937818	858	g_4750	g_20737
ptg000080l	3940683	3951224	10541	g_20737	g_16679
ptg000080l	3954904	3967187	12283	g_16679	g_9624
ptg000080l	3992821	3996358	3537	g_9624	g_18142
ptg000080l	3998046	3999903	1857	g_18142	g_39921
ptg000080l	4001220	4010811	9591	g_39921	g_1223
ptg000080l	4015229	4244768	229539	g_1223	g_180
ptg000080l	4251563	4252924	1361	g_180	g_23058
ptg000080l	4256128	4257886	1758	g_23058	g_15315
ptg000080l	4260051	4261267	1216	g_15315	g_34410
ptg000080l	4265830	4270852	5022	g_34410	g_24931
ptg000080l	4272228	4298704	26476	g_24931	g_15446
ptg000080l	4299093	4302145	3052	g_15446	g_26696
ptg000080l	4314580	4314724	144	g_26696	g_40261
ptg000080l	4316766	4331827	15061	g_40261	g_10348
ptg000080l	4347646	4372863	25217	g_10348	g_4316
ptg000080l	4373882	4488565	114683	g_4316	g_5309
ptg000080l	4490676	4500505	9829	g_5309	g_11847
ptg000080l	4500750	4819634	318884	g_11847	g_26930
ptg000080l	4822153	4930198	108045	g_26930	g_16750
ptg000080l	4932828	5276560	343732	g_16750	g_17167
ptg000080l	5294820	5389910	95090	g_17167	g_5147
ptg000080l	5390410	5410691	20281	g_5147	g_3964
ptg000080l	5410945	5437873	26928	g_3964	g_18489
ptg000080l	5456126	5651504	195378	g_18489	g_13481
ptg000080l	5651785	5720620	68835	g_13481	g_9076
ptg000080l	5736400	5738087	1687	g_9076	g_13964
ptg000080l	5739331	5739525	194	g_13964	g_36123
ptg000080l	5754290	5754934	644	g_36123	g_34939
ptg000080l	5755146	5764298	9152	g_34939	g_37646
ptg000080l	5790914	5792103	1189	g_37646	g_32450
ptg000080l	5796407	5799788	3381	g_32450	g_15012
ptg000080l	5804563	5805215	652	g_15012	g_40139
ptg000080l	5805490	5809515	4025	g_40139	g_37983
ptg000080l	5813718	5820459	6741	g_37983	g_10857
ptg000080l	5821553	5826232	4679	g_10857	g_25851
ptg000080l	5834828	6003418	168590	g_25851	g_34136
ptg000080l	6024454	6025339	885	g_34136	g_23036
ptg000080l	6027420	6029228	1808	g_23036	g_32435
ptg000080l	6032021	6037319	5298	g_32435	g_9554
ptg000080l	6038293	6042415	4122	g_9554	g_40070
ptg000080l	6045410	6062115	16705	g_40070	g_17915
ptg000080l	6071947	6073192	1245	g_17915	g_33726
ptg000080l	6077821	6081479	3658	g_33726	g_28170
ptg000080l	6089183	6180885	91702	g_28170	g_8754
ptg000080l	6182253	6203630	21377	g_8754	g_32214
ptg000080l	6209580	6214036	4456	g_32214	g_2161
ptg000080l	6214641	6219033	4392	g_2161	g_10008
ptg000080l	6219932	6243262	23330	g_10008	g_39483
ptg000080l	6244403	6246349	1946	g_39483	g_5592
ptg000080l	6252253	6256393	4140	g_5592	g_33705
ptg000080l	6283421	6303548	20127	g_38849	g_17186
ptg000080l	6306583	6311844	5261	g_17186	g_37599
ptg000080l	6312866	6314499	1633	g_37599	g_30079
ptg000080l	6318905	6328509	9604	g_30079	g_19683
ptg000080l	6335303	6337806	2503	g_19683	g_13561
ptg000080l	6338735	6356045	17310	g_13561	g_34661
ptg000080l	6356974	6359222	2248	g_34661	g_34492
ptg000080l	6363093	6371019	7926	g_34492	g_9322
ptg000080l	6374811	6390237	15426	g_9322	g_8182
ptg000080l	6394221	6426838	32617	g_8182	g_28359
ptg000080l	6428749	6430439	1690	g_28359	g_2760
ptg000080l	6435982	6447281	11299	g_2760	g_3330
ptg000080l	6457093	6465983	8890	g_3330	g_31405
ptg000080l	6466567	6472355	5788	g_31405	g_33988
ptg000080l	6481253	6491747	10494	g_33988	g_16212
ptg000080l	6492106	6496193	4087	g_16212	g_38137
ptg000080l	6496492	6499910	3418	g_38137	g_29079
ptg000080l	6500864	6503586	2722	g_29079	g_35927
ptg000080l	6513178	6521959	8781	g_35927	g_18608
ptg000080l	6525004	6527401	2397	g_18608	g_14444
ptg000080l	6527655	6532025	4370	g_14444	g_7771
ptg000080l	6536283	6557021	20738	g_7771	g_12740
ptg000080l	6564980	6567488	2508	g_12740	g_16866
ptg000080l	6568666	6581068	12402	g_16866	g_19799
ptg000080l	6597519	6601869	4350	g_19799	g_17787
ptg000080l	6606413	6625689	19276	g_17787	g_39705
ptg000080l	6625907	6652524	26617	g_39705	g_7728
ptg000080l	6653417	6656401	2984	g_7728	g_35089
ptg000080l	6663875	6684561	20686	g_35089	g_36535
ptg000080l	6687381	6718835	31454	g_36535	g_9986
ptg000080l	6720501	6722504	2003	g_9986	g_3295
ptg000080l	6727807	6851799	123992	g_3295	g_12723
ptg000080l	6852044	6855751	3707	g_12723	g_27968
ptg000080l	6867381	6908035	40654	g_27968	g_22321
ptg000080l	6925112	6939141	14029	g_22321	g_21841
ptg000080l	6943111	6963516	20405	g_21841	g_27454
ptg000080l	6972776	6991865	19089	g_27454	g_35859
ptg000080l	6996450	6999490	3040	g_35859	g_30338
ptg000080l	7001157	7012025	10868	g_30338	g_12636
ptg000080l	7025681	7049435	23754	g_12636	g_15752
ptg000080l	7056027	7059233	3206	g_15752	g_4932
ptg000080l	7063982	7071915	7933	g_4932	g_27943
ptg000080l	7074206	7080642	6436	g_27943	g_24541
ptg000080l	7086742	7139591	52849	g_24541	g_8956
ptg000080l	7152187	7170727	18540	g_8956	g_2071
ptg000080l	7184790	7191158	6368	g_2071	g_17455
ptg000080l	7197298	7203946	6648	g_17455	g_348
ptg000080l	7325656	7382757	57101	g_348	g_4780
ptg000080l	7383059	7388186	5127	g_4780	g_30846
ptg000080l	7402485	7402562	77	g_30846	g_31883
ptg000080l	7402792	7463475	60683	g_31883	g_2083
ptg000080l	7466590	7467408	818	g_2083	g_12205
ptg000080l	7471541	7483180	11639	g_12205	g_38191
ptg000080l	7486675	7488729	2054	g_38191	g_24183
ptg000080l	7495637	7508318	12681	g_24183	g_27977
ptg000080l	7529602	7581832	52230	g_27977	g_31571
ptg000080l	7588241	7590497	2256	g_31571	g_25798
ptg000080l	7596631	7598712	2081	g_25798	g_23983
ptg000080l	7628715	7635271	6556	g_23983	g_6215
ptg000080l	7643069	7649350	6281	g_6215	g_23636
ptg000080l	7653249	7708448	55199	g_23636	g_5403
ptg000080l	7709487	7709740	253	g_5403	g_2697
ptg000080l	7709940	7737815	27875	g_2697	g_26569
ptg000080l	7738162	7754414	16252	g_26569	g_32305
ptg000080l	7754662	7762056	7394	g_32305	g_12793
ptg000080l	7764287	7788515	24228	g_12793	g_13776
ptg000080l	7788736	7859137	70401	g_13776	g_12134
ptg000080l	7861007	7866249	5242	g_12134	g_34240
ptg000080l	7871312	7922829	51517	g_34240	g_32095
ptg000080l	7924073	7956352	32279	g_32095	g_9648
ptg000080l	7956585	8000685	44100	g_9648	g_33088
ptg000080l	8001665	8022152	20487	g_33088	g_21627
ptg000080l	8038663	8042603	3940	g_21627	g_25920
ptg000080l	8044350	8046459	2109	g_25920	g_29115
ptg000080l	8049761	8051031	1270	g_29115	g_40271
ptg000080l	8052092	8099810	47718	g_40271	g_17875
ptg000080l	8104423	8107341	2918	g_17875	g_17849
ptg000080l	8108342	8110853	2511	g_17849	g_39139
ptg000080l	8111587	8124177	12590	g_39139	g_19172
ptg000080l	8124722	8152725	28003	g_19172	g_11152
ptg000080l	8154808	8157942	3134	g_11152	g_11009
ptg000080l	8160610	8165791	5181	g_11009	g_2526
ptg000080l	8168692	8204384	35692	g_2526	g_4210
ptg000080l	8206372	8222416	16044	g_4210	g_14430
ptg000080l	8235434	8240099	4665	g_14430	g_9356
ptg000080l	8242707	8265436	22729	g_9356	g_15055
ptg000080l	8268018	8283383	15365	g_15055	g_18411
ptg000080l	8285398	8288604	3206	g_18411	g_770
ptg000080l	8289531	8291862	2331	g_770	g_11488
ptg000080l	8298517	8304738	6221	g_11488	g_9466
ptg000080l	8309556	8319065	9509	g_9466	g_35084
ptg000080l	8329451	8399479	70028	g_35084	g_19491
ptg000080l	8402496	8439656	37160	g_19491	g_3203
ptg000080l	8445344	8449460	4116	g_3203	g_27202
ptg000080l	8455609	8500310	44701	g_27202	g_12645
ptg000080l	8509694	8552825	43131	g_12645	g_9234
ptg000080l	8555184	8555937	753	g_9234	g_18784
ptg000080l	8557550	8566524	8974	g_18784	g_17639
ptg000080l	8568547	8574616	6069	g_17639	g_18480
ptg000080l	8577530	8578456	926	g_18480	g_34745
ptg000080l	8581017	8597140	16123	g_34745	g_8792
ptg000080l	8597460	8603756	6296	g_8792	g_17146
ptg000080l	8604130	8634358	30228	g_17146	g_27768
ptg000080l	8651586	8656288	4702	g_27768	g_4797
ptg000080l	8660421	8661011	590	g_4797	g_19934
ptg000080l	8665681	8668407	2726	g_19934	g_6183
ptg000080l	8673267	8689790	16523	g_6183	g_27383
ptg000080l	8693172	8714854	21682	g_27383	g_38254
ptg000080l	8729817	8745152	15335	g_38254	g_1980
ptg000080l	8764196	8832928	68732	g_1980	g_14960
ptg000080l	8848005	8856084	8079	g_14960	g_18835
ptg000080l	8859066	9120244	261178	g_18835	g_570
ptg000080l	9120477	9140716	20239	g_570	g_16342
ptg000080l	9140922	9313788	172866	g_16342	g_18988
ptg000080l	9333461	9335899	2438	g_18988	g_9641
ptg000080l	9336114	9410166	74052	g_9641	g_3616
ptg000080l	9410531	9680267	269736	g_3616	g_34151
ptg000080l	9683860	9690088	6228	g_34151	g_18946
ptg000080l	9692805	9696435	3630	g_18946	g_10251
ptg000080l	9705663	9823811	118148	g_10251	g_24602
ptg000080l	9824041	9901539	77498	g_24602	g_5007
ptg000080l	9903290	10085735	182445	g_5007	g_4663
ptg000080l	10088176	10090037	1861	g_4663	g_30998
ptg000080l	10091088	10092952	1864	g_30998	g_36018
ptg000080l	10097933	10099594	1661	g_36018	g_12994
ptg000080l	10100298	10118874	18576	g_12994	g_7289
ptg000080l	10119113	10159985	40872	g_7289	g_13958
ptg000080l	10184282	10184636	354	g_13958	g_9067
ptg000080l	10185514	10187639	2125	g_9067	g_16894
ptg000080l	10192815	10219107	26292	g_16894	g_25710
ptg000080l	10224575	10226992	2417	g_25710	g_15721
ptg000080l	10239122	10244900	5778	g_15721	g_32722
ptg000080l	10266502	10269338	2836	g_32722	g_18085
ptg000080l	10269583	10274548	4965	g_18085	g_37597
ptg000080l	10276100	10278151	2051	g_37597	g_34352
ptg000080l	10279874	10331941	52067	g_34352	g_7060
ptg000080l	10340648	10347257	6609	g_7060	g_32140
ptg000080l	10350077	10353519	3442	g_32140	g_17728
ptg000080l	10364024	10393865	29841	g_17728	g_25804
ptg000080l	10405480	10416357	10877	g_25804	g_38081
ptg000080l	10430025	10470965	40940	g_38081	g_16660
ptg000080l	10496823	10514105	17282	g_16660	g_16322
ptg000080l	10514359	10577981	63622	g_16322	g_13331
ptg000080l	10578256	10584548	6292	g_13331	g_21354
ptg000080l	10585896	10587707	1811	g_21354	g_25302
ptg000080l	10594261	10632100	37839	g_25302	g_37908
ptg000080l	10633506	10665618	32112	g_37908	g_24409
ptg000080l	10668198	10689670	21472	g_24409	g_21563
ptg000080l	10692575	10695125	2550	g_39362	g_1576
ptg000080l	10695955	10698972	3017	g_1576	g_33263
ptg000080l	10699550	10709555	10005	g_33263	g_8107
ptg000080l	10709827	10755889	46062	g_8107	g_24888
ptg000080l	10758308	10760147	1839	g_24888	g_25556
ptg000080l	10763270	10768174	4904	g_25556	g_14185
ptg000080l	10771951	10829817	57866	g_14185	g_15121
ptg000080l	10846793	10853923	7130	g_15121	g_29415
ptg000080l	10859989	10885005	25016	g_29415	g_2560
ptg000080l	10904540	10913388	8848	g_2560	g_24958
ptg000080l	10914235	10918116	3881	g_24958	g_15980
ptg000080l	10920186	10930875	10689	g_15980	g_17823
ptg000080l	10951396	10963345	11949	g_17823	g_36744
ptg000080l	10970008	10981381	11373	g_36744	g_13527
ptg000080l	10982532	11038511	55979	g_13527	g_26144
ptg000080l	11043888	11052566	8678	g_26144	g_26950
ptg000080l	11073050	11076559	3509	g_26950	g_17218
ptg000080l	11081141	11087743	6602	g_17218	g_30601
ptg000080l	11093838	11099923	6085	g_30601	g_35965
ptg000080l	11105962	11107746	1784	g_35965	g_35149
ptg000080l	11112831	11113614	783	g_35149	g_37487
ptg000080l	11119015	11140704	21689	g_37487	g_5956
ptg000080l	11146184	11160641	14457	g_5956	g_20494
ptg000080l	11169140	11172626	3486	g_20494	g_10560
ptg000080l	11179513	11203249	23736	g_10560	g_7115
ptg000080l	11204265	11211353	7088	g_7115	g_20208
ptg000080l	11211631	11222961	11330	g_20208	g_32096
ptg000080l	11223254	11234914	11660	g_32096	g_9971
ptg000080l	11256897	11310243	53346	g_9971	g_10222
ptg000080l	11315314	11451321	136007	g_10222	g_2604
ptg000080l	11460982	11494920	33938	g_2604	g_30481
ptg000080l	11500775	11668501	167726	g_30481	g_1095
ptg000080l	11674150	11675235	1085	g_1095	g_13289
ptg000080l	11686144	11741092	54948	g_13289	g_10623
ptg000080l	11741493	11761456	19963	g_10623	g_37101
ptg000080l	11761710	11826847	65137	g_37101	g_34042
ptg000080l	11827614	11828154	540	g_34042	g_9930
ptg000080l	11828438	11851724	23286	g_9930	g_4246
ptg000080l	11852116	12094773	242657	g_4246	g_20515
ptg000080l	12095192	12112794	17602	g_20515	g_14522
ptg000080l	12113009	12130119	17110	g_14522	g_10345
ptg000080l	12131390	12157247	25857	g_10345	g_25071
ptg000080l	12168988	12171377	2389	g_25071	g_13411
ptg000080l	12193611	12197196	3585	g_13411	g_8591
ptg000080l	12199452	12209017	9565	g_8591	g_20179
ptg000080l	12217076	12225768	8692	g_20179	g_18166
ptg000080l	12231963	12238594	6631	g_18166	g_15362
ptg000080l	12240477	12279112	38635	g_15362	g_15743
ptg000080l	12284168	12285219	1051	g_15743	g_30975
ptg000080l	12286010	12303379	17369	g_30975	g_30337
ptg000080l	12310865	12318345	7480	g_30337	g_37839
ptg000080l	12320091	12363052	42961	g_37839	g_21225
ptg000080l	12364569	12447311	82742	g_21225	g_36114
ptg000080l	12447862	12478592	30730	g_36114	g_34185
ptg000080l	12481026	12536193	55167	g_34185	g_26424
ptg000080l	12537011	12546530	9519	g_26424	g_5487
ptg000080l	12546916	12565279	18363	g_5487	g_26286
ptg000080l	12566070	12570250	4180	g_26286	g_36347
ptg000080l	12572640	12590723	18083	g_36347	g_31329
ptg000080l	12591625	12592179	554	g_31329	g_4883
ptg000080l	12593768	12614410	20642	g_4883	g_3631
ptg000080l	12624098	12917297	293199	g_3631	g_8687
ptg000080l	12917518	12976763	59245	g_8687	g_26459
ptg000080l	12980485	12985364	4879	g_26459	g_4110
ptg000080l	12985750	13055326	69576	g_4110	g_1333
ptg000080l	13055940	13127195	71255	g_1333	g_9560
ptg000080l	13127458	13489107	361649	g_9560	g_29203
ptg000080l	13489514	13494127	4613	g_29203	g_11471
ptg000080l	13494576	14174606	680030	g_11471	g_26870
ptg000080l	14174944	14175291	347	g_26870	g_2477
ptg000080l	14175590	14189687	14097	g_2477	g_256
ptg000080l	14191951	14192026	75	g_256	g_30070
ptg000081l	26633	28475	1842	g_20861	g_37887
ptg000081l	28720	28816	96	g_37887	g_7395
ptg000081l	29124	29157	33	g_7395	g_10305
ptg000081l	29567	48250	18683	g_10305	g_8514
ptg000081l	49183	61914	12731	g_8514	g_895
ptg000081l	62351	65369	3018	g_895	g_12776
ptg000081l	73960	126890	52930	g_12776	g_15816
ptg000081l	127447	192904	65457	g_15816	g_33810
ptg000081l	193608	244791	51183	g_33810	g_39180
ptg000081l	245171	245201	30	g_39180	g_39444
ptg000081l	245560	245590	30	g_39444	g_38909
ptg000081l	246288	246953	665	g_38909	g_9969
ptg000081l	247153	254565	7412	g_9969	g_5340
ptg000081l	263136	271946	8810	g_5340	g_15174
ptg000081l	307504	323753	16249	g_15174	g_19210
ptg000081l	324181	332456	8275	g_19210	g_26194
ptg000081l	352585	388895	36310	g_26194	g_29907
ptg000081l	405531	450906	45375	g_29907	g_7697
ptg000081l	472532	497082	24550	g_39093	g_13428
ptg000081l	498029	498811	782	g_13428	g_16268
ptg000081l	500865	554019	53154	g_16268	g_25032
ptg000081l	556214	559108	2894	g_25032	g_24125
ptg000081l	566654	582285	15631	g_24125	g_36501
ptg000081l	582566	616265	33699	g_36501	g_3439
ptg000081l	619126	680578	61452	g_3439	g_16546
ptg000081l	686706	699895	13189	g_16546	g_18747
ptg000081l	701139	711333	10194	g_18747	g_9144
ptg000081l	739378	835988	96610	g_9144	g_30891
ptg000081l	838596	871862	33266	g_30891	g_29139
ptg000081l	892038	945413	53375	g_29139	g_724
ptg000081l	954948	959242	4294	g_724	g_39582
ptg000081l	959838	981783	21945	g_39582	g_27133
ptg000081l	982121	993957	11836	g_27133	g_28688
ptg000081l	994940	1020690	25750	g_28688	g_36514
ptg000081l	1022807	1123859	101052	g_36514	g_10910
ptg000081l	1144507	1264203	119696	g_10910	g_10667
ptg000081l	1264772	1281005	16233	g_10667	g_33892
ptg000081l	1283451	1286914	3463	g_33892	g_20884
ptg000081l	1307339	1315396	8057	g_20884	g_5217
ptg000081l	1318450	1377847	59397	g_5217	g_10511
ptg000081l	1378458	1379747	1289	g_10511	g_27465
ptg000081l	1380532	1445115	64583	g_27465	g_1739
ptg000081l	1446257	1502770	56513	g_1739	g_33403
ptg000081l	1504359	1533121	28762	g_33403	g_11522
ptg000081l	1534436	1540193	5757	g_11522	g_1800
ptg000081l	1578038	1634637	56599	g_1800	g_15654
ptg000081l	1634936	1664619	29683	g_15654	g_5031
ptg000081l	1664942	1712251	47309	g_5031	g_23229
ptg000081l	1712535	1777698	65163	g_23229	g_1945
ptg000081l	1790464	1797815	7351	g_1945	g_9575
ptg000081l	1798873	1826145	27272	g_9575	g_19204
ptg000081l	1827329	1910739	83410	g_19204	g_20727
ptg000081l	1912848	1924361	11513	g_20727	g_17274
ptg000081l	1924696	1930659	5963	g_17274	g_5720
ptg000081l	1934304	2009447	75143	g_5720	g_31698
ptg000081l	2009650	2118478	108828	g_31698	g_35345
ptg000081l	2124945	2157137	32192	g_35345	g_26204
ptg000081l	2164046	2295825	131779	g_26204	g_7589
ptg000081l	2301631	2363895	62264	g_7589	g_15253
ptg000081l	2369070	2387839	18769	g_15253	g_25621
ptg000081l	2393029	2486110	93081	g_25621	g_19331
ptg000081l	2491376	2496286	4910	g_19331	g_35973
ptg000081l	2499325	2511565	12240	g_35973	g_37994
ptg000081l	2512011	2536044	24033	g_37994	g_23213
ptg000081l	2536373	2554352	17979	g_23213	g_38278
ptg000081l	2559221	2576365	17144	g_38278	g_12844
ptg000081l	2592622	2595890	3268	g_12844	g_10580
ptg000081l	2608650	2612487	3837	g_10580	g_17188
ptg000081l	2620497	2740504	120007	g_17188	g_5790
ptg000081l	2750482	2950556	200074	g_5790	g_19659
ptg000081l	2950981	2993649	42668	g_19659	g_40112
ptg000081l	3013007	3019274	6267	g_40112	g_12435
ptg000081l	3020798	3023110	2312	g_12435	g_4884
ptg000081l	3024183	3032049	7866	g_4884	g_29580
ptg000081l	3036212	3044655	8443	g_29580	g_19096
ptg000081l	3062500	3075092	12592	g_19096	g_13368
ptg000081l	3086427	3266359	179932	g_13368	g_13207
ptg000081l	3271354	3371248	99894	g_13207	g_30628
ptg000081l	3371709	3687948	316239	g_30628	g_23833
ptg000081l	3708983	3710779	1796	g_23833	g_26841
ptg000081l	3734324	3744208	9884	g_26841	g_25197
ptg000081l	3762225	3778289	16064	g_25197	g_385
ptg000081l	3790222	3803206	12984	g_385	g_29037
ptg000081l	3803718	3850144	46426	g_29037	g_23778
ptg000081l	3929164	3949509	20345	g_23778	g_14725
ptg000081l	3950337	3993225	42888	g_14725	g_33387
ptg000081l	3993698	4021916	28218	g_33387	g_16727
ptg000081l	4022293	4057418	35125	g_16727	g_27286
ptg000081l	4067400	4069211	1811	g_27286	g_31723
ptg000081l	4069764	4123415	53651	g_31723	g_3169
ptg000081l	4131567	4141804	10237	g_3169	g_37881
ptg000081l	4149279	4219254	69975	g_37881	g_9936
ptg000081l	4255178	4291725	36547	g_9936	g_12907
ptg000081l	4299333	4300657	1324	g_12907	g_22069
ptg000081l	4302042	4312318	10276	g_22069	g_29785
ptg000081l	4312557	4320155	7598	g_29785	g_28574
ptg000081l	4322331	4324300	1969	g_28574	g_19309
ptg000081l	4332726	4493286	160560	g_19309	g_16912
ptg000081l	4501443	4685679	184236	g_16912	g_34249
ptg000081l	4690134	4703052	12918	g_34249	g_14709
ptg000081l	4703567	4806061	102494	g_14709	g_9950
ptg000081l	4817344	4834446	17102	g_9950	g_13006
ptg000081l	4837222	4870537	33315	g_13006	g_13009
ptg000081l	4880236	4909748	29512	g_13009	g_32781
ptg000081l	4911722	4911793	71	g_32781	g_15133
ptg000081l	4936945	4966035	29090	g_15133	g_6238
ptg000081l	4983274	5112242	128968	g_6238	g_29185
ptg000081l	5149669	5150687	1018	g_29185	g_36463
ptg000081l	5150923	5151722	799	g_36463	g_15461
ptg000081l	5152171	5174880	22709	g_15461	g_9647
ptg000081l	5193026	5200644	7618	g_9647	g_9896
ptg000081l	5210495	5327599	117104	g_9896	g_21754
ptg000083l	3009	3069	60	g_7683	g_12991
ptg000083l	3488	5439	1951	g_12991	g_22880
ptg000083l	6038	6204	166	g_22880	g_16431
ptg000083l	6746	9424	2678	g_16431	g_29852
ptg000083l	11787	76520	64733	g_29852	g_18346
ptg000083l	76735	120955	44220	g_18346	g_9555
ptg000083l	122272	123490	1218	g_9555	g_25911
ptg000083l	124011	208855	84844	g_25911	g_24391
ptg000083l	209151	210370	1219	g_24391	g_1182
ptg000083l	211716	274269	62553	g_1182	g_5339
ptg000083l	274592	275269	677	g_5339	g_6251
ptg000083l	275649	276961	1312	g_6251	g_6745
ptg000083l	278319	285237	6918	g_6745	g_38775
ptg000083l	285479	297755	12276	g_38775	g_9993
ptg000083l	297955	334646	36691	g_9993	g_5985
ptg000084l	29171	42319	13148	g_34193	g_11935
ptg000084l	47159	82645	35486	g_11935	g_3783
ptg000084l	85902	108081	22179	g_3783	g_17515
ptg000084l	108725	111277	2552	g_17515	g_8126
ptg000084l	119305	148588	29283	g_8126	g_33634
ptg000084l	149706	150160	454	g_33634	g_25417
ptg000084l	167277	172014	4737	g_25417	g_21858
ptg000084l	172790	179967	7177	g_21858	g_22709
ptg000084l	182157	243516	61359	g_22709	g_11379
ptg000084l	244604	244660	56	g_11379	g_10647
ptg000084l	244974	245029	55	g_10647	g_19571
ptg000084l	245397	246378	981	g_19571	g_9328
ptg000085l	35282	40494	5212	g_34131	g_5498
ptg000085l	41303	95151	53848	g_5498	g_29846
ptg000085l	95654	101258	5604	g_29846	g_37954
ptg000085l	102070	120799	18729	g_37954	g_31947
ptg000085l	124215	125336	1121	g_31947	g_1498
ptg000085l	126016	141731	15715	g_1498	g_10276
ptg000086l	142354	249611	107257	g_10276	g_36553
ptg000086l	249907	250027	120	g_36553	g_7466
ptg000086l	250326	250381	55	g_7466	g_16791
ptg000086l	250830	314490	63660	g_16791	g_23511
ptg000086l	317989	319610	1621	g_23511	g_10505
ptg000086l	331554	414807	83253	g_10505	g_6310
ptg000086l	418375	428087	9712	g_6310	g_36625
ptg000086l	431695	546160	114465	g_36625	g_6827
ptg000086l	546522	546860	338	g_6827	g_17516
ptg000086l	547459	567309	19850	g_17516	g_8083
ptg000086l	567623	585205	17582	g_8083	g_17867
ptg000086l	585831	630446	44615	g_17867	g_7899
ptg000086l	632265	637091	4826	g_7899	g_3565
ptg000086l	637312	665207	27895	g_3565	g_34548
ptg000086l	665575	723019	57444	g_34548	g_17202
ptg000086l	723897	766845	42948	g_17202	g_1606
ptg000086l	767132	773178	6046	g_1606	g_24734
ptg000086l	785309	786267	958	g_24734	g_2595
ptg000086l	786677	914949	128272	g_2595	g_9125
ptg000086l	915674	940494	24820	g_9125	g_1439
ptg000086l	941565	1001919	60354	g_1439	g_37531
ptg000086l	1002455	1007630	5175	g_37531	g_25
ptg000086l	1007842	1047874	40032	g_25	g_11737
ptg000086l	1051764	1073702	21938	g_11737	g_30738
ptg000086l	1074037	1085385	11348	g_30738	g_12092
ptg000086l	1086095	1159971	73876	g_12092	g_29149
ptg000086l	1164597	1191367	26770	g_29149	g_28385
ptg000086l	1191891	1206898	15007	g_28385	g_6990
ptg000086l	1215801	1216693	892	g_6990	g_30726
ptg000086l	1219832	1250456	30624	g_30726	g_24753
ptg000086l	1263820	1269333	5513	g_24753	g_40250
ptg000086l	1279126	1355367	76241	g_40250	g_12203
ptg000086l	1362579	1367319	4740	g_12203	g_28664
ptg000086l	1379979	1404012	24033	g_28664	g_2087
ptg000086l	1406023	1427768	21745	g_2087	g_26339
ptg000086l	1428670	1435500	6830	g_26339	g_10246
ptg000086l	1435793	1439201	3408	g_10246	g_17200
ptg000086l	1439689	1520740	81051	g_17200	g_28043
ptg000086l	1521102	1591687	70585	g_28043	g_38181
ptg000086l	1605616	1618073	12457	g_38181	g_5034
ptg000086l	1619488	1624622	5134	g_5034	g_14849
ptg000086l	1638146	1641682	3536	g_14849	g_36994
ptg000086l	1648370	1657416	9046	g_36994	g_5589
ptg000086l	1658669	1658726	57	g_5589	g_9864
ptg000086l	1659259	1671007	11748	g_9864	g_32586
ptg000086l	1671636	1868202	196566	g_32586	g_11726
ptg000086l	1871966	1986473	114507	g_11726	g_13988
ptg000086l	1986796	2019201	32405	g_13988	g_30158
ptg000086l	2019515	2046996	27481	g_30158	g_17891
ptg000086l	2047211	2068880	21669	g_17891	g_12431
ptg000086l	2069176	2133434	64258	g_12431	g_23894
ptg000086l	2133652	2208729	75077	g_23894	g_29985
ptg000086l	2208938	2214906	5968	g_29985	g_23285
ptg000086l	2215133	2288497	73364	g_23285	g_18041
ptg000086l	2301512	2355266	53754	g_18041	g_19891
ptg000086l	2361752	2444532	82780	g_19891	g_33308
ptg000086l	2452549	2456219	3670	g_33308	g_644
ptg000086l	2456503	2505994	49491	g_644	g_5283
ptg000086l	2520802	2536233	15431	g_5283	g_13459
ptg000086l	2537180	2568060	30880	g_13459	g_12403
ptg000086l	2568812	2591794	22982	g_12403	g_30483
ptg000086l	2592534	2667883	75349	g_30483	g_35851
ptg000086l	2692085	2723098	31013	g_35851	g_27806
ptg000086l	2748672	2768031	19359	g_27806	g_37657
ptg000086l	2774247	2807923	33676	g_37657	g_5462
ptg000086l	2808546	2825308	16762	g_5462	g_15912
ptg000086l	2825805	2828008	2203	g_15912	g_13505
ptg000086l	2828871	2836304	7433	g_13505	g_27183
ptg000086l	2843179	2888288	45109	g_27183	g_7451
ptg000086l	2890877	2927007	36130	g_7451	g_4235
ptg000086l	2927882	2948256	20374	g_4235	g_20190
ptg000086l	2955143	2999404	44261	g_20190	g_28044
ptg000086l	3004237	3086207	81970	g_28044	g_25908
ptg000086l	3102043	3122002	19959	g_25908	g_6847
ptg000086l	3122400	3211544	89144	g_6847	g_28422
ptg000086l	3211747	3227128	15381	g_28422	g_31547
ptg000086l	3231809	3244943	13134	g_31547	g_11096
ptg000086l	3245284	3245329	45	g_11096	g_4270
ptg000086l	3245769	3282715	36946	g_4270	g_11776
ptg000086l	3282966	3410383	127417	g_11776	g_35960
ptg000086l	3422705	3435884	13179	g_35960	g_7472
ptg000086l	3436135	3447337	11202	g_7472	g_26305
ptg000086l	3455753	3459626	3873	g_26305	g_13597
ptg000086l	3480772	3538996	58224	g_13597	g_37740
ptg000086l	3539544	3565992	26448	g_37740	g_35671
ptg000086l	3566420	3597648	31228	g_35671	g_27524
ptg000086l	3623041	3643583	20542	g_27524	g_9177
ptg000086l	3654186	3662238	8052	g_9177	g_37311
ptg000086l	3667845	3687404	19559	g_37311	g_3707
ptg000086l	3691169	3709712	18543	g_3707	g_12159
ptg000086l	3725746	3729674	3928	g_12159	g_22832
ptg000087l	157735	385334	227599	g_4614	g_17534
ptg000087l	390470	427414	36944	g_17534	g_24189
ptg000087l	431659	432599	940	g_24189	g_22488
ptg000087l	432829	433549	720	g_22488	g_18252
ptg000087l	433803	433836	33	g_18252	g_33535
ptg000087l	434090	434194	104	g_33535	g_18603
ptg000087l	434904	436815	1911	g_18603	g_1672
ptg000087l	441639	497241	55602	g_1672	g_29843
ptg000087l	500948	518083	17135	g_29843	g_38979
ptg000088l	64577	67839	3262	g_33691	g_21312
ptg000088l	68075	96829	28754	g_21312	g_27686
ptg000088l	113038	114810	1772	g_27686	g_13011
ptg000088l	116327	168269	51942	g_13011	g_38913
ptg000088l	168838	252643	83805	g_38913	g_22956
ptg000088l	254235	320214	65979	g_22956	g_13495
ptg000088l	332511	342246	9735	g_13495	g_12698
ptg000088l	346952	381801	34849	g_12698	g_3974
ptg000088l	382115	382184	69	g_3974	g_2220
ptg000088l	382624	561707	179083	g_2220	g_25691
ptg000088l	565049	569807	4758	g_25691	g_13110
ptg000089l	24698	84068	59370	g_13465	g_35226
ptg000089l	84448	86308	1860	g_35226	g_24513
ptg000089l	99257	106103	6846	g_24513	g_16810
ptg000089l	106474	116622	10148	g_16810	g_27274
ptg000089l	117302	120735	3433	g_27274	g_5822
ptg000089l	121343	124368	3025	g_5822	g_4774
ptg000089l	127057	145584	18527	g_4774	g_10429
ptg000089l	154307	209368	55061	g_10429	g_25538
ptg000089l	210351	241605	31254	g_25538	g_28692
ptg000089l	241871	241908	37	g_28692	g_5902
ptg000089l	243701	243748	47	g_5902	g_30415
ptg000089l	244842	245039	197	g_30415	g_7461
ptg000089l	247474	271759	24285	g_7461	g_37827
ptg000089l	273195	273684	489	g_37827	g_1321
ptg000089l	280078	320319	40241	g_1321	g_12271
ptg000089l	321476	347280	25804	g_12271	g_7631
ptg000089l	347714	446305	98591	g_7631	g_2925
ptg000089l	447291	449999	2708	g_2925	g_18791
ptg000089l	451066	469645	18579	g_18791	g_17760
ptg000091l	52275	235282	183007	g_6791	g_18195
ptg000092l	13939	43331	29392	g_24934	g_27218
ptg000092l	43828	45146	1318	g_27218	g_18162
ptg000092l	46489	48599	2110	g_18162	g_15562
ptg000092l	49297	49367	70	g_15562	g_23616
ptg000092l	50257	52621	2364	g_23616	g_26941
ptg000093l	10597	39185	28588	g_7199	g_7906
ptg000093l	48734	50459	1725	g_7906	g_27809
ptg000093l	66855	107138	40283	g_27809	g_17558
ptg000093l	107800	122144	14344	g_17558	g_11107
ptg000093l	123019	257078	134059	g_11107	g_34835
ptg000093l	276735	286931	10196	g_34835	g_33911
ptg000093l	287158	299811	12653	g_33911	g_9738
ptg000093l	308299	314470	6171	g_9738	g_33260
ptg000093l	315845	328299	12454	g_33260	g_4161
ptg000093l	328591	425215	96624	g_4161	g_7955
ptg000093l	454786	462964	8178	g_7955	g_37039
ptg000093l	463854	524844	60990	g_37039	g_23823
ptg000093l	526287	545275	18988	g_38580	g_24180
ptg000093l	546321	603167	56846	g_24180	g_6372
ptg000093l	603691	627446	23755	g_6372	g_31464
ptg000093l	627727	628036	309	g_31464	g_24480
ptg000093l	629535	630186	651	g_24480	g_4202
ptg000094l	20071	36565	16494	g_6923	g_24642
ptg000094l	50336	57887	7551	g_24642	g_36367
ptg000094l	58565	59362	797	g_36367	g_34605
ptg000094l	73358	75156	1798	g_34605	g_20987
ptg000094l	75428	113376	37948	g_20987	g_19959
ptg000094l	141241	143213	1972	g_19959	g_37100
ptg000094l	154294	287347	133053	g_37100	g_19750
ptg000094l	287718	363525	75807	g_19750	g_36776
ptg000094l	372950	373898	948	g_36776	g_16675
ptg000094l	402739	403740	1001	g_16675	g_803
ptg000094l	417169	424352	7183	g_803	g_18310
ptg000094l	426502	485103	58601	g_18310	g_20439
ptg000094l	488243	533320	45077	g_20439	g_12541
ptg000094l	534942	538527	3585	g_12541	g_18385
ptg000094l	538904	631526	92622	g_18385	g_29085
ptg000094l	631957	720707	88750	g_29085	g_27264
ptg000094l	722413	730274	7861	g_27264	g_6772
ptg000094l	731230	731400	170	g_6772	g_4051
ptg000094l	732914	739432	6518	g_4051	g_29397
ptg000094l	740724	792861	52137	g_29397	g_27542
ptg000094l	800396	867274	66878	g_27542	g_78
ptg000094l	867552	882063	14511	g_78	g_24672
ptg000095l	11796	24229	12433	g_25561	g_8058
ptg000095l	27672	44211	16539	g_8058	g_18936
ptg000095l	46019	46206	187	g_18936	g_9845
ptg000095l	47153	81942	34789	g_9845	g_4187
ptg000095l	82760	83379	619	g_4187	g_26481
ptg000095l	83954	90297	6343	g_26481	g_2075
ptg000095l	91412	111518	20106	g_2075	g_33248
ptg000095l	112213	117323	5110	g_33248	g_36488
ptg000095l	120155	127404	7249	g_36488	g_35234
ptg000095l	131526	151349	19823	g_35234	g_22015
ptg000095l	167734	170409	2675	g_22015	g_23398
ptg000095l	181264	201133	19869	g_23398	g_2517
ptg000095l	202993	260390	57397	g_2517	g_9814
ptg000095l	265771	309120	43349	g_9814	g_20243
ptg000095l	322771	342770	19999	g_38962	g_12232
ptg000095l	358328	400499	42171	g_12232	g_10864
ptg000096l	8538	20949	12411	g_40216	g_21715
ptg000096l	28924	28960	36	g_34819	g_4714
ptg000096l	30288	30312	24	g_4714	g_22063
ptg000096l	31448	34570	3122	g_22063	g_25581
ptg000096l	39089	49637	10548	g_25581	g_8311
ptg000096l	52726	78884	26158	g_8311	g_2536
ptg000096l	79438	111578	32140	g_2536	g_16097
ptg000096l	111853	135913	24060	g_16097	g_12404
ptg000096l	137421	175527	38106	g_12404	g_2136
ptg000096l	191366	200692	9326	g_2136	g_31918
ptg000096l	200907	206353	5446	g_31918	g_33316
ptg000096l	206571	206706	135	g_33316	g_11261
ptg000096l	224150	229779	5629	g_11261	g_39176
ptg000096l	230309	230449	140	g_39176	g_27848
ptg000096l	232031	233328	1297	g_27848	g_39862
ptg000096l	233996	240267	6271	g_39862	g_10949
ptg000096l	274888	289583	14695	g_10949	g_15854
ptg000096l	313706	353196	39490	g_15854	g_33948
ptg000096l	354731	360958	6227	g_33948	g_19119
ptg000096l	361248	376428	15180	g_19119	g_32463
ptg000096l	376655	376868	213	g_32463	g_8023
ptg000096l	377548	377800	252	g_8023	g_3754
ptg000096l	379287	383665	4378	g_3754	g_17430
ptg000096l	389928	437045	47117	g_17430	g_813
ptg000096l	438854	447769	8915	g_813	g_39913
ptg000096l	450546	463036	12490	g_39913	g_39091
ptg000096l	464133	527970	63837	g_39091	g_22444
ptg000096l	529993	565702	35709	g_22444	g_21282
ptg000096l	572722	576896	4174	g_21282	g_16777
ptg000096l	581379	585214	3835	g_16777	g_39026
ptg000096l	586020	610599	24579	g_39026	g_6085
ptg000096l	623601	646190	22589	g_6085	g_949
ptg000096l	654288	708971	54683	g_949	g_4738
ptg000096l	709504	866411	156907	g_4738	g_33364
ptg000096l	872621	882063	9442	g_33364	g_36184
ptg000096l	882485	917470	34985	g_36184	g_25557
ptg000096l	920956	993542	72586	g_25557	g_21311
ptg000096l	994738	1102378	107640	g_21311	g_12298
ptg000096l	1108316	1143193	34877	g_12298	g_6017
ptg000096l	1151689	1169831	18142	g_6017	g_36168
ptg000096l	1179809	1217784	37975	g_36168	g_31961
ptg000096l	1242979	1273495	30516	g_31961	g_31641
ptg000096l	1274145	1274377	232	g_31641	g_20593
ptg000096l	1277592	1280702	3110	g_20593	g_23263
ptg000096l	1290297	1295014	4717	g_23263	g_40236
ptg000096l	1296461	1329301	32840	g_40236	g_38102
ptg000096l	1336364	1347389	11025	g_38102	g_20607
ptg000096l	1347964	1440668	92704	g_20607	g_8872
ptg000096l	1459444	1467508	8064	g_8872	g_15528
ptg000096l	1468383	1542073	73690	g_15528	g_6980
ptg000096l	1561957	1563395	1438	g_6980	g_23866
ptg000096l	1565062	1570691	5629	g_23866	g_35445
ptg000096l	1590384	1599126	8742	g_35445	g_23822
ptg000096l	1628425	1630233	1808	g_23822	g_40244
ptg000096l	1643167	1692511	49344	g_40244	g_4722
ptg000096l	1692792	1692869	77	g_4722	g_32330
ptg000096l	1693180	1777395	84215	g_32330	g_13552
ptg000096l	1780111	1795485	15374	g_13552	g_25244
ptg000096l	1796279	1922926	126647	g_25244	g_21309
ptg000096l	1925926	1936548	10622	g_21309	g_20263
ptg000096l	1936991	1945497	8506	g_20263	g_25378
ptg000096l	1953188	2009086	55898	g_25378	g_28172
ptg000096l	2021193	2418968	397775	g_28172	g_7870
ptg000096l	2430523	2430829	306	g_7870	g_14065
ptg000096l	2451179	2502684	51505	g_14065	g_29783
ptg000096l	2504006	2596954	92948	g_29783	g_28737
ptg000096l	2597166	2610287	13121	g_28737	g_5401
ptg000096l	2640663	2665593	24930	g_5401	g_13133
ptg000096l	2670336	2678706	8370	g_13133	g_14495
ptg000096l	2679110	2693979	14869	g_14495	g_8267
ptg000096l	2706084	2720207	14123	g_8267	g_773
ptg000096l	2724377	2783574	59197	g_773	g_2088
ptg000096l	2787054	2787103	49	g_2088	g_28676
ptg000096l	2809674	2810449	775	g_28676	g_6340
ptg000096l	2819533	2823342	3809	g_6340	g_5610
ptg000096l	2854520	2934204	79684	g_5610	g_32873
ptg000096l	2940515	2944506	3991	g_32873	g_21142
ptg000096l	2946268	3013129	66861	g_21142	g_34953
ptg000096l	3013425	3122504	109079	g_34953	g_24695
ptg000097l	99402	106367	6965	g_12291	g_34796
ptg000097l	109300	110015	715	g_34796	g_8047
ptg000097l	118213	164634	46421	g_8047	g_4469
ptg000097l	164894	169621	4727	g_4469	g_5574
ptg000097l	173734	193281	19547	g_5574	g_1604
ptg000097l	193928	201200	7272	g_1604	g_26543
ptg000097l	209132	213778	4646	g_26543	g_27908
ptg000097l	214038	214300	262	g_27908	g_29519
ptg000097l	215967	230963	14996	g_29519	g_18273
ptg000097l	236047	238031	1984	g_18273	g_20460
ptg000097l	238288	298645	60357	g_20460	g_32395
ptg000097l	304142	308309	4167	g_32395	g_16596
ptg000097l	311992	334883	22891	g_16596	g_9669
ptg000097l	335146	340888	5742	g_9669	g_21061
ptg000097l	352982	354543	1561	g_21061	g_16182
ptg000097l	357830	358107	277	g_16182	g_18860
ptg000097l	372146	377824	5678	g_18860	g_29746
ptg000097l	378345	383834	5489	g_29746	g_26761
ptg000097l	385207	406834	21627	g_26761	g_28494
ptg000097l	408042	417927	9885	g_28494	g_15110
ptg000097l	421024	433081	12057	g_15110	g_8473
ptg000097l	442766	449400	6634	g_8473	g_16102
ptg000097l	452025	472335	20310	g_16102	g_33386
ptg000097l	475072	483504	8432	g_33386	g_29068
ptg000097l	483860	492769	8909	g_29068	g_19465
ptg000097l	495071	502864	7793	g_19465	g_20430
ptg000097l	504150	590393	86243	g_20430	g_3015
ptg000097l	596636	601707	5071	g_3015	g_32073
ptg000097l	611188	615584	4396	g_32073	g_20924
ptg000097l	617158	618590	1432	g_20924	g_9105
ptg000097l	627470	630958	3488	g_9105	g_16244
ptg000097l	634588	638014	3426	g_16244	g_2040
ptg000097l	638244	644823	6579	g_2040	g_15221
ptg000097l	647302	649451	2149	g_15221	g_28609
ptg000097l	650206	654571	4365	g_28609	g_32580
ptg000097l	656543	660034	3491	g_32580	g_12936
ptg000097l	665545	666153	608	g_12936	g_16892
ptg000097l	666797	743779	76982	g_16892	g_33106
ptg000097l	744027	762551	18524	g_33106	g_29306
ptg000097l	769017	780698	11681	g_39532	g_2890
ptg000097l	805491	806073	582	g_2890	g_19324
ptg000097l	831211	838525	7314	g_19324	g_30499
ptg000097l	860668	874525	13857	g_30499	g_9960
ptg000097l	875142	881209	6067	g_9960	g_31006
ptg000097l	881981	915920	33939	g_31006	g_35003
ptg000097l	917482	917526	44	g_35003	g_11562
ptg000097l	917804	931164	13360	g_11562	g_12926
ptg000097l	932111	1092244	160133	g_12926	g_22684
ptg000097l	1095948	1104509	8561	g_22684	g_14665
ptg000097l	1105448	1179213	73765	g_14665	g_32350
ptg000097l	1195314	1202185	6871	g_32350	g_5044
ptg000097l	1203597	1214109	10512	g_5044	g_35249
ptg000098l	5117	7189	2072	g_18159	g_31339
ptg000098l	43226	43790	564	g_31339	g_29569
ptg000098l	45892	45971	79	g_29569	g_18892
ptg000098l	50472	55545	5073	g_18892	g_37060
ptg000098l	56459	60530	4071	g_37060	g_9468
ptg000098l	78270	78951	681	g_9468	g_23336
ptg000098l	85634	102683	17049	g_23336	g_11108
ptg000098l	104200	112294	8094	g_11108	g_6960
ptg000098l	130733	163856	33123	g_6960	g_11169
ptg000098l	169428	185159	15731	g_11169	g_27817
ptg000098l	185806	231020	45214	g_27817	g_31362
ptg000098l	243192	245709	2517	g_31362	g_2475
ptg000098l	250952	311274	60322	g_2475	g_9940
ptg000098l	311537	344867	33330	g_9940	g_39177
ptg000098l	345070	355008	9938	g_39177	g_9172
ptg000098l	368363	384659	16296	g_9172	g_24224
ptg000098l	386053	387818	1765	g_24224	g_847
ptg000098l	388084	461683	73599	g_847	g_30426
ptg000098l	472916	515729	42813	g_30426	g_32889
ptg000098l	543410	550762	7352	g_32889	g_14545
ptg000098l	559577	561972	2395	g_14545	g_20027
ptg000098l	572349	587738	15389	g_20027	g_33567
ptg000098l	593300	647192	53892	g_33567	g_27752
ptg000098l	666905	673701	6796	g_27752	g_25579
ptg000098l	674352	710897	36545	g_25579	g_5874
ptg000098l	712915	722410	9495	g_5874	g_29499
ptg000098l	740998	745865	4867	g_29499	g_26184
ptg000098l	754998	757755	2757	g_26184	g_29217
ptg000098l	760241	831863	71622	g_29217	g_11991
ptg000098l	832207	840717	8510	g_11991	g_2175
ptg000098l	841931	924571	82640	g_2175	g_14931
ptg000098l	925494	926682	1188	g_14931	g_1044
ptg000098l	928034	941117	13083	g_1044	g_35906
ptg000098l	955132	969429	14297	g_35906	g_17366
ptg000098l	970247	973124	2877	g_17366	g_35715
ptg000098l	973333	973730	397	g_35715	g_24810
ptg000098l	974050	975109	1059	g_24810	g_37255
ptg000098l	975945	983171	7226	g_37255	g_21611
ptg000098l	985359	1055786	70427	g_21611	g_12395
ptg000098l	1056022	1204405	148383	g_12395	g_736
ptg000098l	1208275	1232425	24150	g_736	g_7430
ptg000098l	1239527	1243400	3873	g_7430	g_20888
ptg000098l	1252500	1298813	46313	g_20888	g_27490
ptg000098l	1309084	1326295	17211	g_27490	g_32359
ptg000098l	1331168	1429615	98447	g_32359	g_15608
ptg000098l	1451590	1458676	7086	g_15608	g_33138
ptg000098l	1459461	1463841	4380	g_33138	g_34309
ptg000098l	1497421	1505879	8458	g_34309	g_2601
ptg000098l	1506478	1506536	58	g_2601	g_18763
ptg000098l	1506991	1522379	15388	g_18763	g_36264
ptg000098l	1522978	1525561	2583	g_36264	g_16712
ptg000099l	81435	131289	49854	g_15891	g_16026
ptg000099l	138666	172465	33799	g_16026	g_37714
ptg000099l	173952	211005	37053	g_37714	g_21299
ptg000099l	212744	268985	56241	g_21299	g_30670
ptg000099l	269362	270402	1040	g_30670	g_11183
ptg000099l	270713	279198	8485	g_11183	g_939
ptg000099l	279581	280820	1239	g_939	g_21669
ptg000099l	281230	282321	1091	g_21669	g_36597
ptg000099l	282959	294321	11362	g_36597	g_12141
ptg000099l	294698	295826	1128	g_12141	g_34863
ptg000099l	296209	300310	4101	g_34863	g_3476
ptg000099l	300654	309952	9298	g_3476	g_8810
ptg000099l	310737	319848	9111	g_8810	g_12242
ptg000099l	320480	329291	8811	g_12242	g_28970
ptg000099l	329602	331682	2080	g_28970	g_16467
ptg000099l	332059	333174	1115	g_16467	g_31225
ptg000099l	333557	335093	1536	g_31225	g_6706
ptg000099l	335503	341999	6496	g_6706	g_18105
ptg000099l	342382	343530	1148	g_18105	g_22907
ptg000099l	343907	354548	10641	g_22907	g_20957
ptg000099l	354931	367849	12918	g_20957	g_16508
ptg000099l	368232	369174	942	g_16508	g_25886
ptg000099l	369836	378381	8545	g_25886	g_26762
ptg000099l	379001	380042	1041	g_26762	g_28144
ptg000099l	380452	381962	1510	g_28144	g_32662
ptg000099l	382345	385199	2854	g_32662	g_25006
ptg000099l	385819	399505	13686	g_25006	g_1153
ptg000099l	400173	401656	1483	g_1153	g_27582
ptg000099l	402039	408094	6055	g_27582	g_33137
ptg000099l	408504	409879	1375	g_33137	g_37394
ptg000099l	410190	414178	3988	g_37394	g_35160
ptg000099l	414561	426160	11599	g_35160	g_29909
ptg000099l	436418	465512	29094	g_29909	g_17462
ptg000099l	467191	571466	104275	g_17462	g_14801
ptg000099l	591828	601302	9474	g_14801	g_35343
ptg000099l	608892	659143	50251	g_35343	g_28908
ptg000099l	678189	686585	8396	g_28908	g_13168
ptg000099l	694981	701460	6479	g_13168	g_18991
ptg000099l	712017	748104	36087	g_18991	g_3838
ptg000099l	750382	751043	661	g_3838	g_26817
ptg000099l	751630	774307	22677	g_26817	g_7141
ptg000099l	792789	797905	5116	g_7141	g_8629
ptg000099l	798504	814614	16110	g_8629	g_16249
ptg000099l	818527	824672	6145	g_16249	g_11756
ptg000099l	852412	894541	42129	g_11756	g_28247
ptg000099l	917390	927330	9940	g_28247	g_15564
ptg000099l	934811	991142	56331	g_15564	g_22115
ptg000099l	991447	1075396	83949	g_22115	g_5003
ptg000099l	1076583	1118922	42339	g_5003	g_9562
ptg000099l	1129378	1380316	250938	g_9562	g_3587
ptg000099l	1382632	1399787	17155	g_3587	g_9071
ptg000099l	1400641	1402020	1379	g_9071	g_19028
ptg000099l	1437734	1495080	57346	g_19028	g_36970
ptg000099l	1515053	1548548	33495	g_36970	g_36875
ptg000099l	1560314	1585157	24843	g_36875	g_11282
ptg000099l	1593844	1631175	37331	g_11282	g_2033
ptg000099l	1631939	1647674	15735	g_2033	g_24210
ptg000101l	12450	177039	164589	g_20168	g_5247
ptg000101l	186936	202233	15297	g_5247	g_39794
ptg000101l	203135	203774	639	g_39794	g_17425
ptg000101l	226476	282024	55548	g_17425	g_36466
ptg000101l	282965	295902	12937	g_36466	g_11445
ptg000101l	300635	314659	14024	g_11445	g_9214
ptg000101l	314988	374195	59207	g_9214	g_31495
ptg000101l	396902	479551	82649	g_31495	g_35030
ptg000101l	479814	663630	183816	g_35030	g_10411
ptg000101l	665207	819028	153821	g_10411	g_13417
ptg000101l	819777	827199	7422	g_13417	g_10985
ptg000101l	827621	827751	130	g_10985	g_30419
ptg000101l	828419	875185	46766	g_30419	g_21112
ptg000101l	882839	932022	49183	g_21112	g_4443
ptg000101l	932597	958407	25810	g_4443	g_12507
ptg000104l	181020	181718	698	g_994	g_10045
ptg000104l	182218	200363	18145	g_10045	g_1365
ptg000104l	222099	238633	16534	g_1365	g_36124
ptg000104l	257186	271086	13900	g_36124	g_4531
ptg000104l	271778	272142	364	g_4531	g_2678
ptg000104l	294380	302293	7913	g_2678	g_31752
ptg000104l	302529	320973	18444	g_31752	g_20528
ptg000104l	321440	322267	827	g_20528	g_17903
ptg000104l	322917	338782	15865	g_17903	g_12965
ptg000104l	340173	362791	22618	g_12965	g_39530
ptg000104l	363003	403860	40857	g_39530	g_5124
ptg000104l	404147	404175	28	g_5124	g_30782
ptg000104l	404501	404544	43	g_30782	g_30911
ptg000104l	404747	406653	1906	g_30911	g_36212
ptg000104l	406940	406968	28	g_36212	g_25400
ptg000104l	407216	407603	387	g_25400	g_9851
ptg000104l	407806	409712	1906	g_9851	g_36292
ptg000104l	409999	410027	28	g_36292	g_5840
ptg000104l	410275	410710	435	g_5840	g_37286
ptg000104l	410916	411318	402	g_37286	g_5199
ptg000104l	411554	412515	961	g_5199	g_6117
ptg000104l	412898	412973	75	g_6117	g_5179
ptg000104l	413554	429591	16037	g_5179	g_32607
ptg000104l	431405	458752	27347	g_32607	g_5749
ptg000104l	459204	459229	25	g_5749	g_19746
ptg000104l	459744	461012	1268	g_19746	g_34816
ptg000104l	461320	463672	2352	g_34816	g_29155
ptg000105l	30841	33802	2961	g_35442	g_32100
ptg000106l	34863	75167	40304	g_32100	g_30659
ptg000106l	75490	92790	17300	g_30659	g_13792
ptg000106l	99647	120873	21226	g_13792	g_31214
ptg000106l	124526	125490	964	g_31214	g_32906
ptg000106l	126877	147656	20779	g_32906	g_16862
ptg000106l	159465	168631	9166	g_16862	g_13279
ptg000106l	180874	186125	5251	g_13279	g_2994
ptg000107l	68175	175472	107297	g_27640	g_4380
ptg000107l	175720	218261	42541	g_4380	g_33152
ptg000107l	219154	220707	1553	g_33152	g_19415
ptg000107l	221483	279630	58147	g_19415	g_14252
ptg000107l	279902	298542	18640	g_14252	g_38646
ptg000112l	84744	265079	180335	g_21830	g_6574
ptg000112l	266158	363173	97015	g_6574	g_26874
ptg000112l	372888	405218	32330	g_26874	g_36952
ptg000112l	407098	412225	5127	g_36952	g_39556
ptg000112l	416781	446342	29561	g_39556	g_5584
ptg000113l	23577	34685	11108	g_26551	g_37185
ptg000113l	35143	50320	15177	g_37185	g_1823
ptg000113l	51396	100271	48875	g_1823	g_7592
ptg000113l	101947	104818	2871	g_7592	g_8711
ptg000113l	105051	203693	98642	g_8711	g_35825
ptg000113l	203995	204029	34	g_35825	g_34925
ptg000113l	204331	242221	37890	g_34925	g_35948
ptg000113l	243657	296594	52937	g_35948	g_920
ptg000113l	299334	353305	53971	g_920	g_36689
ptg000114l	30833	34643	3810	g_18174	g_27134
ptg000114l	35440	141218	105778	g_27134	g_10850
ptg000115l	16562	29106	12544	g_23107	g_8651
ptg000115l	29531	31753	2222	g_8651	g_25698
ptg000115l	33804	43822	10018	g_25698	g_19476
ptg000115l	49171	50841	1670	g_19476	g_28133
ptg000115l	51815	53363	1548	g_28133	g_26816
ptg000115l	54715	57748	3033	g_26816	g_23672
ptg000115l	58794	59218	424	g_23672	g_4184
ptg000115l	60126	60485	359	g_4184	g_10919
ptg000115l	61237	61756	519	g_10919	g_2710
ptg000115l	62424	63361	937	g_2710	g_19962
ptg000115l	64077	81795	17718	g_19962	g_27612
ptg000115l	82052	82995	943	g_27612	g_22413
ptg000115l	104718	162412	57694	g_22413	g_8688
ptg000115l	183933	203472	19539	g_8688	g_23333
ptg000115l	203777	223566	19789	g_23333	g_3486
ptg000116l	227470	310993	83523	g_27802	g_17619
ptg000116l	331044	332965	1921	g_17619	g_25782
ptg000116l	336555	337670	1115	g_25782	g_39990
ptg000116l	347589	353496	5907	g_39990	g_5078
ptg000116l	360527	447076	86549	g_5078	g_17333
ptg000116l	448491	481397	32906	g_17333	g_36694
ptg000116l	483517	488781	5264	g_36694	g_16980
ptg000116l	498691	501713	3022	g_16980	g_5190
ptg000116l	503713	503742	29	g_5190	g_39994
ptg000116l	514235	518903	4668	g_39994	g_19539
ptg000116l	524820	670508	145688	g_19539	g_21842
ptg000116l	670831	683285	12454	g_21842	g_18554
ptg000116l	684487	701788	17301	g_18554	g_19523
ptg000116l	702144	729553	27409	g_19523	g_10265
ptg000116l	737343	739047	1704	g_10265	g_18529
ptg000116l	745883	748632	2749	g_18529	g_20672
ptg000116l	748856	750384	1528	g_20672	g_25080
ptg000116l	761510	762084	574	g_25080	g_7987
ptg000116l	762407	763771	1364	g_7987	g_25605
ptg000116l	825375	907513	82138	g_25605	g_25085
ptg000116l	912077	914814	2737	g_25085	g_20159
ptg000116l	918379	921016	2637	g_20159	g_20628
ptg000116l	923605	925047	1442	g_20628	g_35241
ptg000116l	925376	953380	28004	g_35241	g_7149
ptg000116l	963159	972054	8895	g_7149	g_20307
ptg000116l	990905	993198	2293	g_20307	g_21259
ptg000116l	1003211	1014617	11406	g_21259	g_37299
ptg000116l	1024260	1052130	27870	g_37299	g_9415
ptg000116l	1065014	1145652	80638	g_9415	g_18000
ptg000116l	1145852	1168025	22173	g_18000	g_29577
ptg000118l	13362	13392	30	g_35418	g_33766
ptg000118l	14477	88592	74115	g_33766	g_31036
ptg000118l	90490	150526	60036	g_31036	g_22531
ptg000118l	156436	158125	1689	g_22531	g_7752
ptg000118l	159519	186221	26702	g_7752	g_15448
ptg000118l	191233	251766	60533	g_15448	g_5626
ptg000119l	51899	60811	8912	g_10079	g_26504
ptg000119l	61470	129758	68288	g_26504	g_34940
ptg000119l	137066	155246	18180	g_34940	g_24516
ptg000119l	163574	166633	3059	g_24516	g_368
ptg000119l	167016	179446	12430	g_368	g_15065
ptg000119l	191930	218592	26662	g_15065	g_27915
ptg000120l	49763	60040	10277	g_25565	g_18161
ptg000120l	69360	151921	82561	g_18161	g_5617
ptg000120l	153177	153642	465	g_5617	g_18705
ptg000120l	154202	166665	12463	g_18705	g_3207
ptg000120l	167039	176809	9770	g_3207	g_3695
ptg000120l	177201	177252	51	g_3695	g_24088
ptg000120l	177587	177636	49	g_24088	g_21854
ptg000120l	178121	194983	16862	g_21854	g_655
ptg000120l	196186	233367	37181	g_655	g_14362
ptg000120l	234317	254382	20065	g_14362	g_26732
ptg000120l	255522	298842	43320	g_26732	g_4976
ptg000120l	301080	301845	765	g_4976	g_11303
ptg000120l	303488	452450	148962	g_11303	g_34596
ptg000120l	492707	514648	21941	g_34596	g_13935
ptg000120l	522848	634221	111373	g_13935	g_36439
ptg000120l	634424	634718	294	g_36439	g_9280
ptg000120l	636694	726767	90073	g_9280	g_24740
ptg000120l	727516	913472	185956	g_24740	g_9127
ptg000120l	931833	954524	22691	g_9127	g_33561
ptg000120l	957520	968914	11394	g_33561	g_19723
ptg000120l	989608	1047552	57944	g_19723	g_17934
ptg000120l	1047842	1049346	1504	g_17934	g_32079
ptg000123l	21802	71111	49309	g_26436	g_8847
ptg000123l	73492	104162	30670	g_8847	g_29784
ptg000123l	104977	148831	43854	g_29784	g_3084
ptg000123l	149301	190089	40788	g_3084	g_21015
ptg000123l	192119	198095	5976	g_21015	g_33046
ptg000123l	198490	198589	99	g_33046	g_16563
ptg000123l	199248	246425	47177	g_16563	g_22838
ptg000123l	247978	269040	21062	g_22838	g_21660
ptg000123l	269366	273957	4591	g_21660	g_29788
ptg000123l	274529	328863	54334	g_29788	g_32332
ptg000123l	331094	445489	114395	g_32332	g_14164
ptg000123l	446193	446347	154	g_14164	g_3775
ptg000123l	446589	507194	60605	g_3775	g_13390
ptg000123l	526882	568434	41552	g_13390	g_38236
ptg000123l	568970	572660	3690	g_38236	g_37287
ptg000123l	580784	629129	48345	g_37287	g_33463
ptg000123l	629851	739615	109764	g_33463	g_7718
ptg000123l	739848	907248	167400	g_7718	g_33095
ptg000123l	907451	997675	90224	g_33095	g_27992
ptg000123l	1088067	1199142	111075	g_27992	g_17876
ptg000123l	1199897	1228176	28279	g_17876	g_28262
ptg000123l	1252500	1307557	55057	g_28262	g_32392
ptg000123l	1307757	1323089	15332	g_32392	g_17976
ptg000123l	1323298	1350467	27169	g_17976	g_40158
ptg000123l	1350982	1369197	18215	g_40158	g_16442
ptg000123l	1378352	1393544	15192	g_16442	g_4037
ptg000123l	1397145	1451085	53940	g_4037	g_27254
ptg000123l	1452221	1498626	46405	g_27254	g_9977
ptg000123l	1514731	1528108	13377	g_9977	g_20899
ptg000123l	1528728	1678708	149980	g_20899	g_37969
ptg000123l	1687624	1694160	6536	g_37969	g_3215
ptg000123l	1696736	1706045	9309	g_3215	g_1404
ptg000123l	1707338	1773144	65806	g_1404	g_2690
ptg000123l	1773374	1791879	18505	g_2690	g_35402
ptg000123l	1792154	1793410	1256	g_35402	g_20356
ptg000123l	1794408	1878511	84103	g_20356	g_22534
ptg000123l	1879674	1952210	72536	g_22534	g_17811
ptg000123l	1958755	1966977	8222	g_17811	g_7814
ptg000123l	1979505	1986087	6582	g_7814	g_12702
ptg000123l	1991608	1994424	2816	g_12702	g_5121
ptg000123l	1999027	2008849	9822	g_5121	g_19658
ptg000123l	2022386	2023697	1311	g_19658	g_9170
ptg000123l	2027161	2030738	3577	g_9170	g_14511
ptg000123l	2032160	2035616	3456	g_14511	g_18616
ptg000123l	2038394	2041709	3315	g_18616	g_26683
ptg000123l	2045601	2053979	8378	g_26683	g_29029
ptg000123l	2059351	2070151	10800	g_29029	g_14181
ptg000123l	2083005	2130986	47981	g_14181	g_20853
ptg000123l	2131291	2136266	4975	g_20853	g_5286
ptg000123l	2151888	2153305	1417	g_5286	g_8478
ptg000123l	2156799	2163078	6279	g_8478	g_22960
ptg000123l	2176211	2182634	6423	g_22960	g_24227
ptg000123l	2183590	2194913	11323	g_24227	g_18870
ptg000123l	2195914	2198181	2267	g_18870	g_21134
ptg000123l	2202253	2206517	4264	g_21134	g_25998
ptg000123l	2212411	2215570	3159	g_25998	g_17808
ptg000123l	2224248	2227546	3298	g_17808	g_40176
ptg000123l	2231922	2236919	4997	g_40176	g_20699
ptg000123l	2243597	2276578	32981	g_20699	g_8116
ptg000123l	2276904	2296949	20045	g_8116	g_29258
ptg000123l	2301006	2305889	4883	g_29258	g_20900
ptg000123l	2313297	2317112	3815	g_20900	g_11696
ptg000123l	2318209	2319901	1692	g_11696	g_9766
ptg000123l	2320182	2348942	28760	g_9766	g_6831
ptg000123l	2368780	2418102	49322	g_6831	g_16496
ptg000123l	2418326	2422229	3903	g_16496	g_25984
ptg000123l	2427212	2514467	87255	g_25984	g_31983
ptg000123l	2530691	2565450	34759	g_31983	g_26394
ptg000123l	2567789	2586654	18865	g_26394	g_11964
ptg000123l	2589533	2591268	1735	g_11964	g_39691
ptg000123l	2594095	2596898	2803	g_28564	g_36340
ptg000123l	2601949	2603211	1262	g_36340	g_22335
ptg000123l	2617751	2685623	67872	g_22335	g_16013
ptg000123l	2716608	2799805	83197	g_16013	g_23499
ptg000123l	2814933	2829132	14199	g_23499	g_32851
ptg000123l	2829938	2843238	13300	g_32851	g_4998
ptg000123l	2843981	2896923	52942	g_4998	g_14556
ptg000123l	2899908	2911418	11510	g_14556	g_25095
ptg000123l	2911975	3030432	118457	g_25095	g_2400
ptg000123l	3031848	3074028	42180	g_2400	g_12276
ptg000123l	3086851	3119696	32845	g_12276	g_30353
ptg000123l	3124417	3178789	54372	g_30353	g_24447
ptg000123l	3196697	3199495	2798	g_24447	g_33184
ptg000123l	3200959	3201602	643	g_33184	g_32986
ptg000123l	3203068	3212196	9128	g_32986	g_32645
ptg000123l	3213695	3232290	18595	g_32645	g_24015
ptg000123l	3235703	3246274	10571	g_24015	g_3258
ptg000123l	3248556	3250179	1623	g_3258	g_12799
ptg000123l	3265212	3266369	1157	g_12799	g_35659
ptg000123l	3277042	3298727	21685	g_35659	g_26965
ptg000123l	3303985	3332100	28115	g_26965	g_35121
ptg000123l	3337389	3346559	9170	g_35121	g_27299
ptg000123l	3353014	3356281	3267	g_27299	g_27087
ptg000123l	3367340	3465777	98437	g_27087	g_10710
ptg000123l	3484989	3500696	15707	g_10710	g_14995
ptg000123l	3502123	3528086	25963	g_14995	g_15449
ptg000123l	3548582	3554029	5447	g_15449	g_23490
ptg000123l	3558517	3570615	12098	g_23490	g_11015
ptg000123l	3570926	3586840	15914	g_11015	g_38459
ptg000123l	3587145	3657380	70235	g_38459	g_13746
ptg000123l	3657649	3667977	10328	g_13746	g_9114
ptg000123l	3683300	3742501	59201	g_9114	g_9276
ptg000123l	3764795	3765973	1178	g_9276	g_30680
ptg000123l	3769461	3774144	4683	g_30680	g_22388
ptg000123l	3816680	3821921	5241	g_22388	g_13061
ptg000123l	3832413	3844205	11792	g_13061	g_23951
ptg000123l	3845213	3855046	9833	g_23951	g_10771
ptg000123l	3867997	3871252	3255	g_10771	g_36405
ptg000123l	3905220	3925815	20595	g_36405	g_37699
ptg000123l	3937505	3984367	46862	g_37699	g_209
ptg000123l	3999037	4024701	25664	g_209	g_19633
ptg000123l	4024982	4073135	48153	g_19633	g_32020
ptg000123l	4090417	4094350	3933	g_32020	g_16195
ptg000123l	4095204	4453014	357810	g_16195	g_25812
ptg000123l	4453262	4541895	88633	g_25812	g_8746
ptg000123l	4542107	4547731	5624	g_8746	g_38308
ptg000123l	4552010	4553488	1478	g_38308	g_17901
ptg000123l	4560541	4566770	6229	g_17901	g_32548
ptg000123l	4575656	4581660	6004	g_32548	g_3079
ptg000123l	4587294	4602046	14752	g_3079	g_23270
ptg000123l	4609274	4611703	2429	g_23270	g_40237
ptg000123l	4615974	4630146	14172	g_40237	g_23646
ptg000123l	4633777	4634868	1091	g_23646	g_40241
ptg000123l	4637809	4637909	100	g_40241	g_14816
ptg000123l	4640530	4641419	889	g_14816	g_19043
ptg000123l	4644433	4645537	1104	g_19043	g_30366
ptg000123l	4651286	4663073	11787	g_30366	g_8850
ptg000123l	4663522	4664275	753	g_8850	g_2062
ptg000123l	4664556	4665423	867	g_2062	g_851
ptg000123l	4666469	4723782	57313	g_851	g_12897
ptg000123l	4729389	4729484	95	g_12897	g_14479
ptg000123l	4729744	4784861	55117	g_14479	g_16962
ptg000123l	4789562	4793956	4394	g_16962	g_657
ptg000123l	4796759	4857601	60842	g_657	g_7384
ptg000123l	4857897	4863666	5769	g_7384	g_11222
ptg000123l	4879095	4911120	32025	g_11222	g_33154
ptg000123l	4916611	4956680	40069	g_33154	g_16519
ptg000123l	4957982	5013154	55172	g_16519	g_20311
ptg000123l	5015444	5024054	8610	g_20311	g_8994
ptg000123l	5024566	5025595	1029	g_8994	g_11253
ptg000123l	5026590	5047656	21066	g_11253	g_24443
ptg000123l	5055381	5057056	1675	g_24443	g_6812
ptg000123l	5065560	5071507	5947	g_6812	g_35327
ptg000123l	5080512	5085029	4517	g_35327	g_4258
ptg000123l	5086855	5109480	22625	g_4258	g_36125
ptg000123l	5110434	5122538	12104	g_36125	g_5872
ptg000123l	5147616	5180532	32916	g_5872	g_2867
ptg000123l	5197811	5208105	10294	g_2867	g_37606
ptg000123l	5212136	5221979	9843	g_37606	g_6465
ptg000123l	5251960	5256680	4720	g_6465	g_36972
ptg000123l	5256907	5460896	203989	g_36972	g_8788
ptg000123l	5461438	5505471	44033	g_8788	g_33963
ptg000123l	5506136	5723707	217571	g_33963	g_2318
ptg000123l	5741924	5759608	17684	g_2318	g_33841
ptg000123l	5767990	5782333	14343	g_33841	g_1547
ptg000123l	5804136	5831975	27839	g_1547	g_25650
ptg000123l	5836786	5836817	31	g_25675	g_8698
ptg000123l	5837134	5851729	14595	g_8698	g_14598
ptg000123l	5854556	5855834	1278	g_14598	g_5301
ptg000123l	5856052	5856533	481	g_5301	g_27270
ptg000123l	5872137	5903984	31847	g_27270	g_11042
ptg000123l	5917233	5920077	2844	g_11042	g_23114
ptg000123l	5929596	5983534	53938	g_23114	g_24872
ptg000123l	6008367	6056985	48618	g_24872	g_16737
ptg000123l	6065873	6069479	3606	g_16737	g_27569
ptg000123l	6088346	6101462	13116	g_27569	g_11173
ptg000123l	6125998	6150249	24251	g_11173	g_18606
ptg000123l	6158084	6173640	15556	g_18606	g_23524
ptg000123l	6189472	6191195	1723	g_23524	g_22618
ptg000123l	6200231	6207693	7462	g_22618	g_1417
ptg000123l	6213601	6366156	152555	g_1417	g_37598
ptg000123l	6369993	6374687	4694	g_37598	g_35233
ptg000123l	6375391	6387816	12425	g_35233	g_36290
ptg000123l	6388028	6427142	39114	g_36290	g_24580
ptg000123l	6427447	6443499	16052	g_24580	g_6375
ptg000123l	6459126	6468664	9538	g_6375	g_22964
ptg000123l	6472153	6477800	5647	g_22964	g_21242
ptg000123l	6485273	6498782	13509	g_21242	g_28563
ptg000123l	6503837	6505735	1898	g_28563	g_9824
ptg000123l	6506151	6513834	7683	g_9824	g_19983
ptg000123l	6515277	6519290	4013	g_19983	g_9675
ptg000123l	6529320	6541737	12417	g_9675	g_36428
ptg000123l	6546099	6547093	994	g_36428	g_25391
ptg000123l	6547650	6548238	588	g_25391	g_12605
ptg000123l	6563244	6589823	26579	g_12605	g_8031
ptg000123l	6593780	6602492	8712	g_8031	g_14944
ptg000123l	6608827	6628958	20131	g_14944	g_35607
ptg000123l	6635479	6636907	1428	g_35607	g_16706
ptg000123l	6643238	6651138	7900	g_16706	g_16397
ptg000123l	6674177	6681531	7354	g_16397	g_7653
ptg000123l	6686775	6689130	2355	g_7653	g_40033
ptg000123l	6700132	6705814	5682	g_40033	g_29588
ptg000123l	6716950	6717272	322	g_29588	g_36412
ptg000123l	6717991	6731436	13445	g_36412	g_32743
ptg000123l	6732524	6761495	28971	g_32743	g_28910
ptg000123l	6775472	6783107	7635	g_28910	g_19158
ptg000123l	6783796	6784481	685	g_19158	g_18113
ptg000123l	6786909	6792316	5407	g_18113	g_23354
ptg000123l	6797160	6819055	21895	g_23354	g_24678
ptg000123l	6819315	7179820	360505	g_24678	g_32289
ptg000123l	7180065	7180097	32	g_32289	g_17275
ptg000123l	7180366	7229797	49431	g_17275	g_30187
ptg000123l	7244974	7258925	13951	g_30187	g_7621
ptg000123l	7268027	7302933	34906	g_7621	g_2126
ptg000123l	7304135	7311676	7541	g_2126	g_10248
ptg000123l	7329008	7333399	4391	g_10248	g_23783
ptg000123l	7337679	7367575	29896	g_23783	g_31719
ptg000123l	7368069	7369732	1663	g_31719	g_26626
ptg000123l	7373722	7375791	2069	g_26626	g_3345
ptg000123l	7389482	7441759	52277	g_30279	g_11840
ptg000123l	7442709	7510559	67850	g_11840	g_21430
ptg000123l	7516755	7613537	96782	g_21430	g_23801
ptg000123l	7613899	7700578	86679	g_23801	g_29867
ptg000123l	7727946	7781196	53250	g_29867	g_20239
ptg000123l	7781450	7827436	45986	g_20239	g_21540
ptg000123l	7829022	7931875	102853	g_21540	g_37381
ptg000123l	7932558	7961672	29114	g_37381	g_12997
ptg000123l	7962619	8008807	46188	g_12997	g_22593
ptg000123l	8009154	8027887	18733	g_22593	g_6914
ptg000123l	8028090	8119360	91270	g_6914	g_12935
ptg000123l	8125133	8130849	5716	g_12935	g_26048
ptg000123l	8131151	8132732	1581	g_26048	g_27737
ptg000123l	8133237	8138428	5191	g_27737	g_12398
ptg000123l	8147574	8159712	12138	g_12398	g_10144
ptg000123l	8161660	8163125	1465	g_10144	g_20557
ptg000123l	8164409	8176108	11699	g_20557	g_16677
ptg000123l	8176554	8183814	7260	g_16677	g_37661
ptg000123l	8185946	8224532	38586	g_37661	g_19671
ptg000123l	8224735	8259270	34535	g_19671	g_14283
ptg000123l	8272979	8279113	6134	g_14283	g_3163
ptg000123l	8286410	8290359	3949	g_3163	g_33345
ptg000123l	8291498	8294726	3228	g_33345	g_8091
ptg000123l	8295865	8335806	39941	g_8091	g_25105
ptg000123l	8340224	8343640	3416	g_25105	g_26441
ptg000123l	8372764	8395744	22980	g_26441	g_36988
ptg000123l	8401723	8406168	4445	g_36988	g_36450
ptg000123l	8415719	8446077	30358	g_36450	g_39320
ptg000123l	8446394	8447294	900	g_39320	g_26876
ptg000123l	8448505	8453659	5154	g_26876	g_5769
ptg000123l	8455016	8477090	22074	g_5769	g_14334
ptg000123l	8486648	8489759	3111	g_14334	g_12654
ptg000123l	8493204	8494745	1541	g_12654	g_10944
ptg000123l	8503598	8504990	1392	g_10944	g_465
ptg000123l	8509353	8511454	2101	g_465	g_23455
ptg000123l	8513983	8517050	3067	g_23455	g_1636
ptg000123l	8544542	8547187	2645	g_1636	g_39932
ptg000123l	8548299	8551703	3404	g_39932	g_32817
ptg000123l	8554436	8583718	29282	g_32817	g_16545
ptg000123l	8599311	8605667	6356	g_16545	g_6486
ptg000123l	8608107	8610919	2812	g_6486	g_11215
ptg000123l	8617257	8624774	7517	g_11215	g_4773
ptg000123l	8625372	8630406	5034	g_4773	g_35340
ptg000123l	8631438	8636490	5052	g_35340	g_69
ptg000123l	8638187	8654510	16323	g_69	g_27314
ptg000123l	8655959	8711845	55886	g_27314	g_12639
ptg000123l	8712102	8756551	44449	g_12639	g_24466
ptg000123l	8768610	8814003	45393	g_24466	g_21728
ptg000123l	8826266	8833819	7553	g_21728	g_34848
ptg000123l	8834097	8845724	11627	g_34848	g_22721
ptg000123l	8856151	8871178	15027	g_22721	g_29100
ptg000123l	8871602	8878146	6544	g_29100	g_12253
ptg000123l	8878545	8882939	4394	g_12253	g_5483
ptg000123l	8892559	8910091	17532	g_5483	g_12655
ptg000123l	8922029	8927448	5419	g_12655	g_23397
ptg000123l	8935747	8936810	1063	g_23397	g_38947
ptg000123l	8939065	8949961	10896	g_38947	g_34576
ptg000123l	8974116	8981212	7096	g_34576	g_19701
ptg000123l	8985198	8986901	1703	g_19701	g_9861
ptg000123l	8993530	8993686	156	g_9861	g_27913
ptg000123l	8993889	8997183	3294	g_27913	g_36480
ptg000123l	8998439	9002287	3848	g_36480	g_29896
ptg000123l	9007325	9010283	2958	g_29896	g_31167
ptg000123l	9011175	9015712	4537	g_31167	g_7269
ptg000123l	9017384	9019665	2281	g_7269	g_34091
ptg000123l	9033193	9052495	19302	g_34091	g_1318
ptg000123l	9063879	9074261	10382	g_1318	g_10892
ptg000123l	9080511	9093686	13175	g_10892	g_2037
ptg000123l	9096223	9125976	29753	g_2037	g_1527
ptg000123l	9132377	9138564	6187	g_1527	g_40233
ptg000123l	9142649	9148929	6280	g_40233	g_22955
ptg000123l	9152255	9171234	18979	g_22955	g_33996
ptg000123l	9188046	9211722	23676	g_33996	g_28705
ptg000123l	9212204	9308179	95975	g_28705	g_15958
ptg000123l	9312574	9317121	4547	g_15958	g_4583
ptg000123l	9331986	9364060	32074	g_4583	g_39361
ptg000123l	9367661	9374152	6491	g_1586	g_18670
ptg000123l	9374379	9387036	12657	g_18670	g_9902
ptg000123l	9387371	9397144	9773	g_9902	g_5916
ptg000123l	9397368	9409141	11773	g_5916	g_26333
ptg000123l	9409491	9673182	263691	g_26333	g_30132
ptg000123l	9675071	9719011	43940	g_30132	g_36628
ptg000123l	9720143	9736341	16198	g_36628	g_12114
ptg000123l	9736613	9871209	134596	g_12114	g_33444
ptg000123l	9871463	9878805	7342	g_33444	g_25220
ptg000123l	9880319	9886730	6411	g_25220	g_20897
ptg000123l	9890308	9896210	5902	g_20897	g_2902
ptg000123l	9900907	9919784	18877	g_2902	g_40253
ptg000123l	9921592	9922121	529	g_40253	g_25306
ptg000123l	9924292	9926565	2273	g_25306	g_23556
ptg000123l	9951241	9952763	1522	g_23556	g_17175
ptg000123l	9957584	9961019	3435	g_17175	g_40169
ptg000123l	9964026	9964868	842	g_40169	g_1061
ptg000123l	9967091	9974452	7361	g_1061	g_22783
ptg000123l	9976502	9980660	4158	g_22783	g_20811
ptg000123l	9984677	9987961	3284	g_20811	g_26447
ptg000123l	9989958	10013509	23551	g_26447	g_20536
ptg000123l	10015424	10017291	1867	g_20536	g_8133
ptg000123l	10027197	10039383	12186	g_8133	g_17500
ptg000123l	10043764	10048895	5131	g_17500	g_32999
ptg000123l	10059072	10064946	5874	g_32999	g_37961
ptg000123l	10069065	10089730	20665	g_37961	g_18537
ptg000123l	10103926	10104539	613	g_18537	g_13932
ptg000123l	10107872	10109119	1247	g_13932	g_31784
ptg000123l	10111393	10113764	2371	g_31784	g_35026
ptg000123l	10122673	10124319	1646	g_35026	g_25728
ptg000123l	10138559	10141343	2784	g_25728	g_4664
ptg000123l	10148375	10149654	1279	g_4664	g_17690
ptg000123l	10153414	10154788	1374	g_17690	g_15468
ptg000123l	10158297	10159598	1301	g_15468	g_3028
ptg000123l	10163395	10169940	6545	g_3028	g_24527
ptg000123l	10170626	10172581	1955	g_24527	g_37722
ptg000123l	10178731	10179836	1105	g_37722	g_32081
ptg000123l	10183827	10185047	1220	g_32081	g_7469
ptg000123l	10208797	10248060	39263	g_7469	g_16608
ptg000123l	10249208	10250794	1586	g_16608	g_25301
ptg000123l	10257230	10265427	8197	g_25301	g_21414
ptg000123l	10271493	10274962	3469	g_21414	g_36219
ptg000123l	10287695	10291212	3517	g_36219	g_34874
ptg000123l	10292233	10360718	68485	g_34874	g_3246
ptg000123l	10363782	10382133	18351	g_3246	g_12852
ptg000123l	10382402	10396189	13787	g_12852	g_37093
ptg000123l	10405730	10407191	1461	g_37093	g_32167
ptg000123l	10418760	10424173	5413	g_32167	g_32035
ptg000123l	10427628	10441011	13383	g_32035	g_15062
ptg000123l	10443411	10450998	7587	g_15062	g_30041
ptg000123l	10461785	10497325	35540	g_30041	g_11596
ptg000123l	10514723	10544642	29919	g_11596	g_3493
ptg000123l	10579344	10582073	2729	g_3493	g_8776
ptg000123l	10582567	10584100	1533	g_8776	g_16606
ptg000123l	10586327	10588719	2392	g_16606	g_33745
ptg000123l	10595498	10996253	400755	g_33745	g_2419
ptg000123l	10996600	11567108	570508	g_2419	g_15282
ptg000123l	11568196	11608593	40397	g_15282	g_6609
ptg000123l	11608808	11619133	10325	g_6609	g_39970
ptg000123l	11624324	11626449	2125	g_39970	g_3699
ptg000123l	11628275	11631850	3575	g_3699	g_12424
ptg000123l	11635554	11637850	2296	g_12424	g_1536
ptg000123l	11639779	11644766	4987	g_1536	g_33000
ptg000123l	11660579	11669378	8799	g_33000	g_36520
ptg000123l	11675161	11678848	3687	g_36520	g_8360
ptg000123l	11685486	11692720	7234	g_8360	g_15453
ptg000123l	11693909	11695056	1147	g_15453	g_29042
ptg000123l	11700224	11704415	4191	g_29042	g_4729
ptg000123l	11709018	11714095	5077	g_4729	g_16218
ptg000123l	11714797	11748787	33990	g_16218	g_8430
ptg000123l	11751898	11775083	23185	g_8430	g_10191
ptg000123l	11777397	11779114	1717	g_10191	g_40082
ptg000123l	11781764	11782597	833	g_40082	g_40083
ptg000123l	11785608	11792781	7173	g_40083	g_28779
ptg000123l	11805371	11812741	7370	g_28779	g_25864
ptg000123l	11813565	11817752	4187	g_25864	g_11182
ptg000123l	11819716	11841843	22127	g_11182	g_18586
ptg000123l	11852299	11855482	3183	g_18586	g_1496
ptg000123l	11864626	11868802	4176	g_1496	g_5939
ptg000123l	11874548	11877482	2934	g_5939	g_23344
ptg000123l	11880647	11885828	5181	g_23344	g_92
ptg000123l	11886199	11890070	3871	g_92	g_38315
ptg000123l	11892528	11904001	11473	g_38315	g_6620
ptg000123l	11913666	11919334	5668	g_6620	g_28336
ptg000123l	11924787	11926804	2017	g_28336	g_40267
ptg000123l	11932578	11935461	2883	g_40267	g_27639
ptg000123l	11938176	12222372	284196	g_27639	g_32369
ptg000123l	12223073	12226766	3693	g_32369	g_28543
ptg000123l	12242720	12250634	7914	g_28543	g_29120
ptg000123l	12256736	12265278	8542	g_29120	g_10888
ptg000123l	12270107	12369978	99871	g_10888	g_18802
ptg000123l	12372509	12385591	13082	g_18802	g_18906
ptg000123l	12386901	12388369	1468	g_18906	g_37196
ptg000123l	12392233	12430906	38673	g_37196	g_15604
ptg000123l	12442786	12447246	4460	g_15604	g_24236
ptg000123l	12447518	12475001	27483	g_24236	g_27936
ptg000123l	12493490	12531384	37894	g_27936	g_2815
ptg000123l	12540768	12584170	43402	g_2815	g_10078
ptg000123l	12585904	12590424	4520	g_10078	g_23594
ptg000123l	12592360	12602921	10561	g_23594	g_10402
ptg000123l	12610062	12613755	3693	g_10402	g_3759
ptg000123l	12614150	12660023	45873	g_3759	g_7635
ptg000123l	12682914	12689277	6363	g_7635	g_5733
ptg000123l	12690669	12694569	3900	g_5733	g_17766
ptg000123l	12696061	12697509	1448	g_17766	g_15441
ptg000123l	12698709	12699072	363	g_15441	g_23853
ptg000123l	12704594	12712608	8014	g_23853	g_17406
ptg000123l	12723851	12738153	14302	g_17406	g_31740
ptg000123l	12761235	12764912	3677	g_31740	g_24289
ptg000123l	12779537	12785721	6184	g_24289	g_30871
ptg000123l	12787231	12788225	994	g_30871	g_40159
ptg000123l	12790494	12791700	1206	g_40159	g_16466
ptg000123l	12798278	12799159	881	g_16466	g_22099
ptg000123l	12801856	12802837	981	g_22099	g_17353
ptg000123l	12804921	12807712	2791	g_17353	g_26409
ptg000123l	12810752	12812034	1282	g_26409	g_442
ptg000123l	12818591	12821330	2739	g_442	g_39907
ptg000123l	12836209	12850370	14161	g_39907	g_12356
ptg000123l	12858058	12866551	8493	g_12356	g_31472
ptg000123l	12880961	12886350	5389	g_31472	g_20719
ptg000123l	12888857	12891933	3076	g_20719	g_1327
ptg000123l	12901218	12912413	11195	g_1327	g_1376
ptg000123l	12916237	12927847	11610	g_1376	g_4045
ptg000123l	12934001	12939547	5546	g_4045	g_5506
ptg000123l	12939756	12951932	12176	g_5506	g_29181
ptg000123l	12952177	12955679	3502	g_29181	g_27528
ptg000123l	12971087	12974578	3491	g_27528	g_2779
ptg000123l	12977625	12978702	1077	g_2779	g_18155
ptg000123l	12981577	12983250	1673	g_18155	g_925
ptg000123l	12988345	12994385	6040	g_925	g_5173
ptg000123l	12997253	13003557	6304	g_5173	g_30894
ptg000123l	13010193	13032013	21820	g_30894	g_20296
ptg000123l	13049344	13055996	6652	g_20296	g_32075
ptg000123l	13058472	13063401	4929	g_32075	g_2232
ptg000123l	13085693	13090932	5239	g_2232	g_12290
ptg000123l	13091759	13127413	35654	g_12290	g_37710
ptg000123l	13132173	13289311	157138	g_37710	g_28891
ptg000123l	13289538	13325864	36326	g_28891	g_33056
ptg000123l	13326070	13351306	25236	g_33056	g_20769
ptg000123l	13351740	13365911	14171	g_20769	g_14971
ptg000123l	13383646	13419346	35700	g_14971	g_27268
ptg000123l	13422236	13425918	3682	g_27268	g_2260
ptg000123l	13429834	13434432	4598	g_2260	g_9780
ptg000123l	13436753	13439600	2847	g_9780	g_27839
ptg000123l	13446227	13476674	30447	g_27839	g_9931
ptg000123l	13478309	13480748	2439	g_9931	g_25637
ptg000123l	13486386	13490033	3647	g_25637	g_35087
ptg000123l	13492256	13515149	22893	g_35087	g_35395
ptg000123l	13515460	13522835	7375	g_35395	g_27349
ptg000123l	13523050	13533739	10689	g_27349	g_30704
ptg000123l	13535878	13539987	4109	g_30704	g_12287
ptg000123l	13541656	13583322	41666	g_12287	g_6881
ptg000123l	13583627	13593600	9973	g_6881	g_3763
ptg000123l	13602990	13616218	13228	g_3763	g_8400
ptg000123l	13617108	13625011	7903	g_8400	g_18476
ptg000123l	13637836	13648444	10608	g_18476	g_447
ptg000123l	13649343	13702213	52870	g_447	g_18508
ptg000123l	13711473	13712546	1073	g_18508	g_5849
ptg000123l	13716705	13722501	5796	g_5849	g_14108
ptg000123l	13732200	13739119	6919	g_14108	g_22284
ptg000123l	13755008	13758442	3434	g_22284	g_23475
ptg000123l	13779732	13795745	16013	g_23475	g_261
ptg000123l	13820079	13825109	5030	g_261	g_7715
ptg000123l	13835836	13839556	3720	g_7715	g_34871
ptg000123l	13857069	13876406	19337	g_34871	g_8745
ptg000123l	13887780	13892688	4908	g_8745	g_20355
ptg000123l	13901062	13918899	17837	g_20355	g_2212
ptg000123l	13922380	13927687	5307	g_2212	g_21793
ptg000123l	13930289	13931376	1087	g_21793	g_4628
ptg000123l	13935820	13938078	2258	g_4628	g_3905
ptg000123l	13941817	13951939	10122	g_3905	g_4598
ptg000123l	13969287	14044672	75385	g_4598	g_6885
ptg000123l	14045025	14064234	19209	g_6885	g_29525
ptg000123l	14065340	14065445	105	g_29525	g_40024
ptg000123l	14072427	14086665	14238	g_40024	g_607
ptg000123l	14092010	14095836	3826	g_607	g_36592
ptg000123l	14100870	14104185	3315	g_36592	g_29762
ptg000123l	14111183	14113434	2251	g_29762	g_25633
ptg000123l	14114426	14125261	10835	g_25633	g_12599
ptg000123l	14134366	14138076	3710	g_12599	g_22597
ptg000123l	14139566	14147506	7940	g_22597	g_15378
ptg000123l	14149218	14149475	257	g_15378	g_14042
ptg000123l	14160990	14169623	8633	g_14042	g_29578
ptg000123l	14181548	14191690	10142	g_29578	g_7850
ptg000123l	14191944	14267160	75216	g_7850	g_23975
ptg000123l	14273276	14275980	2704	g_23975	g_13766
ptg000123l	14278412	14295421	17009	g_13766	g_18279
ptg000123l	14295738	14317501	21763	g_18279	g_28087
ptg000123l	14330558	14335077	4519	g_28087	g_14662
ptg000123l	14345821	14382062	36241	g_14662	g_30767
ptg000123l	14382364	14483435	101071	g_30767	g_34812
ptg000123l	14496898	14530481	33583	g_34812	g_16489
ptg000123l	14538318	14549535	11217	g_16489	g_22234
ptg000123l	14572738	14601001	28263	g_22234	g_20316
ptg000123l	14624148	14625854	1706	g_20316	g_31713
ptg000123l	14629437	14657736	28299	g_31713	g_9373
ptg000123l	14663471	14665240	1769	g_9373	g_14966
ptg000123l	14672802	14689736	16934	g_14966	g_20060
ptg000123l	14691113	14695103	3990	g_20060	g_5139
ptg000123l	14696159	14698478	2319	g_5139	g_26485
ptg000123l	14706727	14711950	5223	g_26485	g_22310
ptg000123l	14719051	14725170	6119	g_22310	g_24969
ptg000123l	14741433	14743726	2293	g_24969	g_38217
ptg000123l	14752062	14783542	31480	g_38217	g_22013
ptg000123l	14792600	14793259	659	g_22013	g_22638
ptg000123l	14796714	14797506	792	g_22638	g_15085
ptg000123l	14804642	14815645	11003	g_15085	g_10478
ptg000123l	14824690	14826042	1352	g_10478	g_32486
ptg000123l	14826617	14829564	2947	g_32486	g_39130
ptg000123l	14829812	14873729	43917	g_39130	g_23296
ptg000123l	14884511	14888523	4012	g_23296	g_15965
ptg000123l	14889011	14894059	5048	g_15965	g_35639
ptg000123l	14894547	14988789	94242	g_35639	g_25183
ptg000123l	14989835	14994311	4476	g_25183	g_31260
ptg000123l	15001478	15004404	2926	g_31260	g_19706
ptg000123l	15007866	15020069	12203	g_19706	g_23679
ptg000123l	15020443	15022719	2276	g_23679	g_22464
ptg000123l	15023276	15035649	12373	g_22464	g_23065
ptg000123l	15056636	15059678	3042	g_23065	g_25402
ptg000123l	15060600	15061088	488	g_25402	g_33593
ptg000123l	15065776	15068167	2391	g_33593	g_6718
ptg000123l	15081178	15099284	18106	g_6718	g_18442
ptg000123l	15109009	15177264	68255	g_18442	g_1276
ptg000123l	15239413	15254819	15406	g_1276	g_34051
ptg000123l	15266184	15360927	94743	g_34051	g_421
ptg000123l	15362472	15365311	2839	g_421	g_9104
ptg000123l	15383759	15436363	52604	g_9104	g_39499
ptg000123l	15442022	15442584	562	g_39499	g_39414
ptg000123l	15446174	15446267	93	g_39414	g_39351
ptg000123l	15453820	15465039	11219	g_39351	g_27214
ptg000123l	15474573	15477265	2692	g_27214	g_3909
ptg000123l	15485177	15535221	50044	g_3909	g_16955
ptg000123l	15538929	15542507	3578	g_16955	g_13195
ptg000123l	15550015	15678618	128603	g_13195	g_29130
ptg000123l	15680592	15713406	32814	g_29130	g_11814
ptg000123l	15714991	15719627	4636	g_11814	g_33685
ptg000123l	15721084	15725384	4300	g_33685	g_24221
ptg000123l	15732894	15751613	18719	g_24221	g_10084
ptg000123l	15758305	15772730	14425	g_10084	g_6590
ptg000123l	15773927	15785093	11166	g_6590	g_10832
ptg000123l	15789128	15793619	4491	g_10832	g_24203
ptg000123l	15794259	15796641	2382	g_24203	g_6442
ptg000123l	15802181	15802894	713	g_6442	g_20177
ptg000123l	15803381	15811670	8289	g_20177	g_28169
ptg000123l	15830183	15846641	16458	g_28169	g_5946
ptg000123l	15851856	15937391	85535	g_5946	g_16330
ptg000123l	15953537	15956257	2720	g_16330	g_1036
ptg000123l	15956682	15960680	3998	g_1036	g_3396
ptg000123l	15960982	15961009	27	g_3396	g_32013
ptg000123l	15961227	15986313	25086	g_32013	g_35842
ptg000123l	16012229	16014101	1872	g_35842	g_4601
ptg000123l	16022758	16053207	30449	g_4601	g_4540
ptg000123l	16058259	16069813	11554	g_4540	g_31422
ptg000123l	16070151	16075017	4866	g_31422	g_867
ptg000123l	16080861	16083369	2508	g_867	g_2511
ptg000123l	16086955	16088523	1568	g_2511	g_35833
ptg000123l	16096011	16098713	2702	g_35833	g_187
ptg000123l	16100341	16164600	64259	g_187	g_25885
ptg000123l	16165878	16169710	3832	g_25885	g_36381
ptg000123l	16172771	16186109	13338	g_36381	g_20891
ptg000123l	16186396	16238083	51687	g_20891	g_25697
ptg000123l	16239469	16243306	3837	g_25697	g_3931
ptg000123l	16244993	16249248	4255	g_3931	g_17908
ptg000123l	16253125	16264254	11129	g_17908	g_7324
ptg000123l	16265528	16273966	8438	g_7324	g_32511
ptg000123l	16275407	16280719	5312	g_32511	g_28206
ptg000123l	16282333	16286190	3857	g_28206	g_31760
ptg000123l	16287367	16291723	4356	g_31760	g_25803
ptg000123l	16293814	16299582	5768	g_25803	g_36423
ptg000123l	16301259	16311909	10650	g_36423	g_29332
ptg000123l	16313347	16320559	7212	g_29332	g_2467
ptg000123l	16320846	16322452	1606	g_2467	g_12966
ptg000123l	16325403	16345523	20120	g_12966	g_37277
ptg000123l	16367373	16392945	25572	g_37277	g_18415
ptg000123l	16398131	16403463	5332	g_18415	g_37542
ptg000123l	16405853	16433197	27344	g_37542	g_35122
ptg000123l	16435689	16451936	16247	g_35122	g_25411
ptg000123l	16464249	16474043	9794	g_25411	g_16930
ptg000123l	16474477	16476111	1634	g_16930	g_36752
ptg000123l	16478730	16506749	28019	g_36752	g_19303
ptg000123l	16509170	16515944	6774	g_19303	g_38118
ptg000123l	16516159	16543579	27420	g_38118	g_8853
ptg000123l	16543812	16590685	46873	g_8853	g_30388
ptg000123l	16592604	16618935	26331	g_30388	g_35307
ptg000123l	16623003	16625919	2916	g_35307	g_16276
ptg000123l	16626704	16657650	30946	g_16276	g_32287
ptg000123l	16670305	16672071	1766	g_32287	g_5151
ptg000123l	16678215	16682298	4083	g_5151	g_33084
ptg000123l	16701596	16769903	68307	g_33084	g_2408
ptg000123l	16772733	16806430	33697	g_2408	g_8211
ptg000123l	16866393	16877406	11013	g_8211	g_17361
ptg000123l	16877633	16877682	49	g_17361	g_26307
ptg000123l	16892572	16959434	66862	g_26307	g_26777
ptg000123l	16959808	16966402	6594	g_26777	g_34935
ptg000123l	16969349	17003974	34625	g_34935	g_11916
ptg000123l	17007984	17025380	17396	g_11916	g_28801
ptg000123l	17026162	17029658	3496	g_28801	g_38050
ptg000123l	17033452	17044971	11519	g_38050	g_34987
ptg000123l	17057344	17067521	10177	g_34987	g_31664
ptg000123l	17071761	17121268	49507	g_31664	g_20308
ptg000123l	17122056	17201176	79120	g_20308	g_19326
ptg000123l	17215755	17226537	10782	g_19326	g_29061
ptg000123l	17232464	17234619	2155	g_29061	g_3036
ptg000123l	17243079	17253161	10082	g_3036	g_14577
ptg000123l	17268408	17270779	2371	g_14577	g_4095
ptg000123l	17276808	17279713	2905	g_4095	g_8751
ptg000123l	17285287	17287334	2047	g_8751	g_600
ptg000123l	17291865	17333374	41509	g_600	g_8615
ptg000123l	17346986	17364631	17645	g_8615	g_3074
ptg000123l	17387854	17413929	26075	g_3074	g_24380
ptg000123l	17416919	17457887	40968	g_24380	g_13019
ptg000123l	17469113	17475594	6481	g_13019	g_1126
ptg000123l	17481810	17534564	52754	g_1126	g_38337
ptg000123l	17537078	17538332	1254	g_38337	g_24947
ptg000123l	17542452	17543962	1510	g_24947	g_21960
ptg000123l	17551001	17551957	956	g_21960	g_31042
ptg000123l	17560096	17585782	25686	g_31042	g_5418
ptg000123l	17589242	17593146	3904	g_5418	g_33218
ptg000123l	17594014	17598585	4571	g_33218	g_5385
ptg000123l	17604772	17618036	13264	g_5385	g_20399
ptg000123l	17618242	17621081	2839	g_20399	g_6549
ptg000123l	17648992	17655742	6750	g_6549	g_11027
ptg000123l	17656236	17658303	2067	g_11027	g_23032
ptg000123l	17658776	17737473	78697	g_23032	g_22473
ptg000123l	17740545	17743845	3300	g_22473	g_14415
ptg000123l	17746420	17754872	8452	g_14415	g_24070
ptg000123l	17758262	17769812	11550	g_24070	g_20148
ptg000123l	17770021	17777769	7748	g_20148	g_11472
ptg000123l	17779095	17780206	1111	g_11472	g_12727
ptg000123l	17785679	17793437	7758	g_12727	g_20350
ptg000123l	17818232	17920910	102678	g_20350	g_17954
ptg000123l	17922061	17931011	8950	g_17954	g_23090
ptg000123l	17931283	17936278	4995	g_23090	g_39963
ptg000123l	17940922	17942557	1635	g_39963	g_3338
ptg000123l	17944046	18116168	172122	g_3338	g_21151
ptg000123l	18117919	18268567	150648	g_21151	g_7681
ptg000123l	18309234	18313555	4321	g_7681	g_24766
ptg000123l	18323713	18426941	103228	g_24766	g_38925
ptg000123l	18427219	18545489	118270	g_38925	g_37800
ptg000123l	18564633	18598631	33998	g_37800	g_28429
ptg000123l	18603522	18606571	3049	g_28429	g_37797
ptg000123l	18660980	18845168	184188	g_37797	g_9747
ptg000123l	18846082	19132721	286639	g_9747	g_2924
ptg000123l	19133005	19304654	171649	g_2924	g_8068
ptg000123l	19308580	19329907	21327	g_8068	g_39668
ptg000123l	19338816	19412868	74052	g_25979	g_38064
ptg000123l	19413482	19437237	23755	g_38064	g_7638
ptg000123l	19441943	19443156	1213	g_7638	g_2814
ptg000123l	19457505	19466950	9445	g_2814	g_10880
ptg000123l	19491472	19514768	23296	g_10880	g_24558
ptg000123l	19515568	19522829	7261	g_24558	g_14326
ptg000123l	19527958	19571352	43394	g_14326	g_27545
ptg000123l	19577508	19586478	8970	g_27545	g_650
ptg000123l	19594297	19600451	6154	g_650	g_36222
ptg000123l	19609849	19620287	10438	g_36222	g_16887
ptg000123l	19634759	19637108	2349	g_16887	g_29720
ptg000123l	19637941	19664798	26857	g_29720	g_27503
ptg000123l	19673821	19735510	61689	g_27503	g_4040
ptg000123l	19735893	19816105	80212	g_4040	g_30968
ptg000123l	19816347	19828390	12043	g_30968	g_34196
ptg000123l	19831128	19947159	116031	g_34196	g_7237
ptg000123l	19951211	19996848	45637	g_7237	g_4214
ptg000123l	20008416	20037194	28778	g_4214	g_10854
ptg000123l	20038728	20064452	25724	g_10854	g_34945
ptg000123l	20065163	20128557	63394	g_34945	g_2221
ptg000123l	20133906	20144267	10361	g_2221	g_37310
ptg000123l	20151426	20210509	59083	g_37310	g_4398
ptg000123l	20245213	20326463	81250	g_4398	g_40166
ptg000123l	20348565	20370741	22176	g_40166	g_16904
ptg000123l	20380023	20593650	213627	g_16904	g_33632
ptg000123l	20603372	20613511	10139	g_33632	g_1330
ptg000123l	20616093	20670099	54006	g_1330	g_26091
ptg000123l	20677757	20715012	37255	g_26091	g_20056
ptg000123l	20715956	20788238	72282	g_20056	g_33482
ptg000123l	20789020	20840826	51806	g_33482	g_18691
ptg000123l	20841038	20862155	21117	g_18691	g_5197
ptg000123l	20862358	20882162	19804	g_5197	g_20605
ptg000123l	20882419	20932491	50072	g_20605	g_9419
ptg000123l	20933039	20961899	28860	g_9419	g_14261
ptg000123l	20965175	20981824	16649	g_14261	g_341
ptg000123l	20988046	20998521	10475	g_341	g_37928
ptg000123l	21008604	21012230	3626	g_37928	g_35571
ptg000123l	21030586	21046625	16039	g_35571	g_6062
ptg000123l	21063491	21161437	97946	g_6062	g_15465
ptg000123l	21163010	21168051	5041	g_15465	g_29108
ptg000123l	21177366	21181638	4272	g_29108	g_32320
ptg000123l	21189289	21191823	2534	g_32320	g_35403
ptg000123l	21198688	21205525	6837	g_35403	g_31356
ptg000123l	21212479	21259414	46935	g_31356	g_33789
ptg000123l	21262043	21462882	200839	g_33789	g_34119
ptg000123l	21463298	21469298	6000	g_34119	g_11145
ptg000123l	21481239	21516377	35138	g_11145	g_2634
ptg000123l	21529238	21531923	2685	g_2634	g_1377
ptg000123l	21532871	21534818	1947	g_1377	g_20923
ptg000123l	21535522	21550566	15044	g_20923	g_530
ptg000123l	21558558	21589296	30738	g_530	g_21200
ptg000123l	21589574	21643759	54185	g_21200	g_23220
ptg000123l	21661562	21671949	10387	g_23220	g_27062
ptg000123l	21674002	21710133	36131	g_27062	g_3746
ptg000123l	21713483	21719031	5548	g_3746	g_39062
ptg000123l	21720850	21727151	6301	g_17658	g_38918
ptg000123l	21728972	21733546	4574	g_26836	g_38895
ptg000123l	21735179	21772171	36992	g_25850	g_17049
ptg000123l	21774090	21774174	84	g_17049	g_6172
ptg000123l	21774497	21779551	5054	g_6172	g_5200
ptg000123l	21788526	21801994	13468	g_5200	g_29433
ptg000123l	21803037	21811923	8886	g_29433	g_37766
ptg000123l	21815868	21820830	4962	g_37766	g_14535
ptg000123l	21887428	22149273	261845	g_14535	g_9489
ptg000123l	22168293	22214220	45927	g_9489	g_19726
ptg000123l	22220580	22440795	220215	g_19726	g_15756
ptg000123l	22441001	22635535	194534	g_15756	g_14837
ptg000123l	22635870	22650139	14269	g_14837	g_1465
ptg000123l	22650765	22699709	48944	g_1465	g_8619
ptg000123l	22704223	22719583	15360	g_8619	g_36017
ptg000123l	22720299	22928346	208047	g_36017	g_24372
ptg000123l	22945787	22989519	43732	g_24372	g_9315
ptg000123l	23007191	23144124	136933	g_9315	g_21038
ptg000123l	23160141	23192981	32840	g_21038	g_11844
ptg000123l	23193586	23195382	1796	g_11844	g_17546
ptg000123l	23196892	23202404	5512	g_17546	g_11119
ptg000123l	23234372	23353913	119541	g_11119	g_19448
ptg000123l	23358576	23369590	11014	g_19448	g_11334
ptg000123l	23378245	23394028	15783	g_11334	g_4061
ptg000123l	23397062	23437885	40823	g_4061	g_22014
ptg000123l	23439116	23588253	149137	g_22014	g_8983
ptg000123l	23588864	23690433	101569	g_8983	g_35665
ptg000123l	23691530	23858529	166999	g_35665	g_34986
ptg000123l	23858906	23877525	18619	g_34986	g_7951
ptg000123l	23878691	23896126	17435	g_7951	g_15203
ptg000123l	23897529	23928000	30471	g_15203	g_13990
ptg000123l	23948801	23979922	31121	g_13990	g_17960
ptg000123l	23984211	23992531	8320	g_17960	g_5282
ptg000123l	24003061	24016377	13316	g_5282	g_8132
ptg000123l	24038139	24379593	341454	g_8132	g_2763
ptg000123l	24401896	24409353	7457	g_2763	g_7232
ptg000125l	80376	107885	27509	g_16300	g_66
ptg000125l	141359	155181	13822	g_66	g_34205
ptg000125l	164719	176644	11925	g_34205	g_7287
ptg000125l	200688	218265	17577	g_7287	g_18837
ptg000125l	243040	255937	12897	g_18837	g_31094
ptg000125l	263693	267596	3903	g_31094	g_28447
ptg000125l	277583	283767	6184	g_28447	g_23149
ptg000125l	293541	324159	30618	g_23149	g_739
ptg000125l	329102	417469	88367	g_739	g_33174
ptg000125l	418686	451140	32454	g_33174	g_76
ptg000125l	455371	461770	6399	g_76	g_17490
ptg000126l	26453	28053	1600	g_33160	g_32363
ptg000126l	30661	39985	9324	g_32363	g_33879
ptg000126l	41322	60157	18835	g_33879	g_4841
ptg000126l	60513	61172	659	g_4841	g_25089
ptg000126l	74675	81955	7280	g_25089	g_11176
ptg000126l	98999	102139	3140	g_11176	g_2019
ptg000126l	115784	116916	1132	g_2019	g_10687
ptg000126l	117359	126969	9610	g_10687	g_39656
ptg000126l	127376	128074	698	g_39656	g_38502
ptg000126l	128382	168553	40171	g_38502	g_5955
ptg000126l	172647	174349	1702	g_5955	g_2715
ptg000126l	176485	241089	64604	g_2715	g_12797
ptg000126l	255763	265857	10094	g_12797	g_14002
ptg000126l	274647	276020	1373	g_14002	g_29116
ptg000126l	295152	309479	14327	g_29116	g_16878
ptg000126l	317664	359433	41769	g_16878	g_22151
ptg000126l	370916	402321	31405	g_22151	g_16552
ptg000127l	37040	158644	121604	g_45	g_11708
ptg000127l	159003	173325	14322	g_11708	g_3849
ptg000127l	173540	173707	167	g_3849	g_7834
ptg000127l	174006	174087	81	g_7834	g_28346
ptg000127l	174428	175540	1112	g_28346	g_3611
ptg000127l	180842	239125	58283	g_3611	g_7650
ptg000127l	245835	246585	750	g_7650	g_19842
ptg000127l	252850	323354	70504	g_19842	g_17942
ptg000127l	328597	347519	18922	g_17942	g_38032
ptg000127l	359161	361472	2311	g_38032	g_30643
ptg000127l	368355	371692	3337	g_30643	g_12180
ptg000127l	373066	373416	350	g_12180	g_28088
ptg000127l	379471	394281	14810	g_28088	g_10973
ptg000127l	407606	413450	5844	g_10973	g_13760
ptg000127l	418294	425401	7107	g_13760	g_26006
ptg000127l	445008	479483	34475	g_26006	g_5887
ptg000127l	490724	494791	4067	g_5887	g_19402
ptg000127l	495849	533042	37193	g_19402	g_16484
ptg000127l	534412	550819	16407	g_16484	g_21881
ptg000127l	553040	572015	18975	g_21881	g_17610
ptg000127l	574276	670081	95805	g_17610	g_30237
ptg000127l	689448	712137	22689	g_30237	g_39318
ptg000127l	713090	713640	550	g_39318	g_5251
ptg000128l	268669	268699	30	g_18426	g_11359
ptg000128l	269001	275189	6188	g_11359	g_40096
ptg000128l	288819	290094	1275	g_40096	g_13012
ptg000128l	292148	598218	306070	g_13012	g_12184
ptg000129l	986	4047	3061	g_30006	g_7881
ptg000129l	5075	5166	91	g_7881	g_2111
ptg000129l	6170	7300	1130	g_2111	g_1771
ptg000129l	8277	11066	2789	g_1771	g_35885
ptg000129l	11698	11829	131	g_35885	g_15748
ptg000129l	12254	12505	251	g_15748	g_1705
ptg000129l	13794	13996	202	g_1705	g_29743
ptg000129l	14526	14580	54	g_29743	g_4619
ptg000129l	15083	15160	77	g_4619	g_4686
ptg000129l	17547	17936	389	g_4686	g_35449
ptg000129l	18805	22235	3430	g_35449	g_19355
ptg000129l	23278	26697	3419	g_19355	g_27598
ptg000129l	27218	27271	53	g_27598	g_14346
ptg000129l	27588	27738	150	g_14346	g_17204
ptg000129l	29294	29321	27	g_17204	g_10138
ptg000129l	30247	30282	35	g_10138	g_32959
ptg000129l	31091	31202	111	g_32959	g_17309
ptg000129l	31933	32117	184	g_17309	g_36194
ptg000129l	34123	34551	428	g_36194	g_33420
ptg000129l	35375	35468	93	g_33420	g_27119
ptg000129l	36037	36273	236	g_27119	g_34795
ptg000129l	37355	37426	71	g_34795	g_29629
ptg000129l	37881	39462	1581	g_29629	g_26164
ptg000129l	40703	40852	149	g_26164	g_27910
ptg000131l	41475	62945	21470	g_27910	g_4025
ptg000131l	63376	74077	10701	g_4025	g_30306
ptg000131l	81756	87246	5490	g_30306	g_30290
ptg000131l	115318	125245	9927	g_30290	g_1948
ptg000131l	150221	154319	4098	g_1948	g_37390
ptg000131l	161735	172706	10971	g_37390	g_4556
ptg000131l	186932	232957	46025	g_4556	g_11583
ptg000131l	234153	447415	213262	g_11583	g_32066
ptg000131l	447624	478613	30989	g_32066	g_25918
ptg000131l	503744	515729	11985	g_25918	g_572
ptg000131l	528791	576672	47881	g_572	g_32777
ptg000131l	585262	658296	73034	g_32777	g_9137
ptg000131l	683726	694970	11244	g_9137	g_28824
ptg000131l	700252	772775	72523	g_28824	g_26795
ptg000131l	775580	799359	23779	g_26795	g_28879
ptg000131l	799688	848739	49051	g_28879	g_32997
ptg000131l	848960	985015	136055	g_32997	g_23062
ptg000131l	1011400	1015668	4268	g_23062	g_9325
ptg000131l	1032260	1035742	3482	g_9325	g_1808
ptg000131l	1075045	1079101	4056	g_1808	g_8332
ptg000131l	1083223	1121113	37890	g_8332	g_32877
ptg000131l	1141621	1299479	157858	g_32877	g_17923
ptg000131l	1374038	1398340	24302	g_17923	g_887
ptg000131l	1421361	1537457	116096	g_887	g_34491
ptg000131l	1554069	1602457	48388	g_34491	g_27523
ptg000131l	1605420	1785849	180429	g_27523	g_14877
ptg000131l	1790842	1811784	20942	g_14877	g_4611
ptg000131l	1819033	1838553	19520	g_4611	g_36437
ptg000131l	1848664	1853339	4675	g_36437	g_26348
ptg000131l	1862596	1956247	93651	g_26348	g_2523
ptg000131l	1957467	1963764	6297	g_2523	g_30925
ptg000131l	1966220	2050792	84572	g_30925	g_32144
ptg000131l	2079057	2180562	101505	g_32144	g_3702
ptg000131l	2194253	2205983	11730	g_3702	g_38247
ptg000131l	2206870	2223734	16864	g_38247	g_25062
ptg000131l	2230949	2233829	2880	g_25062	g_11634
ptg000131l	2239693	2242830	3137	g_11634	g_22423
ptg000131l	2256886	2261562	4676	g_22423	g_21876
ptg000131l	2272684	2311646	38962	g_21876	g_13538
ptg000131l	2339024	2361608	22584	g_13538	g_7171
ptg000131l	2386649	2550546	163897	g_7171	g_24921
ptg000131l	2561363	2734255	172892	g_24921	g_31303
ptg000131l	2752448	2873237	120789	g_31303	g_29538
ptg000131l	2873611	2974390	100779	g_29538	g_25916
ptg000131l	2985379	3099022	113643	g_25916	g_17522
ptg000131l	3099981	3100522	541	g_17522	g_5277
ptg000131l	3100776	3111769	10993	g_5277	g_17339
ptg000131l	3125965	3130222	4257	g_17339	g_27182
ptg000131l	3147663	3178474	30811	g_27182	g_5873
ptg000131l	3200388	3203058	2670	g_5873	g_2439
ptg000131l	3215511	3224248	8737	g_2439	g_10202
ptg000131l	3308182	3343701	35519	g_10202	g_1745
ptg000131l	3346994	3420626	73632	g_1745	g_8856
ptg000131l	3420832	3554956	134124	g_8856	g_38419
ptg000131l	3555876	3703127	147251	g_38419	g_16928
ptg000131l	3707027	3906594	199567	g_16928	g_21068
ptg000131l	3913920	3918470	4550	g_21068	g_29552
ptg000131l	3931859	4012325	80466	g_29552	g_1664
ptg000131l	4017022	4020154	3132	g_1664	g_23937
ptg000131l	4036903	4086339	49436	g_23937	g_5614
ptg000131l	4086714	4095337	8623	g_5614	g_12338
ptg000131l	4095712	4106002	10290	g_12338	g_20015
ptg000131l	4106377	4111095	4718	g_20015	g_13883
ptg000131l	4111470	4116672	5202	g_13883	g_30558
ptg000131l	4117047	4122142	5095	g_30558	g_645
ptg000131l	4122518	4129387	6869	g_645	g_17154
ptg000131l	4129763	4134410	4647	g_17154	g_10608
ptg000131l	4134784	4144166	9382	g_10608	g_3690
ptg000131l	4144542	4148056	3514	g_3690	g_12034
ptg000131l	4148432	4152656	4224	g_12034	g_7763
ptg000131l	4153032	4165803	12771	g_7763	g_32888
ptg000131l	4166030	4184412	18382	g_32888	g_29775
ptg000131l	4188446	4191819	3373	g_29775	g_36038
ptg000131l	4205979	4225582	19603	g_36038	g_11763
ptg000131l	4235768	4243481	7713	g_11763	g_35796
ptg000131l	4248140	4270598	22458	g_35796	g_3293
ptg000131l	4270894	4278258	7364	g_3293	g_8219
ptg000131l	4279000	4283275	4275	g_8219	g_32235
ptg000131l	4284022	4289037	5015	g_32235	g_26865
ptg000131l	4289905	4294756	4851	g_26865	g_15638
ptg000131l	4295557	4300794	5237	g_15638	g_29483
ptg000131l	4301629	4306161	4532	g_29483	g_7180
ptg000131l	4306995	4316944	9949	g_7180	g_2508
ptg000131l	4317204	4335136	17932	g_2508	g_22836
ptg000131l	4335965	4338098	2133	g_22836	g_8876
ptg000131l	4338832	4342979	4147	g_8876	g_36057
ptg000131l	4343681	4346650	2969	g_36057	g_30043
ptg000131l	4347437	4360827	13390	g_30043	g_26566
ptg000131l	4361435	4505248	143813	g_26566	g_10162
ptg000131l	4510373	4527999	17626	g_10162	g_22041
ptg000131l	4538492	4636465	97973	g_22041	g_6704
ptg000131l	4645268	4685918	40650	g_6704	g_26833
ptg000131l	4700063	4747252	47189	g_26833	g_11571
ptg000131l	4762155	4935324	173169	g_11571	g_35320
ptg000131l	4936076	5459406	523330	g_35320	g_23669
ptg000131l	5460164	5517952	57788	g_23669	g_33221
ptg000131l	5518704	5704806	186102	g_33221	g_15324
ptg000131l	5705558	5722539	16981	g_15324	g_15158
ptg000131l	5723336	5972940	249604	g_15158	g_27917
ptg000131l	5986530	5989371	2841	g_27917	g_11750
ptg000131l	6014039	6030050	16011	g_11750	g_20433
ptg000131l	6046244	6047694	1450	g_20433	g_2143
ptg000131l	6057460	6071695	14235	g_2143	g_33424
ptg000131l	6073101	6079123	6022	g_33424	g_12626
ptg000131l	6079923	6113425	33502	g_12626	g_27643
ptg000131l	6135258	6137084	1826	g_27643	g_7227
ptg000131l	6138262	6199623	61361	g_7227	g_37376
ptg000131l	6210133	6215998	5865	g_37376	g_13312
ptg000131l	6230140	6232678	2538	g_13312	g_15119
ptg000131l	6232971	6249966	16995	g_15119	g_6926
ptg000131l	6252563	6274544	21981	g_6926	g_31518
ptg000131l	6294956	6300379	5423	g_31518	g_33939
ptg000131l	6300665	6303766	3101	g_33939	g_15347
ptg000131l	6309732	6316471	6739	g_15347	g_11428
ptg000131l	6328824	6330362	1538	g_11428	g_38213
ptg000131l	6332944	6336817	3873	g_38213	g_39960
ptg000131l	6347854	6351381	3527	g_39960	g_3221
ptg000131l	6355599	6361652	6053	g_3221	g_5699
ptg000131l	6361945	6422341	60396	g_5699	g_37576
ptg000132l	359	426	67	g_36888	g_37549
ptg000132l	1412	1468	56	g_37549	g_15675
ptg000132l	2616	2799	183	g_15675	g_30394
ptg000132l	4235	4284	49	g_30394	g_3204
ptg000132l	4583	4890	307	g_3204	g_17445
ptg000132l	5357	6619	1262	g_17445	g_20083
ptg000132l	6984	7100	116	g_20083	g_6753
ptg000132l	8686	11871	3185	g_6753	g_27318
ptg000132l	12233	12361	128	g_27318	g_21923
ptg000132l	12699	13258	559	g_21923	g_18926
ptg000132l	13512	13534	22	g_18926	g_23741
ptg000134l	13835	68746	54911	g_23741	g_24506
ptg000134l	69459	81799	12340	g_24506	g_21772
ptg000134l	82740	95673	12933	g_21772	g_22532
ptg000134l	101073	102769	1696	g_22532	g_25350
ptg000134l	103947	108007	4060	g_25350	g_8730
ptg000134l	113091	120667	7576	g_8730	g_40036
ptg000134l	140669	141675	1006	g_40036	g_7838
ptg000134l	141932	144115	2183	g_7838	g_7347
ptg000134l	144858	150509	5651	g_7347	g_9480
ptg000135l	52940	65702	12762	g_23051	g_6764
ptg000135l	78368	85231	6863	g_6764	g_5519
ptg000135l	86208	87540	1332	g_5519	g_8697
ptg000135l	111302	194853	83551	g_8697	g_664
ptg000135l	195092	235715	40623	g_664	g_35678
ptg000135l	244145	245551	1406	g_35678	g_6382
ptg000135l	265335	270914	5579	g_6382	g_5405
ptg000136l	15244	32014	16770	g_21838	g_24048
ptg000136l	32685	52396	19711	g_24048	g_3679
ptg000136l	53839	462794	408955	g_3679	g_3187
ptg000137l	20871	38334	17463	g_32827	g_13991
ptg000137l	58502	133213	74711	g_13991	g_7634
ptg000137l	134313	178091	43778	g_7634	g_37473
ptg000137l	178570	234827	56257	g_37473	g_25533
ptg000137l	235450	266728	31278	g_25533	g_30989
ptg000137l	268395	317030	48635	g_30989	g_10361
ptg000137l	336703	393393	56690	g_10361	g_6663
ptg000137l	394679	427050	32371	g_6663	g_11676
ptg000137l	433961	447513	13552	g_11676	g_31269
ptg000137l	448145	552971	104826	g_31269	g_918
ptg000137l	578897	705881	126984	g_918	g_24923
ptg000137l	706294	707195	901	g_24923	g_23879
ptg000137l	707968	708204	236	g_23879	g_35725
ptg000137l	709118	709949	831	g_35725	g_12346
ptg000141l	7831	33919	26088	g_32501	g_27775
ptg000141l	38953	51139	12186	g_27775	g_17699
ptg000141l	73447	91106	17659	g_17699	g_31538
ptg000141l	92806	94916	2110	g_31538	g_40277
ptg000141l	97085	112529	15444	g_40277	g_24562
ptg000141l	116866	130515	13649	g_24562	g_37617
ptg000141l	131150	151740	20590	g_37617	g_1477
ptg000141l	152639	170403	17764	g_1477	g_30152
ptg000141l	170693	170697	4	g_30152	g_19227
ptg000141l	174749	192387	17638	g_19227	g_6769
ptg000141l	196066	292057	95991	g_6769	g_4802
ptg000141l	292491	294114	1623	g_4802	g_36564
ptg000141l	294803	324442	29639	g_39356	g_30840
ptg000141l	325734	333194	7460	g_30840	g_2387
ptg000141l	343524	353994	10470	g_2387	g_7229
ptg000142l	34029	53754	19725	g_29376	g_2735
ptg000142l	53954	73978	20024	g_2735	g_25508
ptg000142l	75357	85193	9836	g_25508	g_1537
ptg000142l	85786	87010	1224	g_1537	g_11690
ptg000142l	95679	142770	47091	g_11690	g_355
ptg000142l	143237	243388	100151	g_355	g_25718
ptg000142l	243648	243686	38	g_25718	g_5566
ptg000145l	89998	90209	211	g_5554	g_16010
ptg000145l	90652	268435	177783	g_16010	g_2904
ptg000146l	14920	19131	4211	g_3673	g_30399
ptg000146l	20087	28178	8091	g_30399	g_34558
ptg000146l	28762	42349	13587	g_34558	g_11769
ptg000146l	44469	170438	125969	g_11769	g_26000
ptg000146l	186465	187751	1286	g_26000	g_13399
ptg000146l	188209	234992	46783	g_13399	g_14031
ptg000146l	237053	239673	2620	g_14031	g_24204
ptg000146l	240377	240739	362	g_24204	g_9425
ptg000146l	248743	276990	28247	g_9425	g_9985
ptg000146l	277244	316203	38959	g_9985	g_28759
ptg000147l	37213	47456	10243	g_10379	g_23364
ptg000147l	48070	49447	1377	g_23364	g_6254
ptg000147l	65552	68566	3014	g_6254	g_20712
ptg000147l	71735	72370	635	g_20712	g_19917
ptg000147l	73203	75341	2138	g_19917	g_27469
ptg000148l	51627	80750	29123	g_5602	g_11218
ptg000148l	81478	81547	69	g_11218	g_37521
ptg000148l	82554	107682	25128	g_37521	g_21352
ptg000148l	108464	222611	114147	g_21352	g_11724
ptg000148l	223321	227338	4017	g_11724	g_18061
ptg000148l	227895	230641	2746	g_18061	g_37726
ptg000148l	231369	284147	52778	g_37726	g_34648
ptg000148l	285304	288563	3259	g_34648	g_36576
ptg000148l	288799	326258	37459	g_36576	g_19928
ptg000148l	326554	352245	25691	g_19928	g_16074
ptg000148l	363009	438402	75393	g_16074	g_21525
ptg000148l	463362	488303	24941	g_21525	g_3664
ptg000148l	489064	496503	7439	g_3664	g_2858
ptg000148l	497222	497285	63	g_2858	g_16708
ptg000148l	498166	498195	29	g_16708	g_3373
ptg000148l	498761	498784	23	g_3373	g_31941
ptg000148l	499212	632299	133087	g_31941	g_10311
ptg000148l	640374	654762	14388	g_10311	g_27753
ptg000148l	666410	681508	15098	g_27753	g_25072
ptg000148l	686778	777182	90404	g_25072	g_22991
ptg000150l	50420	168481	118061	g_19490	g_24611
ptg000150l	170892	179879	8987	g_24611	g_31061
ptg000150l	182355	183773	1418	g_31061	g_18719
ptg000150l	192215	199756	7541	g_18719	g_1119
ptg000150l	202362	211275	8913	g_1119	g_10915
ptg000150l	214064	222173	8109	g_10915	g_24829
ptg000150l	234905	238504	3599	g_24829	g_19495
ptg000150l	239025	270693	31668	g_19495	g_2977
ptg000150l	295682	306231	10549	g_2977	g_20619
ptg000150l	318340	334476	16136	g_20619	g_13101
ptg000150l	349521	370874	21353	g_13101	g_8322
ptg000150l	373502	408227	34725	g_8322	g_10638
ptg000150l	420556	429023	8467	g_10638	g_10356
ptg000151l	22769	108997	86228	g_18503	g_6607
ptg000151l	119643	122948	3305	g_6607	g_22340
ptg000151l	125231	141904	16673	g_22340	g_34701
ptg000151l	143904	152623	8719	g_34701	g_31347
ptg000151l	158418	170660	12242	g_31347	g_47
ptg000151l	171100	171144	44	g_47	g_26936
ptg000151l	172374	229326	56952	g_26936	g_6872
ptg000151l	230300	235891	5591	g_6872	g_17207
ptg000151l	238756	241932	3176	g_17207	g_25846
ptg000151l	242246	252850	10604	g_25846	g_39675
ptg000151l	253089	263064	9975	g_39675	g_40258
ptg000151l	266979	322026	55047	g_40258	g_1921
ptg000151l	335295	341339	6044	g_1921	g_35020
ptg000151l	343791	399542	55751	g_38882	g_18440
ptg000151l	417602	456511	38909	g_18440	g_6657
ptg000152l	255362	255417	55	g_7095	g_1110
ptg000152l	255866	318724	62858	g_1110	g_25145
ptg000152l	322222	323622	1400	g_25145	g_28708
ptg000152l	328559	359164	30605	g_28708	g_7791
ptg000152l	380879	465560	84681	g_7791	g_35604
ptg000152l	471625	579203	107578	g_35604	g_10105
ptg000152l	579652	584153	4501	g_10105	g_30153
ptg000152l	584425	588250	3825	g_30153	g_40274
ptg000152l	595000	619820	24820	g_40274	g_8168
ptg000152l	620648	697468	76820	g_8168	g_3952
ptg000152l	698181	928102	229921	g_3952	g_7616
ptg000152l	928377	977529	49152	g_7616	g_36051
ptg000152l	977912	978165	253	g_36051	g_37501
ptg000152l	978524	1001436	22912	g_37501	g_10842
ptg000152l	1002074	1141647	139573	g_10842	g_13116
ptg000152l	1142909	1153922	11013	g_13116	g_17128
ptg000152l	1155973	1183813	27840	g_17128	g_10931
ptg000152l	1189033	1224349	35316	g_10931	g_37153
ptg000152l	1224564	1473677	249113	g_37153	g_18417
ptg000152l	1474222	1577150	102928	g_18417	g_29165
ptg000152l	1578271	1636479	58208	g_29165	g_19061
ptg000152l	1636817	1637313	496	g_19061	g_37138
ptg000152l	1637618	1674914	37296	g_37138	g_38336
ptg000152l	1675273	1709839	34566	g_38336	g_19700
ptg000152l	1710465	1945460	234995	g_19700	g_28878
ptg000152l	1945675	1990867	45192	g_28878	g_9357
ptg000152l	2004298	2098044	93746	g_9357	g_35876
ptg000152l	2119823	2121879	2056	g_35876	g_10430
ptg000152l	2134851	2145281	10430	g_10430	g_36772
ptg000152l	2145718	2146666	948	g_36772	g_14865
ptg000152l	2151873	2178405	26532	g_14865	g_378
ptg000152l	2178812	2228664	49852	g_378	g_18064
ptg000152l	2229290	2230591	1301	g_18064	g_1568
ptg000152l	2230974	2381584	150610	g_1568	g_27547
ptg000152l	2381787	2392979	11192	g_27547	g_1449
ptg000152l	2393689	2736960	343271	g_1449	g_10226
ptg000152l	2738210	2847410	109200	g_10226	g_33889
ptg000152l	2849404	2956108	106704	g_33889	g_23022
ptg000152l	2956965	2963662	6697	g_23022	g_16838
ptg000152l	2964030	2968305	4275	g_16838	g_6861
ptg000152l	2968874	3008684	39810	g_6861	g_19882
ptg000152l	3009187	3082950	73763	g_19882	g_21418
ptg000152l	3083390	3098540	15150	g_21418	g_35090
ptg000152l	3098905	3181646	82741	g_35090	g_35330
ptg000152l	3184223	3203129	18906	g_35330	g_35194
ptg000152l	3205933	3218160	12227	g_35194	g_5005
ptg000152l	3218903	3218934	31	g_5005	g_39988
ptg000152l	3219887	3221820	1933	g_39988	g_7725
ptg000152l	3224677	3226138	1461	g_7725	g_24146
ptg000152l	3226614	3236565	9951	g_24146	g_8590
ptg000152l	3237371	3239249	1878	g_8590	g_14462
ptg000152l	3240268	3367861	127593	g_14462	g_38245
ptg000152l	3368208	3409097	40889	g_38245	g_30203
ptg000152l	3411695	3481934	70239	g_30203	g_8239
ptg000152l	3483240	3614243	131003	g_8239	g_12422
ptg000152l	3615022	3615683	661	g_12422	g_31976
ptg000152l	3616924	3622301	5377	g_31976	g_16884
ptg000152l	3623617	3623651	34	g_16884	g_36026
ptg000152l	3624490	3678762	54272	g_36026	g_26503
ptg000152l	3682147	3706721	24574	g_26503	g_11333
ptg000152l	3733866	3984101	250235	g_11333	g_21286
ptg000152l	3984349	3994591	10242	g_21286	g_17214
ptg000152l	3995523	3999495	3972	g_17214	g_14501
ptg000152l	4010804	4053370	42566	g_14501	g_26207
ptg000152l	4069217	4106675	37458	g_26207	g_1860
ptg000152l	4106992	4108532	1540	g_1860	g_25396
ptg000152l	4111048	4116743	5695	g_25396	g_11568
ptg000152l	4136703	4178597	41894	g_11568	g_27885
ptg000152l	4197929	4203980	6051	g_27885	g_24103
ptg000152l	4217916	4257113	39197	g_24103	g_36874
ptg000152l	4261880	4313794	51914	g_36874	g_2242
ptg000152l	4314282	4334008	19726	g_2242	g_24451
ptg000152l	4334448	4356945	22497	g_24451	g_38154
ptg000152l	4357169	4357465	296	g_38154	g_7520
ptg000152l	4371749	4373503	1754	g_7520	g_5495
ptg000152l	4393375	4394931	1556	g_5495	g_27475
ptg000152l	4398369	4400732	2363	g_27475	g_27836
ptg000152l	4406925	4432794	25869	g_27836	g_18589
ptg000152l	4434491	4491697	57206	g_18589	g_282
ptg000152l	4505762	4635415	129653	g_282	g_38165
ptg000152l	4635624	4652053	16429	g_38165	g_17357
ptg000152l	4652388	4652423	35	g_17357	g_25965
ptg000152l	4668370	4693034	24664	g_25965	g_17755
ptg000152l	4700319	4710559	10240	g_17755	g_544
ptg000152l	4713511	4772651	59140	g_544	g_4685
ptg000152l	4786521	4787939	1418	g_4685	g_12465
ptg000152l	4790219	4793501	3282	g_12465	g_31914
ptg000152l	4796334	4810234	13900	g_31914	g_17004
ptg000152l	4812389	4871592	59203	g_17004	g_1964
ptg000152l	4871939	5038702	166763	g_1964	g_28904
ptg000152l	5038968	5041712	2744	g_28904	g_2832
ptg000152l	5044370	5052056	7686	g_2832	g_26558
ptg000152l	5052373	5068700	16327	g_26558	g_37213
ptg000152l	5069635	5115771	46136	g_37213	g_12764
ptg000152l	5115974	5127043	11069	g_12764	g_34785
ptg000152l	5127717	5129510	1793	g_34785	g_17325
ptg000152l	5138210	5229425	91215	g_17325	g_26791
ptg000152l	5232816	5317666	84850	g_26791	g_2650
ptg000152l	5338318	5399885	61567	g_2650	g_37064
ptg000152l	5400172	5407597	7425	g_37064	g_26590
ptg000152l	5412346	5435303	22957	g_26590	g_38061
ptg000152l	5435656	5436454	798	g_38061	g_30471
ptg000152l	5449405	5458077	8672	g_30471	g_35397
ptg000152l	5458661	5529856	71195	g_35397	g_7274
ptg000152l	5532047	5545033	12986	g_7274	g_17996
ptg000152l	5550352	5627389	77037	g_17996	g_2380
ptg000152l	5631435	5682695	51260	g_2380	g_4591
ptg000152l	5683108	5692898	9790	g_4591	g_13059
ptg000152l	5718676	5736753	18077	g_13059	g_18495
ptg000152l	5737067	5779083	42016	g_18495	g_28040
ptg000152l	5786609	5828641	42032	g_28040	g_798
ptg000152l	5830350	5840922	10572	g_798	g_8522
ptg000152l	5841620	5860231	18611	g_8522	g_5193
ptg000152l	5865010	5898144	33134	g_39542	g_22347
ptg000152l	5899140	5916616	17476	g_22347	g_13870
ptg000152l	5917080	5940467	23387	g_13870	g_21801
ptg000152l	5940913	5948007	7094	g_21801	g_24482
ptg000152l	5967155	5994744	27589	g_24482	g_5621
ptg000152l	6005443	6021772	16329	g_5621	g_13566
ptg000152l	6023715	6053433	29718	g_13566	g_21873
ptg000152l	6125713	6127598	1885	g_21873	g_28227
ptg000152l	6129747	6134760	5013	g_28227	g_39839
ptg000152l	6135899	6137209	1310	g_4548	g_4454
ptg000152l	6155592	6166031	10439	g_4454	g_11382
ptg000152l	6170625	6172382	1757	g_11382	g_24329
ptg000152l	6180287	6195319	15032	g_24329	g_13461
ptg000152l	6203091	6206476	3385	g_13461	g_11018
ptg000152l	6209709	6211289	1580	g_11018	g_25805
ptg000152l	6212299	6272578	60279	g_25805	g_11793
ptg000152l	6272862	6292859	19997	g_11793	g_7221
ptg000152l	6293857	6368680	74823	g_7221	g_14611
ptg000152l	6369525	6493538	124013	g_14611	g_30352
ptg000152l	6493792	6556920	63128	g_30352	g_31619
ptg000152l	6557282	6557300	18	g_31619	g_28118
ptg000152l	6557746	6589199	31453	g_28118	g_17852
ptg000152l	6589585	6654030	64445	g_17852	g_15135
ptg000152l	6657239	6731761	74522	g_15135	g_32406
ptg000152l	6732819	6807813	74994	g_32406	g_26937
ptg000152l	6811283	6892018	80735	g_26937	g_16262
ptg000152l	6892541	6896461	3920	g_16262	g_22315
ptg000152l	6897279	7057096	159817	g_22315	g_22785
ptg000152l	7058878	7064290	5412	g_22785	g_24165
ptg000152l	7064538	7187849	123311	g_24165	g_3406
ptg000152l	7188394	7265771	77377	g_3406	g_18715
ptg000152l	7267297	7372770	105473	g_18715	g_15852
ptg000152l	7372991	7415939	42948	g_15852	g_16935
ptg000152l	7419305	7492845	73540	g_16935	g_37859
ptg000152l	7493381	7513052	19671	g_37859	g_12275
ptg000152l	7513336	7541974	28638	g_12275	g_4607
ptg000152l	7542813	7574746	31933	g_4607	g_12886
ptg000152l	7575465	7597366	21901	g_12886	g_28329
ptg000152l	7597611	7632351	34740	g_28329	g_19233
ptg000152l	7632572	7651028	18456	g_19233	g_21186
ptg000152l	7651570	7720978	69408	g_21186	g_19626
ptg000152l	7721511	7734467	12956	g_19626	g_11565
ptg000152l	7735078	7853624	118546	g_11565	g_31282
ptg000152l	7853917	8027563	173646	g_31282	g_14973
ptg000152l	8041786	8057627	15841	g_14973	g_12555
ptg000152l	8059718	8091491	31773	g_12555	g_31972
ptg000152l	8091931	8092128	197	g_31972	g_37871
ptg000152l	8093758	8152215	58457	g_37871	g_1035
ptg000152l	8153099	8243371	90272	g_1035	g_17841
ptg000152l	8243928	8289750	45822	g_17841	g_23629
ptg000152l	8289959	8557339	267380	g_23629	g_7582
ptg000152l	8562727	8568247	5520	g_7582	g_6889
ptg000152l	8590873	8628820	37947	g_6889	g_5708
ptg000152l	8629456	8660264	30808	g_5708	g_15583
ptg000152l	8664588	8684582	19994	g_15583	g_20677
ptg000152l	8694163	8697197	3034	g_20677	g_2984
ptg000152l	8713424	8713562	138	g_2984	g_21028
ptg000152l	8730011	8782086	52075	g_21028	g_10607
ptg000152l	8782628	8791808	9180	g_10607	g_3112
ptg000152l	8792653	8792743	90	g_3112	g_8273
ptg000152l	8794311	8805609	11298	g_8273	g_9401
ptg000152l	8807474	8821516	14042	g_9401	g_36266
ptg000152l	8822502	8834806	12304	g_36266	g_8317
ptg000152l	8851608	8878751	27143	g_8317	g_24582
ptg000152l	8959997	8964573	4576	g_24582	g_8946
ptg000152l	9008344	9204364	196020	g_8946	g_36519
ptg000152l	9204684	9297741	93057	g_36519	g_28872
ptg000152l	9301990	9305965	3975	g_28872	g_36582
ptg000152l	9312155	9327657	15502	g_36582	g_37834
ptg000152l	9333846	9336034	2188	g_37834	g_36072
ptg000152l	9338137	9382588	44451	g_36072	g_3209
ptg000152l	9384933	9391185	6252	g_3209	g_27537
ptg000152l	9404910	9406191	1281	g_27537	g_12891
ptg000152l	9409488	9411203	1715	g_12891	g_22053
ptg000152l	9416566	9419712	3146	g_22053	g_1908
ptg000152l	9423869	9425266	1397	g_1908	g_18562
ptg000152l	9428816	9473206	44390	g_18562	g_14834
ptg000152l	9480212	9482637	2425	g_14834	g_11649
ptg000152l	9485197	9485798	601	g_11649	g_39795
ptg000152l	9486445	9489815	3370	g_39795	g_10725
ptg000152l	9490276	9503957	13681	g_10725	g_31210
ptg000152l	9504706	9509986	5280	g_31210	g_17374
ptg000152l	9517044	9528068	11024	g_17374	g_17705
ptg000152l	9530045	9536380	6335	g_17705	g_25526
ptg000152l	9538062	9545980	7918	g_25526	g_25073
ptg000152l	9546297	9613620	67323	g_25073	g_19758
ptg000152l	9613961	9621008	7047	g_19758	g_9828
ptg000152l	9623080	9625536	2456	g_9828	g_24771
ptg000152l	9625778	9656943	31165	g_24771	g_17779
ptg000152l	9682617	9687745	5128	g_17779	g_3267
ptg000152l	9691998	9693835	1837	g_3267	g_30849
ptg000152l	9695424	9695794	370	g_30849	g_25107
ptg000152l	9697620	9708259	10639	g_25107	g_3518
ptg000152l	9710156	10043078	332922	g_3518	g_13600
ptg000152l	10043281	10158177	114896	g_13600	g_35512
ptg000152l	10158419	10330943	172524	g_35512	g_32738
ptg000152l	10348922	10351960	3038	g_32738	g_17127
ptg000152l	10357187	10358823	1636	g_17127	g_26185
ptg000152l	10361307	10506215	144908	g_26185	g_11211
ptg000152l	10508328	10564026	55698	g_11211	g_39754
ptg000152l	10570450	10670759	100309	g_28288	g_10907
ptg000152l	10671205	10925952	254747	g_10907	g_27715
ptg000152l	10926572	10926603	31	g_27715	g_16415
ptg000152l	10927078	10957965	30887	g_16415	g_32563
ptg000152l	10958429	11003405	44976	g_32563	g_36459
ptg000152l	11004244	11013504	9260	g_36459	g_20694
ptg000152l	11013878	11087357	73479	g_20694	g_17396
ptg000152l	11087914	11215662	127748	g_17396	g_2351
ptg000152l	11215916	11270224	54308	g_2351	g_1283
ptg000152l	11276802	11278227	1425	g_1283	g_34212
ptg000152l	11287136	11290672	3536	g_34212	g_23335
ptg000152l	11314727	11379774	65047	g_23335	g_7310
ptg000152l	11380993	11448834	67841	g_7310	g_26548
ptg000152l	11463840	11479473	15633	g_26548	g_17016
ptg000152l	11485847	11493558	7711	g_17016	g_23059
ptg000152l	11498226	11507979	9753	g_23059	g_30031
ptg000152l	11528990	11548230	19240	g_30031	g_5508
ptg000152l	11550424	11564007	13583	g_5508	g_441
ptg000152l	11566581	11592633	26052	g_441	g_18295
ptg000152l	11610635	11611890	1255	g_18295	g_35950
ptg000152l	11631362	11633547	2185	g_35950	g_6796
ptg000152l	11634866	11670790	35924	g_6796	g_36023
ptg000152l	11671644	11703245	31601	g_36023	g_12731
ptg000152l	11716551	11717338	787	g_12731	g_29658
ptg000152l	11717772	11913167	195395	g_29658	g_14686
ptg000152l	11913591	11926712	13121	g_14686	g_20067
ptg000152l	11928761	11930020	1259	g_20067	g_33331
ptg000152l	11938295	11968091	29796	g_33331	g_36634
ptg000152l	11977897	11987134	9237	g_36634	g_3688
ptg000152l	12008439	12009625	1186	g_3688	g_32856
ptg000152l	12020777	12021655	878	g_32856	g_18242
ptg000152l	12022356	12026841	4485	g_18242	g_7330
ptg000152l	12029170	12034215	5045	g_7330	g_6532
ptg000152l	12039093	12039649	556	g_6532	g_5280
ptg000152l	12049565	12050382	817	g_5280	g_18978
ptg000152l	12061893	12102043	40150	g_18978	g_37058
ptg000152l	12102366	12108477	6111	g_37058	g_19329
ptg000152l	12109571	12483054	373483	g_19329	g_29709
ptg000152l	12498728	12500957	2229	g_29709	g_30047
ptg000152l	12503479	12507808	4329	g_30047	g_3976
ptg000152l	12509635	12561229	51594	g_3976	g_33164
ptg000152l	12561465	12605155	43690	g_33164	g_14290
ptg000152l	12605523	12647606	42083	g_14290	g_37431
ptg000152l	12655775	12656998	1223	g_37431	g_21302
ptg000152l	12657747	12662847	5100	g_21302	g_6209
ptg000152l	12663116	12751207	88091	g_6209	g_21190
ptg000152l	12751737	12796974	45237	g_21190	g_32689
ptg000152l	12797600	12808658	11058	g_32689	g_30323
ptg000152l	12811249	12816917	5668	g_30323	g_38328
ptg000152l	12839395	12852210	12815	g_38328	g_21619
ptg000152l	12863164	12864464	1300	g_21619	g_462
ptg000152l	12866476	12868590	2114	g_462	g_1969
ptg000152l	12872342	12875914	3572	g_1969	g_25654
ptg000152l	12877576	12879170	1594	g_25654	g_27965
ptg000152l	12881480	12885236	3756	g_27965	g_10871
ptg000152l	12892504	12943589	51085	g_10871	g_20516
ptg000152l	12943810	12971446	27636	g_20516	g_34386
ptg000152l	12971721	12992292	20571	g_34386	g_38742
ptg000152l	12992585	13041314	48729	g_38742	g_5942
ptg000152l	13050570	13064573	14003	g_5942	g_27039
ptg000152l	13074666	13077012	2346	g_27039	g_6370
ptg000152l	13079904	13082321	2417	g_6370	g_40014
ptg000152l	13094411	13096246	1835	g_40014	g_1488
ptg000152l	13097995	13103320	5325	g_1488	g_19948
ptg000152l	13112898	13113905	1007	g_19948	g_14712
ptg000152l	13118339	13132053	13714	g_14712	g_16374
ptg000152l	13139893	13141909	2016	g_16374	g_37166
ptg000152l	13144798	13146708	1910	g_37166	g_20875
ptg000152l	13147481	13152247	4766	g_20875	g_791
ptg000152l	13153110	13155306	2196	g_791	g_7200
ptg000152l	13158043	13164790	6747	g_7200	g_8298
ptg000152l	13167623	13184061	16438	g_8298	g_20463
ptg000152l	13185566	13225602	40036	g_20463	g_27656
ptg000152l	13256405	13397580	141175	g_27656	g_22550
ptg000152l	13399148	13419535	20387	g_22550	g_21998
ptg000152l	13421026	13448144	27118	g_21998	g_2330
ptg000152l	13456354	13495889	39535	g_2330	g_860
ptg000152l	13496107	13563626	67519	g_860	g_37965
ptg000152l	13565512	13579343	13831	g_37965	g_1096
ptg000152l	13598471	13616671	18200	g_1096	g_26801
ptg000152l	13623993	13624739	746	g_26801	g_23924
ptg000152l	13634823	13647394	12571	g_23924	g_12117
ptg000152l	13673023	13785806	112783	g_12117	g_31233
ptg000152l	13801036	13818389	17353	g_31233	g_12614
ptg000152l	13819111	13826009	6898	g_12614	g_19910
ptg000152l	13831944	13876016	44072	g_19910	g_25036
ptg000152l	13879267	14075302	196035	g_25036	g_17464
ptg000152l	14090119	14174413	84294	g_17464	g_2038
ptg000152l	14174616	14249349	74733	g_2038	g_18738
ptg000152l	14268206	14275391	7185	g_18738	g_13718
ptg000152l	14276997	14336787	59790	g_13718	g_3827
ptg000152l	14338640	14362249	23609	g_3827	g_38306
ptg000152l	14362515	14372727	10212	g_38306	g_20278
ptg000152l	14373881	14374558	677	g_20278	g_34139
ptg000152l	14374764	14513715	138951	g_34139	g_36215
ptg000152l	14513921	14581434	67513	g_36215	g_38847
ptg000152l	14583023	14616294	33271	g_38847	g_18523
ptg000152l	14620493	14627049	6556	g_18523	g_38812
ptg000152l	14628456	14650236	21780	g_38812	g_30809
ptg000152l	14655095	14670064	14969	g_30809	g_10167
ptg000152l	14671900	14684490	12590	g_10167	g_27757
ptg000152l	14694111	14731096	36985	g_27757	g_38276
ptg000152l	14735069	14735352	283	g_38276	g_14951
ptg000152l	14737242	14739062	1820	g_14951	g_8524
ptg000152l	14742051	14745969	3918	g_8524	g_24318
ptg000152l	14750183	14755264	5081	g_24318	g_9437
ptg000152l	14757939	14774898	16959	g_9437	g_17166
ptg000152l	14778806	14783492	4686	g_17166	g_37202
ptg000152l	14786702	14787289	587	g_37202	g_32801
ptg000152l	14798002	14804433	6431	g_32801	g_26260
ptg000152l	14804782	14838453	33671	g_26260	g_1657
ptg000152l	14839094	14841919	2825	g_1657	g_8958
ptg000152l	14850546	14872621	22075	g_8958	g_34937
ptg000152l	14874204	14876013	1809	g_34937	g_27980
ptg000152l	14884689	14902708	18019	g_27980	g_16002
ptg000152l	14905105	14906303	1198	g_16002	g_11640
ptg000152l	14909145	14911029	1884	g_11640	g_7036
ptg000152l	14916689	14919835	3146	g_7036	g_2985
ptg000152l	14925967	14936050	10083	g_2985	g_1892
ptg000152l	14958342	14959920	1578	g_1892	g_11362
ptg000152l	14967055	14968116	1061	g_11362	g_38557
ptg000152l	14969960	14991007	21047	g_38557	g_7883
ptg000152l	14993920	14997655	3735	g_7883	g_1595
ptg000152l	14997939	15000487	2548	g_1595	g_11968
ptg000152l	15010219	15019430	9211	g_11968	g_23874
ptg000152l	15019711	15020842	1131	g_23874	g_2632
ptg000152l	15021195	15022458	1263	g_2632	g_8662
ptg000152l	15022811	15028703	5892	g_8662	g_6386
ptg000152l	15029101	15037898	8797	g_6386	g_35324
ptg000152l	15039493	15047258	7765	g_35324	g_20452
ptg000152l	15050274	15050976	702	g_20452	g_32519
ptg000152l	15055067	15063465	8398	g_32519	g_26291
ptg000152l	15072870	15082850	9980	g_26291	g_4993
ptg000152l	15083473	15089464	5991	g_4993	g_2299
ptg000152l	15106003	15111762	5759	g_2299	g_38323
ptg000152l	15112385	15153520	41135	g_38323	g_1027
ptg000152l	15154614	15158898	4284	g_1027	g_33936
ptg000152l	15160475	15268741	108266	g_33936	g_26379
ptg000152l	15269199	15271579	2380	g_26379	g_13922
ptg000152l	15271884	15304733	32849	g_13922	g_17545
ptg000152l	15325995	15329553	3558	g_17545	g_13510
ptg000152l	15331599	15333108	1509	g_13510	g_14121
ptg000152l	15339124	15342058	2934	g_14121	g_29819
ptg000152l	15342606	15418924	76318	g_29819	g_12707
ptg000152l	15516382	15563483	47101	g_12707	g_5396
ptg000152l	15565045	15566096	1051	g_5396	g_19970
ptg000152l	15567959	15572249	4290	g_19970	g_19413
ptg000152l	15575873	15580759	4886	g_19413	g_16593
ptg000152l	15586524	15640967	54443	g_16593	g_30967
ptg000152l	15647681	15662556	14875	g_30967	g_31087
ptg000152l	15670628	15701303	30675	g_31087	g_32357
ptg000152l	15706367	15707937	1570	g_32357	g_20241
ptg000152l	15712256	15716939	4683	g_20241	g_15968
ptg000152l	15723061	15729121	6060	g_15968	g_8388
ptg000152l	15734252	15735449	1197	g_8388	g_19048
ptg000152l	15736592	15756782	20190	g_19048	g_1159
ptg000152l	15774073	15803624	29551	g_1159	g_16428
ptg000152l	15817020	15824793	7773	g_16428	g_14718
ptg000152l	15827795	15840412	12617	g_14718	g_35983
ptg000152l	15847053	15849589	2536	g_35983	g_28142
ptg000152l	15850413	15869529	19116	g_28142	g_11969
ptg000152l	15870599	15874460	3861	g_11969	g_7268
ptg000152l	15879875	15923217	43342	g_7268	g_20558
ptg000152l	15929982	15953612	23630	g_20558	g_21045
ptg000152l	15959046	15973634	14588	g_21045	g_2824
ptg000152l	15978649	15992817	14168	g_2824	g_9532
ptg000152l	15996247	15997699	1452	g_9532	g_3435
ptg000152l	16004235	16047688	43453	g_3435	g_30867
ptg000152l	16047888	16109359	61471	g_30867	g_17282
ptg000152l	16120503	16122437	1934	g_17282	g_36083
ptg000152l	16124320	16125746	1426	g_36083	g_14975
ptg000152l	16129254	16140798	11544	g_14975	g_20022
ptg000152l	16144459	16153740	9281	g_20022	g_1270
ptg000152l	16158638	16159990	1352	g_1270	g_33518
ptg000152l	16166620	16168976	2356	g_33518	g_16305
ptg000152l	16170535	16190096	19561	g_16305	g_3360
ptg000152l	16190326	16196241	5915	g_3360	g_17602
ptg000152l	16196489	16196764	275	g_17602	g_16975
ptg000152l	16196964	16217501	20537	g_16975	g_25532
ptg000152l	16241076	16308346	67270	g_25532	g_29877
ptg000152l	16308672	16310426	1754	g_29877	g_9016
ptg000152l	16311091	16314892	3801	g_9016	g_28601
ptg000152l	16315095	16329728	14633	g_28601	g_34195
ptg000152l	16330102	16349612	19510	g_34195	g_940
ptg000152l	16359565	16407519	47954	g_940	g_31055
ptg000152l	16408678	16411714	3036	g_31055	g_33534
ptg000152l	16423250	16425495	2245	g_33534	g_18059
ptg000152l	16426085	16429791	3706	g_18059	g_12630
ptg000152l	16431550	16434685	3135	g_12630	g_21491
ptg000152l	16436785	16439594	2809	g_21491	g_4459
ptg000152l	16445211	16494253	49042	g_4459	g_4410
ptg000152l	16494453	16529059	34606	g_4410	g_27637
ptg000152l	16530312	16531105	793	g_27637	g_20822
ptg000152l	16532376	16533955	1579	g_20822	g_30580
ptg000152l	16534443	16539234	4791	g_30580	g_26935
ptg000152l	16552874	16557205	4331	g_26935	g_28221
ptg000152l	16558605	16567420	8815	g_28221	g_20436
ptg000152l	16569166	16569698	532	g_20436	g_15739
ptg000152l	16571737	16572274	537	g_15739	g_37557
ptg000152l	16578296	16589331	11035	g_37557	g_3200
ptg000152l	16594830	16596679	1849	g_3200	g_21210
ptg000152l	16607514	16608795	1281	g_21210	g_7040
ptg000152l	16609010	16616901	7891	g_7040	g_36598
ptg000152l	16618017	16626603	8586	g_36598	g_6782
ptg000152l	16642907	16654307	11400	g_6782	g_7959
ptg000152l	16655690	16705506	49816	g_7959	g_37611
ptg000152l	16712694	16720132	7438	g_37611	g_23063
ptg000152l	16723065	16723426	361	g_23063	g_1190
ptg000152l	16731361	16750948	19587	g_1190	g_15833
ptg000152l	16751385	16784970	33585	g_15833	g_14768
ptg000152l	16786766	16806777	20011	g_14768	g_29226
ptg000152l	16818906	16838576	19670	g_29226	g_33310
ptg000152l	16849558	16853920	4362	g_33310	g_17231
ptg000152l	16866999	16872076	5077	g_17231	g_36003
ptg000152l	16875550	16879264	3714	g_36003	g_8866
ptg000152l	16880484	16890152	9668	g_8866	g_34963
ptg000152l	16890679	16897630	6951	g_34963	g_17399
ptg000152l	16915795	16919359	3564	g_17399	g_35173
ptg000152l	16919604	16961605	42001	g_35173	g_20860
ptg000152l	16961877	16972650	10773	g_20860	g_1825
ptg000152l	16988529	16999364	10835	g_1825	g_17829
ptg000152l	16999576	17094021	94445	g_17829	g_19515
ptg000152l	17094221	17112606	18385	g_19515	g_21947
ptg000152l	17123662	17126116	2454	g_21947	g_6389
ptg000152l	17127613	17139557	11944	g_6389	g_2627
ptg000152l	17142419	17144821	2402	g_2627	g_33305
ptg000152l	17159976	17167344	7368	g_33305	g_16648
ptg000152l	17168945	17170671	1726	g_16648	g_24017
ptg000152l	17175289	17185305	10016	g_24017	g_16525
ptg000152l	17188777	17189450	673	g_16525	g_27604
ptg000152l	17190223	17256325	66102	g_27604	g_37541
ptg000152l	17266635	17269690	3055	g_37541	g_8795
ptg000152l	17274732	17289013	14281	g_8795	g_13021
ptg000152l	17305334	17308222	2888	g_13021	g_12583
ptg000152l	17313595	17315308	1713	g_12583	g_27592
ptg000152l	17324159	17326040	1881	g_27592	g_31962
ptg000152l	17328023	17332120	4097	g_31962	g_24681
ptg000152l	17337073	17342807	5734	g_24681	g_8156
ptg000152l	17349636	17350405	769	g_8156	g_21051
ptg000152l	17355191	17367298	12107	g_21051	g_34944
ptg000152l	17377320	17409781	32461	g_34944	g_21121
ptg000152l	17415215	17422268	7053	g_21121	g_7392
ptg000152l	17432871	17444425	11554	g_7392	g_18111
ptg000152l	17446010	17446452	442	g_18111	g_15050
ptg000152l	17463103	17465171	2068	g_15050	g_13575
ptg000152l	17482985	17503767	20782	g_13575	g_32615
ptg000152l	17513796	17515179	1383	g_32615	g_24237
ptg000152l	17519277	17522068	2791	g_24237	g_13838
ptg000152l	17529031	17562731	33700	g_13838	g_29106
ptg000152l	17564566	17576175	11609	g_29106	g_27213
ptg000152l	17576507	17582423	5916	g_27213	g_20347
ptg000152l	17584058	17591794	7736	g_20347	g_2926
ptg000152l	17596549	17641151	44602	g_2926	g_635
ptg000152l	17645055	17653012	7957	g_635	g_15462
ptg000152l	17674735	17678999	4264	g_15462	g_37119
ptg000152l	17693324	17694713	1389	g_37119	g_7137
ptg000152l	17697948	17719242	21294	g_7137	g_29391
ptg000152l	17724071	17726299	2228	g_29391	g_29317
ptg000152l	17729358	17730417	1059	g_29317	g_3713
ptg000152l	17736382	17738989	2607	g_3713	g_3804
ptg000152l	17753301	17779017	25716	g_3804	g_9784
ptg000152l	17787196	17839843	52647	g_9784	g_2524
ptg000152l	17848020	17868086	20066	g_2524	g_8255
ptg000152l	17871516	17873033	1517	g_8255	g_6997
ptg000152l	17875366	17876304	938	g_6997	g_1816
ptg000152l	17877849	17884175	6326	g_1816	g_23050
ptg000152l	17885840	17894987	9147	g_23050	g_27531
ptg000152l	17902883	17924836	21953	g_27531	g_37989
ptg000152l	17931687	17936773	5086	g_37989	g_17072
ptg000152l	17946747	17949618	2871	g_17072	g_22001
ptg000152l	17956987	18026391	69404	g_22001	g_18004
ptg000152l	18046421	18048548	2127	g_18004	g_29959
ptg000152l	18052358	18082493	30135	g_29959	g_25311
ptg000152l	18098287	18114415	16128	g_25311	g_33140
ptg000152l	18114783	18133216	18433	g_33140	g_23161
ptg000152l	18138623	18141357	2734	g_23161	g_12842
ptg000152l	18154467	18155639	1172	g_12842	g_35202
ptg000152l	18159388	18167727	8339	g_35202	g_1658
ptg000152l	18169434	18176511	7077	g_1658	g_7064
ptg000152l	18178876	18264964	86088	g_7064	g_4348
ptg000152l	18281208	18289962	8754	g_4348	g_35697
ptg000152l	18291576	18333416	41840	g_35697	g_25067
ptg000152l	18334118	18352189	18071	g_25067	g_24533
ptg000152l	18352530	18484048	131518	g_24533	g_37275
ptg000152l	18484257	18492927	8670	g_37275	g_21643
ptg000152l	18493133	18516395	23262	g_21643	g_26345
ptg000152l	18524264	18551786	27522	g_26345	g_13581
ptg000152l	18553641	18554437	796	g_13581	g_2677
ptg000152l	18558701	18607433	48732	g_2677	g_13125
ptg000152l	18607651	18638661	31010	g_13125	g_17856
ptg000152l	18638900	18739269	100369	g_17856	g_11251
ptg000152l	18740357	18959234	218877	g_11251	g_18690
ptg000152l	18960959	19004697	43738	g_18690	g_37197
ptg000152l	19023916	19039909	15993	g_37197	g_32149
ptg000152l	19041030	19054112	13082	g_32149	g_19395
ptg000152l	19058551	19079768	21217	g_19395	g_9582
ptg000152l	19085071	19095437	10366	g_9582	g_1221
ptg000152l	19102992	19105487	2495	g_1221	g_21246
ptg000152l	19116453	19117957	1504	g_21246	g_33347
ptg000152l	19119432	19121961	2529	g_33347	g_27946
ptg000152l	19123382	19148543	25161	g_27946	g_398
ptg000152l	19160130	19163483	3353	g_398	g_21085
ptg000152l	19177570	19197941	20371	g_21085	g_11482
ptg000152l	19198617	19206235	7618	g_11482	g_1830
ptg000152l	19206680	19221080	14400	g_1830	g_6168
ptg000152l	19226788	19261946	35158	g_6168	g_16854
ptg000152l	19267892	19268786	894	g_16854	g_3527
ptg000152l	19270355	19281520	11165	g_3527	g_27390
ptg000152l	19286734	19288395	1661	g_27390	g_32151
ptg000152l	19289745	19291149	1404	g_32151	g_5914
ptg000152l	19303765	19305934	2169	g_5914	g_15988
ptg000152l	19309186	19313229	4043	g_15988	g_34650
ptg000152l	19314290	19319016	4726	g_34650	g_26506
ptg000152l	19322167	19423500	101333	g_26506	g_23222
ptg000152l	19424645	19453192	28547	g_23222	g_7685
ptg000152l	19471223	19505608	34385	g_7685	g_12370
ptg000152l	19506009	19564876	58867	g_12370	g_13246
ptg000152l	19584114	19606996	22882	g_13246	g_12749
ptg000152l	19610465	19613123	2658	g_12749	g_7363
ptg000152l	19617906	19643209	25303	g_7363	g_36233
ptg000152l	19649924	19653240	3316	g_36233	g_20036
ptg000152l	19655724	19666155	10431	g_20036	g_15966
ptg000152l	19668333	19669622	1289	g_15966	g_24149
ptg000152l	19671159	19732624	61465	g_24149	g_7077
ptg000152l	19741923	19763736	21813	g_7077	g_24214
ptg000152l	19771713	19776073	4360	g_24214	g_15451
ptg000152l	19776801	19779627	2826	g_15451	g_5754
ptg000152l	19805358	19844647	39289	g_5754	g_12577
ptg000152l	19853975	19861474	7499	g_12577	g_16805
ptg000152l	19862241	19870112	7871	g_16805	g_18530
ptg000152l	19890827	19897426	6599	g_18530	g_25479
ptg000152l	19906243	19913155	6912	g_25479	g_24316
ptg000152l	19913786	19957525	43739	g_24316	g_22856
ptg000152l	19957740	19976362	18622	g_22856	g_34934
ptg000152l	19976592	19977337	745	g_34934	g_38157
ptg000152l	19977624	19984303	6679	g_38157	g_27262
ptg000152l	19990434	19999572	9138	g_27262	g_9393
ptg000152l	20003381	20010730	7349	g_9393	g_31379
ptg000152l	20012837	20031092	18255	g_31379	g_33505
ptg000152l	20033352	20121455	88103	g_33505	g_24441
ptg000152l	20163675	20182323	18648	g_24441	g_10655
ptg000152l	20182634	20187600	4966	g_10655	g_25157
ptg000152l	20187956	20314343	126387	g_25157	g_861
ptg000152l	20314624	20398634	84010	g_861	g_31127
ptg000152l	20399356	20405381	6025	g_31127	g_26471
ptg000152l	20406553	20443776	37223	g_26471	g_15998
ptg000152l	20455191	20465868	10677	g_15998	g_25407
ptg000152l	20476031	20478310	2279	g_38610	g_34967
ptg000152l	20481191	20486632	5441	g_34967	g_22535
ptg000152l	20511523	20512582	1059	g_22535	g_29572
ptg000152l	20514622	20518300	3678	g_29572	g_14821
ptg000152l	20523392	20533784	10392	g_14821	g_27751
ptg000152l	20534269	20534451	182	g_27751	g_38085
ptg000152l	20535053	20561570	26517	g_38085	g_29670
ptg000152l	20562808	20671076	108268	g_29670	g_20330
ptg000152l	20673880	20691590	17710	g_20330	g_16833
ptg000152l	20692618	20694713	2095	g_16833	g_16610
ptg000152l	20695789	20713381	17592	g_16610	g_5715
ptg000152l	20714352	20716754	2402	g_5715	g_38672
ptg000152l	20717629	20726141	8512	g_38672	g_3846
ptg000152l	20740225	20749482	9257	g_3846	g_23861
ptg000152l	20762406	20765156	2750	g_23861	g_8236
ptg000152l	20768341	20778077	9736	g_8236	g_10839
ptg000152l	20778277	20864383	86106	g_10839	g_4438
ptg000152l	20864628	20992862	128234	g_4438	g_25624
ptg000152l	20993098	21087916	94818	g_25624	g_3117
ptg000152l	21088227	21248309	160082	g_3117	g_29537
ptg000152l	21248527	21254999	6472	g_29537	g_7747
ptg000152l	21257423	21259442	2019	g_7747	g_6258
ptg000152l	21261068	21415816	154748	g_6258	g_24705
ptg000152l	21441954	21459249	17295	g_24705	g_22435
ptg000152l	21481416	21535174	53758	g_22435	g_9118
ptg000152l	21538637	21588632	49995	g_9118	g_3580
ptg000152l	21596400	21610159	13759	g_3580	g_2605
ptg000152l	21616322	21622284	5962	g_2605	g_6903
ptg000152l	21622753	21627172	4419	g_6903	g_17264
ptg000152l	21638313	21639732	1419	g_17264	g_25910
ptg000152l	21652619	21656118	3499	g_25910	g_18879
ptg000152l	21658286	21662699	4413	g_18879	g_4845
ptg000152l	21663781	21671674	7893	g_4845	g_12540
ptg000152l	21674005	21675407	1402	g_12540	g_19560
ptg000152l	21681153	21704133	22980	g_19560	g_8940
ptg000152l	21704651	21708731	4080	g_8940	g_5140
ptg000152l	21710392	21720877	10485	g_5140	g_15664
ptg000152l	21731864	21775972	44108	g_15664	g_5430
ptg000152l	21776893	21779084	2191	g_5430	g_4659
ptg000152l	21788519	21790094	1575	g_4659	g_37405
ptg000152l	21797650	21801670	4020	g_37405	g_10054
ptg000152l	21803143	21805189	2046	g_10054	g_26717
ptg000152l	21809410	21813762	4352	g_26717	g_21405
ptg000152l	21826670	21826768	98	g_21405	g_40212
ptg000152l	21848066	21935147	87081	g_40212	g_36496
ptg000152l	21938677	21941610	2933	g_36496	g_5889
ptg000152l	21952437	22172208	219771	g_5889	g_26179
ptg000152l	22178545	22181329	2784	g_26179	g_6644
ptg000152l	22188314	22190464	2150	g_6644	g_34360
ptg000152l	22194203	22197690	3487	g_34360	g_22381
ptg000152l	22205067	22214178	9111	g_22381	g_4142
ptg000152l	22223165	22273817	50652	g_4142	g_37590
ptg000152l	22282042	22295973	13931	g_37590	g_7527
ptg000152l	22296179	22298303	2124	g_7527	g_21023
ptg000152l	22311317	22321677	10360	g_21023	g_9793
ptg000152l	22325504	22329313	3809	g_9793	g_34332
ptg000152l	22329974	22348388	18414	g_34332	g_945
ptg000152l	22368026	22373647	5621	g_945	g_27071
ptg000152l	22374006	22377071	3065	g_27071	g_32940
ptg000152l	22388869	22446006	57137	g_32940	g_26457
ptg000152l	22449429	22487971	38542	g_26457	g_24251
ptg000152l	22492547	22511359	18812	g_24251	g_9008
ptg000152l	22513038	22513821	783	g_9008	g_20550
ptg000152l	22516840	22518876	2036	g_20550	g_31948
ptg000152l	22536279	22542531	6252	g_31948	g_20376
ptg000152l	22542743	22543057	314	g_20376	g_33117
ptg000152l	22548084	22553410	5326	g_33117	g_2720
ptg000152l	22560041	22598465	38424	g_2720	g_24067
ptg000152l	22603809	22606837	3028	g_24067	g_33196
ptg000152l	22609690	22611454	1764	g_33196	g_6055
ptg000152l	22612266	22617692	5426	g_6055	g_24639
ptg000152l	22625603	22631676	6073	g_24639	g_37719
ptg000152l	22633277	22639084	5807	g_37719	g_6775
ptg000152l	22657350	22664990	7640	g_6775	g_18649
ptg000152l	22666423	22679377	12954	g_18649	g_32807
ptg000152l	22708431	22756305	47874	g_32807	g_12210
ptg000152l	22757492	22788287	30795	g_12210	g_14942
ptg000152l	22788568	22847834	59266	g_14942	g_8436
ptg000152l	22848937	22860541	11604	g_8436	g_29498
ptg000152l	22860828	22863780	2952	g_29498	g_38053
ptg000152l	22866229	22890366	24137	g_38053	g_2921
ptg000152l	22891010	22891192	182	g_2921	g_17618
ptg000152l	22891551	22891579	28	g_17618	g_3648
ptg000152l	22891941	22910919	18978	g_3648	g_21305
ptg000152l	22911320	22996295	84975	g_21305	g_18256
ptg000152l	23010677	23014050	3373	g_18256	g_5504
ptg000152l	23027964	23126010	98046	g_5504	g_27960
ptg000152l	23152339	23176015	23676	g_27960	g_2246
ptg000152l	23177261	23177413	152	g_2246	g_3388
ptg000152l	23177661	23273081	95420	g_3388	g_15254
ptg000152l	23273608	23361454	87846	g_15254	g_30599
ptg000152l	23365087	23399621	34534	g_30599	g_33090
ptg000152l	23402805	23406921	4116	g_33090	g_18338
ptg000152l	23422692	23434074	11382	g_18338	g_13607
ptg000152l	23441012	23496574	55562	g_13607	g_10993
ptg000152l	23503997	23542069	38072	g_10993	g_34173
ptg000152l	23555630	23558760	3130	g_34173	g_34448
ptg000152l	23561367	23611004	49637	g_34448	g_1729
ptg000152l	23620381	23625593	5212	g_1729	g_35804
ptg000152l	23635761	23639943	4182	g_35804	g_27327
ptg000152l	23645532	23683376	37844	g_27327	g_7941
ptg000152l	23695759	23803574	107815	g_7941	g_37628
ptg000152l	23804341	23812604	8263	g_37628	g_10303
ptg000152l	23813515	23821594	8079	g_10303	g_36932
ptg000152l	23827786	23830257	2471	g_36932	g_1114
ptg000152l	23830686	23877114	46428	g_1114	g_22337
ptg000152l	23885650	23888831	3181	g_22337	g_17431
ptg000152l	23890528	23891138	610	g_17431	g_21773
ptg000152l	23893102	23896980	3878	g_21773	g_14974
ptg000152l	23904671	23935547	30876	g_14974	g_27205
ptg000152l	23954467	24006355	51888	g_27205	g_1905
ptg000152l	24023641	24125482	101841	g_1905	g_21345
ptg000152l	24126912	24126934	22	g_21345	g_35004
ptg000152l	24127299	24130178	2879	g_35004	g_23523
ptg000152l	24130522	24142293	11771	g_23523	g_35908
ptg000152l	24142619	24168738	26119	g_35908	g_34219
ptg000152l	24169136	24181202	12066	g_34219	g_38182
ptg000152l	24181591	24207648	26057	g_38182	g_18947
ptg000152l	24209717	24233446	23729	g_18947	g_6900
ptg000152l	24233838	24244430	10592	g_6900	g_27015
ptg000152l	24247215	24248883	1668	g_27015	g_13514
ptg000152l	24269402	24275884	6482	g_13514	g_3552
ptg000152l	24281143	24403021	121878	g_3552	g_30593
ptg000152l	24409423	24413205	3782	g_30593	g_16514
ptg000152l	24442034	24446159	4125	g_16514	g_29833
ptg000152l	24508578	24569408	60830	g_29833	g_29072
ptg000152l	24570097	24846610	276513	g_29072	g_19596
ptg000152l	24851149	24857299	6150	g_19596	g_36916
ptg000152l	24861253	24893146	31893	g_36916	g_18692
ptg000152l	24897892	24902586	4694	g_18692	g_35134
ptg000152l	24920970	24951275	30305	g_35134	g_17208
ptg000152l	24951658	24969613	17955	g_17208	g_1574
ptg000152l	24969960	24982511	12551	g_1574	g_33968
ptg000152l	24983557	24994381	10824	g_33968	g_27459
ptg000152l	24996963	25009845	12882	g_27459	g_28931
ptg000152l	25013042	25014990	1948	g_28931	g_36670
ptg000152l	25019488	25033246	13758	g_36670	g_738
ptg000152l	25048104	25055698	7594	g_738	g_14305
ptg000152l	25056114	25059873	3759	g_14305	g_21632
ptg000152l	25061600	25063970	2370	g_21632	g_3034
ptg000152l	25065949	25070039	4090	g_3034	g_4355
ptg000152l	25070716	25093922	23206	g_4355	g_613
ptg000152l	25100689	25108196	7507	g_613	g_7913
ptg000152l	25123635	25169217	45582	g_7913	g_37297
ptg000152l	25169891	25172372	2481	g_37297	g_3384
ptg000152l	25173046	25190255	17209	g_3384	g_12417
ptg000152l	25201711	25204827	3116	g_12417	g_40111
ptg000152l	25209718	25211558	1840	g_40111	g_20009
ptg000152l	25219183	25224175	4992	g_20009	g_10605
ptg000152l	25232351	25236591	4240	g_10605	g_39917
ptg000152l	25239763	25244118	4355	g_39917	g_963
ptg000152l	25252528	25260104	7576	g_963	g_16028
ptg000152l	25273671	25305475	31804	g_16028	g_36983
ptg000152l	25313452	25324462	11010	g_36983	g_23502
ptg000152l	25330709	25338037	7328	g_23502	g_10462
ptg000152l	25352054	25360913	8859	g_10462	g_20383
ptg000152l	25367704	25369621	1917	g_20383	g_27128
ptg000152l	25389449	25439384	49935	g_27128	g_4696
ptg000152l	25446451	25463497	17046	g_4696	g_29182
ptg000152l	25465157	25500877	35720	g_29182	g_26518
ptg000152l	25508368	25516476	8108	g_26518	g_37982
ptg000152l	25516685	25660426	143741	g_37982	g_20650
ptg000152l	25660800	25709700	48900	g_20650	g_35573
ptg000152l	25711928	25751458	39530	g_35573	g_9148
ptg000152l	25751787	25772685	20898	g_9148	g_7239
ptg000152l	25772924	25792525	19601	g_7239	g_13833
ptg000152l	25793070	25813842	20772	g_13833	g_24035
ptg000152l	25835868	25883033	47165	g_24035	g_13982
ptg000152l	25892933	25917813	24880	g_13982	g_21113
ptg000152l	25922576	25936059	13483	g_21113	g_31200
ptg000152l	25958825	25965150	6325	g_31200	g_17855
ptg000152l	25967533	25971952	4419	g_17855	g_9935
ptg000152l	25984612	25992875	8263	g_9935	g_12319
ptg000152l	26006372	26011859	5487	g_12319	g_4946
ptg000152l	26029362	26087981	58619	g_4946	g_21384
ptg000152l	26129447	26136781	7334	g_21384	g_1920
ptg000152l	26145891	26231609	85718	g_1920	g_26329
ptg000152l	26244038	26249544	5506	g_26329	g_2414
ptg000152l	26255850	26280088	24238	g_2414	g_11902
ptg000152l	26291435	26433799	142364	g_11902	g_35856
ptg000152l	26436269	26445092	8823	g_35856	g_24122
ptg000152l	26454733	26502567	47834	g_24122	g_12072
ptg000152l	26505668	26587189	81521	g_12072	g_7166
ptg000152l	26611210	26631882	20672	g_7166	g_25806
ptg000152l	26633197	26645552	12355	g_25806	g_4432
ptg000152l	26718704	26752711	34007	g_4432	g_3676
ptg000152l	26763130	26777931	14801	g_3676	g_31082
ptg000152l	26780723	26825069	44346	g_31082	g_1549
ptg000152l	26829393	26845679	16286	g_1549	g_19798
ptg000152l	26854433	26856643	2210	g_19798	g_34066
ptg000152l	26864222	26867445	3223	g_34066	g_17367
ptg000152l	26890896	26957401	66505	g_17367	g_21817
ptg000152l	26958750	26968145	9395	g_21817	g_10117
ptg000152l	26973881	26975505	1624	g_10117	g_34130
ptg000152l	26998012	26998067	55	g_34130	g_38377
ptg000152l	26998711	27011693	12982	g_38377	g_9113
ptg000152l	27022984	27031971	8987	g_9113	g_15478
ptg000152l	27037219	27068581	31362	g_15478	g_8336
ptg000152l	27080042	27089002	8960	g_8336	g_16302
ptg000152l	27089316	27097842	8526	g_16302	g_38428
ptg000152l	27098156	27130032	31876	g_38428	g_36282
ptg000152l	27131895	27135047	3152	g_36282	g_33901
ptg000152l	27135568	27137376	1808	g_33901	g_6712
ptg000152l	27137690	27161896	24206	g_6712	g_10727
ptg000152l	27174012	27181556	7544	g_10727	g_18598
ptg000152l	27186273	27201605	15332	g_18598	g_30296
ptg000152l	27201919	27246481	44562	g_30296	g_12031
ptg000152l	27246777	27246803	26	g_12031	g_36963
ptg000152l	27247579	27251139	3560	g_36963	g_12878
ptg000152l	27251453	27290912	39459	g_12878	g_6298
ptg000152l	27291226	27339046	47820	g_6298	g_34320
ptg000152l	27339360	27373497	34137	g_34320	g_34089
ptg000152l	27374105	27377679	3574	g_34089	g_21535
ptg000152l	27377993	27408683	30690	g_21535	g_4615
ptg000152l	27420863	27436670	15807	g_4615	g_17662
ptg000152l	27438167	27453081	14914	g_17662	g_5668
ptg000152l	27454884	27486653	31769	g_5668	g_33354
ptg000152l	27487557	27491672	4115	g_33354	g_33300
ptg000152l	27492341	27524928	32587	g_33300	g_13778
ptg000152l	27539164	27597317	58153	g_38886	g_11491
ptg000152l	27610426	27637698	27272	g_11491	g_31389
ptg000152l	27661682	27666914	5232	g_31389	g_24946
ptg000152l	27685806	27687876	2070	g_24946	g_8480
ptg000152l	27692303	27699457	7154	g_8480	g_22962
ptg000152l	27715986	27732616	16630	g_22962	g_25981
ptg000152l	27739140	27744082	4942	g_25981	g_36218
ptg000152l	27756648	27804059	47411	g_36218	g_7926
ptg000152l	27806785	27807350	565	g_7926	g_33604
ptg000152l	27808417	27809799	1382	g_33604	g_32505
ptg000152l	27821878	27827341	5463	g_32505	g_15143
ptg000152l	27842257	27844031	1774	g_15143	g_1402
ptg000152l	27848546	27848934	388	g_1402	g_13218
ptg000152l	27858135	27942987	84852	g_13218	g_36164
ptg000152l	27948440	27953388	4948	g_36164	g_87
ptg000152l	27962670	27976291	13621	g_87	g_29112
ptg000152l	27982348	27984537	2189	g_29112	g_31101
ptg000152l	27989131	27991508	2377	g_31101	g_13708
ptg000152l	28000914	28008831	7917	g_13708	g_25113
ptg000152l	28012747	28105250	92503	g_25113	g_37175
ptg000152l	28128475	28174696	46221	g_37175	g_40040
ptg000152l	28175037	28175839	802	g_40040	g_8284
ptg000152l	28200455	28217783	17328	g_8284	g_17449
ptg000152l	28225094	28244634	19540	g_17449	g_30633
ptg000152l	28246418	28322970	76552	g_30633	g_5258
ptg000152l	28334490	28363957	29467	g_5258	g_35526
ptg000152l	28368532	28370992	2460	g_35526	g_1346
ptg000152l	28376820	28379929	3109	g_1346	g_13786
ptg000152l	28384153	28435814	51661	g_13786	g_12691
ptg000152l	28454272	28456495	2223	g_12691	g_18872
ptg000152l	28466452	28471239	4787	g_18872	g_11925
ptg000152l	28471439	28476493	5054	g_11925	g_6553
ptg000152l	28480122	28480813	691	g_6553	g_31092
ptg000152l	28487524	28488679	1155	g_31092	g_4227
ptg000152l	28492359	28495099	2740	g_4227	g_31174
ptg000152l	28512627	28518229	5602	g_31174	g_18048
ptg000152l	28532690	28536296	3606	g_18048	g_20882
ptg000152l	28567307	28568871	1564	g_20882	g_6039
ptg000152l	28584195	28616491	32296	g_6039	g_20374
ptg000152l	28623416	28692501	69085	g_20374	g_26412
ptg000152l	28702727	28705396	2669	g_26412	g_28460
ptg000152l	28710005	28718917	8912	g_28460	g_27058
ptg000152l	28730015	28732771	2756	g_27058	g_37149
ptg000152l	28757308	28760799	3491	g_37149	g_946
ptg000152l	28775459	28785454	9995	g_946	g_10055
ptg000152l	28799575	28804062	4487	g_10055	g_28098
ptg000152l	28806500	28874806	68306	g_28098	g_18043
ptg000152l	28882818	28920951	38133	g_18043	g_11375
ptg000152l	28922817	28930968	8151	g_11375	g_26105
ptg000152l	28934013	29185261	251248	g_26105	g_1628
ptg000152l	29185533	29189981	4448	g_1628	g_2342
ptg000152l	29208472	29211051	2579	g_2342	g_1211
ptg000152l	29217733	29249345	31612	g_1211	g_32618
ptg000152l	29256475	29260564	4089	g_32618	g_11125
ptg000152l	29285429	29426616	141187	g_11125	g_39789
ptg000152l	29426825	29484752	57927	g_39789	g_24415
ptg000152l	29502999	29505479	2480	g_24415	g_30995
ptg000152l	29527443	29537134	9691	g_30995	g_37086
ptg000152l	29542134	29545920	3786	g_37086	g_18183
ptg000152l	29550339	29552346	2007	g_18183	g_34439
ptg000152l	29573078	29577282	4204	g_34439	g_15811
ptg000152l	29579390	29582066	2676	g_15811	g_32185
ptg000152l	29582611	29586478	3867	g_32185	g_34198
ptg000152l	29599213	29615391	16178	g_34198	g_31701
ptg000152l	29615708	29618341	2633	g_31701	g_14679
ptg000152l	29620760	29625057	4297	g_14679	g_28943
ptg000152l	29632279	29635898	3619	g_28943	g_30637
ptg000152l	29645938	29677900	31962	g_30637	g_19076
ptg000152l	29690881	29721808	30927	g_19076	g_1341
ptg000152l	29722371	29723188	817	g_1341	g_7034
ptg000152l	29724834	29741221	16387	g_7034	g_32267
ptg000152l	29742651	29770960	28309	g_32267	g_13731
ptg000152l	29772905	29775619	2714	g_13731	g_36931
ptg000152l	29782076	29789861	7785	g_36931	g_25134
ptg000152l	29812525	29940001	127476	g_25134	g_40106
ptg000152l	29952174	29954253	2079	g_40106	g_12140
ptg000152l	29963272	29963715	443	g_12140	g_36069
ptg000152l	29967229	29998163	30934	g_36069	g_27898
ptg000152l	30000493	30003330	2837	g_27898	g_35384
ptg000152l	30005252	30122873	117621	g_35384	g_35159
ptg000152l	30124519	30194828	70309	g_35159	g_2513
ptg000152l	30196261	30354269	158008	g_2513	g_19961
ptg000152l	30361180	30370057	8877	g_19961	g_24256
ptg000152l	30376014	30458925	82911	g_24256	g_7305
ptg000152l	30503786	30506713	2927	g_7305	g_17989
ptg000152l	30510375	30514070	3695	g_17989	g_17409
ptg000152l	30544210	30569566	25356	g_17409	g_37342
ptg000152l	30570390	30600130	29740	g_37342	g_24403
ptg000152l	30600507	30606311	5804	g_24403	g_12347
ptg000152l	30609161	30631952	22791	g_12347	g_11133
ptg000152l	30633686	30647225	13539	g_11133	g_25639
ptg000152l	30654831	30672891	18060	g_25639	g_5229
ptg000152l	30674627	30683369	8742	g_5229	g_9684
ptg000152l	30683770	30690635	6865	g_9684	g_1902
ptg000152l	30692369	30701896	9527	g_1902	g_28541
ptg000152l	30702177	30747739	45562	g_28541	g_15351
ptg000152l	30756772	30805952	49180	g_15351	g_31261
ptg000152l	30813885	30814523	638	g_31261	g_3802
ptg000152l	30817654	30817976	322	g_3802	g_33366
ptg000152l	30819565	30831488	11923	g_33366	g_130
ptg000152l	30832489	30911045	78556	g_130	g_31562
ptg000152l	30912346	30950828	38482	g_31562	g_19206
ptg000152l	30951274	31199533	248259	g_19206	g_36961
ptg000152l	31199838	31265304	65466	g_36961	g_20545
ptg000152l	31265840	31290198	24358	g_20545	g_37120
ptg000152l	31296515	31298300	1785	g_37120	g_32866
ptg000152l	31303014	31317849	14835	g_39623	g_7756
ptg000152l	31328031	31356304	28273	g_7756	g_16162
ptg000152l	31356855	31372895	16040	g_16162	g_10141
ptg000152l	31373116	31569603	196487	g_10141	g_19660
ptg000152l	31570400	31730158	159758	g_19660	g_25229
ptg000153l	48702	61671	12969	g_11186	g_1157
ptg000153l	79294	119669	40375	g_1157	g_34524
ptg000153l	119992	159932	39940	g_34524	g_24689
ptg000153l	160525	178775	18250	g_24689	g_24993
ptg000153l	179029	179055	26	g_24993	g_14235
ptg000153l	179441	190253	10812	g_14235	g_4490
ptg000153l	192622	255846	63224	g_4490	g_5076
ptg000153l	265361	298870	33509	g_5076	g_10061
ptg000153l	299409	308069	8660	g_10061	g_22950
ptg000153l	318479	337331	18852	g_22950	g_37283
ptg000153l	374561	374835	274	g_37283	g_4000
ptg000153l	375191	376594	1403	g_4000	g_27382
ptg000153l	380644	383824	3180	g_27382	g_2296
ptg000153l	384990	385035	45	g_2296	g_11828
ptg000153l	385313	387281	1968	g_11828	g_26267
ptg000155l	881	1071	190	g_33916	g_5310
ptg000155l	1562	2042	480	g_5310	g_8761
ptg000155l	2731	2889	158	g_8761	g_7016
ptg000155l	3740	3801	61	g_7016	g_25393
ptg000155l	4802	4859	57	g_25393	g_15858
ptg000155l	5404	9246	3842	g_15858	g_20451
ptg000155l	10067	14912	4845	g_20451	g_19655
ptg000155l	16795	16861	66	g_19655	g_7399
ptg000155l	17787	17832	45	g_7399	g_17634
ptg000155l	18929	19065	136	g_17634	g_22570
ptg000155l	20039	20057	18	g_22570	g_35748
ptg000155l	21202	21229	27	g_35748	g_28571
ptg000155l	21936	22067	131	g_28571	g_33809
ptg000155l	23416	23474	58	g_33809	g_33584
ptg000155l	23713	23735	22	g_33584	g_22987
ptg000155l	25315	32334	7019	g_22987	g_5947
ptg000155l	34418	39826	5408	g_5947	g_28993
ptg000155l	41118	43645	2527	g_28993	g_33845
ptg000155l	44991	47725	2734	g_33845	g_28681
ptg000155l	47970	48797	827	g_28681	g_20679
ptg000155l	49366	49411	45	g_20679	g_23996
ptg000155l	50619	51022	403	g_23996	g_9811
ptg000155l	51777	52672	895	g_9811	g_2140
ptg000155l	53361	53535	174	g_2140	g_4186
ptg000157l	496	1049	553	g_1016	g_21247
ptg000157l	1831	5021	3190	g_21247	g_26939
ptg000157l	6169	7863	1694	g_26939	g_36460
ptg000157l	8132	8158	26	g_36460	g_15472
ptg000157l	8547	8770	223	g_15472	g_37445
ptg000157l	9864	9934	70	g_37445	g_33306
ptg000157l	10800	10851	51	g_33306	g_35124
ptg000157l	12119	12266	147	g_35124	g_26611
ptg000157l	12982	13007	25	g_26611	g_31684
ptg000157l	15037	15124	87	g_31684	g_30675
ptg000157l	15891	16040	149	g_30675	g_11373
ptg000157l	17344	17379	35	g_11373	g_9428
ptg000157l	18311	18463	152	g_9428	g_21492
ptg000157l	20040	20079	39	g_21492	g_20693
ptg000157l	21275	23254	1979	g_20693	g_10595
ptg000157l	23664	23763	99	g_10595	g_31508
ptg000157l	24038	24238	200	g_31508	g_34145
ptg000157l	25062	25112	50	g_34145	g_2986
ptg000157l	25930	26785	855	g_2986	g_17453
ptg000157l	27888	27941	53	g_17453	g_33266
ptg000157l	28873	28938	65	g_33266	g_33775
ptg000157l	29345	29513	168	g_33775	g_11632
ptg000158l	30841	37862	7021	g_11632	g_4358
ptg000162l	20791	22981	2190	g_16762	g_34165
ptg000162l	34069	34806	737	g_34165	g_31138
ptg000162l	38117	39574	1457	g_31138	g_31992
ptg000162l	51376	55169	3793	g_31992	g_16036
ptg000162l	57741	71248	13507	g_16036	g_26451
ptg000162l	86440	95654	9214	g_26451	g_35738
ptg000162l	133345	169219	35874	g_35738	g_29579
ptg000162l	172685	213442	40757	g_29579	g_2177
ptg000162l	213666	231076	17410	g_2177	g_21946
ptg000162l	251757	290402	38645	g_21946	g_11055
ptg000162l	292246	305713	13467	g_11055	g_16304
ptg000162l	317557	345204	27647	g_16304	g_33699
ptg000162l	356334	387165	30831	g_33699	g_18593
ptg000162l	393840	430332	36492	g_18593	g_14224
ptg000162l	454735	506633	51898	g_14224	g_9441
ptg000162l	514410	517207	2797	g_9441	g_38765
ptg000165l	10694	11321	627	g_3662	g_31769
ptg000165l	53283	54667	1384	g_31769	g_17547
ptg000168l	62017	74556	12539	g_5706	g_16261
ptg000168l	78415	79253	838	g_16261	g_19554
ptg000168l	92470	164454	71984	g_19554	g_10795
ptg000173l	125877	155359	29482	g_9226	g_16698
ptg000173l	155574	185098	29524	g_16698	g_13352
ptg000173l	191521	194339	2818	g_13352	g_4994
ptg000175l	1367	3362	1995	g_26181	g_4069
ptg000175l	23049	30103	7054	g_4069	g_20475
ptg000175l	33509	35091	1582	g_20475	g_23840
ptg000175l	41209	52170	10961	g_23840	g_491
ptg000175l	58203	123430	65227	g_491	g_25424
ptg000175l	124542	131516	6974	g_25424	g_14273
ptg000175l	131992	194943	62951	g_14273	g_37031
ptg000175l	195212	196325	1113	g_37031	g_3211
ptg000175l	196594	197059	465	g_3211	g_23205
ptg000175l	199479	220198	20719	g_23205	g_14532
ptg000175l	220596	220766	170	g_14532	g_1879
ptg000175l	221116	221170	54	g_1879	g_26079
ptg000175l	221598	236862	15264	g_26079	g_28008
ptg000175l	238190	298252	60062	g_28008	g_17106
ptg000175l	311883	341343	29460	g_17106	g_3224
ptg000175l	354180	377303	23123	g_3224	g_36947
ptg000175l	378133	432295	54162	g_36947	g_24127
ptg000175l	437592	444793	7201	g_24127	g_35360
ptg000175l	445479	458884	13405	g_35360	g_39755
ptg000175l	459416	465013	5597	g_39755	g_395
ptg000175l	487957	499252	11295	g_395	g_35314
ptg000175l	499587	503307	3720	g_35314	g_21673
ptg000175l	503630	504990	1360	g_21673	g_22916
ptg000175l	521512	522754	1242	g_22916	g_18735
ptg000175l	537903	547283	9380	g_18735	g_17955
ptg000175l	549093	550860	1767	g_17955	g_36061
ptg000175l	556578	586291	29713	g_36061	g_23118
ptg000175l	592284	596883	4599	g_23118	g_10697
ptg000175l	597122	597732	610	g_10697	g_28281
ptg000175l	597971	598476	505	g_28281	g_32295
ptg000176l	87080	91265	4185	g_21559	g_35007
ptg000176l	91837	102428	10591	g_35007	g_38107
ptg000176l	115429	128764	13335	g_38107	g_8157
ptg000176l	129363	148029	18666	g_8157	g_19743
ptg000176l	148802	179624	30822	g_10129	g_7471
ptg000176l	181254	188677	7423	g_7471	g_1188
ptg000177l	115	471	356	g_28012	g_11115
ptg000177l	707	2317	1610	g_11115	g_21991
ptg000177l	13396	77102	63706	g_21991	g_3421
ptg000177l	87327	87846	519	g_3421	g_11751
ptg000177l	93822	94218	396	g_11751	g_10997
ptg000177l	95549	118217	22668	g_10997	g_14304
ptg000177l	132919	181241	48322	g_14304	g_34669
ptg000177l	183037	184289	1252	g_34669	g_2133
ptg000177l	199731	223955	24224	g_2133	g_9968
ptg000177l	241856	250518	8662	g_9968	g_26274
ptg000178l	47606	48761	1155	g_18021	g_20852
ptg000178l	52311	73063	20752	g_20852	g_31133
ptg000178l	74079	79644	5565	g_31133	g_12088
ptg000178l	80315	137896	57581	g_12088	g_19341
ptg000179l	28911	32012	3101	g_20790	g_14023
ptg000179l	32404	43081	10677	g_14023	g_39896
ptg000179l	44267	46615	2348	g_39896	g_150
ptg000179l	58393	67938	9545	g_150	g_5745
ptg000179l	76657	80502	3845	g_5745	g_36879
ptg000179l	100911	108636	7725	g_36879	g_21390
ptg000179l	112268	126043	13775	g_21390	g_25228
ptg000179l	127491	141198	13707	g_25228	g_21144
ptg000179l	148688	187709	39021	g_21144	g_35254
ptg000179l	188038	248975	60937	g_35254	g_21895
ptg000179l	249478	257171	7693	g_21895	g_914
ptg000180l	70149	70896	747	g_38059	g_12533
ptg000180l	71117	71542	425	g_12533	g_34194
ptg000180l	71742	72508	766	g_34194	g_20432
ptg000180l	72729	73701	972	g_20432	g_14628
ptg000180l	75824	153079	77255	g_14628	g_24034
ptg000180l	155307	156310	1003	g_24034	g_35830
ptg000180l	157263	160744	3481	g_35830	g_11194
ptg000180l	160998	164273	3275	g_11194	g_1518
ptg000181l	466	733	267	g_21114	g_8918
ptg000181l	1350	1403	53	g_8918	g_24636
ptg000181l	1732	2282	550	g_24636	g_6531
ptg000181l	3259	3590	331	g_6531	g_22102
ptg000181l	5263	5350	87	g_22102	g_34970
ptg000181l	6057	6082	25	g_34970	g_17975
ptg000181l	6822	9237	2415	g_17975	g_2692
ptg000181l	10070	10217	147	g_2692	g_27018
ptg000182l	11179	49221	38042	g_27018	g_9752
ptg000182l	49904	66867	16963	g_9752	g_8833
ptg000182l	67691	67742	51	g_8833	g_20802
ptg000183l	71518	99137	27619	g_1720	g_18284
ptg000183l	100768	103813	3045	g_18284	g_4001
ptg000183l	105285	124582	19297	g_4001	g_2772
ptg000183l	125301	137976	12675	g_2772	g_21789
ptg000183l	138458	138784	326	g_21789	g_20489
ptg000183l	139863	144547	4684	g_20489	g_12601
ptg000183l	150442	164755	14313	g_12601	g_33636
ptg000183l	166650	220219	53569	g_33636	g_27150
ptg000183l	221496	255871	34375	g_27150	g_25043
ptg000183l	257196	261666	4470	g_25043	g_16586
ptg000183l	263176	264596	1420	g_16586	g_25096
ptg000183l	265096	274579	9483	g_25096	g_23690
ptg000183l	277224	279247	2023	g_23690	g_3567
ptg000183l	279639	281523	1884	g_3567	g_32498
ptg000183l	302092	308198	6106	g_32498	g_4011
ptg000183l	308425	319620	11195	g_4011	g_21672
ptg000183l	334817	362655	27838	g_21672	g_25236
ptg000183l	382690	385802	3112	g_25236	g_7550
ptg000184l	1194	4058	2864	g_33673	g_19936
ptg000184l	5494	5622	128	g_19936	g_32255
ptg000184l	6146	6323	177	g_32255	g_37139
ptg000184l	7240	7318	78	g_37139	g_36339
ptg000184l	8772	8830	58	g_36339	g_29457
ptg000184l	9144	9324	180	g_29457	g_15161
ptg000184l	9617	9699	82	g_15161	g_5959
ptg000184l	10535	10581	46	g_5959	g_9591
ptg000184l	11963	12002	39	g_9591	g_21416
ptg000184l	12685	15659	2974	g_21416	g_1347
ptg000184l	16585	17758	1173	g_1347	g_4634
ptg000184l	18156	18190	34	g_4634	g_6945
ptg000184l	18399	21638	3239	g_6945	g_27375
ptg000184l	22621	22783	162	g_27375	g_40266
ptg000184l	23421	23549	128	g_40266	g_1876
ptg000184l	24025	24231	206	g_1876	g_35771
ptg000184l	25109	27972	2863	g_35771	g_34989
ptg000185l	28289	39912	11623	g_34989	g_29111
ptg000185l	40568	43413	2845	g_29111	g_27336
ptg000185l	44144	45183	1039	g_27336	g_1453
ptg000185l	55925	56060	135	g_1453	g_9938
ptg000185l	56650	69454	12804	g_9938	g_12779
ptg000185l	78136	96722	18586	g_12779	g_3426
ptg000185l	97669	108846	11177	g_3426	g_4702
ptg000186l	11765	44595	32830	g_21397	g_36195
ptg000186l	58889	82061	23172	g_36195	g_1397
ptg000186l	82306	105324	23018	g_1397	g_4120
ptg000186l	106343	116025	9682	g_4120	g_26093
ptg000186l	119855	137602	17747	g_26093	g_38078
ptg000186l	137829	236768	98939	g_38078	g_38096
ptg000186l	237947	247604	9657	g_38096	g_16215
ptg000186l	261934	263094	1160	g_16215	g_27224
ptg000186l	273162	274066	904	g_27224	g_3861
ptg000186l	275592	291781	16189	g_3861	g_3047
ptg000186l	299328	319091	19763	g_3047	g_32665
ptg000186l	319663	327448	7785	g_32665	g_11081
ptg000186l	331848	344989	13141	g_11081	g_26273
ptg000186l	349968	351732	1764	g_39228	g_39115
ptg000186l	352643	356083	3440	g_39115	g_2914
ptg000186l	361082	407812	46730	g_2914	g_13824
ptg000186l	420939	455603	34664	g_13824	g_17456
ptg000186l	458632	463088	4456	g_17456	g_16939
ptg000186l	464947	477991	13044	g_16939	g_1287
ptg000186l	487141	493828	6687	g_1287	g_35118
ptg000186l	510379	544556	34177	g_35118	g_19666
ptg000187l	66895	111474	44579	g_12706	g_27862
ptg000187l	113138	118751	5613	g_27862	g_7150
ptg000187l	119059	129662	10603	g_7150	g_33596
ptg000187l	131902	149100	17198	g_33596	g_1726
ptg000187l	157868	200569	42701	g_1726	g_14300
ptg000187l	203133	282529	79396	g_14300	g_31387
ptg000187l	284047	290888	6841	g_31387	g_36804
ptg000187l	291592	311597	20005	g_36804	g_22079
ptg000187l	315790	335540	19750	g_22079	g_36278
ptg000188l	610	705	95	g_11510	g_38701
ptg000188l	1091	2133	1042	g_38701	g_37461
ptg000188l	2384	2534	150	g_37461	g_33801
ptg000188l	3193	4233	1040	g_33801	g_3997
ptg000188l	5240	5471	231	g_3997	g_18656
ptg000188l	7984	8033	49	g_18656	g_25298
ptg000188l	8374	8416	42	g_25298	g_4988
ptg000188l	9099	9468	369	g_4988	g_28081
ptg000188l	9701	9842	141	g_28081	g_23389
ptg000188l	10267	10290	23	g_23389	g_27295
ptg000188l	11057	14897	3840	g_27295	g_36076
ptg000188l	15238	15376	138	g_36076	g_6989
ptg000188l	16992	17015	23	g_6989	g_948
ptg000188l	17920	18945	1025	g_948	g_5927
ptg000188l	19418	20999	1581	g_5927	g_29860
ptg000188l	21412	23478	2066	g_29860	g_3251
ptg000188l	24386	24473	87	g_3251	g_2336
ptg000188l	25459	25659	200	g_2336	g_15310
ptg000188l	26627	26666	39	g_15310	g_28848
ptg000188l	28273	30089	1816	g_28848	g_22011
ptg000188l	31000	31018	18	g_22011	g_22126
ptg000188l	31956	32078	122	g_22126	g_4265
ptg000188l	33790	33968	178	g_4265	g_10920
ptg000188l	34234	36475	2241	g_10920	g_3590
ptg000188l	37155	38479	1324	g_3590	g_2953
ptg000188l	39738	42160	2422	g_2953	g_4574
ptg000188l	42414	42498	84	g_4574	g_4770
ptg000188l	42998	43134	136	g_4770	g_15385
ptg000188l	43418	43683	265	g_15385	g_481
ptg000188l	43961	44068	107	g_481	g_14470
ptg000188l	44286	45537	1251	g_14470	g_4077
ptg000188l	45776	45931	155	g_4077	g_8538
ptg000188l	46800	46968	168	g_8538	g_33077
ptg000188l	47636	49281	1645	g_33077	g_1544
ptg000188l	49961	50031	70	g_1544	g_37956
ptg000188l	50690	50706	16	g_37956	g_7608
ptg000188l	51989	52025	36	g_7608	g_36127
ptg000188l	52531	52619	88	g_36127	g_23655
ptg000188l	53233	53306	73	g_23655	g_34376
ptg000190l	35436	64758	29322	g_11189	g_18584
ptg000190l	65288	112409	47121	g_18584	g_22605
ptg000190l	113125	160060	46935	g_22605	g_36775
ptg000190l	161574	193023	31449	g_36775	g_26555
ptg000190l	218800	221182	2382	g_26555	g_12650
ptg000190l	229254	241539	12285	g_12650	g_9305
ptg000190l	242207	255052	12845	g_9305	g_2872
ptg000190l	266859	272071	5212	g_2872	g_12262
ptg000190l	282642	284222	1580	g_12262	g_5137
ptg000190l	302304	316710	14406	g_5137	g_29584
ptg000190l	318272	323889	5617	g_29584	g_29059
ptg000190l	342471	357988	15517	g_29059	g_3811
ptg000190l	362032	382637	20605	g_3811	g_1478
ptg000190l	388185	390044	1859	g_1478	g_39928
ptg000190l	407762	414638	6876	g_39928	g_3564
ptg000190l	415372	419210	3838	g_3564	g_8705
ptg000190l	419548	433072	13524	g_8705	g_742
ptg000190l	451408	455379	3971	g_742	g_22180
ptg000190l	456071	477740	21669	g_22180	g_5129
ptg000190l	477946	577454	99508	g_5129	g_2233
ptg000190l	577663	594780	17117	g_2233	g_19639
ptg000190l	596324	597383	1059	g_19639	g_32583
ptg000190l	617289	683708	66419	g_32583	g_25707
ptg000190l	697308	711089	13781	g_25707	g_30532
ptg000193l	21614	22808	1194	g_8973	g_33379
ptg000193l	32586	33602	1016	g_33379	g_13113
ptg000196l	7061	7098	37	g_21005	g_37298
ptg000196l	10031	10068	37	g_37298	g_27178
ptg000196l	11561	11598	37	g_27178	g_13121
ptg000196l	14513	14550	37	g_13121	g_16111
ptg000196l	17180	52351	35171	g_16111	g_37561
ptg000198l	10029	12920	2891	g_18938	g_23544
ptg000198l	14440	14572	132	g_23544	g_22219
ptg000198l	15690	15762	72	g_22219	g_11682
ptg000198l	16718	18571	1853	g_11682	g_4284
ptg000198l	19746	19786	40	g_4284	g_21426
ptg000198l	20571	20603	32	g_21426	g_28258
ptg000198l	22102	22159	57	g_28258	g_10683
ptg000198l	23196	23340	144	g_10683	g_23150
ptg000198l	24146	24203	57	g_23150	g_31532
ptg000198l	25165	27928	2763	g_31532	g_25475
ptg000198l	28908	28924	16	g_25475	g_35332
ptg000198l	29427	29565	138	g_35332	g_31608
ptg000198l	30551	30603	52	g_31608	g_19752
ptg000198l	31898	31956	58	g_19752	g_36252
ptg000198l	32906	33128	222	g_36252	g_16316
ptg000198l	34255	34322	67	g_16316	g_24622
ptg000198l	35311	35355	44	g_24622	g_34241
ptg000198l	36824	36883	59	g_34241	g_1645
ptg000198l	37851	40412	2561	g_1645	g_19264
ptg000198l	42025	42181	156	g_19264	g_24606
ptg000198l	43284	43342	58	g_24606	g_28902
ptg000198l	44262	44716	454	g_28902	g_9984
ptg000198l	45375	45512	137	g_9984	g_14860
ptg000198l	45916	46101	185	g_14860	g_5580
ptg000198l	46814	46886	72	g_5580	g_9475
ptg000198l	48937	49027	90	g_9475	g_16390
ptg000198l	49758	53117	3359	g_16390	g_3581
ptg000198l	54148	54178	30	g_3581	g_23993
ptg000198l	55116	55812	696	g_23993	g_19528
ptg000198l	56609	56661	52	g_19528	g_37214
ptg000198l	56924	59996	3072	g_37214	g_16331
ptg000198l	60211	62123	1912	g_16331	g_34885
ptg000201l	4201	4252	51	g_13145	g_36920
ptg000201l	5568	5651	83	g_36920	g_7506
ptg000201l	6439	6588	149	g_7506	g_37308
ptg000201l	7565	7612	47	g_37308	g_23509
ptg000201l	8523	8582	59	g_23509	g_4909
ptg000201l	9541	9647	106	g_4909	g_4934
ptg000201l	10633	10678	45	g_4934	g_2390
ptg000201l	11946	13611	1665	g_2390	g_20710
ptg000201l	13925	15516	1591	g_20710	g_5099
ptg000201l	15989	18031	2042	g_5099	g_27398
ptg000201l	18426	18656	230	g_27398	g_19466
ptg000201l	19012	19150	138	g_19466	g_36364
ptg000202l	6806	11477	4671	g_15579	g_15776
ptg000202l	31434	106108	74674	g_15776	g_27818
ptg000205l	16364	31626	15262	g_3561	g_33475
ptg000205l	39687	39822	135	g_33475	g_28399
ptg000205l	41300	44026	2726	g_28399	g_21348
ptg000205l	47533	105899	58366	g_21348	g_28034
ptg000205l	153033	180998	27965	g_28034	g_24723
ptg000209l	1405	4432	3027	g_26907	g_20580
ptg000209l	4716	7811	3095	g_20580	g_28358
ptg000209l	8137	8297	160	g_28358	g_2510
ptg000209l	8590	8705	115	g_2510	g_6876
ptg000209l	9028	11057	2029	g_6876	g_23928
ptg000209l	11305	13114	1809	g_23928	g_11801
ptg000209l	14085	14223	138	g_11801	g_9989
ptg000209l	15218	15252	34	g_9989	g_28453
ptg000209l	16781	16816	35	g_28453	g_17104
ptg000209l	18303	18333	30	g_17104	g_22697
ptg000209l	19139	19165	26	g_22697	g_36603
ptg000209l	19386	19535	149	g_36603	g_38044
ptg000209l	20752	21012	260	g_38044	g_8195
ptg000209l	21284	21341	57	g_8195	g_31549
ptg000209l	22786	22990	204	g_31549	g_32846
ptg000209l	23316	23561	245	g_32846	g_23950
ptg000209l	24472	24657	185	g_23950	g_25852
ptg000209l	25085	25137	52	g_25852	g_13036
ptg000209l	26327	26406	79	g_13036	g_27740
ptg000209l	27005	27088	83	g_27740	g_35582
ptg000209l	28056	28233	177	g_35582	g_9628
ptg000209l	29897	30099	202	g_9628	g_26102
ptg000209l	30902	30972	70	g_26102	g_8302
ptg000209l	31712	31767	55	g_8302	g_32890
ptg000209l	32549	32602	53	g_32890	g_35280
ptg000209l	34137	34200	63	g_35280	g_8884
ptg000209l	34508	37461	2953	g_8884	g_35729
ptg000212l	13251	13288	37	g_1558	g_34272
ptg000212l	14313	14350	37	g_34272	g_5581
ptg000212l	16530	25635	9105	g_5581	g_21211
ptg000215l	43086	45456	2370	g_19794	g_16093
ptg000215l	45965	62044	16079	g_16093	g_12835
ptg000215l	62973	65706	2733	g_12835	g_27458
ptg000215l	66092	76360	10268	g_27458	g_26808
ptg000216l	26054	34796	8742	g_8574	g_21846
ptg000216l	35131	35840	709	g_21846	g_10081
ptg000216l	36400	36421	21	g_10081	g_3202
ptg000216l	40250	65218	24968	g_3202	g_15953
ptg000216l	66529	81547	15018	g_15953	g_6754
ptg000216l	90550	103695	13145	g_6754	g_9096
ptg000216l	121287	256455	135168	g_9096	g_5624
ptg000216l	270548	271213	665	g_5624	g_31770
ptg000216l	271971	286350	14379	g_31770	g_30417
ptg000216l	287270	291248	3978	g_30417	g_31599
ptg000216l	305888	362309	56421	g_31599	g_34956
ptg000216l	385397	430635	45238	g_34956	g_13452
ptg000216l	433790	489228	55438	g_13452	g_9106
ptg000216l	506820	583617	76797	g_9106	g_33430
ptg000216l	584198	585105	907	g_33430	g_31567
ptg000216l	602035	621393	19358	g_31567	g_13166
ptg000216l	628756	684944	56188	g_13166	g_34040
ptg000216l	686313	689792	3479	g_34040	g_5760
ptg000216l	691333	812649	121316	g_5760	g_12913
ptg000216l	813608	825602	11994	g_12913	g_15297
ptg000216l	826504	861054	34550	g_15297	g_25843
ptg000216l	864048	880437	16389	g_25843	g_32065
ptg000216l	881851	930200	48349	g_32065	g_26565
ptg000216l	937158	937206	48	g_26565	g_10269
ptg000216l	937913	938021	108	g_10269	g_29937
ptg000216l	939103	975277	36174	g_29937	g_21037
ptg000216l	975876	1034109	58233	g_21037	g_2281
ptg000216l	1034791	1044310	9519	g_2281	g_6349
ptg000216l	1045985	1084713	38728	g_6349	g_22961
ptg000216l	1087735	1092520	4785	g_22961	g_24245
ptg000216l	1097479	1122064	24585	g_24245	g_15063
ptg000216l	1122411	1129780	7369	g_15063	g_14358
ptg000216l	1131558	1166706	35148	g_14358	g_13115
ptg000216l	1177710	1223307	45597	g_13115	g_9163
ptg000216l	1241342	1255083	13741	g_9163	g_19184
ptg000216l	1257137	1274295	17158	g_19184	g_28985
ptg000219l	231	264	33	g_23108	g_10827
ptg000219l	1322	1462	140	g_10827	g_18377
ptg000219l	2472	2576	104	g_18377	g_12640
ptg000219l	3409	3458	49	g_12640	g_19736
ptg000219l	4852	5039	187	g_19736	g_12550
ptg000219l	5809	5851	42	g_12550	g_15520
ptg000219l	6264	6281	17	g_15520	g_36636
ptg000219l	7306	7379	73	g_36636	g_21528
ptg000219l	8275	10330	2055	g_21528	g_30169
ptg000219l	11142	11201	59	g_30169	g_11075
ptg000219l	11659	13353	1694	g_11075	g_31590
ptg000220l	14019	30822	16803	g_31590	g_33483
ptg000220l	42093	47624	5531	g_33483	g_34109
ptg000226l	1249	1256	7	g_10432	g_18777
ptg000226l	1663	2104	441	g_18777	g_26623
ptg000226l	3084	6927	3843	g_26623	g_1854
ptg000226l	7727	7840	113	g_1854	g_23687
ptg000226l	9309	9462	153	g_23687	g_10493
ptg000229l	1501	6736	5235	g_2154	g_25398
ptg000229l	7287	40451	33164	g_25398	g_22359
ptg000229l	44596	46998	2402	g_22359	g_20514
ptg000229l	47438	47625	187	g_20514	g_35583
ptg000229l	49359	73763	24404	g_35583	g_12359
ptg000229l	78600	154898	76298	g_12359	g_23888
ptg000231l	6948	7547	599	g_36962	g_1828
ptg000231l	8614	44625	36011	g_1828	g_35997
ptg000241l	29455	49959	20504	g_15431	g_16187
ptg000242l	235	290	55	g_32008	g_35947
ptg000242l	826	1031	205	g_35947	g_14260
ptg000242l	1951	2061	110	g_14260	g_27376
ptg000242l	2834	4290	1456	g_27376	g_23316
ptg000242l	5006	5138	132	g_23316	g_23755
ptg000242l	5764	7222	1458	g_23755	g_11208
ptg000242l	8547	8589	42	g_11208	g_9037
ptg000242l	9350	9393	43	g_9037	g_5785
ptg000242l	10157	10170	13	g_5785	g_18727
ptg000242l	10739	10815	76	g_18727	g_5438
ptg000242l	12458	12580	122	g_5438	g_15118
ptg000242l	13608	13671	63	g_15118	g_46
ptg000242l	15266	15458	192	g_46	g_6898
ptg000242l	16723	17538	815	g_6898	g_25896
ptg000242l	18920	19020	100	g_25896	g_40259
ptg000242l	19550	19578	28	g_40259	g_34401
ptg000242l	19895	19981	86	g_34401	g_34971
ptg000242l	20877	20934	57	g_34971	g_29517
ptg000242l	21344	21426	82	g_29517	g_1406
ptg000242l	21839	21914	75	g_1406	g_9160
ptg000242l	22867	22968	101	g_9160	g_6494
ptg000242l	23438	24504	1066	g_6494	g_12113
ptg000243l	25523	41300	15777	g_12113	g_28254
ptg000243l	71389	106668	35279	g_28254	g_20916
ptg000243l	120492	129741	9249	g_20916	g_9690
ptg000243l	131571	147826	16255	g_9690	g_8568
ptg000243l	151246	203889	52643	g_8568	g_29645
ptg000249l	514	624	110	g_34021	g_21562
ptg000249l	1232	6258	5026	g_21562	g_6639
ptg000249l	6785	6924	139	g_6639	g_32249
ptg000249l	7364	9860	2496	g_32249	g_36351
ptg000249l	10159	10314	155	g_36351	g_30777
ptg000249l	11495	11577	82	g_30777	g_7089
ptg000251l	1077	4695	3618	g_6845	g_1447
ptg000251l	5054	5143	89	g_1447	g_7660
ptg000251l	5652	5716	64	g_7660	g_13233
ptg000251l	6909	6967	58	g_13233	g_10875
ptg000251l	7482	16316	8834	g_10875	g_1421
ptg000251l	16921	17020	99	g_1421	g_14390
ptg000251l	17529	17569	40	g_14390	g_22052
ptg000251l	17982	18079	97	g_22052	g_17865
ptg000251l	18660	18796	136	g_17865	g_36820
ptg000251l	19194	19223	29	g_36820	g_23729
ptg000251l	19450	19514	64	g_23729	g_23978
ptg000251l	19732	20307	575	g_23978	g_33291
ptg000251l	21626	21886	260	g_33291	g_34631
ptg000251l	22227	22472	245	g_34631	g_2453
ptg000251l	22705	27231	4526	g_2453	g_2051
ptg000251l	27467	28480	1013	g_2051	g_23153
ptg000251l	28683	28862	179	g_23153	g_36330
ptg000251l	29356	30126	770	g_36330	g_24627
ptg000251l	30356	30588	232	g_24627	g_20415
ptg000251l	30914	32389	1475	g_20415	g_35920
ptg000251l	32964	34466	1502	g_35920	g_9898
ptg000252l	35061	58211	23150	g_9898	g_9110
ptg000252l	62293	64412	2119	g_9110	g_29270
ptg000252l	88616	92490	3874	g_29270	g_18345
ptg000252l	93215	93281	66	g_18345	g_34766
ptg000252l	93760	96475	2715	g_34766	g_12091
ptg000252l	96936	98896	1960	g_12091	g_34072
ptg000253l	104	229	125	g_20244	g_22582
ptg000253l	774	875	101	g_22582	g_16995
ptg000253l	2212	3992	1780	g_16995	g_19837
ptg000253l	4276	9028	4752	g_19837	g_35724
ptg000253l	10128	10238	110	g_35724	g_4893
ptg000253l	12085	12112	27	g_4893	g_33491
ptg000253l	13347	13398	51	g_33491	g_33461
ptg000253l	14438	14486	48	g_33461	g_13201
ptg000253l	15868	15958	90	g_13201	g_34983
ptg000253l	16845	16881	36	g_34983	g_38029
ptg000253l	17642	17727	85	g_38029	g_31754
ptg000253l	18956	19076	120	g_31754	g_27676
ptg000253l	20314	22022	1708	g_27676	g_2132
ptg000253l	23224	26991	3767	g_2132	g_21269
ptg000253l	27218	29360	2142	g_21269	g_12061
ptg000253l	30004	30244	240	g_12061	g_1912
ptg000253l	31326	31679	353	g_1912	g_17771
ptg000253l	33139	33233	94	g_17771	g_38281
ptg000253l	33853	34294	441	g_38281	g_37705
ptg000253l	35451	35510	59	g_37705	g_28709
ptg000255l	5134	6673	1539	g_8642	g_22268
ptg000255l	9069	12674	3605	g_22268	g_9835
ptg000255l	13255	16486	3231	g_9835	g_9551
ptg000255l	19020	19086	66	g_9551	g_3128
ptg000256l	4603	4821	218	g_21638	g_1864
ptg000256l	5732	31186	25454	g_1864	g_2310
ptg000256l	31524	34427	2903	g_2310	g_9771
ptg000257l	40237	77913	37676	g_20797	g_23271
ptg000257l	78854	104524	25670	g_23271	g_19776
ptg000260l	307	395	88	g_21711	g_15860
ptg000260l	769	38650	37881	g_15860	g_39908
ptg000260l	47225	50019	2794	g_39908	g_452
ptg000265l	2576	2622	46	g_11339	g_6498
ptg000265l	4316	5862	1546	g_6498	g_20829
ptg000265l	7016	11446	4430	g_20829	g_4830
ptg000266l	5861	9788	3927	g_31661	g_6265
ptg000266l	10228	55282	45054	g_6265	g_32203
ptg000266l	55581	79571	23990	g_32203	g_33660
ptg000270l	127	3259	3132	g_10185	g_8054
ptg000270l	6252	6459	207	g_8054	g_23246
ptg000270l	8156	14711	6555	g_23246	g_25222
ptg000270l	16372	17178	806	g_25222	g_32831
ptg000270l	17612	17814	202	g_32831	g_6448
ptg000270l	18722	18848	126	g_6448	g_2282
ptg000270l	19600	19775	175	g_2282	g_23634
ptg000270l	20452	20532	80	g_23634	g_4449
ptg000270l	21416	24414	2998	g_4449	g_18601
ptg000270l	25280	25448	168	g_18601	g_31691
ptg000270l	27115	27186	71	g_31691	g_1325
ptg000270l	27956	28365	409	g_1325	g_9444
ptg000270l	29783	29799	16	g_9444	g_15304
ptg000270l	31865	33671	1806	g_15304	g_32941
ptg000270l	34045	34064	19	g_32941	g_30983
ptg000270l	34651	34728	77	g_30983	g_5353
ptg000273l	35411	53974	18563	g_5353	g_17759
ptg000273l	54369	91005	36636	g_17759	g_7000
ptg000273l	91331	106974	15643	g_7000	g_19883
ptg000273l	107369	145712	38343	g_19883	g_14341
ptg000273l	145912	146857	945	g_14341	g_32069
ptg000273l	147183	184951	37768	g_32069	g_2793
ptg000273l	185322	240465	55143	g_2793	g_29284
ptg000278l	3390	13078	9688	g_6169	g_35499
ptg000278l	13869	13902	33	g_35499	g_17236
ptg000278l	14609	14812	203	g_17236	g_28063
ptg000278l	15741	17387	1646	g_28063	g_35605
ptg000278l	18352	18579	227	g_35605	g_9256
ptg000278l	19352	19688	336	g_9256	g_33204
ptg000278l	21928	22123	195	g_33204	g_17329
ptg000278l	23382	23481	99	g_17329	g_6226
ptg000278l	24581	26512	1931	g_6226	g_37986
ptg000278l	27495	27542	47	g_37986	g_31435
ptg000278l	28504	28567	63	g_31435	g_20655
ptg000278l	30258	30347	89	g_20655	g_5233
ptg000278l	32623	32777	154	g_5233	g_33656
ptg000278l	33733	33774	41	g_33656	g_122
ptg000278l	34247	34403	156	g_122	g_8347
ptg000278l	34762	35127	365	g_8347	g_17050
ptg000278l	36050	36209	159	g_17050	g_33132
ptg000278l	36793	36823	30	g_33132	g_16033
ptg000278l	37683	37778	95	g_16033	g_32135
ptg000278l	38674	38678	4	g_32135	g_19852
ptg000278l	39589	39674	85	g_19852	g_1304
ptg000278l	40492	40557	65	g_1304	g_37441
ptg000278l	41513	42874	1361	g_37441	g_2784
ptg000278l	44160	53688	9528	g_2784	g_1760
ptg000278l	54767	57201	2434	g_1760	g_27900
ptg000282l	11055	46950	35895	g_5816	g_35792
ptg000282l	49801	51261	1460	g_35792	g_23742
ptg000282l	51737	70991	19254	g_23742	g_24074
ptg000289l	3302	5621	2319	g_28763	g_32867
ptg000289l	6085	9093	3008	g_32867	g_37543
ptg000289l	9755	9833	78	g_37543	g_7731
ptg000289l	11296	11478	182	g_7731	g_13407
ptg000289l	12254	12562	308	g_13407	g_14402
ptg000289l	13302	13582	280	g_14402	g_32864
ptg000289l	14211	14289	78	g_32864	g_19408
ptg000289l	14711	14765	54	g_19408	g_4191
ptg000289l	15337	15405	68	g_4191	g_25033
ptg000289l	16292	16440	148	g_25033	g_14265
ptg000289l	17024	17252	228	g_14265	g_22911
ptg000289l	17758	17892	134	g_22911	g_22236
ptg000289l	18254	19313	1059	g_22236	g_17990
ptg000289l	19771	19830	59	g_17990	g_21447
ptg000289l	20270	20392	122	g_21447	g_9231
ptg000289l	20898	21499	601	g_9231	g_13632
ptg000289l	22209	24061	1852	g_13632	g_10806
ptg000289l	25146	25247	101	g_10806	g_22075
ptg000289l	25573	25669	96	g_22075	g_33382
ptg000289l	26577	26611	34	g_33382	g_30567
ptg000289l	27237	27287	50	g_30567	g_27693
ptg000289l	27616	27716	100	g_27693	g_18650
ptg000289l	28894	28945	51	g_18650	g_35363
ptg000289l	30309	30376	67	g_35363	g_5259
ptg000289l	31188	32111	923	g_5259	g_13544
ptg000289l	32389	33838	1449	g_13544	g_19193
ptg000289l	34089	34224	135	g_19193	g_14859
ptg000289l	34511	34586	75	g_14859	g_3243
ptg000289l	34861	35536	675	g_3243	g_6568
ptg000289l	36324	36363	39	g_6568	g_15761
ptg000289l	36644	36796	152	g_15761	g_11110
ptg000289l	37062	37114	52	g_11110	g_5894
ptg000289l	37320	38408	1088	g_5894	g_29104
ptg000289l	39823	39928	105	g_29104	g_8276
ptg000289l	40725	40806	81	g_8276	g_13360
ptg000289l	41342	41372	30	g_13360	g_9962
ptg000289l	42616	42787	171	g_9962	g_5860
ptg000289l	43500	43572	72	g_5860	g_37940
ptg000289l	43904	44013	109	g_37940	g_13490
ptg000289l	44528	44638	110	g_13490	g_33094
ptg000289l	46644	46711	67	g_33094	g_4396
ptg000289l	47757	48056	299	g_4396	g_17862
ptg000289l	49393	49451	58	g_17862	g_30721
ptg000289l	49810	49877	67	g_30721	g_18931
ptg000289l	50155	50246	91	g_18931	g_23049
ptg000289l	52870	52959	89	g_23049	g_9810
ptg000289l	54050	54105	55	g_9810	g_24340
ptg000289l	55310	55333	23	g_24340	g_5386
ptg000289l	56355	56390	35	g_5386	g_4391
ptg000289l	57169	57210	41	g_4391	g_19777
ptg000289l	58148	58204	56	g_19777	g_37423
ptg000289l	59331	59466	135	g_37423	g_3473
ptg000289l	60404	60538	134	g_3473	g_34542
ptg000289l	61239	61284	45	g_34542	g_26415
ptg000289l	61691	66995	5304	g_26415	g_2746
ptg000301l	272	2916	2644	g_1025	g_14896
ptg000301l	4409	5978	1569	g_14896	g_38294
ptg000301l	7066	7134	68	g_38294	g_2348
ptg000301l	8159	8218	59	g_2348	g_33999
ptg000301l	9105	9168	63	g_33999	g_10307
ptg000301l	9812	9858	46	g_10307	g_23120
ptg000301l	10664	10736	72	g_23120	g_13088
ptg000301l	11617	11729	112	g_13088	g_34520
ptg000301l	12451	12581	130	g_34520	g_27708
ptg000301l	13354	13382	28	g_27708	g_3414
ptg000301l	13789	13867	78	g_3414	g_16510
ptg000301l	14682	14761	79	g_16510	g_38204
ptg000301l	16563	17789	1226	g_38204	g_4019
ptg000301l	19807	19985	178	g_4019	g_20751
ptg000301l	21421	21492	71	g_20751	g_20651
ptg000301l	22826	24886	2060	g_20651	g_18853
ptg000301l	25617	25845	228	g_18853	g_11845
ptg000301l	26267	26336	69	g_11845	g_14403
ptg000301l	26623	26733	110	g_14403	g_17371
ptg000303l	729	2834	2105	g_23055	g_3934
ptg000303l	3322	3438	116	g_3934	g_5341
ptg000303l	4721	12659	7938	g_5341	g_3380
ptg000303l	13822	16222	2400	g_3380	g_35913
ptg000303l	16638	16660	22	g_35913	g_27284
ptg000303l	17223	18210	987	g_27284	g_24085
ptg000303l	19397	21872	2475	g_24085	g_4425
ptg000303l	22426	22600	174	g_4425	g_14239
ptg000303l	22935	23995	1060	g_14239	g_20124
ptg000303l	24999	26351	1352	g_20124	g_28932
ptg000303l	26557	27678	1121	g_28932	g_37492
ptg000303l	28070	28148	78	g_37492	g_34156
ptg000309l	28821	76307	47486	g_34156	g_15225
ptg000315l	4263	4323	60	g_16406	g_22512
ptg000315l	4661	7510	2849	g_22512	g_28124
ptg000315l	8058	12504	4446	g_28124	g_6685
ptg000315l	12821	14803	1982	g_6685	g_25476
ptg000315l	15765	16129	364	g_25476	g_35750
ptg000315l	17529	17560	31	g_35750	g_1615
ptg000315l	19074	19353	279	g_1615	g_10148
ptg000315l	20033	21454	1421	g_10148	g_4555
ptg000315l	22680	24024	1344	g_4555	g_13129
ptg000315l	25070	25146	76	g_13129	g_11614
ptg000315l	25997	26063	66	g_11614	g_29839
ptg000315l	26734	26804	70	g_29839	g_2367
ptg000315l	28012	28128	116	g_2367	g_13086
ptg000315l	29066	31643	2577	g_13086	g_9673
ptg000315l	32896	32932	36	g_9673	g_4885
ptg000315l	33912	34219	307	g_4885	g_15763
ptg000315l	34482	36352	1870	g_15763	g_32954
ptg000315l	36753	36833	80	g_32954	g_33658
ptg000315l	37174	37326	152	g_33658	g_25179
ptg000315l	37997	39077	1080	g_25179	g_39238
ptg000315l	39481	41904	2423	g_39238	g_31555
ptg000315l	43106	43249	143	g_31555	g_6692
ptg000315l	43794	43904	110	g_6692	g_22154
ptg000315l	44281	44483	202	g_22154	g_4336
ptg000315l	44698	44810	112	g_4336	g_13142
ptg000315l	45490	48778	3288	g_13142	g_10180
ptg000315l	49236	49403	167	g_10180	g_11627
ptg000318l	7696	8638	942	g_8579	g_7875
ptg000318l	10980	35601	24621	g_7875	g_4974
ptg000318l	47319	55179	7860	g_4974	g_27160
ptg000318l	71058	72041	983	g_27160	g_20071
ptg000318l	72364	73232	868	g_20071	g_15582
ptg000318l	73555	94280	20725	g_15582	g_10665
ptg000318l	94489	148144	53655	g_10665	g_3955
ptg000318l	150360	234695	84335	g_3955	g_30326
ptg000329l	881	913	32	g_21918	g_18118
ptg000329l	1806	1880	74	g_18118	g_11584
ptg000329l	2962	3103	141	g_11584	g_27334
ptg000329l	4023	4084	61	g_27334	g_684
ptg000329l	10134	10332	198	g_684	g_21825
ptg000329l	10607	10653	46	g_21825	g_19869
ptg000329l	11708	11711	3	g_19869	g_17609
ptg000329l	13381	13497	116	g_17609	g_1367
ptg000329l	14177	14212	35	g_1367	g_16695
ptg000329l	15117	15227	110	g_16695	g_1032
ptg000333l	33941	51303	17362	g_37446	g_1869
ptg000333l	52433	62624	10191	g_1869	g_9228
ptg000335l	2358	2622	264	g_10056	g_30736
ptg000335l	4655	7933	3278	g_30736	g_6629
ptg000335l	9246	9295	49	g_6629	g_7540
ptg000335l	10722	11039	317	g_7540	g_30671
ptg000335l	12841	14010	1169	g_30671	g_17251
ptg000335l	14285	19041	4756	g_17251	g_5992
ptg000335l	20675	20736	61	g_5992	g_23224
ptg000335l	22334	22393	59	g_23224	g_34273
ptg000335l	23373	29540	6167	g_34273	g_22465
ptg000335l	29965	29989	24	g_22465	g_13468
ptg000335l	31182	31205	23	g_13468	g_22584
ptg000349l	7190	10084	2894	g_7207	g_23777
ptg000349l	10785	33710	22925	g_23777	g_13058
ptg000371l	1294	3873	2579	g_25268	g_4593
ptg000371l	4898	7013	2115	g_4593	g_901
ptg000371l	7417	7528	111	g_901	g_11416
ptg000371l	8625	8648	23	g_11416	g_29286
ptg000371l	9805	9835	30	g_29286	g_8732
ptg000371l	10230	10267	37	g_8732	g_37189
ptg000371l	11181	11344	163	g_37189	g_8611
ptg000371l	12645	12881	236	g_8611	g_10393
ptg000371l	13141	14893	1752	g_10393	g_7135
ptg000371l	16095	16211	116	g_7135	g_25064
ptg000371l	17647	17670	23	g_25064	g_38232
ptg000371l	18734	18968	234	g_38232	g_37525
ptg000376l	207	3723	3516	g_33548	g_25541
ptg000376l	4109	8853	4744	g_25541	g_13140
ptg000376l	9401	9477	76	g_13140	g_18215
ptg000387l	2087	2264	177	g_3247	g_39962
ptg000387l	2980	3058	78	g_39962	g_28487
ptg000387l	4380	5562	1182	g_28487	g_36944
ptg000387l	6056	6221	165	g_36944	g_32282
ptg000387l	6589	6692	103	g_32282	g_11369
ptg000387l	7432	7519	87	g_11369	g_2350
ptg000387l	8175	9931	1756	g_2350	g_2988
ptg000387l	10992	11082	90	g_2988	g_20138
ptg000387l	12812	12899	87	g_20138	g_20931
ptg000400l	248	277	29	g_24258	g_24542
ptg000400l	1206	1313	107	g_24542	g_30055
ptg000400l	2278	3347	1069	g_30055	g_13801
ptg000400l	4276	4404	128	g_13801	g_33009
ptg000400l	5186	5428	242	g_33009	g_7185
ptg000400l	9060	9187	127	g_7185	g_1046
ptg000400l	10476	10505	29	g_1046	g_1689
ptg000400l	11014	11776	762	g_1689	g_26946
ptg000400l	12858	12954	96	g_26946	g_27051
ptg000400l	13454	13476	22	g_27051	g_3229
ptg000400l	14294	14476	182	g_3229	g_15107
ptg000400l	15057	15136	79	g_15107	g_21601
ptg000400l	16566	16610	44	g_21601	g_34626
ptg000400l	17050	17116	66	g_34626	g_32953
ptg000400l	18462	18477	15	g_32953	g_7641
ptg000405l	72	106	34	g_17382	g_16356
ptg000405l	981	6065	5084	g_16356	g_3984
ptg000405l	6337	6482	145	g_3984	g_24572
ptg000405l	7504	7544	40	g_24572	g_2599
ptg000405l	7861	7913	52	g_2599	g_13861
ptg000405l	8923	12089	3166	g_13861	g_15018
ptg000405l	12856	12879	23	g_15018	g_32875
ptg000405l	13325	13354	29	g_32875	g_29404
ptg000405l	13749	15129	1380	g_29404	g_434
ptg000405l	15689	15796	107	g_434	g_24585
ptg000405l	16194	16271	77	g_24585	g_2
ptg000405l	17743	17845	102	g_2	g_33073
ptg000405l	18273	18340	67	g_33073	g_11621
ptg000405l	19032	19205	173	g_11621	g_26113
ptg000405l	19630	19891	261	g_26113	g_23031
ptg000405l	20112	20313	201	g_23031	g_19359
ptg000405l	20687	22272	1585	g_19359	g_1431
ptg000405l	22544	22651	107	g_1431	g_35577
ptg000405l	23832	23896	64	g_35577	g_6528
ptg000405l	24195	24412	217	g_6528	g_20261
ptg000405l	25314	27364	2050	g_20261	g_28374
ptg000405l	29295	29451	156	g_28374	g_25401
ptg000405l	29993	30197	204	g_25401	g_27962
ptg000405l	30400	30560	160	g_27962	g_14250
ptg000405l	30787	32024	1237	g_14250	g_27858
ptg000405l	32332	34606	2274	g_27858	g_30161
ptg000405l	34833	34898	65	g_30161	g_27856
ptg000411l	573	7829	7256	g_34568	g_15920
ptg000411l	9562	9610	48	g_15920	g_4675
ptg000411l	9936	18227	8291	g_4675	g_14421
ptg000411l	19759	19866	107	g_14421	g_20213
ptg000411l	22526	22589	63	g_20213	g_35509
ptg000411l	23512	23775	263	g_35509	g_31449
ptg000411l	24050	24080	30	g_31449	g_3709
ptg000411l	24334	24366	32	g_3709	g_16820
ptg000411l	24644	24840	196	g_16820	g_10508
ptg000411l	25544	25575	31	g_10508	g_594
ptg000411l	25829	25925	96	g_594	g_27421
ptg000411l	26158	26222	64	g_27421	g_19261
ptg000411l	27037	28616	1579	g_19261	g_11660
ptg000411l	30817	30996	179	g_11660	g_15408
ptg000411l	31781	31863	82	g_15408	g_11328
ptg000411l	32102	32141	39	g_11328	g_5620
ptg000411l	32740	32867	127	g_5620	g_37771
ptg000411l	33334	33480	146	g_37771	g_11317
ptg000411l	34811	34881	70	g_11317	g_35028
ptg000411l	35918	36088	170	g_35028	g_27634
ptg000411l	37800	37879	79	g_27634	g_23515
ptg000411l	39714	39826	112	g_23515	g_19937
ptg000411l	40617	40668	51	g_19937	g_1851
ptg000411l	41462	41632	170	g_1851	g_22700
ptg000411l	42867	43109	242	g_22700	g_18866
ptg000411l	44344	44397	53	g_18866	g_37267
ptg000411l	45350	48407	3057	g_37267	g_9867
ptg000412l	27386	45348	17962	g_7447	g_33326
ptg000412l	50980	54042	3062	g_33326	g_24374
ptg000412l	56285	58536	2251	g_24374	g_19685
ptg000412l	61047	61248	201	g_19685	g_26066
ptg000415l	253	487	234	g_37846	g_1440
ptg000415l	1254	1284	30	g_1440	g_7493
ptg000415l	2315	2490	175	g_7493	g_31839
ptg000415l	3284	3368	84	g_31839	g_22617
ptg000415l	4021	5292	1271	g_22617	g_28383
ptg000415l	6218	10038	3820	g_28383	g_23805
ptg000415l	10496	10625	129	g_23805	g_27807
ptg000418l	12964	96924	83960	g_27807	g_30693
ptg000418l	99280	125052	25772	g_30693	g_17327
ptg000418l	127857	133048	5191	g_17327	g_347
ptg000418l	147376	170857	23481	g_347	g_7025
ptg000418l	175872	176226	354	g_7025	g_32380
ptg000418l	176621	176658	37	g_32380	g_10581
ptg000418l	177026	177063	37	g_10581	g_4506
ptg000418l	178754	178893	139	g_4506	g_20098
ptg000418l	192609	206110	13501	g_20098	g_5158
ptg000418l	206805	211414	4609	g_5158	g_39549
ptg000418l	212154	212239	85	g_39549	g_39992
ptg000418l	217587	228025	10438	g_39992	g_18115
ptg000418l	232970	275768	42798	g_18115	g_36862
ptg000418l	276256	284870	8614	g_36862	g_37000
ptg000418l	292974	356346	63372	g_37000	g_26660
ptg000418l	378293	457129	78836	g_26660	g_25474
ptg000418l	465976	466177	201	g_25474	g_39822
ptg000418l	466404	488555	22151	g_39822	g_35406
ptg000418l	489016	528039	39023	g_35406	g_18878
ptg000418l	528281	593360	65079	g_18878	g_4162
ptg000422l	650	752	102	g_34137	g_11103
ptg000422l	1315	1565	250	g_11103	g_30826
ptg000422l	1879	2119	240	g_30826	g_19393
ptg000422l	2385	2593	208	g_19393	g_25808
ptg000422l	4854	4973	119	g_25808	g_20809
ptg000422l	5974	5977	3	g_20809	g_34082
ptg000422l	6723	6782	59	g_34082	g_22139
ptg000422l	7174	7450	276	g_22139	g_16068
ptg000422l	7809	8964	1155	g_16068	g_627
ptg000422l	10217	12126	1909	g_627	g_7610
ptg000422l	15271	15337	66	g_7610	g_33270
ptg000422l	15792	15827	35	g_33270	g_32386
ptg000422l	16495	16531	36	g_32386	g_36236
ptg000422l	16800	22278	5478	g_36236	g_2248
ptg000422l	22787	23230	443	g_2248	g_15502
ptg000422l	24171	24242	71	g_15502	g_35736
ptg000422l	24883	26238	1355	g_35736	g_2444
ptg000425l	1988	12103	10115	g_23419	g_10782
ptg000425l	13137	13190	53	g_10782	g_14950
ptg000425l	13807	13981	174	g_14950	g_23332
ptg000425l	15135	16260	1125	g_23332	g_35733
ptg000425l	17168	17270	102	g_35733	g_11365
ptg000425l	18919	18960	41	g_11365	g_15938
ptg000425l	19211	19269	58	g_15938	g_39457
ptg000425l	19829	19882	53	g_39457	g_31642
ptg000425l	21161	26792	5631	g_31642	g_26362
ptg000430l	2590	2657	67	g_13251	g_22807
ptg000430l	3253	3390	137	g_22807	g_29669
ptg000430l	3854	4121	267	g_29669	g_4860
ptg000430l	5488	9756	4268	g_4860	g_3218
ptg000430l	10169	12479	2310	g_3218	g_5908
ptg000430l	13426	17392	3966	g_5908	g_25488
ptg000430l	17664	17757	93	g_25488	g_14826
ptg000430l	19085	21299	2214	g_14826	g_22467
ptg000430l	22453	23267	814	g_22467	g_22005
ptg000430l	24220	26875	2655	g_22005	g_278
ptg000430l	27510	27679	169	g_278	g_16942
ptg000430l	29205	30747	1542	g_16942	g_27463
ptg000430l	32237	32270	33	g_27463	g_3413
ptg000430l	32719	34399	1680	g_3413	g_17543
ptg000430l	34653	36109	1456	g_17543	g_8880
ptg000430l	36450	38733	2283	g_8880	g_23786
ptg000430l	39095	39238	143	g_23786	g_7497
ptg000430l	39492	39680	188	g_7497	g_33029
ptg000430l	39883	42172	2289	g_33029	g_1835
ptg000430l	42426	43965	1539	g_1835	g_2518
ptg000430l	44435	45294	859	g_2518	g_37458
ptg000430l	46283	46398	115	g_37458	g_7131
ptg000435l	579	809	230	g_21160	g_7386
ptg000435l	1579	1792	213	g_7386	g_7387
ptg000435l	3030	3216	186	g_7387	g_24176
ptg000435l	3758	10050	6292	g_24176	g_23933
ptg000435l	10715	11371	656	g_23933	g_31376
ptg000435l	12561	12733	172	g_31376	g_3942
ptg000435l	13116	13206	90	g_3942	g_4761
ptg000435l	13700	15307	1607	g_4761	g_21748
ptg000435l	15723	15761	38	g_21748	g_469
ptg000435l	16138	16415	277	g_469	g_38259
ptg000435l	17944	17980	36	g_38259	g_14680
ptg000435l	20526	27655	7129	g_14680	g_12273
ptg000435l	29898	29940	42	g_12273	g_17448
ptg000435l	30611	30855	244	g_17448	g_9939
ptg000435l	31307	42013	10706	g_9939	g_36031
ptg000435l	42747	42796	49	g_36031	g_17632
ptg000435l	43155	47675	4520	g_17632	g_34329
ptg000435l	47977	48392	415	g_34329	g_754
ptg000436l	267	3651	3384	g_19601	g_13841
ptg000436l	4631	4656	25	g_13841	g_33313
ptg000436l	6053	9703	3650	g_33313	g_10757
ptg000436l	10731	14099	3368	g_10757	g_10350
ptg000436l	14836	16524	1688	g_10350	g_34427
ptg000436l	17423	17867	444	g_34427	g_33112
ptg000436l	18811	19129	318	g_33112	g_16775
ptg000436l	19674	19710	36	g_16775	g_20476
ptg000436l	20969	21002	33	g_20476	g_28791
ptg000436l	22045	22202	157	g_28791	g_15504
ptg000436l	22858	23095	237	g_15504	g_2540
ptg000436l	23415	23424	9	g_2540	g_7201
ptg000436l	24371	24478	107	g_7201	g_19406
ptg000436l	25440	25473	33	g_19406	g_31865
ptg000436l	26549	26580	31	g_31865	g_13241
ptg000436l	27992	28187	195	g_13241	g_34915
ptg000436l	28660	28759	99	g_34915	g_32678
ptg000436l	29850	29945	95	g_32678	g_24429
ptg000436l	30703	30775	72	g_24429	g_25118
ptg000436l	32826	32879	53	g_25118	g_33213
ptg000436l	34705	34747	42	g_33213	g_14395
ptg000436l	35223	35299	76	g_14395	g_23570
ptg000436l	35964	36099	135	g_23570	g_13078
ptg000436l	36650	36758	108	g_13078	g_3244
ptg000436l	38026	38067	41	g_3244	g_37026
ptg000436l	38399	39372	973	g_37026	g_40294
ptg000436l	40202	50706	10504	g_40294	g_14847
ptg000436l	51353	51406	53	g_14847	g_20160
ptg000436l	53124	54219	1095	g_20160	g_13315
ptg000436l	54425	54511	86	g_13315	g_29916
ptg000436l	54996	55285	289	g_29916	g_26781
ptg000436l	56229	56301	72	g_26781	g_30165
ptg000436l	56831	58859	2028	g_30165	g_22303
ptg000436l	59227	59281	54	g_22303	g_36763
ptg000436l	59781	59826	45	g_36763	g_8333
ptg000436l	60845	60926	81	g_8333	g_21131
ptg000436l	61180	61319	139	g_21131	g_16250
ptg000436l	61612	61657	45	g_16250	g_10577
ptg000436l	62181	62281	100	g_10577	g_17238
ptg000436l	62529	62794	265	g_17238	g_8209
ptg000436l	63297	64569	1272	g_8209	g_1989
ptg000436l	65114	65261	147	g_1989	g_30291
ptg000436l	65479	65487	8	g_30291	g_10776
ptg000436l	66584	66719	135	g_10776	g_6776
ptg000436l	66946	66956	10	g_6776	g_24531
ptg000436l	67165	67879	714	g_24531	g_4203
ptg000436l	68340	68547	207	g_4203	g_34510
ptg000436l	69179	70462	1283	g_34510	g_19127
ptg000436l	70758	74804	4046	g_19127	g_36857
ptg000436l	75016	84268	9252	g_36857	g_8363
ptg000436l	84672	86059	1387	g_8363	g_15513
ptg000436l	86811	86844	33	g_15513	g_29532
ptg000436l	87458	87521	63	g_29532	g_12545
ptg000436l	87886	90114	2228	g_12545	g_29990
ptg000436l	91841	92989	1148	g_29990	g_19084
ptg000436l	93459	93628	169	g_19084	g_34313
ptg000436l	94329	94388	59	g_34313	g_20229
ptg000436l	95395	95468	73	g_20229	g_29264
ptg000436l	95953	95992	39	g_29264	g_8643
ptg000436l	96405	98793	2388	g_8643	g_34813
ptg000436l	99362	102548	3186	g_34813	g_9518
ptg000436l	102751	102862	111	g_9518	g_22398
ptg000436l	103977	104164	187	g_22398	g_13593
ptg000436l	105228	105244	16	g_13593	g_13545
ptg000436l	106359	110651	4292	g_13545	g_18806
ptg000436l	111190	111258	68	g_18806	g_975
ptg000436l	112709	112922	213	g_975	g_24964
ptg000436l	113803	114494	691	g_24964	g_35870
ptg000436l	115243	117386	2143	g_35870	g_11412
ptg000436l	118231	118287	56	g_11412	g_35802
ptg000436l	118643	118695	52	g_35802	g_15413
ptg000436l	119165	121076	1911	g_15413	g_35506
ptg000445l	2504	2604	100	g_30128	g_33520
ptg000445l	3515	3868	353	g_33520	g_12686
ptg000445l	4794	4926	132	g_12686	g_29359
ptg000445l	5174	5197	23	g_29359	g_19888
ptg000445l	5460	5505	45	g_19888	g_36227
ptg000445l	6722	6764	42	g_36227	g_13626
ptg000445l	7645	7686	41	g_13626	g_10309
ptg000445l	8762	11467	2705	g_10309	g_4315
ptg000445l	11838	11897	59	g_4315	g_2847
ptg000445l	12775	19269	6494	g_2847	g_19832
ptg000445l	20318	20348	30	g_19832	g_15705
ptg000445l	22258	27122	4864	g_15705	g_30635
ptg000445l	28156	28388	232	g_30635	g_25584
ptg000445l	28798	29965	1167	g_25584	g_6963
ptg000445l	31407	31446	39	g_6963	g_30678
ptg000445l	32408	33417	1009	g_30678	g_17995
ptg000445l	34013	34241	228	g_17995	g_34611
ptg000445l	35902	37032	1130	g_34611	g_13303
ptg000445l	37706	37778	72	g_13303	g_16864
ptg000445l	38761	41517	2756	g_16864	g_31755
ptg000445l	42266	43992	1726	g_31755	g_15245
ptg000445l	44699	44742	43	g_15245	g_10447
ptg000445l	46343	48315	1972	g_10447	g_30268
ptg000445l	48686	54214	5528	g_30268	g_32366
ptg000451l	3816	11724	7908	g_5164	g_30806
ptg000457l	9143	11098	1955	g_38841	g_33302
ptg000463l	491	4245	3754	g_29905	g_13859
ptg000463l	4826	4903	77	g_13859	g_37059
ptg000463l	5241	11146	5905	g_37059	g_22245
ptg000463l	11652	13706	2054	g_22245	g_30370
ptg000463l	14638	16259	1621	g_30370	g_15327
ptg000463l	16831	16947	116	g_15327	g_1469
ptg000463l	17756	17819	63	g_1469	g_892
ptg000463l	18091	18159	68	g_892	g_28595
ptg000463l	19151	19418	267	g_28595	g_27010
ptg000465l	4782	4842	60	g_35829	g_28660
ptg000465l	5855	5915	60	g_28660	g_15764
ptg000465l	9178	9216	38	g_15764	g_34949
ptg000465l	9548	9626	78	g_34949	g_3450
ptg000465l	10633	10801	168	g_3450	g_35361
ptg000465l	11178	11486	308	g_35361	g_15799
ptg000465l	13783	13838	55	g_15799	g_11006
ptg000480l	2501	2588	87	g_21663	g_199
ptg000480l	2935	2949	14	g_199	g_17040
ptg000480l	3770	9032	5262	g_17040	g_5087
ptg000480l	9706	9736	30	g_5087	g_21408
ptg000480l	10344	10419	75	g_21408	g_25259
ptg000480l	11009	11094	85	g_25259	g_5311
ptg000480l	11333	11394	61	g_5311	g_37444
ptg000480l	11846	12758	912	g_37444	g_14732
ptg000480l	13444	15375	1931	g_14732	g_29126
ptg000480l	16349	16450	101	g_29126	g_14998
ptg000480l	16935	17017	82	g_14998	g_11864
ptg000480l	18135	20484	2349	g_11864	g_18413
ptg000480l	20918	23629	2711	g_18413	g_12032
ptg000480l	24666	24704	38	g_12032	g_16616
ptg000480l	25885	25911	26	g_16616	g_9693
ptg000480l	26729	26908	179	g_9693	g_24027
ptg000480l	28710	29609	899	g_24027	g_17180
ptg000492l	162	258	96	g_28967	g_26051
ptg000492l	896	983	87	g_26051	g_23769
ptg000492l	1219	2892	1673	g_23769	g_34486
ptg000492l	3233	11573	8340	g_34486	g_22894
ptg000492l	12394	12448	54	g_22894	g_37587
ptg000492l	13425	13479	54	g_37587	g_13613
ptg000492l	14219	16779	2560	g_13613	g_25931
ptg000492l	17915	19479	1564	g_25931	g_191
ptg000492l	20912	21017	105	g_191	g_19991
ptg000492l	21853	21916	63	g_19991	g_12778
ptg000492l	22458	22612	154	g_12778	g_21984
ptg000492l	23139	23321	182	g_21984	g_29543
ptg000492l	25090	25582	492	g_29543	g_14766
ptg000492l	27426	27430	4	g_14766	g_27308
ptg000492l	28731	30583	1852	g_27308	g_19370
ptg000492l	30921	31023	102	g_19370	g_24313
ptg000492l	31328	32058	730	g_24313	g_32657
ptg000492l	32438	32646	208	g_32657	g_24158
ptg000492l	33437	33524	87	g_24158	g_31151
ptg000492l	33982	34164	182	g_31151	g_6401
ptg000492l	34412	34830	418	g_6401	g_28921
ptg000492l	36614	36770	156	g_28921	g_24099
ptg000492l	37261	37957	696	g_24099	g_2012
ptg000492l	38238	39624	1386	g_2012	g_1302
ptg000492l	39920	40089	169	g_1302	g_25901
ptg000494l	11242	21451	10209	g_17598	g_38820
ptg000500l	286	1816	1530	g_4586	g_5457
ptg000500l	2196	2225	29	g_5457	g_15032
ptg000500l	3067	3126	59	g_15032	g_10903
ptg000500l	3350	3383	33	g_10903	g_16159
ptg000500l	3790	3917	127	g_16159	g_21537
ptg000500l	4510	4573	63	g_21537	g_17421
ptg000500l	5085	5144	59	g_17421	g_18822
ptg000500l	5464	5513	49	g_18822	g_728
ptg000500l	6397	12918	6521	g_728	g_28991
ptg000500l	13124	18285	5161	g_28991	g_5448
ptg000500l	21578	21616	38	g_5448	g_12269
ptg000500l	22140	22223	83	g_12269	g_26011
ptg000500l	27334	30734	3400	g_26011	g_5625
ptg000500l	31123	31252	129	g_5625	g_20171
ptg000500l	32328	32393	65	g_20171	g_16782
ptg000500l	33583	38262	4679	g_16782	g_32588
ptg000500l	39032	39139	107	g_32588	g_31706
ptg000500l	40572	40833	261	g_31706	g_36791
ptg000500l	41360	41385	25	g_36791	g_35100
ptg000500l	42917	43265	348	g_35100	g_30089
ptg000500l	43774	44081	307	g_30089	g_18054
ptg000500l	44572	46751	2179	g_18054	g_29336
ptg000500l	46951	47192	241	g_29336	g_33589
ptg000500l	47425	48734	1309	g_33589	g_18574
ptg000500l	49186	49235	49	g_18574	g_22755
ptg000500l	49675	49968	293	g_22755	g_33417
ptg000500l	50336	51005	669	g_33417	g_6191
ptg000500l	51205	53260	2055	g_6191	g_24212
ptg000500l	53742	53772	30	g_24212	g_15732
ptg000505l	481	621	140	g_1713	g_16129
ptg000505l	2183	2219	36	g_16129	g_2516
ptg000505l	3298	5034	1736	g_2516	g_27773
ptg000505l	5561	11191	5630	g_27773	g_3417
ptg000505l	11841	18214	6373	g_3417	g_14216
ptg000505l	18870	18926	56	g_14216	g_13872
ptg000505l	21313	21631	318	g_13872	g_14480
ptg000505l	22701	26725	4024	g_14480	g_21835
ptg000505l	28311	30178	1867	g_21835	g_10488
ptg000505l	31356	34809	3453	g_10488	g_6243
ptg000505l	35900	36093	193	g_6243	g_8138
ptg000505l	37505	37544	39	g_8138	g_8814
ptg000505l	39061	39157	96	g_8814	g_35632
ptg000505l	39960	40149	189	g_35632	g_18552
ptg000505l	41156	43367	2211	g_18552	g_23085
ptg000505l	44026	45111	1085	g_23085	g_37760
ptg000505l	45680	45736	56	g_37760	g_7286
ptg000505l	46446	46635	189	g_7286	g_33556
ptg000505l	51365	51387	22	g_33556	g_28354
ptg000507l	7399	8918	1519	g_12428	g_32217
ptg000507l	9199	12754	3555	g_32217	g_7549
ptg000507l	13002	13251	249	g_7549	g_22574
ptg000507l	13652	13680	28	g_22574	g_29614
ptg000507l	14027	21474	7447	g_29614	g_21303
ptg000507l	22940	23180	240	g_21303	g_29885
ptg000507l	24529	24682	153	g_29885	g_1786
ptg000507l	25584	27717	2133	g_1786	g_36823
ptg000507l	28022	28032	10	g_36823	g_34996
ptg000507l	29237	29340	103	g_34996	g_29880
ptg000509l	2682	2692	10	g_38551	g_31583
ptg000509l	3483	3518	35	g_31583	g_27288
ptg000509l	4195	6428	2233	g_27288	g_3255
ptg000509l	8035	10106	2071	g_3255	g_32150
ptg000509l	10909	10988	79	g_32150	g_13984
ptg000509l	11497	11773	276	g_13984	g_7931
ptg000509l	12489	12505	16	g_7931	g_23498
ptg000509l	13140	14836	1696	g_23498	g_20499
ptg000544l	10097	10467	370	g_36469	g_22881
ptg000549l	1565	1907	342	g_13608	g_15417
ptg000549l	2173	13350	11177	g_15417	g_16089
ptg000549l	14285	14655	370	g_16089	g_28312
ptg000549l	16889	17044	155	g_28312	g_37534
ptg000549l	17391	17501	110	g_37534	g_21921
ptg000549l	17710	18064	354	g_21921	g_15428
ptg000549l	18465	19849	1384	g_15428	g_13895
ptg000549l	20739	20931	192	g_13895	g_16424
ptg000549l	21491	23242	1751	g_16424	g_31500
ptg000549l	24681	24789	108	g_31500	g_28139
ptg000549l	26996	27500	504	g_28139	g_34183
ptg000549l	28042	28186	144	g_34183	g_21152
ptg000549l	28416	28617	201	g_21152	g_37762
ptg000549l	29879	29928	49	g_37762	g_8063
ptg000549l	30602	30798	196	g_8063	g_23990
ptg000549l	31172	32540	1368	g_23990	g_826
ptg000549l	33307	33392	85	g_826	g_32331
ptg000549l	34090	34127	37	g_32331	g_12207
ptg000556l	410	492	82	g_31687	g_2747
ptg000556l	932	3918	2986	g_2747	g_16245
ptg000556l	4307	4359	52	g_16245	g_6164
ptg000556l	4955	5030	75	g_6164	g_294
ptg000556l	5584	5681	97	g_294	g_21999
ptg000556l	6397	6513	116	g_21999	g_1957
ptg000556l	8174	8603	429	g_1957	g_2156
ptg000556l	10411	10642	231	g_2156	g_39940
ptg000556l	11388	15590	4202	g_39940	g_2117
ptg000556l	16690	18604	1914	g_2117	g_21146
ptg000556l	19239	27102	7863	g_21146	g_384
ptg000556l	27485	28686	1201	g_384	g_22328
ptg000556l	29630	34994	5364	g_22328	g_23170
ptg000556l	35524	35560	36	g_23170	g_2423
ptg000556l	36048	39959	3911	g_2423	g_27114
ptg000556l	40903	41145	242	g_27114	g_21150
ptg000556l	42395	42465	70	g_21150	g_11347
ptg000556l	43607	43708	101	g_11347	g_21178
ptg000556l	44109	46443	2334	g_21178	g_27829
ptg000556l	47000	47337	337	g_27829	g_20572
ptg000556l	47618	47691	73	g_20572	g_28770
ptg000574l	1866	3321	1455	g_34670	g_9150
ptg000574l	3638	3757	119	g_9150	g_11679
ptg000574l	5091	5293	202	g_11679	g_37602
ptg000574l	6192	6331	139	g_37602	g_8465
ptg000574l	7200	7299	99	g_8465	g_36089
ptg000574l	7664	7745	81	g_36089	g_3436
ptg000574l	8845	8950	105	g_3436	g_29295
ptg000574l	9435	9470	35	g_29295	g_25700
ptg000574l	10135	10176	41	g_25700	g_1923
ptg000574l	11069	20174	9105	g_1923	g_1244
ptg000574l	20722	20916	194	g_1244	g_14825
ptg000574l	21560	21578	18	g_14825	g_8917
ptg000574l	22654	22744	90	g_8917	g_9128
ptg000574l	23838	23860	22	g_9128	g_35187
ptg000574l	25284	27224	1940	g_35187	g_13482
